"","DEPARTMENT","MUNICIPALITY","PRECINCT","CC","FPV","MTS","UCS","MAS","X21F","PDC","MNR","PAN.BOL","VALID","BLANK","NULL.","VOTES","ELECTORATE","MAS.vote","Turnout"
"1","Chuquisaca","Sucre","Escuela Seccional De Chaunaca",12,2,4,2,135,3,11,1,1,171,6,12,189,219,0.789,0.863
"2","Chuquisaca","Sucre","Unidad Educativa Chuqui Chuqui",30,1,1,2,118,3,11,2,0,168,11,13,192,221,0.702,0.869
"3","Chuquisaca","Sucre","Unidad Educativa Chuqui Chuqui",29,2,1,1,118,6,15,0,0,172,13,5,190,213,0.686,0.892
"4","Chuquisaca","Sucre","Escuela Fray Gabriel Maria Landini",11,3,1,3,123,3,9,0,5,158,12,10,180,219,0.778,0.822
"5","Chuquisaca","Sucre","Escuela Fray Gabriel Maria Landini",19,2,3,0,113,0,12,3,3,155,15,7,177,209,0.729,0.847
"6","Chuquisaca","Sucre","Escuela Fray Gabriel Mariscal",14,1,5,1,112,3,8,1,9,154,12,14,180,218,0.727,0.826
"7","Chuquisaca","Sucre","Escuela Punilla",35,1,4,0,86,11,21,2,5,165,9,14,188,216,0.521,0.87
"8","Chuquisaca","Sucre","Unidad Educativa La Palma",32,0,1,1,111,6,13,1,0,165,16,4,185,210,0.673,0.881
"9","Chuquisaca","Sucre","Unidad Educativa La Palma",33,3,0,1,101,3,16,1,3,161,14,13,188,214,0.627,0.879
"10","Chuquisaca","Sucre","Unidad Educativa La Palma",25,1,3,3,105,2,19,0,2,160,16,10,186,217,0.656,0.857
"11","Chuquisaca","Sucre","Escuela José Sampa",36,2,1,2,76,8,34,2,4,165,10,13,188,219,0.461,0.858
"12","Chuquisaca","Sucre","Unidad Educativa Luis Espinal",41,0,0,0,101,10,21,1,3,177,7,14,198,222,0.571,0.892
"13","Chuquisaca","Sucre","Unidad Educativa Luis Espinal",55,1,1,4,81,5,19,2,7,175,5,11,191,223,0.463,0.857
"14","Chuquisaca","Sucre","U. Edu. Gualberto Villarroel",17,1,1,0,119,4,15,1,0,158,14,7,179,208,0.753,0.861
"15","Chuquisaca","Sucre","U. Edu. Gualberto Villarroel",15,0,4,0,129,2,13,5,0,168,16,7,191,216,0.768,0.884
"16","Chuquisaca","Sucre","U. Edu. Gualberto Villarroel",19,1,3,2,108,2,16,3,0,154,18,8,180,208,0.701,0.865
"17","Chuquisaca","Sucre","U. Edu. Gualberto Villarroel",10,1,1,2,113,7,19,0,0,153,19,8,180,207,0.739,0.87
"18","Chuquisaca","Sucre","U. Edu. Gualberto Villarroel",8,3,0,2,118,3,16,5,0,155,21,5,181,201,0.761,0.9
"19","Chuquisaca","Sucre","Unidad Educativa Quila Quila",39,3,3,4,98,3,11,1,0,162,16,14,192,217,0.605,0.885
"20","Chuquisaca","Sucre","Kinder San Vicente De Paul",155,0,0,0,25,3,14,0,0,197,0,5,202,224,0.127,0.902
"21","Chuquisaca","Sucre","Kinder San Vicente De Paul",162,0,0,0,21,1,1,1,0,186,3,2,191,223,0.113,0.857
"22","Chuquisaca","Sucre","Kinder San Vicente De Paul",147,1,0,1,33,2,9,0,0,193,0,4,197,220,0.171,0.895
"23","Chuquisaca","Sucre","Kinder San Vicente De Paul",150,0,0,2,28,1,13,4,3,201,1,2,204,221,0.139,0.923
"24","Chuquisaca","Sucre","Kinder San Vicente De Paul",158,0,1,0,26,3,8,0,1,197,0,3,200,226,0.132,0.885
"25","Chuquisaca","Sucre","Kinder San Vicente De Paul",135,0,0,1,33,4,11,0,0,184,1,6,191,218,0.179,0.876
"26","Chuquisaca","Sucre","Kinder San Vicente De Paul",162,0,0,0,16,0,7,0,1,186,2,1,189,224,0.086,0.844
"27","Chuquisaca","Sucre","Kinder San Vicente De Paul",163,0,1,3,20,3,8,1,0,199,0,1,200,227,0.101,0.881
"28","Chuquisaca","Sucre","Kinder San Vicente De Paul",142,0,0,0,25,2,4,1,1,175,2,1,178,205,0.143,0.868
"29","Chuquisaca","Sucre","Esc. Benjamin Guzman",163,0,1,0,21,0,5,1,0,191,2,6,199,221,0.11,0.9
"30","Chuquisaca","Sucre","Esc. Benjamin Guzman",145,0,2,0,28,6,5,2,0,188,1,6,195,211,0.149,0.924
"31","Chuquisaca","Sucre","Esc. Benjamin Guzman",145,0,1,0,40,1,11,0,2,200,0,2,202,220,0.2,0.918
"32","Chuquisaca","Sucre","Esc. Benjamin Guzman",152,1,1,1,35,2,9,0,2,203,1,6,210,225,0.172,0.933
"33","Chuquisaca","Sucre","Esc. Benjamin Guzman",136,1,1,1,35,2,5,2,1,184,1,5,190,220,0.19,0.864
"34","Chuquisaca","Sucre","Esc. Benjamin Guzman",142,0,0,1,29,2,6,1,1,182,2,2,186,216,0.159,0.861
"35","Chuquisaca","Sucre","Esc. Benjamin Guzman",160,0,2,0,24,1,5,0,3,195,2,2,199,227,0.123,0.877
"36","Chuquisaca","Sucre","U.Pedag. Mariscal Sucre",166,0,0,1,26,1,4,1,1,200,0,1,201,225,0.13,0.893
"37","Chuquisaca","Sucre","U.Pedag. Mariscal Sucre",135,0,1,1,35,6,13,0,1,192,0,4,196,224,0.182,0.875
"38","Chuquisaca","Sucre","U.Pedag. Mariscal Sucre",152,0,0,0,26,2,4,0,2,186,1,5,192,223,0.14,0.861
"39","Chuquisaca","Sucre","U.Pedag. Mariscal Sucre",154,0,1,0,20,1,9,1,2,188,0,8,196,220,0.106,0.891
"40","Chuquisaca","Sucre","U.Pedag. Mariscal Sucre",151,1,0,0,26,1,10,0,0,189,2,7,198,224,0.138,0.884
"41","Chuquisaca","Sucre","U.Pedag. Mariscal Sucre",136,0,0,0,38,2,11,1,0,188,0,10,198,222,0.202,0.892
"42","Chuquisaca","Sucre","U.Pedag. Mariscal Sucre",165,1,0,0,24,1,1,1,0,193,1,5,199,225,0.124,0.884
"43","Chuquisaca","Sucre","Facultad de Tecnología",156,0,0,0,24,4,11,0,1,196,1,7,204,230,0.122,0.887
"44","Chuquisaca","Sucre","Facultad de Tecnología",144,0,1,0,32,0,7,1,0,185,0,3,188,228,0.173,0.825
"45","Chuquisaca","Sucre","Facultad de Tecnología",140,0,0,2,34,1,17,2,1,197,1,4,202,229,0.173,0.882
"46","Chuquisaca","Sucre","Facultad de Tecnología",158,0,0,0,26,5,12,1,2,204,3,5,212,235,0.127,0.902
"47","Chuquisaca","Sucre","Facultad de Tecnología",119,0,0,0,43,4,24,0,3,193,1,4,198,231,0.223,0.857
"48","Chuquisaca","Sucre","Facultad de Tecnología",150,1,0,0,38,1,11,0,0,201,1,6,208,228,0.189,0.912
"49","Chuquisaca","Sucre","Facultad de Tecnología",139,0,2,1,35,2,8,1,1,189,2,4,195,230,0.185,0.848
"50","Chuquisaca","Sucre","Facultad de Tecnología",153,1,0,0,42,3,12,1,0,212,1,3,216,232,0.198,0.931
"51","Chuquisaca","Sucre","Facultad de Tecnología",148,1,0,0,32,2,14,1,0,198,2,6,206,237,0.162,0.869
"52","Chuquisaca","Sucre","Facultad de Tecnología",139,0,2,2,28,3,14,1,0,189,0,9,198,235,0.148,0.843
"53","Chuquisaca","Sucre","Facultad de Tecnología",139,0,0,0,40,0,13,0,2,194,0,8,202,231,0.206,0.874
"54","Chuquisaca","Sucre","Facultad de Tecnología",132,0,1,2,36,3,14,0,3,191,0,5,196,234,0.188,0.838
"55","Chuquisaca","Sucre","Facultad de Tecnología",149,0,1,0,25,1,8,2,2,188,2,4,194,224,0.133,0.866
"56","Chuquisaca","Sucre","Facultad de Tecnología",142,0,0,0,35,2,14,1,0,194,0,4,198,222,0.18,0.892
"57","Chuquisaca","Sucre","Facultad de Tecnología",139,0,1,1,36,5,14,0,0,196,0,7,203,232,0.184,0.875
"58","Chuquisaca","Sucre","Facultad de Tecnología",142,0,0,2,37,0,18,0,3,202,0,5,207,237,0.183,0.873
"59","Chuquisaca","Sucre","Facultad de Tecnología",140,0,0,0,37,1,18,2,2,200,0,3,203,226,0.185,0.898
"60","Chuquisaca","Sucre","Facultad de Tecnología",143,0,0,1,40,3,10,0,2,199,1,3,203,229,0.201,0.886
"61","Chuquisaca","Sucre","Facultad de Tecnología",157,0,0,0,29,3,10,0,0,199,0,8,207,232,0.146,0.892
"62","Chuquisaca","Sucre","Facultad de Tecnología",157,0,0,0,22,2,13,2,0,196,0,0,196,232,0.112,0.845
"63","Chuquisaca","Sucre","Col. Bernardo Monteagudo",145,0,0,0,39,1,6,0,1,192,1,7,200,226,0.203,0.885
"64","Chuquisaca","Sucre","Col. Bernardo Monteagudo",149,0,2,0,24,2,15,1,0,193,1,4,198,225,0.124,0.88
"65","Chuquisaca","Sucre","Col. Bernardo Monteagudo",149,0,2,1,31,2,12,1,2,200,1,4,205,229,0.155,0.895
"66","Chuquisaca","Sucre","Col. Bernardo Monteagudo",147,0,1,0,25,0,5,0,1,179,1,8,188,228,0.14,0.825
"67","Chuquisaca","Sucre","Col. Bernardo Monteagudo",150,0,0,0,20,2,7,2,1,182,0,5,187,219,0.11,0.854
"68","Chuquisaca","Sucre","Col. Bernardo Monteagudo",131,0,1,1,39,2,9,0,0,183,1,4,188,215,0.213,0.874
"69","Chuquisaca","Sucre","Coliseo Jorge Revilla Aldana",156,0,1,1,30,3,5,0,1,197,2,7,206,231,0.152,0.892
"70","Chuquisaca","Sucre","Coliseo Jorge Revilla Aldana",158,0,0,2,32,4,9,0,0,205,2,6,213,230,0.156,0.926
"71","Chuquisaca","Sucre","Coliseo Jorge Revilla Aldana",150,0,1,0,38,2,14,0,0,205,0,8,213,232,0.185,0.918
"72","Chuquisaca","Sucre","Coliseo Jorge Revilla Aldana",151,1,0,1,23,2,6,0,1,185,0,8,193,225,0.124,0.858
"73","Chuquisaca","Sucre","Coliseo Jorge Revilla Aldana",162,0,1,0,30,3,1,0,0,197,0,4,201,226,0.152,0.889
"74","Chuquisaca","Sucre","Coliseo Jorge Revilla Aldana",149,0,0,1,36,5,7,1,0,199,1,4,204,234,0.181,0.872
"75","Chuquisaca","Sucre","Colegio Junin",158,0,0,0,24,4,2,0,0,188,1,3,192,217,0.128,0.885
"76","Chuquisaca","Sucre","Colegio Junin",131,1,0,2,32,2,8,0,1,177,2,4,183,219,0.181,0.836
"77","Chuquisaca","Sucre","Colegio Junin",151,0,0,0,26,2,11,1,1,192,0,2,194,226,0.135,0.858
"78","Chuquisaca","Sucre","Colegio Junin",153,0,1,1,15,2,6,0,1,179,1,2,182,219,0.084,0.831
"79","Chuquisaca","Sucre","Colegio Junin",152,1,0,2,33,0,3,2,2,195,0,2,197,217,0.169,0.908
"80","Chuquisaca","Sucre","Esc. Mariscal De Ayacucho",162,0,0,1,14,2,8,1,0,188,1,3,192,215,0.074,0.893
"81","Chuquisaca","Sucre","Esc. Mariscal De Ayacucho",155,0,0,0,11,4,7,2,0,179,0,3,182,210,0.061,0.867
"82","Chuquisaca","Sucre","Esc. Mariscal De Ayacucho",125,0,0,0,22,1,4,1,0,153,1,4,158,183,0.144,0.863
"83","Chuquisaca","Sucre","Col. Mariano Serrano",146,1,0,1,37,2,11,1,0,199,0,5,204,224,0.186,0.911
"84","Chuquisaca","Sucre","Col. Mariano Serrano",149,0,2,1,37,1,8,1,2,201,1,7,209,229,0.184,0.913
"85","Chuquisaca","Sucre","Col. Mariano Serrano",161,0,0,1,22,0,8,0,1,193,1,7,201,224,0.114,0.897
"86","Chuquisaca","Sucre","Col. Mariano Serrano",148,0,0,0,32,3,6,0,1,190,1,9,200,225,0.168,0.889
"87","Chuquisaca","Sucre","Col. Mariano Serrano",154,0,2,1,27,0,7,0,1,192,0,6,198,223,0.141,0.888
"88","Chuquisaca","Sucre","Col. Mariano Serrano",156,0,0,0,34,2,4,0,1,197,0,2,199,226,0.173,0.881
"89","Chuquisaca","Sucre","Col. Mariano Serrano",164,0,0,0,30,1,7,1,0,203,0,1,204,229,0.148,0.891
"90","Chuquisaca","Sucre","Col. Mariano Serrano",161,0,0,1,27,1,7,0,0,197,1,4,202,228,0.137,0.886
"91","Chuquisaca","Sucre","Col. Mariano Serrano",147,0,1,0,38,3,8,0,0,197,1,3,201,223,0.193,0.901
"92","Chuquisaca","Sucre","Col. Mariano Serrano",148,0,0,0,27,5,13,0,1,194,1,5,200,223,0.139,0.897
"93","Chuquisaca","Sucre","Col. Mariano Serrano",153,1,0,0,27,2,7,1,3,194,1,5,200,224,0.139,0.893
"94","Chuquisaca","Sucre","Col. Mariano Serrano",153,0,0,0,31,2,5,0,3,194,1,4,199,222,0.16,0.896
"95","Chuquisaca","Sucre","Col. Mariano Serrano",138,1,0,2,33,2,18,0,1,195,0,8,203,226,0.169,0.898
"96","Chuquisaca","Sucre","Col. Mariano Serrano",161,0,0,1,25,2,7,0,0,196,1,6,203,226,0.128,0.898
"97","Chuquisaca","Sucre","Col. Mariano Serrano",176,0,1,0,26,1,1,0,1,206,0,2,208,228,0.126,0.912
"98","Chuquisaca","Sucre","Col. Mariano Serrano",151,0,0,0,32,1,8,0,2,194,2,1,197,227,0.165,0.868
"99","Chuquisaca","Sucre","Col. Mariano Serrano",137,2,1,0,31,3,9,0,2,185,1,8,194,227,0.168,0.855
"100","Chuquisaca","Sucre","Jardín De Niños San Lázaro",151,0,0,1,38,2,5,1,1,199,5,7,211,226,0.191,0.934
"101","Chuquisaca","Sucre","Jardín De Niños San Lázaro",134,0,0,1,36,3,11,2,1,188,0,6,194,224,0.191,0.866
"102","Chuquisaca","Sucre","Jardín De Niños San Lázaro",160,0,0,0,32,3,10,0,0,205,3,4,212,229,0.156,0.926
"103","Chuquisaca","Sucre","Jardín De Niños San Lázaro",131,0,0,2,38,3,11,0,0,185,2,15,202,229,0.205,0.882
"104","Chuquisaca","Sucre","Jardín De Niños San Lázaro",145,0,1,1,35,0,8,1,0,191,6,4,201,229,0.183,0.878
"105","Chuquisaca","Sucre","Jardín De Niños San Lázaro",137,1,0,0,37,1,10,0,2,188,4,9,201,220,0.197,0.914
"106","Chuquisaca","Sucre","Jardín De Niños San Lázaro",145,2,0,1,38,3,8,1,3,201,1,5,207,225,0.189,0.92
"107","Chuquisaca","Sucre","Jardín De Niños San Lázaro",141,0,2,2,40,3,13,0,2,203,2,5,210,233,0.197,0.901
"108","Chuquisaca","Sucre","Jardín De Niños San Lázaro",144,0,0,1,39,4,3,0,2,193,2,5,200,226,0.202,0.885
"109","Chuquisaca","Sucre","Kinder Serrano",143,1,1,0,36,4,7,0,0,192,2,3,197,229,0.188,0.86
"110","Chuquisaca","Sucre","Kinder Serrano",148,1,0,0,39,1,8,0,2,199,0,6,205,231,0.196,0.887
"111","Chuquisaca","Sucre","Kinder Serrano",145,0,1,0,34,2,6,3,0,191,1,7,199,223,0.178,0.892
"112","Chuquisaca","Sucre","Colegio Simón Rodríguez",174,0,0,0,16,2,6,2,1,201,0,1,202,226,0.08,0.894
"113","Chuquisaca","Sucre","Colegio Simón Rodríguez",157,0,2,1,19,0,8,3,1,191,1,6,198,223,0.099,0.888
"114","Chuquisaca","Sucre","Colegio Simón Rodríguez",153,0,1,1,30,3,6,1,0,195,1,0,196,225,0.154,0.871
"115","Chuquisaca","Sucre","Colegio Simón Rodríguez",174,0,1,2,25,3,3,0,0,208,1,1,210,227,0.12,0.925
"116","Chuquisaca","Sucre","Colegio Simón Rodríguez",157,1,0,0,21,2,11,0,1,193,1,1,195,224,0.109,0.871
"117","Chuquisaca","Sucre","Colegio Simón Rodríguez",174,1,0,1,22,2,3,0,0,203,1,1,205,232,0.108,0.884
"118","Chuquisaca","Sucre","Colegio Simón Rodríguez",165,0,1,2,24,0,3,0,0,195,1,3,199,225,0.123,0.884
"119","Chuquisaca","Sucre","Estación De Bomberos",152,1,1,0,34,4,10,0,1,203,1,2,206,229,0.167,0.9
"120","Chuquisaca","Sucre","Estación De Bomberos",143,1,0,1,39,2,8,0,2,196,1,7,204,227,0.199,0.899
"121","Chuquisaca","Sucre","Estación De Bomberos",135,0,1,2,34,3,4,0,3,182,0,4,186,226,0.187,0.823
"122","Chuquisaca","Sucre","Estación De Bomberos",162,0,0,0,22,2,13,0,3,202,2,6,210,232,0.109,0.905
"123","Chuquisaca","Sucre","Estación De Bomberos",134,0,0,2,31,5,15,0,3,190,1,7,198,229,0.163,0.865
"124","Chuquisaca","Sucre","Estación De Bomberos",147,1,0,0,38,5,10,1,2,204,0,1,205,230,0.186,0.891
"125","Chuquisaca","Sucre","Estación De Bomberos",151,0,0,1,37,2,6,1,1,199,0,3,202,231,0.186,0.874
"126","Chuquisaca","Sucre","Estación De Bomberos",149,0,1,1,25,3,8,0,1,188,1,15,204,228,0.133,0.895
"127","Chuquisaca","Sucre","Estación De Bomberos",149,0,0,0,30,3,7,0,4,193,1,8,202,228,0.155,0.886
"128","Chuquisaca","Sucre","Estación De Bomberos",115,1,2,0,34,4,9,1,0,166,2,2,170,186,0.205,0.914
"129","Chuquisaca","Sucre","Kinder Echeverria",170,0,0,0,18,2,2,0,0,192,2,3,197,226,0.094,0.872
"130","Chuquisaca","Sucre","Kinder Echeverria",159,0,1,1,20,1,5,2,2,191,0,4,195,220,0.105,0.886
"131","Chuquisaca","Sucre","Kinder Echeverria",145,0,0,1,30,0,3,5,0,184,1,6,191,214,0.163,0.893
"132","Chuquisaca","Sucre","Kinder Echeverria",157,0,0,2,28,3,2,1,1,194,1,1,196,226,0.144,0.867
"133","Chuquisaca","Sucre","Kinder Echeverria",144,0,0,1,15,4,4,0,0,168,2,5,175,194,0.089,0.902
"134","Chuquisaca","Sucre","Esc. Josefina Goytia",150,1,0,1,29,1,9,2,1,194,2,7,203,224,0.149,0.906
"135","Chuquisaca","Sucre","Esc. Josefina Goytia",141,0,1,1,46,2,11,0,3,205,2,3,210,231,0.224,0.909
"136","Chuquisaca","Sucre","Esc. Josefina Goytia",117,1,1,0,47,1,15,1,4,187,0,10,197,230,0.251,0.857
"137","Chuquisaca","Sucre","Esc. Josefina Goytia",156,0,1,0,30,3,9,1,4,204,3,8,215,233,0.147,0.923
"138","Chuquisaca","Sucre","Esc. Josefina Goytia",123,2,1,0,40,4,13,0,2,185,2,9,196,229,0.216,0.856
"139","Chuquisaca","Sucre","Esc. Josefina Goytia",145,1,0,0,42,3,9,1,0,201,2,3,206,229,0.209,0.9
"140","Chuquisaca","Sucre","Esc. Josefina Goytia",147,2,0,3,36,3,10,1,4,206,1,2,209,228,0.175,0.917
"141","Chuquisaca","Sucre","Esc. Josefina Goytia",142,0,1,0,38,2,15,1,0,199,3,9,211,229,0.191,0.921
"142","Chuquisaca","Sucre","Col. Cardenal Maurer",145,0,0,0,40,2,9,0,0,196,1,5,202,230,0.204,0.878
"143","Chuquisaca","Sucre","Col. Cardenal Maurer",153,2,0,1,29,1,1,3,1,191,2,7,200,225,0.152,0.889
"144","Chuquisaca","Sucre","Col. Cardenal Maurer",153,1,1,1,24,1,6,0,2,189,2,11,202,227,0.127,0.89
"145","Chuquisaca","Sucre","Col. Cardenal Maurer",167,1,0,1,20,2,3,0,0,194,0,0,194,229,0.103,0.847
"146","Chuquisaca","Sucre","Col. Cardenal Maurer",143,1,0,0,35,2,3,1,1,186,1,5,192,224,0.188,0.857
"147","Chuquisaca","Sucre","Col. Cardenal Maurer",143,1,0,0,39,2,2,0,0,187,1,5,193,219,0.209,0.881
"148","Chuquisaca","Sucre","Col. Cardenal Maurer",156,0,1,1,26,7,9,0,1,201,0,0,201,230,0.129,0.874
"149","Chuquisaca","Sucre","Col. Cardenal Maurer",161,0,1,1,36,3,5,1,1,209,2,4,215,231,0.172,0.931
"150","Chuquisaca","Sucre","Col. Cardenal Maurer",139,1,0,1,46,2,7,1,0,197,0,5,202,231,0.234,0.874
"151","Chuquisaca","Sucre","Col. Cardenal Maurer",132,0,0,0,21,3,5,1,0,162,5,5,172,193,0.13,0.891
"152","Chuquisaca","Sucre","Salon Multifuncional America",95,1,0,2,61,2,26,0,2,189,4,7,200,224,0.323,0.893
"153","Chuquisaca","Sucre","Salon Multifuncional America",106,0,1,1,62,1,23,1,1,196,3,13,212,236,0.316,0.898
"154","Chuquisaca","Sucre","Salon Multifuncional America",104,3,1,0,41,9,26,2,3,189,5,9,203,232,0.217,0.875
"155","Chuquisaca","Sucre","Salon Multifuncional America",104,0,0,3,51,6,25,0,2,191,0,13,204,232,0.267,0.879
"156","Chuquisaca","Sucre","Salon Multifuncional America",99,1,1,1,68,1,16,3,1,191,2,7,200,232,0.356,0.862
"157","Chuquisaca","Sucre","Salon Multifuncional America",111,1,1,0,51,5,16,2,4,191,2,14,207,230,0.267,0.9
"158","Chuquisaca","Sucre","Salon Multifuncional America",117,3,5,2,36,4,13,0,4,184,4,9,197,229,0.196,0.86
"159","Chuquisaca","Sucre","(Cárcel) Cárcel Pública",46,1,0,1,85,3,33,0,3,172,4,11,187,238,0.494,0.786
"160","Chuquisaca","Sucre","Esc. Aniceto Arce",93,2,1,0,66,0,27,2,2,193,2,9,204,226,0.342,0.903
"161","Chuquisaca","Sucre","Esc. Aniceto Arce",105,1,3,1,47,2,18,2,1,180,4,10,194,226,0.261,0.858
"162","Chuquisaca","Sucre","Esc. Aniceto Arce",99,1,1,0,60,3,16,1,2,183,3,18,204,226,0.328,0.903
"163","Chuquisaca","Sucre","Esc. Aniceto Arce",100,0,0,0,60,1,18,1,7,187,6,9,202,229,0.321,0.882
"164","Chuquisaca","Sucre","Esc. Aniceto Arce",92,2,1,0,60,6,28,1,5,195,4,3,202,233,0.308,0.867
"165","Chuquisaca","Sucre","Esc. Aniceto Arce",73,2,3,2,56,4,25,0,2,167,6,13,186,226,0.335,0.823
"166","Chuquisaca","Sucre","Esc. Aniceto Arce",86,3,2,2,57,6,25,0,2,183,5,13,201,231,0.311,0.87
"167","Chuquisaca","Sucre","Esc. Aniceto Arce",107,0,0,0,64,2,26,0,7,206,0,7,213,231,0.311,0.922
"168","Chuquisaca","Sucre","Esc. Aniceto Arce",78,3,3,0,59,2,34,0,0,179,5,14,198,228,0.33,0.868
"169","Chuquisaca","Sucre","Esc. Aniceto Arce",105,2,2,1,45,3,20,1,1,180,3,15,198,223,0.25,0.888
"170","Chuquisaca","Sucre","Esc. Aniceto Arce",82,2,3,0,57,4,26,0,2,176,3,16,195,232,0.324,0.841
"171","Chuquisaca","Sucre","Esc. Aniceto Arce",70,4,3,3,66,1,22,2,2,173,5,11,189,231,0.382,0.818
"172","Chuquisaca","Sucre","Esc. Aniceto Arce",94,2,2,0,64,6,18,1,3,190,2,9,201,232,0.337,0.866
"173","Chuquisaca","Sucre","Esc. Aniceto Arce",89,0,2,1,61,6,21,0,1,181,6,9,196,224,0.337,0.875
"174","Chuquisaca","Sucre","Esc. Aniceto Arce",96,2,5,0,46,7,19,0,2,177,5,12,194,233,0.26,0.833
"175","Chuquisaca","Sucre","Esc. Aniceto Arce",100,2,2,0,54,3,27,0,4,192,1,7,200,229,0.281,0.873
"176","Chuquisaca","Sucre","Esc. Aniceto Arce",83,2,0,0,64,1,25,2,2,179,4,12,195,225,0.358,0.867
"177","Chuquisaca","Sucre","Esc. Aniceto Arce",92,0,2,2,68,4,30,4,2,204,3,4,211,233,0.333,0.906
"178","Chuquisaca","Sucre","Esc. Aniceto Arce",104,3,1,0,45,4,15,2,0,174,2,7,183,220,0.259,0.832
"179","Chuquisaca","Sucre","Esc. Aniceto Arce",108,1,3,0,52,5,15,1,3,188,4,9,201,229,0.277,0.878
"180","Chuquisaca","Sucre","Esc. Aniceto Arce",119,0,0,0,39,5,34,2,2,201,3,10,214,234,0.194,0.915
"181","Chuquisaca","Sucre","Esc. Aniceto Arce",97,1,1,0,52,3,20,2,2,178,6,11,195,228,0.292,0.855
"182","Chuquisaca","Sucre","Esc. Aniceto Arce",99,0,1,0,51,5,21,0,2,179,1,8,188,230,0.285,0.817
"183","Chuquisaca","Sucre","Esc. Aniceto Arce",76,1,3,1,57,5,31,1,4,179,2,10,191,227,0.318,0.841
"184","Chuquisaca","Sucre","Salon Multifuncional La Hoyada",123,1,0,0,50,6,11,1,1,193,4,6,203,236,0.259,0.86
"185","Chuquisaca","Sucre","Salon Multifuncional La Hoyada",137,1,1,0,49,2,10,1,1,202,2,4,208,224,0.243,0.929
"186","Chuquisaca","Sucre","Salon Multifuncional La Hoyada",116,0,0,2,40,2,16,1,4,181,0,8,189,227,0.221,0.833
"187","Chuquisaca","Sucre","Salon Multifuncional La Hoyada",131,0,1,0,52,2,11,1,1,199,4,6,209,231,0.261,0.905
"188","Chuquisaca","Sucre","U.E. San Roque Nivel Inicial",147,1,1,0,27,2,4,3,3,188,0,5,193,225,0.144,0.858
"189","Chuquisaca","Sucre","U.E. San Roque Nivel Inicial",147,1,0,0,30,4,14,1,0,197,2,5,204,223,0.152,0.915
"190","Chuquisaca","Sucre","U.E. San Roque Nivel Inicial",126,0,1,2,46,5,12,1,2,195,1,3,199,226,0.236,0.881
"191","Chuquisaca","Sucre","U.E. San Roque Nivel Inicial",132,1,1,0,37,3,13,1,4,192,3,11,206,231,0.193,0.892
"192","Chuquisaca","Sucre","U.E. San Roque Nivel Inicial",144,0,2,2,43,2,7,0,3,203,0,3,206,227,0.212,0.907
"193","Chuquisaca","Sucre","U.E. San Roque Nivel Inicial",140,0,0,0,36,3,11,2,2,194,1,7,202,224,0.186,0.902
"194","Chuquisaca","Sucre","U.E. San Roque Nivel Inicial",159,0,0,1,27,3,4,0,0,194,2,6,202,231,0.139,0.874
"195","Chuquisaca","Sucre","Col. Don Bosco",162,0,0,1,32,2,5,0,0,202,0,6,208,225,0.158,0.924
"196","Chuquisaca","Sucre","Col. Don Bosco",158,1,0,0,28,2,3,0,0,192,2,6,200,232,0.146,0.862
"197","Chuquisaca","Sucre","Col. Don Bosco",152,0,0,0,18,4,9,4,1,188,1,3,192,223,0.096,0.861
"198","Chuquisaca","Sucre","Col. Don Bosco",162,0,0,1,25,3,8,0,0,199,1,5,205,225,0.126,0.911
"199","Chuquisaca","Sucre","Col. Don Bosco",155,0,1,0,29,4,7,3,0,199,1,3,203,230,0.146,0.883
"200","Chuquisaca","Sucre","Col. Don Bosco",163,0,1,0,29,1,7,2,0,203,1,1,205,230,0.143,0.891
"201","Chuquisaca","Sucre","Col. Don Bosco",163,0,1,0,26,2,4,3,1,200,1,3,204,226,0.13,0.903
"202","Chuquisaca","Sucre","Col. Don Bosco",161,0,0,0,29,1,4,1,0,196,0,4,200,226,0.148,0.885
"203","Chuquisaca","Sucre","Kinder Municipal",149,1,1,7,31,2,4,0,2,197,2,3,202,222,0.157,0.91
"204","Chuquisaca","Sucre","Kinder Municipal",159,0,0,2,24,3,7,0,1,196,2,2,200,224,0.122,0.893
"205","Chuquisaca","Sucre","Kinder Municipal",146,1,1,0,33,4,12,3,0,200,2,10,212,230,0.165,0.922
"206","Chuquisaca","Sucre","Kinder Municipal",152,0,1,0,30,1,11,1,1,197,0,6,203,223,0.152,0.91
"207","Chuquisaca","Sucre","Kinder Municipal",148,0,0,0,35,3,7,2,1,196,1,5,202,226,0.179,0.894
"208","Chuquisaca","Sucre","Kinder Municipal",158,0,0,0,31,6,8,2,0,205,3,1,209,227,0.151,0.921
"209","Chuquisaca","Sucre","Kinder Municipal",153,0,0,0,29,2,3,0,1,188,0,5,193,220,0.154,0.877
"210","Chuquisaca","Sucre","Kinder Municipal",152,1,0,0,43,3,4,0,1,204,0,3,207,224,0.211,0.924
"211","Chuquisaca","Sucre","Kinder Municipal",162,0,0,1,28,4,11,0,3,209,2,6,217,245,0.134,0.886
"212","Chuquisaca","Sucre","Colegio Domingo Sabio",104,0,0,0,53,8,18,1,4,188,9,7,204,220,0.282,0.927
"213","Chuquisaca","Sucre","Colegio Domingo Sabio",131,2,1,1,31,10,18,2,0,196,4,9,209,229,0.158,0.913
"214","Chuquisaca","Sucre","Colegio Domingo Sabio",110,1,4,0,44,3,33,1,3,199,4,5,208,230,0.221,0.904
"215","Chuquisaca","Sucre","Colegio Domingo Sabio",106,0,5,0,53,3,29,0,2,198,6,5,209,231,0.268,0.905
"216","Chuquisaca","Sucre","Colegio Domingo Sabio",88,2,0,0,45,6,47,1,2,191,1,4,196,224,0.236,0.875
"217","Chuquisaca","Sucre","Colegio Domingo Sabio",102,1,1,0,48,4,31,1,3,191,6,8,205,228,0.251,0.899
"218","Chuquisaca","Sucre","Colegio Domingo Sabio",90,4,4,0,53,7,33,1,2,194,7,7,208,234,0.273,0.889
"219","Chuquisaca","Sucre","Colegio Domingo Sabio",126,1,0,0,41,1,33,1,2,205,4,4,213,234,0.2,0.91
"220","Chuquisaca","Sucre","Colegio Domingo Sabio",121,2,2,0,37,6,29,1,1,199,6,8,213,233,0.186,0.914
"221","Chuquisaca","Sucre","Colegio Domingo Sabio",111,1,2,1,61,8,17,0,0,201,2,8,211,227,0.303,0.93
"222","Chuquisaca","Sucre","Colegio Domingo Sabio",93,0,1,0,46,8,22,1,2,173,4,7,184,204,0.266,0.902
"223","Chuquisaca","Sucre","Liceo María Josefa Mujia",151,0,0,0,32,1,5,1,0,190,0,4,194,224,0.168,0.866
"224","Chuquisaca","Sucre","Liceo María Josefa Mujia",165,0,1,1,22,2,7,0,3,201,0,4,205,232,0.109,0.884
"225","Chuquisaca","Sucre","Liceo María Josefa Mujia",156,1,1,2,25,1,2,0,0,188,3,3,194,226,0.133,0.858
"226","Chuquisaca","Sucre","Liceo María Josefa Mujia",142,1,0,0,26,2,5,1,0,177,1,6,184,219,0.147,0.84
"227","Chuquisaca","Sucre","Liceo María Josefa Mujia",172,0,0,0,23,2,6,1,1,205,1,6,212,233,0.112,0.91
"228","Chuquisaca","Sucre","Liceo María Josefa Mujia",175,0,0,0,20,1,5,1,0,202,0,5,207,233,0.099,0.888
"229","Chuquisaca","Sucre","Liceo María Josefa Mujia",161,0,0,1,19,3,5,1,0,190,2,7,199,228,0.1,0.873
"230","Chuquisaca","Sucre","Liceo María Josefa Mujia",166,1,1,1,29,5,5,1,0,209,1,1,211,231,0.139,0.913
"231","Chuquisaca","Sucre","Unidad Educativa Ruffo",69,1,5,1,86,7,44,2,3,218,6,6,230,236,0.394,0.975
"232","Chuquisaca","Sucre","Unidad Educativa Ruffo",42,3,3,2,85,4,60,1,0,200,8,17,225,236,0.425,0.953
"233","Chuquisaca","Sucre","Unidad Educativa Ruffo",48,2,3,1,84,0,60,1,3,202,8,12,222,232,0.416,0.957
"234","Chuquisaca","Sucre","Unidad Educativa Ruffo",49,3,3,1,100,5,37,0,7,205,7,14,226,239,0.488,0.946
"235","Chuquisaca","Sucre","Unidad Educativa Ruffo",59,1,2,2,73,3,33,0,2,175,11,8,194,215,0.417,0.902
"236","Chuquisaca","Sucre","U.E. Eduardo Abaroa",133,0,0,0,21,3,6,4,1,168,1,7,176,224,0.125,0.786
"237","Chuquisaca","Sucre","U.E. Eduardo Abaroa",142,0,0,0,29,2,2,0,1,176,1,8,185,225,0.165,0.822
"238","Chuquisaca","Sucre","U.E. Eduardo Abaroa",147,0,0,1,31,1,4,0,0,184,0,6,190,225,0.168,0.844
"239","Chuquisaca","Sucre","U.E. Eduardo Abaroa",133,0,2,0,31,2,15,0,4,187,0,6,193,232,0.166,0.832
"240","Chuquisaca","Sucre","U.E. Eduardo Abaroa",138,0,0,0,36,1,12,1,2,190,2,5,197,228,0.189,0.864
"241","Chuquisaca","Sucre","U.E. Eduardo Abaroa",145,0,0,2,24,1,6,1,1,180,2,5,187,222,0.133,0.842
"242","Chuquisaca","Sucre","U.E. Eduardo Abaroa",127,0,0,1,27,5,9,1,3,173,2,4,179,222,0.156,0.806
"243","Chuquisaca","Sucre","U.E. Eduardo Abaroa",152,0,0,0,23,3,8,1,3,190,2,6,198,232,0.121,0.853
"244","Chuquisaca","Sucre","U.E. Eduardo Abaroa",146,1,0,1,30,2,13,2,0,195,1,8,204,235,0.154,0.868
"245","Chuquisaca","Sucre","U.E. Eduardo Abaroa",139,1,0,0,22,1,11,3,2,179,0,6,185,231,0.123,0.801
"246","Chuquisaca","Sucre","U.E. Eduardo Abaroa",146,0,2,0,34,1,7,5,2,197,0,4,201,232,0.173,0.866
"247","Chuquisaca","Sucre","U.E. Eduardo Abaroa",145,1,0,2,27,4,6,1,0,186,1,4,191,228,0.145,0.838
"248","Chuquisaca","Sucre","U.E. Eduardo Abaroa",136,0,1,0,28,2,4,1,0,172,5,9,186,226,0.163,0.823
"249","Chuquisaca","Sucre","U.E. Eduardo Abaroa",137,0,4,1,22,3,10,0,0,177,0,7,184,227,0.124,0.811
"250","Chuquisaca","Sucre","U.E. Eduardo Abaroa",150,0,0,1,25,1,13,0,0,190,0,7,197,231,0.132,0.853
"251","Chuquisaca","Sucre","U.E. Eduardo Abaroa",143,0,1,1,36,3,6,0,2,192,0,3,195,229,0.188,0.852
"252","Chuquisaca","Sucre","U.E. Eduardo Abaroa",139,0,0,0,28,5,12,2,1,187,2,3,192,233,0.15,0.824
"253","Chuquisaca","Sucre","Col. Sagrado Corazon",160,0,0,0,19,3,5,1,0,188,2,4,194,228,0.101,0.851
"254","Chuquisaca","Sucre","Col. Sagrado Corazon",152,0,1,2,30,4,3,1,0,193,0,3,196,224,0.155,0.875
"255","Chuquisaca","Sucre","Col. Sagrado Corazon",152,0,0,1,22,1,5,1,0,182,1,7,190,225,0.121,0.844
"256","Chuquisaca","Sucre","Col. Sagrado Corazon",158,0,0,1,22,1,3,2,0,187,3,4,194,228,0.118,0.851
"257","Chuquisaca","Sucre","Col. Sagrado Corazon",151,0,0,1,22,2,10,1,2,189,2,4,195,222,0.116,0.878
"258","Chuquisaca","Sucre","Fundacion Pachamama",144,0,0,1,38,4,13,0,3,203,1,2,206,228,0.187,0.904
"259","Chuquisaca","Sucre","Fundacion Pachamama",150,0,1,0,24,4,21,1,2,203,3,6,212,236,0.118,0.898
"260","Chuquisaca","Sucre","Fundacion Pachamama",139,0,2,0,36,3,17,1,0,198,0,7,205,231,0.182,0.887
"261","Chuquisaca","Sucre","Fundacion Pachamama",159,0,3,0,22,4,11,0,1,200,3,7,210,231,0.11,0.909
"262","Chuquisaca","Sucre","Fundacion Pachamama",154,0,1,0,27,2,8,0,1,193,0,9,202,228,0.14,0.886
"263","Chuquisaca","Sucre","Fundacion Pachamama",147,0,0,0,27,5,13,0,1,193,1,9,203,227,0.14,0.894
"264","Chuquisaca","Sucre","Kinder Gerardo Vaca Guzman",134,0,2,2,32,1,11,0,1,183,0,5,188,216,0.175,0.87
"265","Chuquisaca","Sucre","Kinder Gerardo Vaca Guzman",150,0,0,1,32,4,5,0,0,192,0,2,194,217,0.167,0.894
"266","Chuquisaca","Sucre","Kinder Gerardo Vaca Guzman",137,0,0,0,31,3,6,2,4,183,1,6,190,220,0.169,0.864
"267","Chuquisaca","Sucre","Escuela Daniel Calvo",163,0,0,0,21,5,6,3,0,198,0,1,199,224,0.106,0.888
"268","Chuquisaca","Sucre","Escuela Daniel Calvo",135,0,1,0,27,5,1,4,0,173,1,5,179,210,0.156,0.852
"269","Chuquisaca","Sucre","Escuela Daniel Calvo",143,0,0,3,23,2,4,4,0,179,0,3,182,213,0.128,0.854
"270","Chuquisaca","Sucre","Colegio 23 de Marzo",136,1,1,1,29,3,21,4,0,196,0,6,202,226,0.148,0.894
"271","Chuquisaca","Sucre","Colegio 23 de Marzo",144,1,0,0,30,2,13,0,0,190,1,9,200,231,0.158,0.866
"272","Chuquisaca","Sucre","Colegio 23 de Marzo",133,4,2,0,32,4,21,0,2,198,5,4,207,232,0.162,0.892
"273","Chuquisaca","Sucre","Colegio 23 de Marzo",151,0,1,0,30,5,14,0,0,201,1,8,210,229,0.149,0.917
"274","Chuquisaca","Sucre","Colegio 23 de Marzo",144,1,2,1,31,4,16,0,3,202,2,7,211,233,0.153,0.906
"275","Chuquisaca","Sucre","Colegio 23 de Marzo",142,0,1,0,38,3,16,2,0,202,3,6,211,231,0.188,0.913
"276","Chuquisaca","Sucre","Colegio 23 de Marzo",142,0,1,0,38,5,11,0,0,197,1,6,204,229,0.193,0.891
"277","Chuquisaca","Sucre","Colegio 23 de Marzo",137,0,1,0,33,1,9,3,3,187,1,6,194,221,0.176,0.878
"278","Chuquisaca","Sucre","Colegio 23 de Marzo",152,0,0,0,33,2,6,0,0,193,3,4,200,233,0.171,0.858
"279","Chuquisaca","Sucre","Colegio 23 de Marzo",156,0,0,1,23,4,18,0,0,202,0,2,204,232,0.114,0.879
"280","Chuquisaca","Sucre","Colegio 23 de Marzo",150,0,0,0,26,3,15,2,0,196,1,6,203,225,0.133,0.902
"281","Chuquisaca","Sucre","Salón Multifuncional Satélite",112,0,1,0,49,4,19,2,1,188,3,7,198,222,0.261,0.892
"282","Chuquisaca","Sucre","Salón Multifuncional Satélite",128,1,0,1,40,2,20,0,2,194,3,9,206,226,0.206,0.912
"283","Chuquisaca","Sucre","Salón Multifuncional Satélite",122,1,1,3,39,5,16,1,1,189,2,7,198,225,0.206,0.88
"284","Chuquisaca","Sucre","Salón Multifuncional Satélite",110,1,1,3,54,3,24,1,7,204,1,10,215,232,0.265,0.927
"285","Chuquisaca","Sucre","Salón Multifuncional Satélite",127,0,1,3,45,3,20,0,0,199,1,4,204,223,0.226,0.915
"286","Chuquisaca","Sucre","Salón Multifuncional Satélite",134,1,1,1,34,2,25,0,2,200,3,9,212,231,0.17,0.918
"287","Chuquisaca","Sucre","Salón Multifuncional Satélite",124,1,2,2,47,3,9,0,1,189,0,3,192,220,0.249,0.873
"288","Chuquisaca","Sucre","Salón Multifuncional Satélite",124,0,1,0,34,3,24,1,1,188,5,12,205,229,0.181,0.895
"289","Chuquisaca","Sucre","Colegio Fe y Alegria",127,1,0,0,43,3,14,4,1,193,4,6,203,226,0.223,0.898
"290","Chuquisaca","Sucre","Colegio Fe y Alegria",150,1,2,1,38,0,13,0,1,206,1,5,212,236,0.184,0.898
"291","Chuquisaca","Sucre","Colegio Fe y Alegria",140,0,1,1,40,1,7,1,3,194,1,7,202,228,0.206,0.886
"292","Chuquisaca","Sucre","Colegio Fe y Alegria",106,0,1,0,55,5,13,0,2,182,0,7,189,225,0.302,0.84
"293","Chuquisaca","Sucre","Colegio Fe y Alegria",139,0,1,1,53,2,5,0,4,205,1,1,207,232,0.259,0.892
"294","Chuquisaca","Sucre","Colegio Fe y Alegria",153,0,1,0,34,4,9,0,2,203,1,2,206,228,0.167,0.904
"295","Chuquisaca","Sucre","Colegio Fe y Alegria",153,0,0,1,48,1,3,1,3,210,1,5,216,231,0.229,0.935
"296","Chuquisaca","Sucre","Colegio Fe y Alegria",148,0,1,1,37,4,11,0,1,203,2,6,211,233,0.182,0.906
"297","Chuquisaca","Sucre","Colegio Fe y Alegria",145,1,0,1,36,2,7,0,1,193,1,4,198,231,0.187,0.857
"298","Chuquisaca","Sucre","Colegio Fe y Alegria",148,0,1,0,39,2,12,1,7,210,3,8,221,229,0.186,0.965
"299","Chuquisaca","Sucre","Colegio Fe y Alegria",108,0,0,0,50,2,11,1,4,176,3,15,194,226,0.284,0.858
"300","Chuquisaca","Sucre","Colegio Fe y Alegria",151,0,1,3,36,4,5,0,0,200,1,4,205,229,0.18,0.895
"301","Chuquisaca","Sucre","Colegio Fe y Alegria",142,0,3,0,27,7,8,1,2,190,1,8,199,227,0.142,0.877
"302","Chuquisaca","Sucre","Colegio Fe y Alegria",126,1,2,1,51,5,13,0,3,202,0,7,209,230,0.252,0.909
"303","Chuquisaca","Sucre","Colegio Fe y Alegria",142,0,0,0,36,3,11,2,6,200,2,2,204,232,0.18,0.879
"304","Chuquisaca","Sucre","Colegio Fe y Alegria",119,0,2,0,42,4,19,1,8,195,3,13,211,233,0.215,0.906
"305","Chuquisaca","Sucre","Colegio Fe y Alegria",139,0,1,0,34,6,9,1,3,193,4,9,206,227,0.176,0.907
"306","Chuquisaca","Sucre","Colegio Fe y Alegria",157,0,1,2,36,3,6,2,0,207,0,8,215,226,0.174,0.951
"307","Chuquisaca","Sucre","Colegio Fe y Alegria",150,0,2,0,37,2,9,1,6,207,3,7,217,234,0.179,0.927
"308","Chuquisaca","Sucre","Colegio Fe y Alegria",139,0,0,0,40,4,13,0,2,198,0,9,207,232,0.202,0.892
"309","Chuquisaca","Sucre","Colegio Fe y Alegria",125,0,0,0,34,2,7,1,0,169,1,5,175,189,0.201,0.926
"310","Chuquisaca","Sucre","Estadium Patria",136,0,0,0,33,3,17,1,2,192,1,7,200,221,0.172,0.905
"311","Chuquisaca","Sucre","Estadium Patria",153,0,2,2,26,2,8,2,3,198,3,3,204,230,0.131,0.887
"312","Chuquisaca","Sucre","Estadium Patria",155,1,0,0,23,1,18,0,1,199,2,6,207,228,0.116,0.908
"313","Chuquisaca","Sucre","Estadium Patria",146,0,1,2,39,2,15,2,0,207,2,5,214,233,0.188,0.918
"314","Chuquisaca","Sucre","Estadium Patria",138,0,1,0,38,2,15,0,2,196,1,5,202,231,0.194,0.874
"315","Chuquisaca","Sucre","Estadium Patria",161,1,1,1,26,4,7,0,2,203,1,10,214,230,0.128,0.93
"316","Chuquisaca","Sucre","Estadium Patria",148,0,2,0,30,4,12,1,0,197,3,6,206,228,0.152,0.904
"317","Chuquisaca","Sucre","Estadium Patria",156,0,1,0,33,4,12,0,2,208,1,3,212,232,0.159,0.914
"318","Chuquisaca","Sucre","Estadium Patria",141,0,1,0,41,1,15,0,3,202,5,4,211,235,0.203,0.898
"319","Chuquisaca","Sucre","Estadium Patria",140,0,0,0,35,5,11,0,2,193,5,5,203,230,0.181,0.883
"320","Chuquisaca","Sucre","Estadium Patria",135,0,3,0,53,3,5,1,2,202,3,3,208,231,0.262,0.9
"321","Chuquisaca","Sucre","Estadium Patria",136,0,2,0,38,1,9,2,3,191,0,5,196,221,0.199,0.887
"322","Chuquisaca","Sucre","Estadium Patria",148,1,1,0,27,0,5,0,1,183,3,7,193,222,0.148,0.869
"323","Chuquisaca","Sucre","Estadium Patria",129,0,0,0,38,2,10,0,3,182,2,8,192,222,0.209,0.865
"324","Chuquisaca","Sucre","Estadium Patria",146,0,0,1,34,2,15,0,2,200,1,10,211,230,0.17,0.917
"325","Chuquisaca","Sucre","Estadium Patria",156,0,0,0,25,2,8,1,1,193,0,5,198,229,0.13,0.865
"326","Chuquisaca","Sucre","Estadium Patria",142,0,0,0,50,1,6,1,1,201,1,3,205,229,0.249,0.895
"327","Chuquisaca","Sucre","Estadium Patria",105,0,0,0,36,2,11,1,0,155,2,4,161,177,0.232,0.91
"328","Chuquisaca","Sucre","Iglesia San Matías",142,4,0,0,33,3,12,1,4,199,3,3,205,226,0.166,0.907
"329","Chuquisaca","Sucre","Iglesia San Matías",155,0,0,0,36,1,7,2,1,202,0,2,204,228,0.178,0.895
"330","Chuquisaca","Sucre","Iglesia San Matías",151,0,0,2,31,3,8,0,1,196,1,5,202,232,0.158,0.871
"331","Chuquisaca","Sucre","Iglesia San Matías",140,0,2,0,48,0,6,1,4,201,2,3,206,232,0.239,0.888
"332","Chuquisaca","Sucre","Iglesia San Matías",157,0,0,0,27,4,7,1,1,197,1,4,202,221,0.137,0.914
"333","Chuquisaca","Sucre","Iglesia San Matías",154,0,0,0,26,0,9,1,3,193,1,4,198,225,0.135,0.88
"334","Chuquisaca","Sucre","Iglesia San Matías",145,0,0,1,33,5,7,0,1,192,1,9,202,229,0.172,0.882
"335","Chuquisaca","Sucre","Iglesia San Matías",143,0,0,0,37,4,9,0,5,198,0,4,202,228,0.187,0.886
"336","Chuquisaca","Sucre","Iglesia San Matías",157,1,1,0,27,3,9,1,1,200,1,5,206,230,0.135,0.896
"337","Chuquisaca","Sucre","Iglesia San Matías",157,0,0,1,31,3,9,0,2,203,0,5,208,227,0.153,0.916
"338","Chuquisaca","Sucre","Iglesia San Matías",141,0,0,1,37,5,6,1,2,193,2,5,200,223,0.192,0.897
"339","Chuquisaca","Sucre","Iglesia San Matías",141,0,0,0,27,2,13,3,0,186,0,4,190,225,0.145,0.844
"340","Chuquisaca","Sucre","Iglesia San Matías",157,0,1,0,28,0,5,0,0,191,2,4,197,222,0.147,0.887
"341","Chuquisaca","Sucre","Iglesia San Matías",161,0,0,3,30,5,3,1,0,203,2,4,209,232,0.148,0.901
"342","Chuquisaca","Sucre","Iglesia San Matías",150,0,0,0,32,1,13,0,1,197,0,4,201,227,0.162,0.885
"343","Chuquisaca","Sucre","Campo Deportivo Noria Alta",153,0,0,1,25,2,8,1,3,193,3,5,201,229,0.13,0.878
"344","Chuquisaca","Sucre","Campo Deportivo Noria Alta",144,0,1,0,43,3,4,1,1,197,4,4,205,225,0.218,0.911
"345","Chuquisaca","Sucre","Campo Deportivo Noria Alta",135,0,1,1,44,3,7,1,3,195,2,7,204,229,0.226,0.891
"346","Chuquisaca","Sucre","Campo Deportivo Noria Alta",149,0,1,0,27,5,10,3,2,197,3,2,202,222,0.137,0.91
"347","Chuquisaca","Sucre","Campo Deportivo Noria Alta",122,0,2,1,42,9,11,1,4,192,2,7,201,225,0.219,0.893
"348","Chuquisaca","Sucre","Campo Deportivo Noria Alta",148,0,0,0,35,4,10,1,4,202,1,6,209,223,0.173,0.937
"349","Chuquisaca","Sucre","Campo Deportivo Noria Alta",153,1,1,0,26,0,8,0,3,192,1,7,200,227,0.135,0.881
"350","Chuquisaca","Sucre","Unidad Educativa 6 de Junio",99,2,2,1,58,7,20,0,2,191,4,9,204,227,0.304,0.899
"351","Chuquisaca","Sucre","Unidad Educativa 6 de Junio",117,0,0,0,49,5,20,2,3,196,3,15,214,229,0.25,0.934
"352","Chuquisaca","Sucre","Unidad Educativa 6 de Junio",92,0,0,0,62,7,23,1,3,188,6,11,205,226,0.33,0.907
"353","Chuquisaca","Sucre","Unidad Educativa 6 de Junio",95,3,1,1,72,6,14,0,2,194,7,6,207,232,0.371,0.892
"354","Chuquisaca","Sucre","Unidad Educativa 6 de Junio",92,4,2,2,57,5,24,0,2,188,3,7,198,225,0.303,0.88
"355","Chuquisaca","Sucre","Unidad Educativa 6 de Junio",72,1,3,1,61,7,27,1,3,176,8,8,192,224,0.347,0.857
"356","Chuquisaca","Sucre","Unidad Educativa 6 de Junio",90,0,1,2,58,1,28,1,4,185,7,12,204,226,0.314,0.903
"357","Chuquisaca","Sucre","Unidad Educativa 6 de Junio",140,0,1,1,33,4,12,1,2,194,3,12,209,234,0.17,0.893
"358","Chuquisaca","Sucre","Unidad Educativa 6 de Junio",91,1,1,1,61,3,16,0,14,188,4,11,203,224,0.324,0.906
"359","Chuquisaca","Sucre","Unidad Educativa 6 de Junio",96,1,0,0,57,5,30,1,6,196,2,7,205,230,0.291,0.891
"360","Chuquisaca","Sucre","Unidad Educativa 6 de Junio",106,2,1,2,56,4,22,0,5,198,1,7,206,232,0.283,0.888
"361","Chuquisaca","Sucre","Unidad Educativa 6 de Junio",111,2,1,0,47,7,16,3,3,190,3,11,204,229,0.247,0.891
"362","Chuquisaca","Sucre","Unidad Educativa 6 de Junio",120,2,0,1,43,6,19,0,2,193,2,15,210,231,0.223,0.909
"363","Chuquisaca","Sucre","Unidad Educativa 6 de Junio",89,0,1,1,54,6,33,1,5,190,3,8,201,229,0.284,0.878
"364","Chuquisaca","Sucre","Unidad Educativa 6 de Junio",118,1,0,1,39,5,14,1,5,184,5,19,208,230,0.212,0.904
"365","Chuquisaca","Sucre","Unidad Educativa 6 de Junio",114,1,1,1,69,3,19,0,1,209,1,3,213,233,0.33,0.914
"366","Chuquisaca","Sucre","Unidad Educativa 6 de Junio",110,1,3,1,39,5,22,2,4,187,3,9,199,226,0.209,0.881
"367","Chuquisaca","Sucre","Unidad Educativa 6 de Junio",101,2,0,0,48,7,25,0,4,187,8,10,205,229,0.257,0.895
"368","Chuquisaca","Sucre","Unidad Educativa 6 de Junio",119,0,1,0,48,10,11,2,6,197,2,3,202,230,0.244,0.878
"369","Chuquisaca","Sucre","Unidad Educativa 6 de Junio",123,0,0,1,40,2,14,0,7,187,7,7,201,227,0.214,0.885
"370","Chuquisaca","Sucre","Unidad Educativa 6 de Junio",100,0,0,0,53,4,20,1,5,183,7,9,199,228,0.29,0.873
"371","Chuquisaca","Sucre","Unidad Educativa 6 de Junio",126,0,2,1,47,3,18,0,2,199,3,8,210,234,0.236,0.897
"372","Chuquisaca","Sucre","Unidad Educativa 6 de Junio",97,1,1,1,59,5,16,1,3,184,3,10,197,229,0.321,0.86
"373","Chuquisaca","Sucre","U.E. Francisco Cermeño",157,0,2,0,28,1,15,0,1,204,0,1,205,229,0.137,0.895
"374","Chuquisaca","Sucre","U.E. Francisco Cermeño",148,0,0,0,27,6,14,2,0,197,1,6,204,227,0.137,0.899
"375","Chuquisaca","Sucre","U.E. Francisco Cermeño",150,0,0,0,33,1,11,0,1,196,1,5,202,229,0.168,0.882
"376","Chuquisaca","Sucre","U.E. Francisco Cermeño",144,0,2,0,29,4,14,0,2,195,3,4,202,227,0.149,0.89
"377","Chuquisaca","Sucre","U.E. Francisco Cermeño",151,0,1,0,25,5,16,0,5,203,1,9,213,227,0.123,0.938
"378","Chuquisaca","Sucre","U.E. Francisco Cermeño",136,1,0,1,35,3,19,0,3,198,0,7,205,226,0.177,0.907
"379","Chuquisaca","Sucre","U.E. Francisco Cermeño",122,0,1,2,40,0,28,1,0,194,4,5,203,229,0.206,0.886
"380","Chuquisaca","Sucre","U.E. Francisco Cermeño",138,1,1,1,37,1,15,1,1,196,1,5,202,231,0.189,0.874
"381","Chuquisaca","Sucre","U.E. Francisco Cermeño",132,0,1,1,39,3,6,0,4,186,5,7,198,220,0.21,0.9
"382","Chuquisaca","Sucre","U.E. Francisco Cermeño",134,1,0,1,42,2,13,2,0,195,3,11,209,230,0.215,0.909
"383","Chuquisaca","Sucre","U.E. Francisco Cermeño",127,1,0,0,46,4,11,0,1,190,1,2,193,215,0.242,0.898
"384","Chuquisaca","Sucre","U.E. Francisco Cermeño",144,1,0,1,35,2,12,0,0,195,0,2,197,224,0.179,0.879
"385","Chuquisaca","Sucre","Mercado Yurac Yurac",139,0,1,0,43,4,11,0,2,200,1,14,215,238,0.215,0.903
"386","Chuquisaca","Sucre","Mercado Yurac Yurac",116,1,1,1,39,10,25,0,5,198,2,14,214,235,0.197,0.911
"387","Chuquisaca","Sucre","Mercado Yurac Yurac",113,0,3,1,51,3,20,3,3,197,2,13,212,237,0.259,0.895
"388","Chuquisaca","Sucre","Mercado Yurac Yurac",125,2,0,0,39,4,25,2,3,200,4,15,219,237,0.195,0.924
"389","Chuquisaca","Sucre","Mercado Yurac Yurac",116,1,0,1,66,1,14,0,4,203,2,8,213,237,0.325,0.899
"390","Chuquisaca","Sucre","Mercado Yurac Yurac",111,1,1,2,65,1,18,1,2,202,1,8,211,235,0.322,0.898
"391","Chuquisaca","Sucre","Mercado Yurac Yurac",129,1,1,1,50,6,11,0,6,205,5,13,223,236,0.244,0.945
"392","Chuquisaca","Sucre","Mercado Yurac Yurac",142,0,1,0,33,3,14,2,4,199,5,9,213,235,0.166,0.906
"393","Chuquisaca","Sucre","Mercado Yurac Yurac",107,3,1,0,44,7,35,0,3,200,1,15,216,236,0.22,0.915
"394","Chuquisaca","Sucre","Mercado Yurac Yurac",120,1,2,1,56,4,11,2,5,202,3,7,212,236,0.277,0.898
"395","Chuquisaca","Sucre","Mercado Yurac Yurac",112,2,1,0,54,3,16,1,6,195,4,10,209,230,0.277,0.909
"396","Chuquisaca","Sucre","Esc. San Juanillo",122,2,0,2,46,1,13,1,5,192,4,5,201,225,0.24,0.893
"397","Chuquisaca","Sucre","Esc. San Juanillo",129,0,1,0,35,1,19,1,3,189,3,3,195,228,0.185,0.855
"398","Chuquisaca","Sucre","Esc. San Juanillo",133,0,0,2,34,2,23,0,1,195,3,4,202,229,0.174,0.882
"399","Chuquisaca","Sucre","Esc. San Juanillo",132,1,0,1,35,7,13,2,2,193,1,6,200,224,0.181,0.893
"400","Chuquisaca","Sucre","Esc. San Juanillo",125,1,0,0,46,0,21,1,3,197,0,9,206,233,0.234,0.884
"401","Chuquisaca","Sucre","Esc. San Juanillo",123,0,0,0,38,6,24,0,1,192,3,9,204,225,0.198,0.907
"402","Chuquisaca","Sucre","Esc. San Juanillo",115,0,0,2,55,4,14,0,3,193,3,6,202,228,0.285,0.886
"403","Chuquisaca","Sucre","Esc. San Juanillo",88,3,2,0,64,2,27,1,1,188,4,8,200,232,0.34,0.862
"404","Chuquisaca","Sucre","Esc. San Juanillo",123,3,1,0,45,2,20,0,1,195,2,9,206,228,0.231,0.904
"405","Chuquisaca","Sucre","Esc. San Juanillo",131,2,0,2,34,3,17,1,1,191,2,10,203,231,0.178,0.879
"406","Chuquisaca","Sucre","Esc. San Juanillo",141,1,0,1,27,2,23,1,1,197,3,7,207,230,0.137,0.9
"407","Chuquisaca","Sucre","Esc. San Juanillo",118,0,3,2,38,4,17,0,3,185,2,7,194,230,0.205,0.843
"408","Chuquisaca","Sucre","Esc. San Juanillo",124,0,2,1,34,2,24,0,3,190,5,6,201,229,0.179,0.878
"409","Chuquisaca","Sucre","Esc. San Juanillo",122,0,1,0,40,2,26,1,3,195,3,5,203,232,0.205,0.875
"410","Chuquisaca","Sucre","Esc. San Juanillo",125,2,1,0,42,4,11,0,2,187,2,7,196,229,0.225,0.856
"411","Chuquisaca","Sucre","Esc. San Juanillo",120,2,2,0,45,5,12,1,4,191,0,8,199,231,0.236,0.861
"412","Chuquisaca","Sucre","Esc. San Juanillo",125,0,2,0,36,5,17,1,2,188,2,5,195,228,0.191,0.855
"413","Chuquisaca","Sucre","Esc. San Juanillo",133,0,2,2,44,3,15,0,2,201,0,5,206,232,0.219,0.888
"414","Chuquisaca","Sucre","Esc. San Juanillo",115,1,2,1,48,5,14,2,3,191,2,6,199,229,0.251,0.869
"415","Chuquisaca","Sucre","Esc. San Juanillo",140,0,0,0,37,2,10,2,4,195,4,5,204,227,0.19,0.899
"416","Chuquisaca","Sucre","Esc. San Juanillo",124,0,3,1,38,0,15,1,2,184,1,5,190,224,0.207,0.848
"417","Chuquisaca","Sucre","Esc. San Juanillo",107,0,0,0,41,4,11,1,5,169,3,11,183,220,0.243,0.832
"418","Chuquisaca","Sucre","Esc. San Juanillo",121,1,0,2,33,3,22,1,3,186,1,9,196,229,0.177,0.856
"419","Chuquisaca","Sucre","Esc. San Juanillo",137,0,1,1,36,1,16,0,4,196,2,5,203,230,0.184,0.883
"420","Chuquisaca","Sucre","Esc. San Juanillo",136,0,0,0,50,4,11,0,0,201,2,9,212,231,0.249,0.918
"421","Chuquisaca","Sucre","Esc. San Juanillo",116,1,1,0,46,2,18,0,1,185,1,1,187,226,0.249,0.827
"422","Chuquisaca","Sucre","Esc. San Juanillo",131,0,0,1,44,1,13,0,2,192,1,4,197,228,0.229,0.864
"423","Chuquisaca","Sucre","Esc. San Juanillo",131,2,0,1,38,2,14,0,2,190,1,9,200,224,0.2,0.893
"424","Chuquisaca","Sucre","Esc. San Juanillo",124,1,1,1,37,4,17,1,4,190,0,3,193,225,0.195,0.858
"425","Chuquisaca","Sucre","Esc. San Juanillo",125,2,3,1,40,2,15,1,4,193,3,10,206,230,0.207,0.896
"426","Chuquisaca","Sucre","Esc. San Juanillo",129,0,0,0,40,4,11,0,2,186,7,7,200,227,0.215,0.881
"427","Chuquisaca","Sucre","Esc. San Juanillo",126,1,2,1,52,2,10,2,0,196,3,6,205,227,0.265,0.903
"428","Chuquisaca","Sucre","Esc. San Juanillo",121,0,0,1,40,3,24,2,2,193,3,7,203,233,0.207,0.871
"429","Chuquisaca","Sucre","Esc. San Juanillo",138,1,0,1,47,2,11,2,3,205,0,0,205,229,0.229,0.895
"430","Chuquisaca","Sucre","Seminario Teologico Del Sur",133,1,2,0,48,1,15,0,0,200,1,7,208,229,0.24,0.908
"431","Chuquisaca","Sucre","Seminario Teologico Del Sur",130,1,0,2,33,5,19,0,0,190,1,5,196,222,0.174,0.883
"432","Chuquisaca","Sucre","Seminario Teologico Del Sur",104,2,2,0,46,7,31,0,3,195,4,9,208,229,0.236,0.908
"433","Chuquisaca","Sucre","Seminario Teologico Del Sur",114,2,1,2,53,2,22,0,3,199,2,7,208,231,0.266,0.9
"434","Chuquisaca","Sucre","Seminario Teologico Del Sur",130,0,1,1,40,1,27,1,0,201,5,3,209,233,0.199,0.897
"435","Chuquisaca","Sucre","Seminario Teologico Del Sur",131,1,1,0,42,5,18,0,1,199,3,8,210,229,0.211,0.917
"436","Chuquisaca","Sucre","Seminario Teologico Del Sur",116,2,0,1,52,3,22,1,5,202,2,8,212,231,0.257,0.918
"437","Chuquisaca","Sucre","Seminario Teologico Del Sur",134,1,1,1,42,5,18,0,6,208,1,8,217,230,0.202,0.943
"438","Chuquisaca","Sucre","Seminario Teologico Del Sur",138,0,2,0,37,2,23,1,4,207,4,8,219,234,0.179,0.936
"439","Chuquisaca","Sucre","Seminario Teologico Del Sur",121,2,0,2,42,0,19,1,3,190,1,6,197,229,0.221,0.86
"440","Chuquisaca","Sucre","Seminario Teologico Del Sur",120,0,1,0,35,1,25,0,5,187,3,11,201,227,0.187,0.885
"441","Chuquisaca","Sucre","Seminario Teologico Del Sur",127,0,0,0,46,4,9,0,0,186,4,8,198,223,0.247,0.888
"442","Chuquisaca","Sucre","Seminario Teologico Del Sur",142,0,1,2,36,2,19,0,0,202,2,10,214,232,0.178,0.922
"443","Chuquisaca","Sucre","Campo Deportivo San Juanillo Bajo",130,1,0,1,57,3,27,1,1,221,2,6,229,237,0.258,0.966
"444","Chuquisaca","Sucre","Campo Deportivo San Juanillo Bajo",138,0,0,1,43,4,23,0,4,213,0,6,219,239,0.202,0.916
"445","Chuquisaca","Sucre","Campo Deportivo San Juanillo Bajo",124,0,0,0,54,4,39,0,1,222,0,6,228,240,0.243,0.95
"446","Chuquisaca","Sucre","Campo Deportivo San Juanillo Bajo",111,2,2,0,47,4,25,0,3,194,1,5,200,215,0.242,0.93
"447","Chuquisaca","Sucre","Esc. Roberto Alvarado",105,4,0,2,57,5,20,2,0,195,3,6,204,229,0.292,0.891
"448","Chuquisaca","Sucre","Esc. Roberto Alvarado",117,0,0,0,51,1,17,0,1,187,4,15,206,228,0.273,0.904
"449","Chuquisaca","Sucre","Esc. Roberto Alvarado",125,1,0,2,46,2,11,0,0,187,3,12,202,234,0.246,0.863
"450","Chuquisaca","Sucre","Esc. Roberto Alvarado",95,0,1,3,67,4,16,1,2,189,3,9,201,223,0.354,0.901
"451","Chuquisaca","Sucre","Esc. Roberto Alvarado",114,0,6,0,52,5,14,1,1,193,3,10,206,232,0.269,0.888
"452","Chuquisaca","Sucre","Esc. Roberto Alvarado",124,4,1,1,40,3,23,0,4,200,1,10,211,232,0.2,0.909
"453","Chuquisaca","Sucre","Esc. Roberto Alvarado",116,2,0,2,42,2,19,0,4,187,4,5,196,231,0.225,0.848
"454","Chuquisaca","Sucre","Esc. Roberto Alvarado",119,2,1,0,45,5,20,1,1,194,3,12,209,230,0.232,0.909
"455","Chuquisaca","Sucre","Esc. Roberto Alvarado",134,1,0,1,33,3,18,1,1,192,3,9,204,226,0.172,0.903
"456","Chuquisaca","Sucre","Esc. Roberto Alvarado",118,3,1,1,36,6,24,1,2,192,0,9,201,229,0.188,0.878
"457","Chuquisaca","Sucre","Esc. Roberto Alvarado",123,1,1,0,33,4,29,0,2,193,2,10,205,233,0.171,0.88
"458","Chuquisaca","Sucre","Esc. Roberto Alvarado",110,0,0,0,67,1,14,1,4,197,6,4,207,228,0.34,0.908
"459","Chuquisaca","Sucre","Esc. Roberto Alvarado",114,1,1,3,46,3,27,0,3,198,3,9,210,234,0.232,0.897
"460","Chuquisaca","Sucre","Esc. Roberto Alvarado",109,0,1,0,38,7,32,0,5,192,2,9,203,231,0.198,0.879
"461","Chuquisaca","Sucre","Esc. Roberto Alvarado",124,7,0,1,44,6,12,0,2,196,3,5,204,234,0.224,0.872
"462","Chuquisaca","Sucre","Esc. Roberto Alvarado",116,2,0,0,52,3,10,0,7,190,2,11,203,228,0.274,0.89
"463","Chuquisaca","Sucre","Esc. Roberto Alvarado",124,0,1,1,47,3,12,0,3,191,4,11,206,229,0.246,0.9
"464","Chuquisaca","Sucre","Esc. Roberto Alvarado",114,0,0,0,45,4,23,1,3,190,1,7,198,229,0.237,0.865
"465","Chuquisaca","Sucre","Esc. Roberto Alvarado",124,0,0,1,37,2,25,1,4,194,2,6,202,226,0.191,0.894
"466","Chuquisaca","Sucre","Esc. Roberto Alvarado",114,2,1,0,48,4,20,1,4,194,1,8,203,234,0.247,0.868
"467","Chuquisaca","Sucre","Esc. Roberto Alvarado",112,0,1,2,50,1,21,2,8,197,2,13,212,233,0.254,0.91
"468","Chuquisaca","Sucre","Esc. Roberto Alvarado",127,1,0,0,32,5,23,1,1,190,2,14,206,231,0.168,0.892
"469","Chuquisaca","Sucre","Esc. Roberto Alvarado",140,0,2,0,36,2,12,0,2,194,2,10,206,233,0.186,0.884
"470","Chuquisaca","Sucre","Esc. Roberto Alvarado",116,0,0,2,53,2,17,2,3,195,1,15,211,232,0.272,0.909
"471","Chuquisaca","Sucre","Esc. Roberto Alvarado",105,3,0,1,51,4,20,0,4,188,3,9,200,231,0.271,0.866
"472","Chuquisaca","Sucre","Esc. Roberto Alvarado",96,1,2,1,40,1,23,0,2,166,2,6,174,189,0.241,0.921
"473","Chuquisaca","Sucre","IPTK-N. Aguirre 560 / CERPI",142,0,2,0,40,3,7,2,0,196,2,4,202,226,0.204,0.894
"474","Chuquisaca","Sucre","IPTK-N. Aguirre 560 / CERPI",136,1,0,2,32,0,12,0,0,183,3,8,194,222,0.175,0.874
"475","Chuquisaca","Sucre","IPTK-N. Aguirre 560 / CERPI",145,0,1,0,27,1,0,0,1,175,2,7,184,227,0.154,0.811
"476","Chuquisaca","Sucre","IPTK-N. Aguirre 560 / CERPI",143,0,0,0,36,3,18,0,3,203,2,2,207,228,0.177,0.908
"477","Chuquisaca","Sucre","IPTK-N. Aguirre 560 / CERPI",135,0,1,2,37,4,8,0,0,187,1,6,194,224,0.198,0.866
"478","Chuquisaca","Sucre","IPTK-N. Aguirre 560 / CERPI",146,0,2,1,37,5,11,1,2,205,0,7,212,233,0.18,0.91
"479","Chuquisaca","Sucre","IPTK-N. Aguirre 560 / CERPI",125,1,0,1,48,2,21,0,0,198,2,6,206,230,0.242,0.896
"480","Chuquisaca","Sucre","IPTK-N. Aguirre 560 / CERPI",161,2,1,1,15,0,18,0,1,199,1,4,204,225,0.075,0.907
"481","Chuquisaca","Sucre","IPTK-N. Aguirre 560 / CERPI",141,2,0,0,38,5,12,1,0,199,1,7,207,227,0.191,0.912
"482","Chuquisaca","Sucre","IPTK-N. Aguirre 560 / CERPI",147,0,2,0,36,2,9,1,1,198,2,3,203,224,0.182,0.906
"483","Chuquisaca","Sucre","IPTK-N. Aguirre 560 / CERPI",142,1,1,0,36,1,18,0,1,200,2,3,205,230,0.18,0.891
"484","Chuquisaca","Sucre","IPTK-N. Aguirre 560 / CERPI",176,0,1,1,25,1,6,0,0,210,0,1,211,230,0.119,0.917
"485","Chuquisaca","Sucre","IPTK-N. Aguirre 560 / CERPI",135,0,1,1,49,2,12,0,0,200,2,6,208,228,0.245,0.912
"486","Chuquisaca","Sucre","Esc. Sagrada Familia",91,0,2,3,65,4,27,0,5,197,6,12,215,233,0.33,0.923
"487","Chuquisaca","Sucre","Esc. Sagrada Familia",125,2,0,1,40,3,12,0,2,185,5,10,200,220,0.216,0.909
"488","Chuquisaca","Sucre","Esc. Sagrada Familia",115,1,0,1,38,3,22,2,5,187,3,9,199,229,0.203,0.869
"489","Chuquisaca","Sucre","Esc. Sagrada Familia",103,0,1,0,49,5,32,1,2,193,1,9,203,231,0.254,0.879
"490","Chuquisaca","Sucre","Esc. Sagrada Familia",113,2,0,1,48,4,20,0,6,194,1,6,201,229,0.247,0.878
"491","Chuquisaca","Sucre","Esc. Sagrada Familia",97,1,0,1,57,3,28,0,4,191,3,10,204,229,0.298,0.891
"492","Chuquisaca","Sucre","Esc. Sagrada Familia",102,2,1,2,47,6,28,1,4,193,5,6,204,230,0.244,0.887
"493","Chuquisaca","Sucre","Esc. Sagrada Familia",104,2,1,0,63,2,17,1,5,195,5,10,210,229,0.323,0.917
"494","Chuquisaca","Sucre","Esc. Sagrada Familia",113,0,0,0,53,2,21,0,8,197,1,8,206,235,0.269,0.877
"495","Chuquisaca","Sucre","Esc. Sagrada Familia",112,2,1,0,45,2,22,2,6,192,5,8,205,230,0.234,0.891
"496","Chuquisaca","Sucre","Esc. Sagrada Familia",109,1,2,0,51,2,29,0,2,196,4,9,209,234,0.26,0.893
"497","Chuquisaca","Sucre","Esc. Sagrada Familia",102,0,2,1,47,5,18,2,4,181,4,12,197,231,0.26,0.853
"498","Chuquisaca","Sucre","Esc. Sagrada Familia",120,2,2,1,45,2,19,1,5,197,1,4,202,232,0.228,0.871
"499","Chuquisaca","Sucre","Esc. Sagrada Familia",105,0,3,0,56,5,24,0,0,193,3,9,205,229,0.29,0.895
"500","Chuquisaca","Sucre","Esc. Sagrada Familia",103,1,1,2,49,2,21,0,8,187,1,13,201,227,0.262,0.885
"501","Chuquisaca","Sucre","Esc. Sagrada Familia",136,0,0,1,37,4,13,0,1,192,4,9,205,230,0.193,0.891
"502","Chuquisaca","Sucre","Esc. Sagrada Familia",103,1,2,1,62,4,18,1,3,195,2,9,206,231,0.318,0.892
"503","Chuquisaca","Sucre","Esc. Sagrada Familia",107,1,1,0,44,1,17,1,5,177,6,17,200,220,0.249,0.909
"504","Chuquisaca","Sucre","Esc. Sagrada Familia",100,2,2,2,46,5,23,0,3,183,5,13,201,232,0.251,0.866
"505","Chuquisaca","Sucre","Esc. Sagrada Familia",122,0,1,0,40,4,15,1,12,195,3,7,205,231,0.205,0.887
"506","Chuquisaca","Sucre","Esc. Sagrada Familia",118,0,2,2,42,7,17,1,3,192,3,8,203,226,0.219,0.898
"507","Chuquisaca","Sucre","Esc. Sagrada Familia",120,1,0,0,61,6,15,2,1,206,3,9,218,233,0.296,0.936
"508","Chuquisaca","Sucre","Esc. Sagrada Familia",115,0,2,0,49,8,19,0,5,198,4,6,208,229,0.247,0.908
"509","Chuquisaca","Sucre","Esc. Sagrada Familia",122,1,2,0,35,3,26,1,2,192,8,12,212,232,0.182,0.914
"510","Chuquisaca","Sucre","Esc. Sagrada Familia",110,2,2,1,56,2,16,1,2,192,4,11,207,230,0.292,0.9
"511","Chuquisaca","Sucre","Esc. Sagrada Familia",106,2,2,0,46,5,27,0,2,190,2,5,197,228,0.242,0.864
"512","Chuquisaca","Sucre","Centro de Salud Luis Espinal",85,0,2,1,78,3,24,0,4,197,3,9,209,234,0.396,0.893
"513","Chuquisaca","Sucre","Centro de Salud Luis Espinal",100,1,1,0,75,2,21,1,7,208,5,9,222,237,0.361,0.937
"514","Chuquisaca","Sucre","Coliseo Libertadores",131,0,3,0,38,3,17,0,1,193,4,8,205,232,0.197,0.884
"515","Chuquisaca","Sucre","Coliseo Libertadores",144,1,0,1,43,3,9,2,0,203,1,3,207,229,0.212,0.904
"516","Chuquisaca","Sucre","Coliseo Libertadores",143,1,0,0,37,3,12,1,3,200,2,4,206,230,0.185,0.896
"517","Chuquisaca","Sucre","Coliseo Libertadores",115,1,3,1,54,4,15,2,1,196,1,5,202,232,0.276,0.871
"518","Chuquisaca","Sucre","Coliseo Libertadores",149,1,1,3,30,4,9,0,2,199,3,2,204,226,0.151,0.903
"519","Chuquisaca","Sucre","Coliseo Libertadores",142,0,1,1,36,3,12,2,1,198,2,8,208,230,0.182,0.904
"520","Chuquisaca","Sucre","Coliseo Libertadores",129,2,0,1,41,6,9,0,4,192,1,13,206,232,0.214,0.888
"521","Chuquisaca","Sucre","Coliseo Libertadores",119,1,0,1,46,2,23,1,2,195,1,8,204,225,0.236,0.907
"522","Chuquisaca","Sucre","Coliseo Libertadores",132,2,2,1,42,3,13,1,1,197,3,5,205,230,0.213,0.891
"523","Chuquisaca","Sucre","Coliseo Libertadores",140,0,0,0,36,4,11,0,4,195,1,11,207,230,0.185,0.9
"524","Chuquisaca","Sucre","Coliseo Libertadores",142,0,0,1,36,3,12,1,3,198,1,10,209,231,0.182,0.905
"525","Chuquisaca","Sucre","Coliseo Libertadores",130,0,1,1,49,1,14,3,0,199,0,4,203,229,0.246,0.886
"526","Chuquisaca","Sucre","Coliseo Libertadores",150,0,2,0,31,3,4,0,2,192,4,8,204,235,0.161,0.868
"527","Chuquisaca","Sucre","Coliseo Libertadores",140,3,0,1,31,3,13,1,2,194,2,8,204,231,0.16,0.883
"528","Chuquisaca","Sucre","Coliseo Libertadores",128,0,1,0,44,3,13,0,6,195,5,10,210,231,0.226,0.909
"529","Chuquisaca","Sucre","Coliseo Libertadores",140,1,0,1,33,3,25,1,4,208,2,10,220,235,0.159,0.936
"530","Chuquisaca","Sucre","Esc. San Javier",147,1,0,2,34,2,4,1,1,192,2,7,201,224,0.177,0.897
"531","Chuquisaca","Sucre","Esc. San Javier",168,0,0,1,34,2,4,1,0,210,0,6,216,226,0.162,0.956
"532","Chuquisaca","Sucre","Esc. San Javier",161,0,2,0,26,3,7,0,2,201,3,5,209,225,0.129,0.929
"533","Chuquisaca","Sucre","Esc. San Javier",154,1,1,1,30,2,8,0,2,199,2,13,214,237,0.151,0.903
"534","Chuquisaca","Sucre","Esc. San Javier",175,0,1,0,24,3,5,1,0,209,0,1,210,234,0.115,0.897
"535","Chuquisaca","Sucre","Esc. San Javier",158,0,0,1,32,1,7,1,2,202,0,5,207,229,0.158,0.904
"536","Chuquisaca","Sucre","Esc. San Javier",169,0,0,1,21,5,7,0,1,204,0,6,210,224,0.103,0.938
"537","Chuquisaca","Sucre","Esc. San Javier",144,0,0,0,45,3,6,0,1,199,1,7,207,224,0.226,0.924
"538","Chuquisaca","Sucre","Esc. San Javier",151,0,0,0,30,3,4,1,0,189,3,7,199,223,0.159,0.892
"539","Chuquisaca","Sucre","Esc. San Javier",149,0,0,2,43,4,5,0,0,203,3,4,210,227,0.212,0.925
"540","Chuquisaca","Sucre","Esc. San Javier",157,0,1,0,26,6,9,2,0,201,4,3,208,224,0.129,0.929
"541","Chuquisaca","Sucre","Esc. San Javier",165,0,0,0,32,1,11,0,1,210,2,3,215,231,0.152,0.931
"542","Chuquisaca","Sucre","Esc. San Javier",146,0,0,0,37,4,12,2,2,203,0,1,204,224,0.182,0.911
"543","Chuquisaca","Sucre","Esc. San Javier",159,0,1,0,28,2,9,1,2,202,0,4,206,226,0.139,0.912
"544","Chuquisaca","Sucre","Esc. San Javier",166,0,0,0,33,2,4,3,1,209,0,4,213,228,0.158,0.934
"545","Chuquisaca","Sucre","Esc. San Javier",157,0,0,1,38,4,5,0,0,205,0,5,210,228,0.185,0.921
"546","Chuquisaca","Sucre","Fac. Derecho",160,1,0,1,25,4,11,0,1,203,0,1,204,229,0.123,0.891
"547","Chuquisaca","Sucre","Fac. Derecho",148,0,0,0,37,1,7,2,0,195,2,6,203,231,0.19,0.879
"548","Chuquisaca","Sucre","Fac. Derecho",160,0,0,0,37,2,7,1,1,208,4,2,214,231,0.178,0.926
"549","Chuquisaca","Sucre","Fac. Derecho",151,0,0,1,36,4,13,1,2,208,0,2,210,234,0.173,0.897
"550","Chuquisaca","Sucre","Fac. Derecho",149,0,0,0,38,2,10,0,2,201,1,2,204,231,0.189,0.883
"551","Chuquisaca","Sucre","Fac. Derecho",165,1,0,0,29,0,9,0,2,206,0,6,212,229,0.141,0.926
"552","Chuquisaca","Sucre","Fac. Derecho",163,0,0,0,29,1,9,0,0,202,1,7,210,230,0.144,0.913
"553","Chuquisaca","Sucre","Fac. Derecho",155,0,0,2,31,1,11,2,0,202,0,5,207,231,0.153,0.896
"554","Chuquisaca","Sucre","Fac. Derecho",152,0,0,0,33,0,12,2,3,202,1,7,210,235,0.163,0.894
"555","Chuquisaca","Sucre","Fac. Derecho",158,0,1,1,31,2,3,1,1,198,0,8,206,230,0.157,0.896
"556","Chuquisaca","Sucre","Fac. Derecho",152,0,0,1,36,1,11,0,1,202,3,3,208,230,0.178,0.904
"557","Chuquisaca","Sucre","Fac. Derecho",165,0,0,1,34,0,5,0,0,205,0,2,207,232,0.166,0.892
"558","Chuquisaca","Sucre","Fac. Derecho",165,0,0,2,27,2,4,1,0,201,0,8,209,230,0.134,0.909
"559","Chuquisaca","Sucre","Fac. Derecho",143,0,0,0,34,0,7,0,1,185,1,12,198,227,0.184,0.872
"560","Chuquisaca","Sucre","Esc. Taller De Integracion Eti",167,0,0,1,31,2,11,0,1,213,0,6,219,236,0.146,0.928
"561","Chuquisaca","Sucre","Esc. Taller De Integracion Eti",138,1,0,0,37,4,11,0,1,192,2,5,199,224,0.193,0.888
"562","Chuquisaca","Sucre","Esc. Taller De Integracion Eti",159,0,0,1,22,2,14,1,2,201,2,10,213,232,0.109,0.918
"563","Chuquisaca","Sucre","Esc. Taller De Integracion Eti",145,1,0,1,29,3,14,2,1,196,1,7,204,230,0.148,0.887
"564","Chuquisaca","Sucre","Esc. Taller De Integracion Eti",144,0,0,0,47,4,9,1,1,206,1,5,212,233,0.228,0.91
"565","Chuquisaca","Sucre","Esc. Taller De Integracion Eti",158,0,0,2,34,2,10,1,1,208,1,3,212,230,0.163,0.922
"566","Chuquisaca","Sucre","Esc. Taller De Integracion Eti",150,0,0,2,46,3,2,0,2,205,2,6,213,230,0.224,0.926
"567","Chuquisaca","Sucre","Terminal De Buses",150,0,0,1,41,1,9,1,1,204,0,4,208,233,0.201,0.893
"568","Chuquisaca","Sucre","Terminal De Buses",158,1,0,0,32,4,6,0,1,202,1,4,207,232,0.158,0.892
"569","Chuquisaca","Sucre","Terminal De Buses",155,0,0,0,29,0,12,0,2,198,0,3,201,230,0.146,0.874
"570","Chuquisaca","Sucre","Terminal De Buses",153,0,0,0,29,5,12,1,0,200,1,5,206,230,0.145,0.896
"571","Chuquisaca","Sucre","Terminal De Buses",147,1,2,1,42,2,14,1,3,213,0,5,218,234,0.197,0.932
"572","Chuquisaca","Sucre","Terminal De Buses",140,1,0,0,41,4,10,2,0,198,1,2,201,226,0.207,0.889
"573","Chuquisaca","Sucre","Terminal De Buses",141,0,0,0,46,2,8,0,2,199,1,5,205,229,0.231,0.895
"574","Chuquisaca","Sucre","Terminal De Buses",134,0,1,0,37,0,21,0,2,195,0,6,201,231,0.19,0.87
"575","Chuquisaca","Sucre","Terminal De Buses",130,1,1,2,46,3,10,1,0,194,3,8,205,232,0.237,0.884
"576","Chuquisaca","Sucre","Terminal De Buses",140,1,0,0,44,1,16,1,0,203,1,4,208,235,0.217,0.885
"577","Chuquisaca","Sucre","Terminal De Buses",147,0,0,3,39,1,10,0,0,200,1,3,204,227,0.195,0.899
"578","Chuquisaca","Sucre","Terminal De Buses",154,0,0,1,26,6,10,0,2,199,0,5,204,232,0.131,0.879
"579","Chuquisaca","Sucre","Terminal De Buses",134,0,0,0,33,1,12,3,2,185,2,7,194,225,0.178,0.862
"580","Chuquisaca","Sucre","Terminal De Buses",164,1,0,2,25,1,8,1,1,203,1,7,211,235,0.123,0.898
"581","Chuquisaca","Sucre","Terminal De Buses",138,0,1,2,33,2,9,1,4,190,2,6,198,227,0.174,0.872
"582","Chuquisaca","Sucre","Terminal De Buses",156,1,1,0,22,3,9,0,2,194,2,5,201,230,0.113,0.874
"583","Chuquisaca","Sucre","Terminal De Buses",160,0,0,0,31,4,7,0,0,202,1,8,211,230,0.153,0.917
"584","Chuquisaca","Sucre","Terminal De Buses",150,1,2,0,33,1,8,1,1,197,1,1,199,228,0.168,0.873
"585","Chuquisaca","Sucre","Terminal De Buses",148,0,1,2,35,1,6,2,3,198,3,1,202,232,0.177,0.871
"586","Chuquisaca","Sucre","Terminal De Buses",147,0,1,0,21,2,12,0,1,184,0,13,197,232,0.114,0.849
"587","Chuquisaca","Sucre","Col. Victorino Vega",98,2,1,0,64,5,21,0,3,194,1,10,205,230,0.33,0.891
"588","Chuquisaca","Sucre","Col. Victorino Vega",105,0,0,0,61,5,14,0,1,186,3,9,198,232,0.328,0.853
"589","Chuquisaca","Sucre","Col. Victorino Vega",97,1,0,1,51,5,15,0,4,174,2,17,193,225,0.293,0.858
"590","Chuquisaca","Sucre","Col. Victorino Vega",146,0,0,0,31,6,9,2,1,195,1,9,205,226,0.159,0.907
"591","Chuquisaca","Sucre","Col. Victorino Vega",95,1,1,0,70,1,21,0,2,191,5,7,203,231,0.366,0.879
"592","Chuquisaca","Sucre","Col. Victorino Vega",114,2,1,1,52,4,24,0,4,202,4,5,211,232,0.257,0.909
"593","Chuquisaca","Sucre","Col. Victorino Vega",120,0,1,0,48,3,15,1,1,189,6,13,208,229,0.254,0.908
"594","Chuquisaca","Sucre","Col. Victorino Vega",104,2,1,0,58,6,24,0,1,196,4,10,210,234,0.296,0.897
"595","Chuquisaca","Sucre","Col. Victorino Vega",113,2,1,1,36,5,17,1,4,180,1,14,195,227,0.2,0.859
"596","Chuquisaca","Sucre","Col. Victorino Vega",105,1,0,0,56,5,22,1,0,190,2,14,206,230,0.295,0.896
"597","Chuquisaca","Sucre","Col. Victorino Vega",107,1,0,1,54,6,18,2,2,191,3,12,206,231,0.283,0.892
"598","Chuquisaca","Sucre","Col. Victorino Vega",82,2,1,0,73,3,27,1,2,191,7,10,208,226,0.382,0.92
"599","Chuquisaca","Sucre","Col. Victorino Vega",126,3,0,0,51,4,15,1,0,200,2,10,212,232,0.255,0.914
"600","Chuquisaca","Sucre","Col. Victorino Vega",119,3,2,0,53,2,13,2,5,199,3,8,210,233,0.266,0.901
"601","Chuquisaca","Sucre","Col. Victorino Vega",112,1,2,1,51,2,15,0,2,186,3,11,200,230,0.274,0.87
"602","Chuquisaca","Sucre","Col. Victorino Vega",99,0,3,1,53,1,31,3,1,192,4,6,202,233,0.276,0.867
"603","Chuquisaca","Sucre","Col. Victorino Vega",118,0,0,1,44,6,18,1,3,191,3,8,202,231,0.23,0.874
"604","Chuquisaca","Sucre","Col. Victorino Vega",120,0,1,3,51,3,16,0,4,198,7,8,213,230,0.258,0.926
"605","Chuquisaca","Sucre","Col. Victorino Vega",126,0,0,2,50,3,8,0,0,189,6,9,204,232,0.265,0.879
"606","Chuquisaca","Sucre","Col. Victorino Vega",95,3,1,1,50,5,20,1,2,178,6,16,200,231,0.281,0.866
"607","Chuquisaca","Sucre","Col. Victorino Vega",100,0,0,1,63,6,25,3,1,199,1,5,205,231,0.317,0.887
"608","Chuquisaca","Sucre","Col. Victorino Vega",113,1,1,0,52,7,13,1,1,189,2,12,203,231,0.275,0.879
"609","Chuquisaca","Sucre","Unid. Ed. Hugo Poppe Entrambasaguas",106,1,1,1,68,3,17,1,1,199,3,7,209,231,0.342,0.905
"610","Chuquisaca","Sucre","Unid. Ed. Hugo Poppe Entrambasaguas",122,2,0,1,50,3,20,1,2,201,2,7,210,227,0.249,0.925
"611","Chuquisaca","Sucre","Unid. Ed. Hugo Poppe Entrambasaguas",117,1,0,0,52,4,16,0,1,191,6,9,206,226,0.272,0.912
"612","Chuquisaca","Sucre","Unid. Ed. Hugo Poppe Entrambasaguas",87,0,0,3,65,2,25,1,4,187,4,11,202,234,0.348,0.863
"613","Chuquisaca","Sucre","Unid. Ed. Hugo Poppe Entrambasaguas",109,0,3,1,44,10,26,1,3,197,1,16,214,232,0.223,0.922
"614","Chuquisaca","Sucre","Unid. Ed. Hugo Poppe Entrambasaguas",112,0,2,1,57,4,13,1,1,191,2,7,200,227,0.298,0.881
"615","Chuquisaca","Sucre","Unid. Ed. Hugo Poppe Entrambasaguas",95,0,2,2,49,3,37,3,2,193,4,8,205,228,0.254,0.899
"616","Chuquisaca","Sucre","Unid. Ed. Hugo Poppe Entrambasaguas",110,0,1,1,58,2,20,0,3,195,5,10,210,227,0.297,0.925
"617","Chuquisaca","Sucre","Unid. Ed. Hugo Poppe Entrambasaguas",118,0,1,0,53,1,21,0,1,195,2,11,208,230,0.272,0.904
"618","Chuquisaca","Sucre","Unid. Ed. Hugo Poppe Entrambasaguas",119,1,1,1,36,2,22,3,0,185,2,20,207,226,0.195,0.916
"619","Chuquisaca","Sucre","Unid. Ed. Hugo Poppe Entrambasaguas",130,1,1,1,43,5,15,1,0,197,7,9,213,230,0.218,0.926
"620","Chuquisaca","Sucre","Unid. Ed. Hugo Poppe Entrambasaguas",118,0,1,2,48,3,21,4,4,201,1,11,213,232,0.239,0.918
"621","Chuquisaca","Sucre","Unid. Ed. Hugo Poppe Entrambasaguas",115,0,0,1,53,4,16,1,6,196,1,6,203,229,0.27,0.886
"622","Chuquisaca","Sucre","Unid. Ed. Hugo Poppe Entrambasaguas",124,2,1,0,43,8,14,0,2,194,2,6,202,230,0.222,0.878
"623","Chuquisaca","Sucre","Unid. Ed. Hugo Poppe Entrambasaguas",113,0,0,1,37,5,13,2,4,175,7,5,187,225,0.211,0.831
"624","Chuquisaca","Sucre","Unid. Ed. Hugo Poppe Entrambasaguas",105,1,0,2,65,6,18,0,0,197,2,9,208,233,0.33,0.893
"625","Chuquisaca","Sucre","Unid. Ed. Hugo Poppe Entrambasaguas",107,1,1,1,51,5,19,0,1,186,7,10,203,228,0.274,0.89
"626","Chuquisaca","Sucre","Unid. Educ. Jose Clemente Maurer",69,1,4,3,85,1,37,0,3,203,6,8,217,235,0.419,0.923
"627","Chuquisaca","Sucre","Unid. Educ. Jose Clemente Maurer",90,3,3,1,65,4,24,2,4,196,2,12,210,233,0.332,0.901
"628","Chuquisaca","Sucre","Unid. Educ. Jose Clemente Maurer",55,0,3,1,80,5,37,0,4,185,6,11,202,233,0.432,0.867
"629","Chuquisaca","Sucre","Unid. Educ. Jose Clemente Maurer",70,1,6,1,75,5,37,0,1,196,9,12,217,233,0.383,0.931
"630","Chuquisaca","Sucre","Unid. Educ. Jose Clemente Maurer",51,1,0,2,99,1,31,1,6,192,11,7,210,231,0.516,0.909
"631","Chuquisaca","Sucre","Unid. Educ. Jose Clemente Maurer",69,2,1,1,80,6,27,0,6,192,6,8,206,229,0.417,0.9
"632","Chuquisaca","Sucre","Unid. Educ. Jose Clemente Maurer",60,3,6,2,90,3,28,1,0,193,10,8,211,231,0.466,0.913
"633","Chuquisaca","Sucre","Unid. Educ. Jose Clemente Maurer",65,5,5,2,83,2,32,1,0,195,6,8,209,234,0.426,0.893
"634","Chuquisaca","Sucre","Unid. Educ. Jose Clemente Maurer",54,2,4,2,101,4,25,1,2,195,6,11,212,234,0.518,0.906
"635","Chuquisaca","Sucre","Unid. Educ. Jose Clemente Maurer",77,1,4,0,64,1,28,1,9,185,9,15,209,229,0.346,0.913
"636","Chuquisaca","Sucre","Unid. Educ. Jose Clemente Maurer",76,0,7,1,80,4,22,1,4,195,8,12,215,234,0.41,0.919
"637","Chuquisaca","Sucre","Unid. Educ. Jose Clemente Maurer",58,1,3,3,97,6,25,1,1,195,5,8,208,229,0.497,0.908
"638","Chuquisaca","Sucre","Unid. Educ. Jose Clemente Maurer",63,2,3,1,82,8,25,1,10,195,6,13,214,234,0.421,0.915
"639","Chuquisaca","Sucre","Unid. Educ. Jose Clemente Maurer",89,1,4,2,76,5,26,0,3,206,2,5,213,232,0.369,0.918
"640","Chuquisaca","Sucre","Unid. Educ. Jose Clemente Maurer",60,2,3,0,90,3,27,1,3,189,5,15,209,231,0.476,0.905
"641","Chuquisaca","Sucre","Unid. Educ. Jose Clemente Maurer",76,3,0,0,86,4,27,3,4,203,5,9,217,231,0.424,0.939
"642","Chuquisaca","Sucre","Unid. Educ. Jose Clemente Maurer",55,1,2,1,75,3,37,3,5,182,9,14,205,227,0.412,0.903
"643","Chuquisaca","Sucre","Unid. Educ. Jose Clemente Maurer",73,1,4,0,83,3,23,3,1,191,11,7,209,230,0.435,0.909
"644","Chuquisaca","Sucre","Unid. Educ. Jose Clemente Maurer",79,1,2,0,71,4,31,0,4,192,2,11,205,228,0.37,0.899
"645","Chuquisaca","Sucre","Unid. Educ. Jose Clemente Maurer",47,5,2,1,93,8,42,0,1,199,6,12,217,232,0.467,0.935
"646","Chuquisaca","Sucre","Unid. Educ. Jose Clemente Maurer",53,0,2,0,97,3,35,1,4,195,5,12,212,237,0.497,0.895
"647","Chuquisaca","Sucre","Esc. La Recoleta",148,0,0,1,35,3,10,1,1,199,0,9,208,231,0.176,0.9
"648","Chuquisaca","Sucre","Esc. La Recoleta",140,0,0,0,36,1,5,0,1,183,3,6,192,224,0.197,0.857
"649","Chuquisaca","Sucre","Esc. La Recoleta",137,0,1,0,45,5,12,1,4,205,1,11,217,230,0.22,0.943
"650","Chuquisaca","Sucre","Esc. La Recoleta",157,0,1,1,27,2,5,0,2,195,0,5,200,231,0.138,0.866
"651","Chuquisaca","Sucre","Esc. La Recoleta",139,2,0,0,33,2,15,1,1,193,2,5,200,231,0.171,0.866
"652","Chuquisaca","Sucre","Esc. La Recoleta",164,6,1,1,30,3,9,3,1,218,1,2,221,227,0.138,0.974
"653","Chuquisaca","Sucre","Esc. La Recoleta",132,0,1,0,51,4,10,0,0,198,3,13,214,233,0.258,0.918
"654","Chuquisaca","Sucre","Esc. La Recoleta",161,1,1,1,24,1,4,0,1,194,1,3,198,228,0.124,0.868
"655","Chuquisaca","Sucre","Esc. La Recoleta",138,0,1,1,45,0,13,0,0,198,0,7,205,230,0.227,0.891
"656","Chuquisaca","Sucre","Esc. La Recoleta",126,0,0,1,51,1,9,0,1,189,2,5,196,232,0.27,0.845
"657","Chuquisaca","Sucre","Esc. La Recoleta",138,0,0,1,32,4,5,0,4,184,2,8,194,225,0.174,0.862
"658","Chuquisaca","Sucre","Esc. La Recoleta",146,1,0,1,37,5,9,2,3,204,0,3,207,232,0.181,0.892
"659","Chuquisaca","Sucre","Esc. La Recoleta",153,0,0,0,31,2,8,0,3,197,2,4,203,230,0.157,0.883
"660","Chuquisaca","Sucre","Esc. La Recoleta",147,2,0,1,34,4,7,0,0,195,1,4,200,228,0.174,0.877
"661","Chuquisaca","Sucre","Esc. La Recoleta",137,2,0,0,39,5,13,0,2,198,0,6,204,233,0.197,0.876
"662","Chuquisaca","Sucre","Esc. La Recoleta",145,0,0,0,37,3,9,3,1,198,1,9,208,227,0.187,0.916
"663","Chuquisaca","Sucre","Esc. La Recoleta",144,0,0,1,48,2,6,1,2,204,4,7,215,230,0.235,0.935
"664","Chuquisaca","Sucre","Esc. La Recoleta",148,0,1,1,42,3,6,0,2,203,3,6,212,235,0.207,0.902
"665","Chuquisaca","Sucre","Salon Multifuncional El Abra",118,1,1,2,57,2,20,0,0,201,0,7,208,231,0.284,0.9
"666","Chuquisaca","Sucre","Salon Multifuncional El Abra",111,0,1,1,58,3,14,0,3,191,3,5,199,227,0.304,0.877
"667","Chuquisaca","Sucre","Salon Multifuncional El Abra",92,2,2,2,67,4,22,0,8,199,5,10,214,232,0.337,0.922
"668","Chuquisaca","Sucre","Salon Multifuncional El Abra",113,0,1,0,58,3,16,0,1,192,1,7,200,227,0.302,0.881
"669","Chuquisaca","Sucre","Salon Multifuncional El Abra",106,2,1,3,52,3,21,0,2,190,2,8,200,229,0.274,0.873
"670","Chuquisaca","Sucre","Salon Multifuncional El Abra",100,1,3,1,61,5,21,1,1,194,3,10,207,235,0.314,0.881
"671","Chuquisaca","Sucre","Salon Multifuncional El Abra",102,0,0,2,52,4,25,0,0,185,1,21,207,235,0.281,0.881
"672","Chuquisaca","Sucre","Salon Multifuncional El Abra",120,0,1,0,46,4,25,1,3,200,2,8,210,230,0.23,0.913
"673","Chuquisaca","Sucre","Salon Multifuncional El Abra",100,0,0,3,60,2,27,1,1,194,3,9,206,229,0.309,0.9
"674","Chuquisaca","Sucre","Salon Multifuncional El Abra",106,0,1,2,41,4,22,0,4,180,4,7,191,222,0.228,0.86
"675","Chuquisaca","Sucre","Salon Multifuncional El Abra",109,2,0,0,56,8,22,0,0,197,4,8,209,228,0.284,0.917
"676","Chuquisaca","Sucre","Salon Multifuncional El Abra",94,1,0,0,54,4,35,3,0,191,0,11,202,227,0.283,0.89
"677","Chuquisaca","Sucre","Salon Multifuncional El Abra",68,0,0,4,73,4,9,1,0,159,1,9,169,183,0.459,0.923
"678","Chuquisaca","Sucre","Salon Multifuncional San Francisco",153,0,0,0,37,1,6,3,3,203,1,3,207,225,0.182,0.92
"679","Chuquisaca","Sucre","Salon Multifuncional San Francisco",143,0,0,2,32,2,12,2,3,196,1,9,206,231,0.163,0.892
"680","Chuquisaca","Sucre","Salon Multifuncional San Francisco",159,2,1,1,20,0,9,3,1,196,4,3,203,227,0.102,0.894
"681","Chuquisaca","Sucre","Salon Multifuncional San Francisco",163,0,0,0,35,1,5,2,0,206,0,3,209,223,0.17,0.937
"682","Chuquisaca","Sucre","Salon Multifuncional San Francisco",150,1,0,0,36,4,6,2,0,199,2,6,207,231,0.181,0.896
"683","Chuquisaca","Sucre","Salon Multifuncional San Francisco",123,0,0,0,27,0,1,2,5,158,1,6,165,181,0.171,0.912
"684","Chuquisaca","Sucre","U.E. Evo Morales Ayma",110,0,3,0,66,5,21,0,6,211,2,10,223,240,0.313,0.929
"685","Chuquisaca","Sucre","U.E. Evo Morales Ayma",108,1,1,1,58,5,27,1,4,206,6,14,226,235,0.282,0.962
"686","Chuquisaca","Sucre","U.E. Evo Morales Ayma",95,1,1,0,72,5,24,1,3,202,6,8,216,234,0.356,0.923
"687","Chuquisaca","Sucre","U.E. Evo Morales Ayma",93,1,0,0,69,4,26,2,3,198,3,15,216,235,0.348,0.919
"688","Chuquisaca","Sucre","U.E. Evo Morales Ayma",104,1,0,1,67,4,20,0,2,199,4,9,212,234,0.337,0.906
"689","Chuquisaca","Sucre","U.E. Evo Morales Ayma",119,3,3,1,57,3,16,0,4,206,4,8,218,233,0.277,0.936
"690","Chuquisaca","Sucre","U.E. Evo Morales Ayma",99,1,0,0,76,2,17,2,2,199,3,4,206,224,0.382,0.92
"691","Chuquisaca","Sucre","Esc. Guido Villagomez",100,0,0,2,52,7,35,1,3,200,6,9,215,232,0.26,0.927
"692","Chuquisaca","Sucre","Esc. Guido Villagomez",113,0,1,2,45,5,19,1,5,191,2,6,199,227,0.236,0.877
"693","Chuquisaca","Sucre","Esc. Guido Villagomez",107,1,1,1,46,6,19,0,2,183,6,14,203,231,0.251,0.879
"694","Chuquisaca","Sucre","Esc. Guido Villagomez",96,1,1,1,66,3,29,0,4,201,4,12,217,233,0.328,0.931
"695","Chuquisaca","Sucre","Esc. Guido Villagomez",95,1,6,2,51,3,21,1,3,183,5,9,197,223,0.279,0.883
"696","Chuquisaca","Sucre","Esc. Guido Villagomez",90,0,1,1,59,4,26,0,8,189,4,11,204,232,0.312,0.879
"697","Chuquisaca","Sucre","Esc. Guido Villagomez",111,0,3,0,41,4,28,0,1,188,10,13,211,228,0.218,0.925
"698","Chuquisaca","Sucre","Esc. Guido Villagomez",99,0,2,2,64,1,20,0,7,195,8,13,216,231,0.328,0.935
"699","Chuquisaca","Sucre","Esc. Guido Villagomez",120,0,1,1,44,2,32,2,0,202,3,10,215,234,0.218,0.919
"700","Chuquisaca","Sucre","Esc. Guido Villagomez",95,2,2,0,41,4,26,0,9,179,6,16,201,226,0.229,0.889
"701","Chuquisaca","Sucre","Esc. Guido Villagomez",104,0,1,1,51,7,20,0,2,186,8,21,215,236,0.274,0.911
"702","Chuquisaca","Sucre","Esc. Guido Villagomez",79,1,2,1,75,5,25,1,2,191,7,7,205,235,0.393,0.872
"703","Chuquisaca","Sucre","Esc. Guido Villagomez",120,3,2,1,42,3,27,0,4,202,7,6,215,233,0.208,0.923
"704","Chuquisaca","Sucre","Esc. Guido Villagomez",109,1,2,0,62,3,16,0,7,200,2,1,203,232,0.31,0.875
"705","Chuquisaca","Sucre","Esc. Guido Villagomez",119,1,1,1,41,5,16,1,1,186,4,9,199,224,0.22,0.888
"706","Chuquisaca","Sucre","Esc. Guido Villagomez",83,0,2,3,55,5,41,3,4,196,5,11,212,231,0.281,0.918
"707","Chuquisaca","Sucre","Esc. Guido Villagomez",122,0,2,1,48,3,21,0,2,199,3,8,210,235,0.241,0.894
"708","Chuquisaca","Sucre","Esc. Guido Villagomez",125,1,7,3,31,4,30,0,3,204,2,3,209,227,0.152,0.921
"709","Chuquisaca","Sucre","Esc. Guido Villagomez",93,0,0,0,57,3,22,0,2,177,9,13,199,230,0.322,0.865
"710","Chuquisaca","Sucre","Esc. Guido Villagomez",124,1,1,1,52,2,14,0,0,195,6,8,209,232,0.267,0.901
"711","Chuquisaca","Sucre","Campo Deportivo 20 de Octubre",115,0,3,0,46,3,25,0,5,197,2,9,208,231,0.234,0.9
"712","Chuquisaca","Sucre","Campo Deportivo 20 de Octubre",91,1,2,1,63,5,28,0,6,197,5,13,215,231,0.32,0.931
"713","Chuquisaca","Sucre","Campo Deportivo 20 de Octubre",114,0,1,3,54,2,27,0,8,209,4,10,223,233,0.258,0.957
"714","Chuquisaca","Sucre","Campo Deportivo 20 de Octubre",100,0,3,1,48,4,40,2,4,202,5,5,212,229,0.238,0.926
"715","Chuquisaca","Sucre","Campo Deportivo 20 de Octubre",126,1,2,2,32,5,18,3,14,203,1,10,214,236,0.158,0.907
"716","Chuquisaca","Sucre","Campo Deportivo 20 de Octubre",108,1,0,1,54,6,27,1,12,210,3,9,222,231,0.257,0.961
"717","Chuquisaca","Sucre","Campo Deportivo 20 de Octubre",114,1,3,0,53,5,23,0,4,203,1,7,211,233,0.261,0.906
"718","Chuquisaca","Sucre","Unidad Educativa Alberto Bohorquez",52,1,2,0,79,9,50,0,1,194,11,13,218,237,0.407,0.92
"719","Chuquisaca","Sucre","Unidad Educativa Alberto Bohorquez",47,5,0,0,75,8,48,1,3,187,13,19,219,234,0.401,0.936
"720","Chuquisaca","Sucre","Unidad Educativa Alberto Bohorquez",44,1,5,0,82,8,37,3,9,189,12,21,222,233,0.434,0.953
"721","Chuquisaca","Sucre","Unidad Educativa Alberto Bohorquez",46,3,2,0,101,5,45,1,7,210,8,8,226,234,0.481,0.966
"722","Chuquisaca","Sucre","Unidad Educativa Alberto Bohorquez",36,5,2,1,97,5,40,0,5,191,15,18,224,239,0.508,0.937
"723","Chuquisaca","Sucre","Unidad Educativa Alberto Bohorquez",55,2,4,3,80,5,33,1,7,190,14,11,215,239,0.421,0.9
"724","Chuquisaca","Sucre","Unidad Educativa Alberto Bohorquez",52,1,1,0,89,2,35,0,10,190,13,17,220,233,0.468,0.944
"725","Chuquisaca","Sucre","Unidad Educativa Alberto Bohorquez",61,3,4,1,72,4,38,2,10,195,6,19,220,237,0.369,0.928
"726","Chuquisaca","Sucre","Unidad Educativa Alberto Bohorquez",55,3,1,2,84,8,33,1,7,194,11,15,220,239,0.433,0.921
"727","Chuquisaca","Sucre","Unidad Educativa Alberto Bohorquez",57,2,3,1,80,4,38,1,7,193,4,16,213,234,0.415,0.91
"728","Chuquisaca","Sucre","Escuela Tucsupaya",120,0,0,1,56,4,19,1,2,203,4,9,216,231,0.276,0.935
"729","Chuquisaca","Sucre","Escuela Tucsupaya",125,1,0,2,52,5,18,1,1,205,2,5,212,231,0.254,0.918
"730","Chuquisaca","Sucre","Escuela Tucsupaya",109,1,1,1,61,5,12,0,2,192,6,7,205,229,0.318,0.895
"731","Chuquisaca","Sucre","Escuela Tucsupaya",92,0,0,2,63,4,21,0,1,183,2,21,206,233,0.344,0.884
"732","Chuquisaca","Sucre","Escuela Tucsupaya",93,1,0,2,60,5,22,1,6,190,7,10,207,230,0.316,0.9
"733","Chuquisaca","Sucre","Escuela Tucsupaya",123,1,2,0,40,3,25,0,8,202,6,8,216,233,0.198,0.927
"734","Chuquisaca","Sucre","Escuela Tucsupaya",108,2,1,1,52,2,33,2,1,202,2,3,207,230,0.257,0.9
"735","Chuquisaca","Sucre","Escuela Tucsupaya",103,0,4,1,64,4,21,0,2,199,5,6,210,234,0.322,0.897
"736","Chuquisaca","Sucre","Escuela Tucsupaya",99,4,2,1,59,1,15,0,2,183,5,17,205,229,0.322,0.895
"737","Chuquisaca","Sucre","Escuela Tucsupaya",110,0,4,0,56,6,22,3,9,210,3,9,222,232,0.267,0.957
"738","Chuquisaca","Sucre","Escuela Tucsupaya",121,0,0,1,49,5,15,0,4,195,4,6,205,225,0.251,0.911
"739","Chuquisaca","Sucre","Escuela Tucsupaya",126,0,0,1,64,2,13,0,2,208,7,3,218,235,0.308,0.928
"740","Chuquisaca","Sucre","Escuela Tucsupaya",117,2,1,1,49,1,22,1,2,196,4,15,215,231,0.25,0.931
"741","Chuquisaca","Sucre","Escuela Tucsupaya",121,1,0,0,52,3,25,1,3,206,0,3,209,231,0.252,0.905
"742","Chuquisaca","Sucre","Escuela Tucsupaya",126,0,2,0,49,3,16,0,3,199,2,11,212,233,0.246,0.91
"743","Chuquisaca","Sucre","Escuela Tucsupaya",119,2,0,2,48,5,19,1,1,197,3,10,210,234,0.244,0.897
"744","Chuquisaca","Sucre","Escuela Tucsupaya",104,2,3,0,52,0,23,0,6,190,2,4,196,215,0.274,0.912
"745","Chuquisaca","Sucre","Salon Multifuncional El Niño",135,2,1,2,40,2,20,0,2,204,4,6,214,238,0.196,0.899
"746","Chuquisaca","Sucre","Salon Multifuncional El Niño",144,0,0,1,48,3,17,1,4,218,1,4,223,235,0.22,0.949
"747","Chuquisaca","Sucre","Salon Multifuncional El Niño",140,0,4,1,44,1,23,1,2,216,2,6,224,237,0.204,0.945
"748","Chuquisaca","Sucre","Salon Multifuncional El Niño",150,2,0,0,30,3,16,1,3,205,5,4,214,234,0.146,0.915
"749","Chuquisaca","Sucre","U.E. Gastón Vilar Casso",76,1,1,0,72,3,31,1,4,189,5,6,200,234,0.381,0.855
"750","Chuquisaca","Sucre","U.E. Gastón Vilar Casso",91,0,0,0,59,5,31,3,4,193,5,7,205,227,0.306,0.903
"751","Chuquisaca","Sucre","U.E. Gastón Vilar Casso",114,1,2,0,46,5,27,0,4,199,4,8,211,230,0.231,0.917
"752","Chuquisaca","Sucre","U.E. Gastón Vilar Casso",90,1,2,2,53,2,34,0,5,189,8,9,206,226,0.28,0.912
"753","Chuquisaca","Sucre","U.E. Gastón Vilar Casso",76,2,1,3,63,5,35,1,3,189,11,9,209,232,0.333,0.901
"754","Chuquisaca","Sucre","U.E. Gastón Vilar Casso",93,0,5,0,68,4,28,0,4,202,1,13,216,234,0.337,0.923
"755","Chuquisaca","Sucre","U.E. Gastón Vilar Casso",72,1,3,1,86,5,25,1,3,197,2,5,204,229,0.437,0.891
"756","Chuquisaca","Sucre","U.E. Gastón Vilar Casso",82,1,3,0,65,1,35,0,4,191,6,14,211,231,0.34,0.913
"757","Chuquisaca","Sucre","U.E. Gastón Vilar Casso",94,5,1,0,45,6,29,0,9,189,2,23,214,232,0.238,0.922
"758","Chuquisaca","Sucre","U.E. Gastón Vilar Casso",117,1,3,1,50,9,21,1,7,210,3,5,218,234,0.238,0.932
"759","Chuquisaca","Sucre","U.E. Gastón Vilar Casso",85,1,2,1,60,3,22,2,5,181,4,22,207,225,0.331,0.92
"760","Chuquisaca","Sucre","U.E. Gastón Vilar Casso",96,2,1,0,47,7,28,1,7,189,5,10,204,229,0.249,0.891
"761","Chuquisaca","Sucre","U.E. Gastón Vilar Casso",86,2,3,1,59,4,26,2,7,190,2,8,200,224,0.311,0.893
"762","Chuquisaca","Sucre","U.E. Gastón Vilar Casso",70,1,1,2,63,9,33,0,7,186,4,14,204,229,0.339,0.891
"763","Chuquisaca","Sucre","U.E. Gastón Vilar Casso",87,0,4,1,61,1,26,5,4,189,6,8,203,229,0.323,0.886
"764","Chuquisaca","Sucre","U.E. Gastón Vilar Casso",62,2,1,2,74,1,36,2,5,185,8,15,208,235,0.4,0.885
"765","Chuquisaca","Sucre","U.E. Gastón Vilar Casso",95,3,0,0,49,5,27,0,9,188,7,9,204,230,0.261,0.887
"766","Chuquisaca","Sucre","U.E. Gastón Vilar Casso",92,3,3,1,62,3,30,0,1,195,4,12,211,229,0.318,0.921
"767","Chuquisaca","Sucre","U.E. Gastón Vilar Casso",93,5,1,2,61,3,25,0,10,200,4,9,213,234,0.305,0.91
"768","Chuquisaca","Sucre","U.E. Gastón Vilar Casso",84,1,1,1,68,6,27,2,3,193,10,9,212,227,0.352,0.934
"769","Chuquisaca","Sucre","U.E. Gastón Vilar Casso",103,1,0,1,48,5,29,0,3,190,4,17,211,230,0.253,0.917
"770","Chuquisaca","Sucre","U.E. Gastón Vilar Casso",81,2,2,4,56,7,33,1,1,187,7,15,209,233,0.299,0.897
"771","Chuquisaca","Sucre","U.E. Gastón Vilar Casso",104,1,2,1,53,2,26,0,4,193,1,10,204,230,0.275,0.887
"772","Chuquisaca","Sucre","U.E. Gastón Vilar Casso",123,1,1,0,40,3,22,1,8,199,2,10,211,229,0.201,0.921
"773","Chuquisaca","Sucre","U.E. Gastón Vilar Casso",89,2,4,0,51,5,36,1,1,189,6,11,206,228,0.27,0.904
"774","Chuquisaca","Sucre","U.E. Gastón Vilar Casso",89,0,4,2,53,5,26,2,6,187,5,13,205,230,0.283,0.891
"775","Chuquisaca","Sucre","U.E. Gastón Vilar Casso",86,0,4,1,62,3,28,2,6,192,5,10,207,229,0.323,0.904
"776","Chuquisaca","Sucre","U.E. Gastón Vilar Casso",91,0,3,1,49,6,28,1,4,183,3,10,196,230,0.268,0.852
"777","Chuquisaca","Sucre","U.E. Gastón Vilar Casso",78,1,2,0,67,4,29,1,11,193,6,16,215,231,0.347,0.931
"778","Chuquisaca","Sucre","Coliseo Los Pinos",89,0,2,0,80,3,43,1,0,218,5,7,230,240,0.367,0.958
"779","Chuquisaca","Sucre","Coliseo Los Pinos",100,2,1,0,65,3,42,1,6,220,2,9,231,238,0.295,0.971
"780","Chuquisaca","Sucre","Coliseo Los Pinos",96,2,1,0,62,3,44,1,7,216,1,12,229,239,0.287,0.958
"781","Chuquisaca","Sucre","U.E. Marcelo Quiroga Santa Cruz",74,0,1,1,76,3,32,0,4,191,7,13,211,227,0.398,0.93
"782","Chuquisaca","Sucre","U.E. Marcelo Quiroga Santa Cruz",70,0,1,0,81,2,28,0,2,184,6,12,202,233,0.44,0.867
"783","Chuquisaca","Sucre","U.E. Marcelo Quiroga Santa Cruz",95,0,1,2,64,5,29,0,2,198,3,10,211,230,0.323,0.917
"784","Chuquisaca","Sucre","U.E. Marcelo Quiroga Santa Cruz",76,0,2,2,74,0,43,2,3,202,7,7,216,231,0.366,0.935
"785","Chuquisaca","Sucre","U.E. Marcelo Quiroga Santa Cruz",62,0,2,1,89,8,34,0,3,199,10,14,223,236,0.447,0.945
"786","Chuquisaca","Sucre","U.E. Marcelo Quiroga Santa Cruz",69,1,3,2,74,5,32,0,4,190,10,9,209,236,0.389,0.886
"787","Chuquisaca","Sucre","U.E. Marcelo Quiroga Santa Cruz",77,2,5,0,68,3,22,0,3,180,10,16,206,230,0.378,0.896
"788","Chuquisaca","Sucre","U.E. Marcelo Quiroga Santa Cruz",98,3,2,1,50,4,28,6,6,198,6,13,217,233,0.253,0.931
"789","Chuquisaca","Sucre","U.E. Marcelo Quiroga Santa Cruz",79,3,2,0,66,3,29,0,7,189,6,16,211,228,0.349,0.925
"790","Chuquisaca","Sucre","U.E. Marcelo Quiroga Santa Cruz",65,2,1,0,67,5,24,1,17,182,9,10,201,232,0.368,0.866
"791","Chuquisaca","Sucre","U.E. Marcelo Quiroga Santa Cruz",67,0,3,1,63,7,33,0,5,179,7,12,198,229,0.352,0.865
"792","Chuquisaca","Sucre","U.E. Marcelo Quiroga Santa Cruz",88,1,0,0,56,3,28,0,7,183,6,10,199,225,0.306,0.884
"793","Chuquisaca","Sucre","U.E. Marcelo Quiroga Santa Cruz",60,2,1,1,83,8,33,1,3,192,10,6,208,229,0.432,0.908
"794","Chuquisaca","Sucre","U.E. Marcelo Quiroga Santa Cruz",92,0,1,0,64,2,30,2,2,193,4,12,209,236,0.332,0.886
"795","Chuquisaca","Sucre","U.E. Marcelo Quiroga Santa Cruz",77,0,1,2,67,4,40,1,4,196,6,10,212,235,0.342,0.902
"796","Chuquisaca","Sucre","U.E. Marcelo Quiroga Santa Cruz",73,2,1,0,74,11,26,0,5,192,7,14,213,232,0.385,0.918
"797","Chuquisaca","Sucre","U.E. Marcelo Quiroga Santa Cruz",90,2,0,0,61,6,27,2,4,192,5,12,209,224,0.318,0.933
"798","Chuquisaca","Sucre","U.E. Marcelo Quiroga Santa Cruz",87,0,1,0,57,6,19,2,10,182,5,16,203,227,0.313,0.894
"799","Chuquisaca","Sucre","U.E. Marcelo Quiroga Santa Cruz",93,1,2,1,62,5,26,0,2,192,5,12,209,235,0.323,0.889
"800","Chuquisaca","Sucre","U.E. Marcelo Quiroga Santa Cruz",104,3,2,0,51,3,21,0,4,188,6,12,206,232,0.271,0.888
"801","Chuquisaca","Sucre","U.E. Marcelo Quiroga Santa Cruz",109,2,1,0,56,6,19,1,3,197,6,6,209,231,0.284,0.905
"802","Chuquisaca","Sucre","U.E. Marcelo Quiroga Santa Cruz",96,3,2,3,62,5,21,1,0,193,5,7,205,232,0.321,0.884
"803","Chuquisaca","Sucre","U.E. Marcelo Quiroga Santa Cruz",82,1,0,2,64,3,27,1,5,185,8,5,198,220,0.346,0.9
"804","Chuquisaca","Sucre","Col. Emilio Hoschman",81,2,1,1,73,5,24,8,4,199,7,12,218,234,0.367,0.932
"805","Chuquisaca","Sucre","Col. Emilio Hoschman",67,1,2,2,75,5,25,0,2,179,8,12,199,227,0.419,0.877
"806","Chuquisaca","Sucre","Col. Emilio Hoschman",90,1,2,2,59,8,26,2,7,197,5,13,215,232,0.299,0.927
"807","Chuquisaca","Sucre","Col. Emilio Hoschman",79,0,1,0,67,3,31,0,6,187,5,10,202,231,0.358,0.874
"808","Chuquisaca","Sucre","Col. Emilio Hoschman",60,4,0,1,91,6,32,1,4,199,6,14,219,237,0.457,0.924
"809","Chuquisaca","Sucre","Col. Emilio Hoschman",92,0,0,2,70,10,31,1,4,210,3,8,221,235,0.333,0.94
"810","Chuquisaca","Sucre","Col. Emilio Hoschman",48,2,2,0,86,8,41,2,4,193,8,12,213,224,0.446,0.951
"811","Chuquisaca","Sucre","Col. Emilio Hoschman",78,2,0,1,61,5,39,0,3,189,5,14,208,234,0.323,0.889
"812","Chuquisaca","Sucre","Col. Emilio Hoschman",68,2,3,0,76,7,33,3,2,194,4,12,210,230,0.392,0.913
"813","Chuquisaca","Sucre","Col. Emilio Hoschman",67,2,1,0,66,2,43,1,3,185,7,11,203,223,0.357,0.91
"814","Chuquisaca","Sucre","Col. Emilio Hoschman",76,2,2,2,73,5,22,1,4,187,6,12,205,229,0.39,0.895
"815","Chuquisaca","Sucre","Col. Emilio Hoschman",81,3,2,1,78,2,34,1,1,203,3,9,215,230,0.384,0.935
"816","Chuquisaca","Sucre","Col. Emilio Hoschman",67,0,2,0,72,6,35,0,3,185,3,20,208,233,0.389,0.893
"817","Chuquisaca","Sucre","Col. Emilio Hoschman",63,2,5,1,74,8,33,2,3,191,8,13,212,232,0.387,0.914
"818","Chuquisaca","Sucre","Col. Emilio Hoschman",67,0,0,1,72,6,41,1,5,193,8,14,215,234,0.373,0.919
"819","Chuquisaca","Sucre","Col. Emilio Hoschman",81,0,2,0,55,8,37,0,7,190,4,9,203,232,0.289,0.875
"820","Chuquisaca","Sucre","Col. Emilio Hoschman",59,3,1,5,75,5,28,1,2,179,8,24,211,230,0.419,0.917
"821","Chuquisaca","Sucre","Col. Emilio Hoschman",91,0,2,1,54,3,29,3,2,185,9,4,198,234,0.292,0.846
"822","Chuquisaca","Sucre","Col. Emilio Hoschman",91,0,3,0,59,5,32,0,2,192,9,14,215,228,0.307,0.943
"823","Chuquisaca","Sucre","Col. Emilio Hoschman",76,0,1,1,69,5,34,3,3,192,5,12,209,231,0.359,0.905
"824","Chuquisaca","Sucre","Col. Emilio Hoschman",72,1,3,1,72,8,28,3,5,193,7,9,209,233,0.373,0.897
"825","Chuquisaca","Sucre","Col. Emilio Hoschman",95,2,0,3,54,7,29,0,3,193,6,10,209,230,0.28,0.909
"826","Chuquisaca","Sucre","Col. Emilio Hoschman",67,2,2,3,60,5,32,3,5,179,6,11,196,231,0.335,0.848
"827","Chuquisaca","Sucre","Col. Emilio Hoschman",73,4,1,1,74,9,32,0,2,196,3,11,210,232,0.378,0.905
"828","Chuquisaca","Sucre","Col. Emilio Hoschman",74,2,2,0,74,3,27,2,9,193,6,11,210,236,0.383,0.89
"829","Chuquisaca","Sucre","Col. Emilio Hoschman",84,1,3,0,58,2,47,2,3,200,5,7,212,229,0.29,0.926
"830","Chuquisaca","Sucre","Col. Emilio Hoschman",60,2,1,1,53,5,33,1,11,167,2,46,215,232,0.317,0.927
"831","Chuquisaca","Sucre","Col. Emilio Hoschman",83,0,1,3,75,4,28,1,5,200,1,5,206,232,0.375,0.888
"832","Chuquisaca","Sucre","Col. Emilio Hoschman",93,2,1,3,54,7,32,3,4,199,6,9,214,237,0.271,0.903
"833","Chuquisaca","Sucre","Col. Emilio Hoschman",84,2,1,0,66,4,27,0,7,191,6,8,205,230,0.346,0.891
"834","Chuquisaca","Sucre","Col. Jorge Revilla",124,0,0,1,52,0,15,1,5,198,3,7,208,236,0.263,0.881
"835","Chuquisaca","Sucre","Col. Jorge Revilla",120,0,1,1,48,6,12,2,2,192,2,5,199,232,0.25,0.858
"836","Chuquisaca","Sucre","Col. Jorge Revilla",127,2,1,1,42,4,10,0,4,191,6,7,204,229,0.22,0.891
"837","Chuquisaca","Sucre","Col. Jorge Revilla",138,1,2,4,34,1,15,0,3,198,2,9,209,228,0.172,0.917
"838","Chuquisaca","Sucre","Col. Jorge Revilla",134,1,3,1,45,3,12,0,5,204,3,11,218,235,0.221,0.928
"839","Chuquisaca","Sucre","Col. Jorge Revilla",90,1,0,5,59,1,41,1,5,203,2,10,215,228,0.291,0.943
"840","Chuquisaca","Sucre","Col. Jorge Revilla",96,1,0,1,46,5,33,0,2,184,4,11,199,229,0.25,0.869
"841","Chuquisaca","Sucre","Col. Jorge Revilla",94,0,3,2,56,4,27,2,3,191,3,7,201,226,0.293,0.889
"842","Chuquisaca","Sucre","Col. Jorge Revilla",117,0,2,0,41,7,18,1,6,192,0,6,198,223,0.214,0.888
"843","Chuquisaca","Sucre","Col. Jorge Revilla",122,0,1,0,46,1,23,2,2,197,4,11,212,231,0.234,0.918
"844","Chuquisaca","Sucre","Col. Jorge Revilla",112,0,1,1,52,8,15,1,2,192,1,10,203,233,0.271,0.871
"845","Chuquisaca","Sucre","Col. Jorge Revilla",118,1,0,0,40,1,28,0,3,191,1,11,203,223,0.209,0.91
"846","Chuquisaca","Sucre","Col. Jorge Revilla",115,0,0,1,54,2,21,1,3,197,0,5,202,224,0.274,0.902
"847","Chuquisaca","Sucre","Col. Jorge Revilla",125,1,0,0,45,5,16,1,3,196,5,10,211,232,0.23,0.909
"848","Chuquisaca","Sucre","Col. Jorge Revilla",96,2,3,1,65,6,30,0,0,203,5,7,215,236,0.32,0.911
"849","Chuquisaca","Sucre","Col. Jorge Revilla",132,0,1,1,40,4,18,0,1,197,4,3,204,227,0.203,0.899
"850","Chuquisaca","Sucre","Col. Jorge Revilla",135,3,0,0,37,4,18,1,4,202,1,11,214,233,0.183,0.918
"851","Chuquisaca","Sucre","Col. Jorge Revilla",122,0,2,1,49,1,14,1,3,193,2,12,207,229,0.254,0.904
"852","Chuquisaca","Sucre","Col. Jorge Revilla",120,0,1,1,41,4,20,0,3,190,2,15,207,230,0.216,0.9
"853","Chuquisaca","Sucre","Col. Jorge Revilla",112,2,1,0,53,4,18,0,6,196,5,12,213,236,0.27,0.903
"854","Chuquisaca","Sucre","Col. Jorge Revilla",118,0,2,0,53,3,17,2,2,197,2,10,209,230,0.269,0.909
"855","Chuquisaca","Sucre","Col. Jorge Revilla",120,0,0,0,50,2,16,0,0,188,2,9,199,227,0.266,0.877
"856","Chuquisaca","Sucre","Col. Jorge Revilla",111,0,1,0,49,8,22,0,2,193,3,13,209,229,0.254,0.913
"857","Chuquisaca","Sucre","Col. Jorge Revilla",140,0,1,0,37,5,14,0,2,199,5,8,212,232,0.186,0.914
"858","Chuquisaca","Sucre","Col. Jorge Revilla",124,1,1,0,43,4,17,0,2,192,0,9,201,223,0.224,0.901
"859","Chuquisaca","Sucre","Col. Jorge Revilla",123,0,0,0,44,5,27,0,1,200,1,7,208,229,0.22,0.908
"860","Chuquisaca","Sucre","Col. Jorge Revilla",121,0,1,0,44,6,22,0,2,196,3,14,213,233,0.224,0.914
"861","Chuquisaca","Sucre","U.E. Las Americas",103,1,2,0,53,3,21,0,3,186,7,13,206,234,0.285,0.88
"862","Chuquisaca","Sucre","U.E. Las Americas",87,0,1,0,62,4,24,2,3,183,5,13,201,233,0.339,0.863
"863","Chuquisaca","Sucre","U.E. Las Americas",103,0,2,2,42,1,36,1,0,187,5,14,206,233,0.225,0.884
"864","Chuquisaca","Sucre","U.E. Las Americas",84,2,2,0,61,2,34,0,7,192,6,11,209,228,0.318,0.917
"865","Chuquisaca","Sucre","U.E. Las Americas",81,2,1,2,64,3,27,0,4,184,8,11,203,229,0.348,0.886
"866","Chuquisaca","Sucre","U.E. Las Americas",72,0,2,1,70,8,33,2,4,192,3,14,209,232,0.365,0.901
"867","Chuquisaca","Sucre","U.E. Las Americas",75,0,1,2,74,5,23,0,6,186,12,8,206,231,0.398,0.892
"868","Chuquisaca","Sucre","U.E. Las Americas",106,3,3,1,45,2,26,2,5,193,6,9,208,226,0.233,0.92
"869","Chuquisaca","Sucre","U.E. Las Americas",77,2,1,0,67,4,35,0,2,188,5,9,202,228,0.356,0.886
"870","Chuquisaca","Sucre","U.E. Las Americas",83,3,2,2,65,4,27,0,1,187,4,9,200,223,0.348,0.897
"871","Chuquisaca","Sucre","U.E. Las Americas",96,0,1,3,60,4,29,0,4,197,3,10,210,231,0.305,0.909
"872","Chuquisaca","Sucre","U.E. Las Americas",82,1,1,0,73,6,27,3,6,199,1,10,210,232,0.367,0.905
"873","Chuquisaca","Sucre","U.E. Las Americas",84,1,2,1,68,5,17,2,3,183,5,13,201,225,0.372,0.893
"874","Chuquisaca","Sucre","U.E. Las Americas",76,2,0,1,56,4,29,2,4,174,7,13,194,229,0.322,0.847
"875","Chuquisaca","Sucre","U.E. Las Americas",76,3,0,0,52,5,29,1,4,170,11,22,203,228,0.306,0.89
"876","Chuquisaca","Sucre","U.E. Las Americas",100,1,0,1,46,5,32,0,5,190,5,9,204,227,0.242,0.899
"877","Chuquisaca","Sucre","U.E. Las Americas",79,0,1,1,64,5,28,1,3,182,5,9,196,232,0.352,0.845
"878","Chuquisaca","Sucre","U.E. Las Americas",66,0,1,2,83,4,32,0,3,191,4,10,205,230,0.435,0.891
"879","Chuquisaca","Sucre","U.E. Las Americas",72,3,1,1,59,2,23,4,4,169,9,12,190,230,0.349,0.826
"880","Chuquisaca","Sucre","U.E. Las Americas",106,1,2,1,53,5,15,3,3,189,8,10,207,229,0.28,0.904
"881","Chuquisaca","Sucre","U.E. Las Americas",82,1,0,0,61,5,31,0,1,181,1,17,199,229,0.337,0.869
"882","Chuquisaca","Sucre","U.E. Las Americas",87,0,1,5,56,4,30,0,6,189,5,18,212,234,0.296,0.906
"883","Chuquisaca","Sucre","U.E. Las Americas",105,1,1,1,46,4,34,0,2,194,1,7,202,228,0.237,0.886
"884","Chuquisaca","Sucre","U.E. Las Americas",102,4,0,0,55,3,25,1,4,194,3,11,208,229,0.284,0.908
"885","Chuquisaca","Sucre","U.E. Las Americas",77,2,1,0,66,7,37,0,6,196,3,12,211,231,0.337,0.913
"886","Chuquisaca","Sucre","Salon Mult. Alto Loyola",101,0,2,1,61,0,18,2,4,189,5,9,203,230,0.323,0.883
"887","Chuquisaca","Sucre","Salon Mult. Alto Loyola",94,1,0,2,49,7,28,4,5,190,5,7,202,227,0.258,0.89
"888","Chuquisaca","Sucre","Salon Mult. Alto Loyola",98,0,1,1,55,5,23,0,3,186,0,17,203,228,0.296,0.89
"889","Chuquisaca","Sucre","Salon Mult. Alto Loyola",93,0,0,0,56,3,28,1,4,185,2,8,195,223,0.303,0.874
"890","Chuquisaca","Sucre","Salon Mult. Alto Loyola",97,0,3,0,62,0,26,0,6,194,6,8,208,229,0.32,0.908
"891","Chuquisaca","Sucre","Salon Mult. Alto Loyola",83,1,0,3,70,5,27,1,3,193,5,7,205,228,0.363,0.899
"892","Chuquisaca","Sucre","Salon Mult. Alto Loyola",111,1,2,0,41,3,19,2,4,183,3,8,194,233,0.224,0.833
"893","Chuquisaca","Sucre","Esc. Angel Baspineiro",44,1,1,3,94,4,36,3,5,191,12,13,216,233,0.492,0.927
"894","Chuquisaca","Sucre","Esc. Angel Baspineiro",21,4,2,0,112,6,36,1,10,192,10,17,219,237,0.583,0.924
"895","Chuquisaca","Sucre","Esc. Angel Baspineiro",39,1,1,1,93,2,37,3,9,186,7,24,217,231,0.5,0.939
"896","Chuquisaca","Sucre","Esc. Angel Baspineiro",14,4,1,1,122,5,45,2,5,199,7,14,220,235,0.613,0.936
"897","Chuquisaca","Sucre","Esc. Angel Baspineiro",19,1,0,1,89,5,40,2,6,163,22,20,205,234,0.546,0.876
"898","Chuquisaca","Sucre","Esc. Angel Baspineiro",26,4,2,1,111,6,27,1,7,185,16,21,222,234,0.6,0.949
"899","Chuquisaca","Sucre","Esc. Angel Baspineiro",33,3,0,1,112,8,35,0,5,197,11,12,220,235,0.569,0.936
"900","Chuquisaca","Sucre","Unid. Educativa Victoria Diez",45,0,5,1,85,7,39,0,3,185,8,19,212,233,0.459,0.91
"901","Chuquisaca","Sucre","Unid. Educativa Victoria Diez",45,4,8,0,81,8,36,1,7,190,7,13,210,232,0.426,0.905
"902","Chuquisaca","Sucre","Unid. Educativa Victoria Diez",78,3,2,0,64,4,32,0,4,187,7,17,211,230,0.342,0.917
"903","Chuquisaca","Sucre","Unid. Educativa Victoria Diez",29,0,0,2,93,2,46,1,10,183,8,8,199,231,0.508,0.861
"904","Chuquisaca","Sucre","Unid. Educativa Victoria Diez",52,0,1,1,84,3,41,2,4,188,10,18,216,227,0.447,0.952
"905","Chuquisaca","Sucre","Unid. Educativa Victoria Diez",39,3,3,0,86,5,47,1,4,188,5,16,209,231,0.457,0.905
"906","Chuquisaca","Sucre","Unid. Educativa Victoria Diez",34,0,0,0,101,4,33,2,10,184,9,9,202,231,0.549,0.874
"907","Chuquisaca","Sucre","Unid. Educativa Victoria Diez",33,3,7,2,74,4,49,0,5,177,8,19,204,230,0.418,0.887
"908","Chuquisaca","Sucre","Unid. Educativa Victoria Diez",45,2,1,1,84,9,35,2,7,186,11,13,210,231,0.452,0.909
"909","Chuquisaca","Sucre","Unid. Educativa Victoria Diez",57,1,1,0,85,6,33,1,9,193,8,13,214,234,0.44,0.915
"910","Chuquisaca","Sucre","Unid. Educativa Victoria Diez",56,2,2,1,73,5,33,0,6,178,4,20,202,227,0.41,0.89
"911","Chuquisaca","Sucre","Unid. Educativa Victoria Diez",60,3,9,2,81,7,24,0,3,189,6,14,209,231,0.429,0.905
"912","Chuquisaca","Sucre","Unid. Educativa Victoria Diez",55,3,0,0,80,6,39,1,1,185,7,18,210,230,0.432,0.913
"913","Chuquisaca","Sucre","Unid. Educativa Victoria Diez",41,1,2,2,86,6,38,2,5,183,15,11,209,236,0.47,0.886
"914","Chuquisaca","Sucre","Unid. Educativa Victoria Diez",37,0,2,1,82,10,39,0,9,180,10,10,200,226,0.456,0.885
"915","Chuquisaca","Sucre","Unid. Educativa Victoria Diez",40,0,2,3,90,3,44,3,2,187,8,10,205,232,0.481,0.884
"916","Chuquisaca","Sucre","Unid. Educativa Victoria Diez",45,1,5,0,86,7,31,1,2,178,3,14,195,231,0.483,0.844
"917","Chuquisaca","Sucre","Unid. Educativa Victoria Diez",24,2,0,2,99,7,45,1,2,182,6,11,199,220,0.544,0.905
"918","Chuquisaca","Sucre","Unid. Educativa Victoria Diez",67,1,1,0,72,3,34,3,4,185,7,14,206,234,0.389,0.88
"919","Chuquisaca","Sucre","Unid. Educativa Victoria Diez",48,1,1,0,98,6,30,2,3,189,10,13,212,229,0.519,0.926
"920","Chuquisaca","Sucre","Unid. Educativa Victoria Diez",52,2,1,1,96,12,27,1,7,199,6,14,219,233,0.482,0.94
"921","Chuquisaca","Sucre","Unid. Educativa Victoria Diez",39,2,5,0,92,8,37,0,5,188,11,13,212,233,0.489,0.91
"922","Chuquisaca","Sucre","Unid. Educativa Victoria Diez",50,4,3,3,82,8,29,0,5,184,8,14,206,233,0.446,0.884
"923","Chuquisaca","Sucre","Unid. Educativa Victoria Diez",29,1,3,0,76,5,54,1,3,172,6,16,194,231,0.442,0.84
"924","Chuquisaca","Sucre","Unid. Educativa Victoria Diez",53,0,2,0,84,10,30,0,1,180,9,14,203,228,0.467,0.89
"925","Chuquisaca","Sucre","Unid. Educativa Victoria Diez",46,3,5,0,69,5,35,0,8,171,2,19,192,231,0.404,0.831
"926","Chuquisaca","Sucre","Unid. Educativa Victoria Diez",83,2,1,0,77,3,24,0,2,192,8,9,209,230,0.401,0.909
"927","Chuquisaca","Sucre","Unid. Educativa Victoria Diez",57,2,1,0,78,3,39,0,4,184,9,17,210,233,0.424,0.901
"928","Chuquisaca","Sucre","Unid. Educativa Victoria Diez",73,2,1,1,62,4,31,1,5,180,5,15,200,226,0.344,0.885
"929","Chuquisaca","Sucre","Unid. Educativa Victoria Diez",34,4,3,3,89,3,42,0,5,183,7,29,219,233,0.486,0.94
"930","Chuquisaca","Sucre","Unid. Educativa Victoria Diez",52,1,5,0,65,12,41,1,2,179,3,19,201,230,0.363,0.874
"931","Chuquisaca","Sucre","Unid. Educativa Victoria Diez",35,1,2,1,89,4,29,1,5,167,8,13,188,212,0.533,0.887
"932","Chuquisaca","Sucre","Unidad Educativa Alegría",45,1,5,0,93,4,30,1,4,183,5,15,203,229,0.508,0.886
"933","Chuquisaca","Sucre","Unidad Educativa Alegría",26,2,2,2,100,9,31,2,2,176,5,31,212,234,0.568,0.906
"934","Chuquisaca","Sucre","Unidad Educativa Alegría",53,1,3,0,97,4,26,1,7,192,6,15,213,229,0.505,0.93
"935","Chuquisaca","Sucre","Unidad Educativa Alegría",48,3,0,3,100,3,27,1,6,191,7,19,217,230,0.524,0.943
"936","Chuquisaca","Sucre","Unidad Educativa Alegría",41,3,3,0,92,5,39,1,3,187,8,20,215,236,0.492,0.911
"937","Chuquisaca","Sucre","Unidad Educativa Alegría",35,2,3,0,103,5,33,1,4,186,9,24,219,236,0.554,0.928
"938","Chuquisaca","Sucre","Unidad Educativa Alegría",46,4,2,1,111,9,23,2,5,203,7,9,219,230,0.547,0.952
"939","Chuquisaca","Sucre","Unidad Educativa Alegría",48,1,1,0,100,3,38,3,3,197,4,13,214,238,0.508,0.899
"940","Chuquisaca","Sucre","Unidad Educativa Alegría",49,1,2,2,91,1,27,2,5,180,8,25,213,234,0.506,0.91
"941","Chuquisaca","Sucre","Unidad Educativa Alegría",51,4,2,1,88,3,30,1,2,182,10,18,210,231,0.484,0.909
"942","Chuquisaca","Sucre","U.E. Villa Marlecita",56,7,4,1,85,11,19,0,5,188,13,19,220,238,0.452,0.924
"943","Chuquisaca","Sucre","U.E. Villa Marlecita",40,1,0,3,113,4,29,1,4,195,7,15,217,238,0.579,0.912
"944","Chuquisaca","Sucre","U.E. Villa Marlecita",43,0,1,0,71,9,23,0,6,153,10,10,173,186,0.464,0.93
"945","Chuquisaca","Sucre","Escuela Elizardo Perez",40,4,3,1,117,5,9,0,2,181,9,6,196,216,0.646,0.907
"946","Chuquisaca","Sucre","Escuela Falafaya",27,4,1,2,78,11,23,4,3,153,14,10,177,210,0.51,0.843
"947","Chuquisaca","Sucre","Escuela Llinfi",32,2,1,1,118,6,39,0,3,202,7,11,220,232,0.584,0.948
"948","Chuquisaca","Sucre","Escuela Llinfi",30,1,3,4,109,7,43,2,2,201,4,12,217,233,0.542,0.931
"949","Chuquisaca","Sucre","Escuela Llinfi",42,2,3,1,99,6,30,1,2,186,12,19,217,228,0.532,0.952
"950","Chuquisaca","Sucre","Unidad Educativa La Barranca",28,5,1,0,117,9,23,1,4,188,9,14,211,227,0.622,0.93
"951","Chuquisaca","Sucre","Unidad Educativa La Barranca",39,1,2,1,116,2,33,2,5,201,7,9,217,231,0.577,0.939
"952","Chuquisaca","Sucre","Unidad Educativa La Barranca",30,2,0,0,91,4,43,0,4,174,5,8,187,202,0.523,0.926
"953","Chuquisaca","Sucre","U.E. Qhora Qhora Alta",43,1,3,1,114,3,23,3,5,196,7,12,215,236,0.582,0.911
"954","Chuquisaca","Sucre","U.E. Qhora Qhora Alta",49,3,1,0,111,6,23,1,4,198,8,10,216,235,0.561,0.919
"955","Chuquisaca","Sucre","U.E. Qhora Qhora Alta",49,1,0,3,112,3,36,0,5,209,7,4,220,231,0.536,0.952
"956","Chuquisaca","Sucre","U.E. Qhora Qhora Alta",44,3,3,4,92,0,24,0,4,174,2,9,185,207,0.529,0.894
"957","Chuquisaca","Sucre","U.E. 9 de Marzo",26,3,4,3,131,2,30,0,5,204,12,20,236,239,0.642,0.987
"958","Chuquisaca","Sucre","U.E. 9 de Marzo",17,3,4,2,121,7,31,1,5,191,8,12,211,217,0.634,0.972
"959","Chuquisaca","Yotala","Colegio Gregorio Pacheco",46,2,2,0,111,3,6,1,0,171,9,4,184,215,0.649,0.856
"960","Chuquisaca","Yotala","Colegio Gregorio Pacheco",57,1,1,2,110,4,10,1,1,187,3,2,192,219,0.588,0.877
"961","Chuquisaca","Yotala","Colegio Gregorio Pacheco",62,2,1,1,95,1,14,0,2,178,6,11,195,223,0.534,0.874
"962","Chuquisaca","Yotala","Colegio Gregorio Pacheco",54,1,3,0,93,8,5,5,0,169,7,8,184,219,0.55,0.84
"963","Chuquisaca","Yotala","Colegio Gregorio Pacheco",62,0,1,1,88,3,11,2,1,169,5,5,179,212,0.521,0.844
"964","Chuquisaca","Yotala","Centro Educativo Santa Rosa",55,0,2,0,100,3,9,2,1,172,3,12,187,224,0.581,0.835
"965","Chuquisaca","Yotala","Centro Educativo Santa Rosa",65,1,3,0,92,2,18,2,1,184,1,9,194,222,0.5,0.874
"966","Chuquisaca","Yotala","Centro Educativo Santa Rosa",92,0,0,1,83,1,10,1,1,189,2,13,204,233,0.439,0.876
"967","Chuquisaca","Yotala","Centro Educativo Santa Rosa",102,0,2,0,61,4,12,0,0,181,2,9,192,226,0.337,0.85
"968","Chuquisaca","Yotala","Centro Educativo Santa Rosa",65,0,2,0,103,3,8,1,1,183,5,12,200,226,0.563,0.885
"969","Chuquisaca","Yotala","Colegio San Isidro De Anfaya",8,0,1,1,160,1,10,0,0,181,5,1,187,208,0.884,0.899
"970","Chuquisaca","Yotala","Colegio San Isidro De Anfaya",4,0,1,1,137,1,8,1,0,153,2,2,157,171,0.895,0.918
"971","Chuquisaca","Yotala","Colegio Tasa Pampa",8,0,0,0,162,1,7,0,0,178,3,2,183,225,0.91,0.813
"972","Chuquisaca","Yotala","Escuela Antonio Tovar Hinojosa",15,0,0,1,136,1,15,0,4,172,6,7,185,211,0.791,0.877
"973","Chuquisaca","Yotala","Unidad Educativa German Busch",35,2,2,0,101,4,18,3,3,168,3,15,186,213,0.601,0.873
"974","Chuquisaca","Yotala","Unidad Educativa Campanario",47,1,0,1,89,2,12,0,1,153,3,10,166,185,0.582,0.897
"975","Chuquisaca","Yotala","Unidad Educativa Victor Sandi",38,0,2,1,130,6,15,0,3,195,5,9,209,231,0.667,0.905
"976","Chuquisaca","Yotala","Unidad Educativa Victor Sandi",50,3,1,1,115,5,14,1,0,190,7,12,209,231,0.605,0.905
"977","Chuquisaca","Poroma","U. Edu. San Andres De Poroma",29,2,2,0,112,4,10,0,1,160,8,15,183,219,0.7,0.836
"978","Chuquisaca","Poroma","U. Edu. San Andres De Poroma",25,3,1,1,120,0,6,2,2,160,14,6,180,221,0.75,0.814
"979","Chuquisaca","Poroma","U. Edu. San Andres De Poroma",13,2,1,4,132,1,6,0,2,161,14,12,187,230,0.82,0.813
"980","Chuquisaca","Poroma","U. Edu. San Andres De Poroma",25,0,1,1,118,2,6,0,1,154,11,13,178,220,0.766,0.809
"981","Chuquisaca","Poroma","Sub Alcaldía De Sapse",13,0,1,0,127,6,2,4,2,155,2,6,163,194,0.819,0.84
"982","Chuquisaca","Poroma","Colegio Rafael Campos De Luje",12,1,2,1,142,2,7,1,0,168,7,5,180,218,0.845,0.826
"983","Chuquisaca","Poroma","Escuela Central Challcha",28,2,1,0,121,7,5,3,1,168,3,11,182,225,0.72,0.809
"984","Chuquisaca","Poroma","Unidad Educativa Los Alamos",19,5,1,1,129,5,10,3,4,177,10,9,196,217,0.729,0.903
"985","Chuquisaca","Poroma","Colegiomanuel Ovando San Juan De Orcas",5,1,2,1,129,0,12,3,3,156,4,8,168,212,0.827,0.792
"986","Chuquisaca","Poroma","Unidad Educativa Iru Kkota",13,2,1,2,151,3,5,2,1,180,14,11,205,242,0.839,0.847
"987","Chuquisaca","Poroma","Unidad Educativa Chijmuri",13,0,2,1,117,5,15,4,1,158,9,8,175,199,0.741,0.879
"988","Chuquisaca","Poroma","Unidad Educativa Palajla",1,0,1,0,168,0,0,0,0,170,3,3,176,199,0.988,0.884
"989","Chuquisaca","Poroma","Unidad Educativa Sanabria",17,3,0,2,123,4,13,0,1,163,8,11,182,194,0.755,0.938
"990","Chuquisaca","Poroma","Unidad Educativa Cucuri",8,4,1,2,132,4,11,1,0,163,14,13,190,225,0.81,0.844
"991","Chuquisaca","Poroma","Unidad Educativa Yanani",2,0,0,0,184,1,4,2,1,194,7,10,211,230,0.948,0.917
"992","Chuquisaca","Azurduy","Unidad Educativa Nicanor Lopez",40,2,1,0,98,3,6,0,1,151,21,12,184,218,0.649,0.844
"993","Chuquisaca","Azurduy","Unidad Educativa Nicanor Lopez",60,0,0,0,104,3,5,0,1,173,11,6,190,218,0.601,0.872
"994","Chuquisaca","Azurduy","Unidad Educativa Nicanor Lopez",59,0,1,1,79,4,9,0,0,153,12,15,180,223,0.516,0.807
"995","Chuquisaca","Azurduy","Unidad Educativa Nicanor Lopez",55,0,2,2,94,5,3,0,2,163,9,10,182,218,0.577,0.835
"996","Chuquisaca","Azurduy","Unidad Educativa Nicanor Lopez",52,0,3,0,91,3,7,1,0,157,6,14,177,218,0.58,0.812
"997","Chuquisaca","Azurduy","Unidad Educativa Nicanor Lopez",52,0,4,1,106,4,4,2,0,173,8,6,187,224,0.613,0.835
"998","Chuquisaca","Azurduy","Unidad Educativa Nicanor Lopez",42,1,3,1,115,6,3,0,0,171,9,10,190,226,0.673,0.841
"999","Chuquisaca","Azurduy","Unidad Educativa Nicanor Lopez",64,0,1,1,88,5,9,2,0,170,9,14,193,221,0.518,0.873
"1000","Chuquisaca","Azurduy","Unidad Educativa Nicanor Lopez",52,2,5,0,78,6,9,0,0,152,10,5,167,185,0.513,0.903
"1001","Chuquisaca","Azurduy","Escuela Pinos",3,1,1,1,176,0,1,1,1,185,8,7,200,226,0.951,0.885
"1002","Chuquisaca","Azurduy","Escuela  Rodeo Chico",3,0,0,2,189,0,0,1,0,195,5,7,207,228,0.969,0.908
"1003","Chuquisaca","Azurduy","Escuela  Rodeo Chico",3,0,2,2,171,2,3,0,0,183,10,11,204,227,0.934,0.899
"1004","Chuquisaca","Azurduy","Escuela Tablani",5,2,5,3,168,2,1,2,1,189,7,4,200,217,0.889,0.922
"1005","Chuquisaca","Azurduy","Escuela Duraznal",4,1,0,2,186,1,1,1,1,197,4,2,203,231,0.944,0.879
"1006","Chuquisaca","Azurduy","U.E. Collpamayu",6,4,1,3,158,2,1,0,2,177,18,5,200,219,0.893,0.913
"1007","Chuquisaca","Azurduy","U.E. Collpamayu",2,2,1,5,173,1,2,1,1,188,11,4,203,227,0.92,0.894
"1008","Chuquisaca","Tarvita","Unidad Educativa Antonio Tovar",49,0,2,2,109,3,6,0,2,173,19,5,197,218,0.63,0.904
"1009","Chuquisaca","Tarvita","Unidad Educativa Antonio Tovar",61,0,2,0,88,3,9,0,0,163,16,12,191,213,0.54,0.897
"1010","Chuquisaca","Tarvita","Unidad Educativa Antonio Tovar",60,0,3,2,107,0,7,1,1,181,11,8,200,225,0.591,0.889
"1011","Chuquisaca","Tarvita","Unidad Educativa Antonio Tovar",58,1,4,0,89,2,8,0,2,164,13,6,183,220,0.543,0.832
"1012","Chuquisaca","Tarvita","Escuela 12 de Octubre",20,2,0,2,131,3,6,0,2,166,9,6,181,208,0.789,0.87
"1013","Chuquisaca","Tarvita","Escuela 12 de Octubre",20,0,3,2,129,7,5,3,2,171,10,7,188,217,0.754,0.866
"1014","Chuquisaca","Tarvita","Escuela 12 de Octubre",23,0,0,4,125,6,0,2,0,160,15,12,187,216,0.781,0.866
"1015","Chuquisaca","Tarvita","Escuela Luis Evencio Orías",44,3,2,1,82,5,21,1,0,159,10,14,183,224,0.516,0.817
"1016","Chuquisaca","Tarvita","Escuela Luis Evencio Orías",23,5,2,1,106,5,10,2,1,155,11,11,177,207,0.684,0.855
"1017","Chuquisaca","Tarvita","Escuela Luis Evencio Orías",44,4,2,1,91,7,4,1,1,155,9,9,173,210,0.587,0.824
"1018","Chuquisaca","Tarvita","Escuela Mariscal Braun",18,1,4,3,110,7,12,1,2,158,12,15,185,205,0.696,0.902
"1019","Chuquisaca","Tarvita","Escuela Mariscal Braun",14,6,4,1,108,4,14,3,2,156,16,15,187,211,0.692,0.886
"1020","Chuquisaca","Tarvita","Escuela Cruz Ckasa",5,1,2,2,152,3,0,1,1,167,4,3,174,217,0.91,0.802
"1021","Chuquisaca","Tarvita","Escuela Cruz Ckasa",8,3,4,1,151,4,1,1,7,180,8,0,188,221,0.839,0.851
"1022","Chuquisaca","Tarvita","Escuela Cruz Ckasa",9,2,2,1,155,0,1,1,4,175,5,9,189,217,0.886,0.871
"1023","Chuquisaca","Tarvita","Unidad Educativa Jesús Maestro",4,0,1,1,164,0,3,1,0,174,3,5,182,226,0.943,0.805
"1024","Chuquisaca","Tarvita","Unidad Educativa Jesús Maestro",3,0,2,1,158,0,2,0,2,168,8,11,187,222,0.94,0.842
"1025","Chuquisaca","Tarvita","Unidad Educativa Jesús Maestro",2,0,1,1,147,5,2,1,0,159,7,5,171,223,0.925,0.767
"1026","Chuquisaca","Tarvita","Unidad Educativa Jesús Maestro",7,1,0,0,167,1,1,1,1,179,5,5,189,225,0.933,0.84
"1027","Chuquisaca","Tarvita","Unidad Educativa Pampas de Leque",8,0,0,0,168,4,1,1,1,183,6,5,194,222,0.918,0.874
"1028","Chuquisaca","Tarvita","U.E. Villa Pampa",32,2,4,4,121,5,3,4,1,176,14,19,209,246,0.688,0.85
"1029","Chuquisaca","Zudañez","Col. Jaime De Zudañez",31,1,0,0,146,3,15,2,1,199,3,7,209,225,0.734,0.929
"1030","Chuquisaca","Zudañez","Col. Jaime De Zudañez",45,1,2,0,121,2,15,1,0,187,2,9,198,227,0.647,0.872
"1031","Chuquisaca","Zudañez","Col. Jaime De Zudañez",60,0,3,0,109,2,13,0,3,190,2,5,197,231,0.574,0.853
"1032","Chuquisaca","Zudañez","Col. Jaime De Zudañez",38,0,1,1,131,1,9,0,0,181,6,6,193,219,0.724,0.881
"1033","Chuquisaca","Zudañez","Col. Jaime De Zudañez",46,0,0,0,122,2,15,1,1,187,7,6,200,227,0.652,0.881
"1034","Chuquisaca","Zudañez","Col. Jaime De Zudañez",20,4,0,0,138,1,6,0,1,170,5,15,190,225,0.812,0.844
"1035","Chuquisaca","Zudañez","Col. Ignacio Prudencio Bustillos",1,1,0,0,141,2,5,0,1,151,9,10,170,214,0.934,0.794
"1036","Chuquisaca","Zudañez","Col. Ignacio Prudencio Bustillos",31,3,1,1,120,2,8,0,1,167,3,10,180,209,0.719,0.861
"1037","Chuquisaca","Zudañez","Col. Ignacio Prudencio Bustillos",30,3,0,0,127,4,8,1,2,175,6,3,184,216,0.726,0.852
"1038","Chuquisaca","Zudañez","Col. Ignacio Prudencio Bustillos",18,0,0,1,149,6,5,0,0,179,5,5,189,218,0.832,0.867
"1039","Chuquisaca","Zudañez","Col. Ignacio Prudencio Bustillos",21,0,1,0,146,1,12,2,0,183,3,4,190,216,0.798,0.88
"1040","Chuquisaca","Zudañez","Col. Ignacio Prudencio Bustillos",28,0,0,0,142,2,6,0,1,179,4,6,189,216,0.793,0.875
"1041","Chuquisaca","Zudañez","Col. Ignacio Prudencio Bustillos",19,0,1,0,137,5,5,1,1,169,6,6,181,213,0.811,0.85
"1042","Chuquisaca","Zudañez","Escuela Sayan Chaca",5,0,2,1,166,1,1,2,0,178,3,4,185,218,0.933,0.849
"1043","Chuquisaca","Presto","Unidad Educativa Ricardo Mujia",20,2,3,1,120,5,9,0,1,161,11,11,183,218,0.745,0.839
"1044","Chuquisaca","Presto","Unidad Educativa Ricardo Mujia",22,3,1,1,122,2,11,1,2,165,12,7,184,220,0.739,0.836
"1045","Chuquisaca","Presto","Unidad Educativa Ricardo Mujia",33,1,2,3,121,2,16,1,1,180,5,10,195,223,0.672,0.874
"1046","Chuquisaca","Presto","Unidad Educativa Ricardo Mujia",34,0,1,0,104,4,16,1,2,162,13,12,187,215,0.642,0.87
"1047","Chuquisaca","Presto","Unidad Educativa Ricardo Mujia",16,3,0,1,115,3,13,3,0,154,13,11,178,218,0.747,0.817
"1048","Chuquisaca","Presto","Escuela Elisardo Perez",10,0,3,1,126,2,13,1,0,156,11,12,179,224,0.808,0.799
"1049","Chuquisaca","Presto","Escuela José María Martínez",7,2,1,1,125,5,13,2,0,156,11,17,184,221,0.801,0.833
"1050","Chuquisaca","Presto","Unidad Educativa Tomoroco",21,0,1,1,124,3,6,3,4,163,9,8,180,213,0.761,0.845
"1051","Chuquisaca","Presto","Unidad Educativa Tomoroco",19,3,0,1,125,4,9,3,1,165,16,9,190,210,0.758,0.905
"1052","Chuquisaca","Mojocoya","Unidad Educativa Eduardo Avaroa",45,2,0,1,99,6,9,1,2,165,9,7,181,211,0.6,0.858
"1053","Chuquisaca","Mojocoya","Colegio Franz Tamayo",19,0,1,0,140,2,5,0,2,169,9,10,188,211,0.828,0.891
"1054","Chuquisaca","Mojocoya","Colegio Franz Tamayo",31,1,1,0,143,4,9,0,0,189,6,8,203,230,0.757,0.883
"1055","Chuquisaca","Mojocoya","Colegio Franz Tamayo",17,0,0,0,142,5,20,0,1,185,4,3,192,216,0.768,0.889
"1056","Chuquisaca","Mojocoya","Colegio Franz Tamayo",24,2,1,2,135,3,13,2,1,183,6,10,199,223,0.738,0.892
"1057","Chuquisaca","Mojocoya","Colegio Franz Tamayo",29,1,0,2,145,3,8,1,0,189,3,4,196,224,0.767,0.875
"1058","Chuquisaca","Mojocoya","Colegio Franz Tamayo",24,2,0,0,125,0,7,1,0,159,8,24,191,218,0.786,0.876
"1059","Chuquisaca","Mojocoya","Colegio Franz Tamayo",34,1,1,0,143,3,8,0,1,191,4,4,199,220,0.749,0.905
"1060","Chuquisaca","Mojocoya","Colegio Franz Tamayo",17,0,0,1,137,3,14,0,2,174,5,11,190,217,0.787,0.876
"1061","Chuquisaca","Mojocoya","Colegio Franz Tamayo",16,0,0,0,143,3,13,0,0,175,6,10,191,214,0.817,0.893
"1062","Chuquisaca","Mojocoya","Colegio Franz Tamayo",18,1,0,1,131,6,18,0,4,179,5,13,197,224,0.732,0.879
"1063","Chuquisaca","Mojocoya","Colegio Franz Tamayo",21,2,1,3,116,8,12,1,1,165,5,5,175,195,0.703,0.897
"1064","Chuquisaca","Mojocoya","Escuela Guadalupe",13,0,0,0,148,0,13,0,0,174,6,3,183,217,0.851,0.843
"1065","Chuquisaca","Mojocoya","Escuela Hilarion Vides Choque",14,1,0,2,154,3,4,3,1,182,2,11,195,216,0.846,0.903
"1066","Chuquisaca","Villa Ricardo Mugia - Icla","Colegio Antonio José De Sucre",32,2,1,1,126,3,8,0,1,174,12,6,192,218,0.724,0.881
"1067","Chuquisaca","Villa Ricardo Mugia - Icla","Colegio Antonio José De Sucre",34,0,1,0,110,1,5,2,1,154,10,7,171,213,0.714,0.803
"1068","Chuquisaca","Villa Ricardo Mugia - Icla","Colegio Antonio José De Sucre",41,1,2,2,96,3,8,2,1,156,8,16,180,218,0.615,0.826
"1069","Chuquisaca","Villa Ricardo Mugia - Icla","Escuela Rodeo",3,1,0,1,146,1,9,1,2,164,3,5,172,212,0.89,0.811
"1070","Chuquisaca","Villa Ricardo Mugia - Icla","Escuela Jatun Mayu",13,3,1,1,148,1,6,1,3,177,7,8,192,216,0.836,0.889
"1071","Chuquisaca","Villa Ricardo Mugia - Icla","Colegio Rosendo La Fuente",31,3,1,1,109,0,4,2,1,152,10,8,170,207,0.717,0.821
"1072","Chuquisaca","Villa Ricardo Mugia - Icla","Escuela Thaco Pampa",15,0,1,1,153,0,13,2,1,186,2,7,195,219,0.823,0.89
"1073","Chuquisaca","Villa Ricardo Mugia - Icla","Colegio Elizardo Perez",25,4,0,0,126,6,25,1,0,187,6,8,201,221,0.674,0.91
"1074","Chuquisaca","Villa Ricardo Mugia - Icla","Colegio Elizardo Perez",20,1,0,1,123,8,12,2,1,168,6,13,187,214,0.732,0.874
"1075","Chuquisaca","Villa Ricardo Mugia - Icla","Escuela San Jacinto",10,1,0,0,146,1,6,1,2,167,7,11,185,214,0.874,0.864
"1076","Chuquisaca","Villa Ricardo Mugia - Icla","U. Edu. Seccional Chunca Cancha Baja",5,2,2,0,155,3,9,2,5,183,8,12,203,231,0.847,0.879
"1077","Chuquisaca","Padilla","Colegio San Pio X",84,0,0,1,86,6,7,2,1,187,1,12,200,222,0.46,0.901
"1078","Chuquisaca","Padilla","Colegio San Pio X",78,0,0,1,95,4,11,1,1,191,3,7,201,223,0.497,0.901
"1079","Chuquisaca","Padilla","Colegio San Pio X",41,0,2,1,118,3,14,2,0,181,7,18,206,225,0.652,0.916
"1080","Chuquisaca","Padilla","Colegio San Pio X",48,1,0,0,124,6,5,0,1,185,9,7,201,232,0.67,0.866
"1081","Chuquisaca","Padilla","Colegio San Pio X",62,2,1,0,111,3,7,2,3,191,6,8,205,224,0.581,0.915
"1082","Chuquisaca","Padilla","Colegio San Pio X",74,0,2,1,88,4,6,0,2,177,9,10,196,225,0.497,0.871
"1083","Chuquisaca","Padilla","Colegio San Pio X",62,0,1,2,101,3,15,0,0,184,5,9,198,226,0.549,0.876
"1084","Chuquisaca","Padilla","Colegio San Pio X",74,0,3,2,94,5,6,0,1,185,7,7,199,232,0.508,0.858
"1085","Chuquisaca","Padilla","Colegio San Pio X",64,0,0,0,99,1,13,0,2,179,11,11,201,225,0.553,0.893
"1086","Chuquisaca","Padilla","Escuela Manuel A. Padilla",80,0,0,1,86,4,10,0,1,182,6,13,201,225,0.473,0.893
"1087","Chuquisaca","Padilla","Escuela Manuel A. Padilla",49,0,1,3,104,3,13,0,0,173,7,18,198,222,0.601,0.892
"1088","Chuquisaca","Padilla","Escuela Manuel A. Padilla",61,0,0,1,100,4,8,1,0,175,8,17,200,224,0.571,0.893
"1089","Chuquisaca","Padilla","Escuela Manuel A. Padilla",45,0,0,2,103,2,7,0,3,162,4,14,180,214,0.636,0.841
"1090","Chuquisaca","Padilla","Escuela Manuel A. Padilla",55,0,1,0,104,3,0,0,1,164,4,14,182,223,0.634,0.816
"1091","Chuquisaca","Padilla","Escuela Manuel A. Padilla",67,1,2,2,112,3,0,0,2,189,3,10,202,217,0.593,0.931
"1092","Chuquisaca","Padilla","Escuela Manuel A. Padilla",72,0,1,0,106,4,7,0,1,191,3,11,205,223,0.555,0.919
"1093","Chuquisaca","Padilla","Escuela Manuel A. Padilla",69,0,1,1,96,5,9,0,2,183,6,8,197,220,0.525,0.895
"1094","Chuquisaca","Padilla","Escuela Manuel A. Padilla",50,2,1,1,116,4,9,0,0,183,5,6,194,214,0.634,0.907
"1095","Chuquisaca","Padilla","Unidad Educativa 2 de Abril La Cienega",15,1,2,0,146,1,4,0,2,171,13,14,198,219,0.854,0.904
"1096","Chuquisaca","Padilla","Unidad Educativa Telemina Barja",11,3,0,0,122,4,13,0,2,155,7,19,181,208,0.787,0.87
"1097","Chuquisaca","Padilla","Nucleo Escolar Humberto Delgadillo",25,4,0,0,128,3,20,1,0,181,8,6,195,219,0.707,0.89
"1098","Chuquisaca","Padilla","Nucleo Escolar Humberto Delgadillo",24,0,1,3,127,3,9,1,2,170,5,8,183,204,0.747,0.897
"1099","Chuquisaca","Tomina","Unidad Educativa Eduardo Avaroa",35,1,0,0,113,6,14,4,5,178,7,10,195,223,0.635,0.874
"1100","Chuquisaca","Tomina","Unidad Educativa Eduardo Avaroa",20,1,2,0,123,4,14,0,2,166,8,12,186,224,0.741,0.83
"1101","Chuquisaca","Tomina","Unidad Educativa Eduardo Avaroa",41,0,3,3,128,5,7,2,1,190,8,5,203,222,0.674,0.914
"1102","Chuquisaca","Tomina","Unidad Educativa Eduardo Avaroa",28,0,0,0,129,4,8,4,1,174,7,8,189,214,0.741,0.883
"1103","Chuquisaca","Tomina","Unidad Educativa Eduardo Avaroa",19,2,0,0,135,2,16,3,1,178,5,8,191,216,0.758,0.884
"1104","Chuquisaca","Tomina","Unidad Educativa Eduardo Avaroa",26,0,1,2,115,4,9,0,6,163,8,11,182,217,0.706,0.839
"1105","Chuquisaca","Tomina","Unidad Educativa Eduardo Avaroa",23,2,0,0,112,4,12,1,1,155,7,10,172,214,0.723,0.804
"1106","Chuquisaca","Tomina","Escuela Simón Rodriguez",21,0,1,1,135,4,3,2,3,170,10,12,192,212,0.794,0.906
"1107","Chuquisaca","Tomina","Escuela Simón Rodriguez",13,2,0,3,136,4,6,1,1,166,10,10,186,212,0.819,0.877
"1108","Chuquisaca","Tomina","Escuela Simón Rodriguez",11,4,0,2,132,4,0,1,0,154,7,7,168,186,0.857,0.903
"1109","Chuquisaca","Tomina","Escuela Lorenzo Catala",6,1,0,0,170,1,8,3,0,189,5,4,198,216,0.899,0.917
"1110","Chuquisaca","Tomina","U. E. Seccional Faustino Suarez",1,0,1,0,151,1,9,0,0,163,6,6,175,205,0.926,0.854
"1111","Chuquisaca","Tomina","Unidad Educativa Seccional Fuerte Rua",2,0,1,0,207,0,0,1,0,211,3,2,216,235,0.981,0.919
"1112","Chuquisaca","Tomina","U.E. Pucara",8,0,2,0,125,5,9,4,1,154,8,2,164,176,0.812,0.932
"1113","Chuquisaca","Tomina","U.E. Antofagasta",6,0,1,1,163,5,9,4,1,190,11,18,219,235,0.858,0.932
"1114","Chuquisaca","Sopachui","Escuela Juan Bosing",39,3,1,2,116,5,6,2,2,176,11,11,198,221,0.659,0.896
"1115","Chuquisaca","Sopachui","Escuela Juan Bosing",24,2,1,2,127,3,2,1,5,167,7,16,190,221,0.76,0.86
"1116","Chuquisaca","Sopachui","Escuela Juan Bosing",39,3,1,2,108,4,5,0,4,166,9,20,195,228,0.651,0.855
"1117","Chuquisaca","Sopachui","Escuela Juan Bosing",42,1,0,2,107,9,10,0,4,175,14,17,206,234,0.611,0.88
"1118","Chuquisaca","Sopachui","Colegio 25 de Mayo",27,1,2,0,111,5,5,0,5,156,15,9,180,210,0.712,0.857
"1119","Chuquisaca","Sopachui","Colegio 25 de Mayo",37,2,3,0,112,2,8,0,6,170,6,7,183,215,0.659,0.851
"1120","Chuquisaca","Sopachui","Internado Santa Rosa De Amancaya",9,0,2,2,154,0,0,0,0,167,4,11,182,205,0.922,0.888
"1121","Chuquisaca","Sopachui","Escuela Sipicani",1,1,2,0,188,2,0,0,1,195,5,4,204,214,0.964,0.953
"1122","Chuquisaca","Sopachui","Unidad Educativa Mama Huasi",0,0,0,0,189,0,2,0,1,192,2,2,196,201,0.984,0.975
"1123","Chuquisaca","Alcalá","Unidad Educativa Alcala",65,1,0,0,115,2,3,0,0,186,6,10,202,226,0.618,0.894
"1124","Chuquisaca","Alcalá","Unidad Educativa Alcala",47,1,0,0,113,5,4,1,1,172,7,5,184,216,0.657,0.852
"1125","Chuquisaca","Alcalá","Unidad Educativa Alcala",49,1,2,1,99,3,3,1,0,159,11,13,183,216,0.623,0.847
"1126","Chuquisaca","Alcalá","Unidad Educativa Alcala",68,0,0,0,100,2,2,0,2,174,8,10,192,219,0.575,0.877
"1127","Chuquisaca","Alcalá","Escuela Oscar Alfaro",19,1,0,0,152,3,10,2,0,187,4,9,200,220,0.813,0.909
"1128","Chuquisaca","Alcalá","Escuela Oscar Alfaro",11,2,5,0,168,4,6,0,0,196,4,4,204,223,0.857,0.915
"1129","Chuquisaca","El Villar","Colegio Eduardo Abaroa",22,1,2,1,134,4,8,0,3,175,8,11,194,226,0.766,0.858
"1130","Chuquisaca","El Villar","Colegio Eduardo Abaroa",32,0,6,0,136,4,2,1,3,184,3,6,193,223,0.739,0.865
"1131","Chuquisaca","El Villar","Colegio Eduardo Abaroa",27,0,4,1,139,1,7,1,0,180,9,5,194,218,0.772,0.89
"1132","Chuquisaca","El Villar","Colegio Eduardo Abaroa",35,1,4,1,106,2,9,2,5,165,2,11,178,209,0.642,0.852
"1133","Chuquisaca","El Villar","Escuela Seccional La Revuelta",10,2,1,1,137,6,4,2,2,165,15,6,186,211,0.83,0.882
"1134","Chuquisaca","El Villar","Escuela Seccional La Revuelta",9,0,1,2,133,4,4,0,3,156,4,6,166,191,0.853,0.869
"1135","Chuquisaca","El Villar","Unidad Educativa El Dorado",0,1,1,0,176,3,8,1,1,191,3,5,199,227,0.921,0.877
"1136","Chuquisaca","Monteagudo","Escuela María Vda. De Valda",94,4,1,1,64,3,17,3,1,188,5,4,197,230,0.34,0.857
"1137","Chuquisaca","Monteagudo","Escuela María Vda. De Valda",103,0,1,0,62,14,9,2,0,191,5,7,203,223,0.325,0.91
"1138","Chuquisaca","Monteagudo","Escuela María Vda. De Valda",93,0,1,0,70,2,7,0,1,174,9,15,198,232,0.402,0.853
"1139","Chuquisaca","Monteagudo","Escuela María Vda. De Valda",91,2,0,1,62,9,15,0,1,181,1,16,198,224,0.343,0.884
"1140","Chuquisaca","Monteagudo","Escuela María Vda. De Valda",75,2,2,1,70,10,9,0,0,169,4,7,180,226,0.414,0.796
"1141","Chuquisaca","Monteagudo","Escuela María Vda. De Valda",110,2,1,0,59,3,13,0,2,190,2,6,198,228,0.311,0.868
"1142","Chuquisaca","Monteagudo","Escuela María Vda. De Valda",86,0,2,2,76,10,12,0,4,192,6,9,207,232,0.396,0.892
"1143","Chuquisaca","Monteagudo","Escuela María Vda. De Valda",83,0,2,1,92,7,8,0,0,193,6,4,203,233,0.477,0.871
"1144","Chuquisaca","Monteagudo","Escuela María Vda. De Valda",73,1,1,1,79,7,17,0,4,183,6,12,201,226,0.432,0.889
"1145","Chuquisaca","Monteagudo","Escuela María Vda. De Valda",87,0,1,0,74,7,21,2,2,194,5,3,202,225,0.381,0.898
"1146","Chuquisaca","Monteagudo","Escuela María Vda. De Valda",89,0,0,1,74,7,10,0,1,182,2,8,192,225,0.407,0.853
"1147","Chuquisaca","Monteagudo","Escuela María Vda. De Valda",72,0,1,1,84,8,12,2,2,182,5,5,192,223,0.462,0.861
"1148","Chuquisaca","Monteagudo","Escuela María Vda. De Valda",114,0,0,0,69,2,9,1,1,196,6,7,209,227,0.352,0.921
"1149","Chuquisaca","Monteagudo","Escuela María Vda. De Valda",87,0,1,0,71,5,10,0,1,175,2,14,191,226,0.406,0.845
"1150","Chuquisaca","Monteagudo","Escuela María Vda. De Valda",73,1,0,0,91,7,17,1,0,190,4,8,202,228,0.479,0.886
"1151","Chuquisaca","Monteagudo","Escuela María Vda. De Valda",82,1,5,0,80,6,13,0,4,191,3,4,198,225,0.419,0.88
"1152","Chuquisaca","Monteagudo","Escuela María Vda. De Valda",97,0,3,3,63,6,15,0,3,190,6,4,200,226,0.332,0.885
"1153","Chuquisaca","Monteagudo","Escuela María Vda. De Valda",81,0,2,0,80,8,11,0,3,185,2,9,196,229,0.432,0.856
"1154","Chuquisaca","Monteagudo","Escuela María Vda. De Valda",83,0,2,1,72,4,18,1,0,181,3,7,191,224,0.398,0.853
"1155","Chuquisaca","Monteagudo","Escuela Bernardo Monteagudo",98,2,3,0,61,6,11,1,0,182,3,15,200,224,0.335,0.893
"1156","Chuquisaca","Monteagudo","Escuela Bernardo Monteagudo",88,0,2,2,71,6,8,0,1,178,5,13,196,221,0.399,0.887
"1157","Chuquisaca","Monteagudo","Escuela Bernardo Monteagudo",91,1,1,3,72,9,6,0,1,184,6,11,201,228,0.391,0.882
"1158","Chuquisaca","Monteagudo","Escuela Bernardo Monteagudo",71,0,1,0,75,7,11,2,2,169,3,14,186,220,0.444,0.845
"1159","Chuquisaca","Monteagudo","Escuela Bernardo Monteagudo",69,1,3,1,55,8,19,3,4,163,2,22,187,221,0.337,0.846
"1160","Chuquisaca","Monteagudo","Escuela Bernardo Monteagudo",88,0,2,0,66,7,13,0,0,176,3,11,190,229,0.375,0.83
"1161","Chuquisaca","Monteagudo","Escuela Bernardo Monteagudo",93,0,1,0,72,6,12,0,1,185,2,7,194,216,0.389,0.898
"1162","Chuquisaca","Monteagudo","Escuela Bernardo Monteagudo",93,0,2,0,70,7,6,0,4,182,5,10,197,226,0.385,0.872
"1163","Chuquisaca","Monteagudo","Escuela Bernardo Monteagudo",80,0,3,0,85,5,15,0,0,188,8,8,204,229,0.452,0.891
"1164","Chuquisaca","Monteagudo","Escuela Bernardo Monteagudo",97,1,3,0,64,4,14,1,2,186,3,11,200,229,0.344,0.873
"1165","Chuquisaca","Monteagudo","Escuela Bernardo Monteagudo",88,0,0,1,81,5,10,0,1,186,5,7,198,225,0.435,0.88
"1166","Chuquisaca","Monteagudo","Escuela Bernardo Monteagudo",88,2,0,1,71,12,13,3,3,193,3,8,204,232,0.368,0.879
"1167","Chuquisaca","Monteagudo","Escuela Bernardo Monteagudo",85,0,1,0,63,5,20,1,4,179,7,9,195,226,0.352,0.863
"1168","Chuquisaca","Monteagudo","Escuela Bernardo Monteagudo",76,1,3,1,86,7,12,1,0,187,1,13,201,224,0.46,0.897
"1169","Chuquisaca","Monteagudo","Escuela Bernardo Monteagudo",89,1,3,0,60,7,10,3,1,174,4,9,187,221,0.345,0.846
"1170","Chuquisaca","Monteagudo","Escuela Bernardo Monteagudo",84,1,7,2,61,5,18,1,0,179,5,14,198,228,0.341,0.868
"1171","Chuquisaca","Monteagudo","Escuela Bernardo Monteagudo",83,1,1,0,71,8,22,0,3,189,3,11,203,230,0.376,0.883
"1172","Chuquisaca","Monteagudo","Escuela Bernardo Monteagudo",82,1,0,0,80,7,15,0,2,187,3,6,196,229,0.428,0.856
"1173","Chuquisaca","Monteagudo","U. Edu. Juana Azurduy De Padilla",53,2,1,0,82,12,6,2,2,160,4,16,180,216,0.512,0.833
"1174","Chuquisaca","Monteagudo","U. Edu. Juana Azurduy De Padilla",47,1,3,8,82,10,6,3,2,162,11,13,186,218,0.506,0.853
"1175","Chuquisaca","Monteagudo","Unidad Educativa Rebeca De La Vega",64,0,2,2,78,5,17,1,3,172,9,18,199,225,0.453,0.884
"1176","Chuquisaca","Monteagudo","Unidad Educativa Rebeca De La Vega",75,1,1,1,71,10,14,0,3,176,5,9,190,220,0.403,0.864
"1177","Chuquisaca","Monteagudo","Unidad Educativa Rebeca De La Vega",61,2,3,0,95,7,13,2,0,183,9,6,198,226,0.519,0.876
"1178","Chuquisaca","Monteagudo","Unidad Educativa Rebeca De La Vega",71,0,3,2,95,2,17,0,5,195,13,5,213,230,0.487,0.926
"1179","Chuquisaca","Monteagudo","Unidad Educativa Rebeca De La Vega",58,3,1,0,86,11,20,3,1,183,7,9,199,228,0.47,0.873
"1180","Chuquisaca","Monteagudo","Unidad Educativa Rebeca De La Vega",65,2,6,1,94,4,11,2,2,187,5,14,206,229,0.503,0.9
"1181","Chuquisaca","Monteagudo","Unidad Educativa Rebeca De La Vega",64,2,5,1,85,10,13,1,3,184,6,9,199,225,0.462,0.884
"1182","Chuquisaca","Monteagudo","Unidad Educativa Rebeca De La Vega",71,0,0,4,80,7,10,2,2,176,4,14,194,213,0.455,0.911
"1183","Chuquisaca","Monteagudo","Unidad Educativa Rebeca De La Vega",75,1,2,2,68,7,14,1,3,173,5,12,190,224,0.393,0.848
"1184","Chuquisaca","Monteagudo","Unidad Educativa Rebeca De La Vega",71,2,1,4,67,7,15,0,3,170,5,12,187,219,0.394,0.854
"1185","Chuquisaca","Monteagudo","Escuela Pedernal",23,1,1,0,127,14,11,2,2,181,10,3,194,221,0.702,0.878
"1186","Chuquisaca","Monteagudo","Escuela 6 de Junio",58,0,2,3,84,10,1,1,2,161,6,6,173,218,0.522,0.794
"1187","Chuquisaca","Monteagudo","Escuela 6 de Junio",56,2,5,2,92,9,5,2,1,174,6,7,187,229,0.529,0.817
"1188","Chuquisaca","Monteagudo","Escuela Fernandez",38,1,2,4,100,8,8,5,3,169,7,8,184,215,0.592,0.856
"1189","Chuquisaca","Monteagudo","Escuela Chapimayu",26,4,1,2,110,5,15,2,3,168,11,7,186,215,0.655,0.865
"1190","Chuquisaca","Monteagudo","Escuela Despensas",24,2,2,1,125,8,2,0,0,164,8,9,181,226,0.762,0.801
"1191","Chuquisaca","Monteagudo","U. Edu. San Miguel Del Bañado",40,0,5,4,81,11,15,1,4,161,15,14,190,222,0.503,0.856
"1192","Chuquisaca","Monteagudo","U. Edu. San Miguel Del Bañado",51,6,0,5,72,12,19,0,1,166,15,16,197,228,0.434,0.864
"1193","Chuquisaca","Monteagudo","Escuela El Zapallar",33,0,5,2,105,8,18,1,1,173,12,7,192,223,0.607,0.861
"1194","Chuquisaca","Monteagudo","Unidad Educativa Valle Nuevo",28,4,2,1,133,6,10,1,3,188,17,11,216,237,0.707,0.911
"1195","Chuquisaca","Huacareta","Colegio Amistad A",78,2,0,3,65,6,4,0,7,165,7,7,179,217,0.394,0.825
"1196","Chuquisaca","Huacareta","Colegio Amistad A",76,1,1,1,70,3,7,1,4,164,7,11,182,225,0.427,0.809
"1197","Chuquisaca","Huacareta","Colegio Amistad A",88,1,0,2,65,3,4,1,7,171,10,16,197,229,0.38,0.86
"1198","Chuquisaca","Huacareta","Colegio Amistad A",90,0,0,3,69,5,3,1,6,177,5,10,192,227,0.39,0.846
"1199","Chuquisaca","Huacareta","Colegio Amistad A",93,0,2,2,69,4,3,1,4,178,2,10,190,230,0.388,0.826
"1200","Chuquisaca","Huacareta","Colegio Amistad A",74,0,0,3,97,3,0,0,1,178,7,4,189,226,0.545,0.836
"1201","Chuquisaca","Huacareta","Colegio Amistad A",76,1,0,2,86,5,6,2,5,183,5,6,194,225,0.47,0.862
"1202","Chuquisaca","Huacareta","Escuela Miguel Jhaster",61,1,3,3,90,6,7,2,5,178,7,10,195,230,0.506,0.848
"1203","Chuquisaca","Huacareta","Unidad Baldomero Lopez",42,2,2,2,100,4,12,1,1,166,13,9,188,231,0.602,0.814
"1204","Chuquisaca","Huacareta","Escuela Rafael Pabon",54,1,0,1,114,6,5,2,1,184,10,5,199,230,0.62,0.865
"1205","Chuquisaca","Huacareta","Escuela Rafael Pabon",47,0,2,0,108,6,6,3,0,172,15,11,198,228,0.628,0.868
"1206","Chuquisaca","Huacareta","Escuela Salvio Lanuza",84,3,3,6,42,11,3,1,8,161,11,17,189,224,0.261,0.844
"1207","Chuquisaca","Huacareta","Unidad Educativa Ernesto Theobald",27,1,1,1,121,3,8,3,2,167,10,9,186,220,0.725,0.845
"1208","Chuquisaca","Huacareta","Unidad Educativa Ernesto Theobald",42,1,2,5,108,3,9,1,1,172,6,6,184,221,0.628,0.833
"1209","Chuquisaca","Huacareta","Unidad Educativa Ernesto Theobald",34,0,1,4,100,7,6,2,2,156,3,7,166,182,0.641,0.912
"1210","Chuquisaca","Huacareta","Unidad Educativa San Jorge De Ipaty",1,1,1,1,164,2,3,0,2,175,6,4,185,231,0.937,0.801
"1211","Chuquisaca","Huacareta","Unidad Educativa Huirasai",12,0,0,2,130,3,1,2,1,151,7,5,163,186,0.861,0.876
"1212","Chuquisaca","Tarabuco","U. Edu. Rosalia Vda. De Antezana",26,2,2,0,111,8,14,2,3,168,12,13,193,222,0.661,0.869
"1213","Chuquisaca","Tarabuco","U. Edu. Rosalia Vda. De Antezana",21,4,3,1,122,2,11,0,4,168,10,13,191,220,0.726,0.868
"1214","Chuquisaca","Tarabuco","U. Edu. Rosalia Vda. De Antezana",33,2,2,2,102,0,19,1,3,164,17,11,192,225,0.622,0.853
"1215","Chuquisaca","Tarabuco","U. Edu. Rosalia Vda. De Antezana",21,0,0,0,118,2,15,2,1,159,7,12,178,207,0.742,0.86
"1216","Chuquisaca","Tarabuco","U. Edu. Rosalia Vda. De Antezana",20,0,0,3,115,3,15,1,2,159,20,13,192,223,0.723,0.861
"1217","Chuquisaca","Tarabuco","U. Edu. Rosalia Vda. De Antezana",13,4,0,0,144,0,10,1,1,173,9,13,195,218,0.832,0.894
"1218","Chuquisaca","Tarabuco","Colegio Aniceto Arce",26,1,2,2,106,2,18,1,4,162,5,12,179,223,0.654,0.803
"1219","Chuquisaca","Tarabuco","Colegio Aniceto Arce",31,1,0,1,97,3,28,1,4,166,9,18,193,222,0.584,0.869
"1220","Chuquisaca","Tarabuco","Colegio Aniceto Arce",23,1,0,0,110,3,19,2,2,160,7,16,183,222,0.688,0.824
"1221","Chuquisaca","Tarabuco","Colegio Aniceto Arce",31,2,2,0,103,3,14,0,4,159,12,16,187,218,0.648,0.858
"1222","Chuquisaca","Tarabuco","Colegio Aniceto Arce",24,1,1,1,111,2,16,1,1,158,8,11,177,212,0.703,0.835
"1223","Chuquisaca","Tarabuco","Colegio Aniceto Arce",29,1,0,4,118,4,12,3,3,174,9,14,197,222,0.678,0.887
"1224","Chuquisaca","Tarabuco","Colegio Aniceto Arce",36,1,4,0,106,5,18,1,3,174,7,12,193,223,0.609,0.865
"1225","Chuquisaca","Tarabuco","Colegio Aniceto Arce",17,1,1,2,131,3,14,1,0,170,10,8,188,220,0.771,0.855
"1226","Chuquisaca","Tarabuco","Colegio Nacional Mixto Bolivia",30,0,1,2,117,1,20,3,5,179,3,5,187,218,0.654,0.858
"1227","Chuquisaca","Tarabuco","Colegio Nacional Mixto Bolivia",37,1,0,1,117,3,21,0,2,182,6,7,195,227,0.643,0.859
"1228","Chuquisaca","Tarabuco","U. Edu. Jaime Villa Zamora",12,1,3,3,154,9,6,0,0,188,2,4,194,211,0.819,0.919
"1229","Chuquisaca","Tarabuco","Unidad Educativa Sarufaya",5,0,1,0,141,3,18,0,0,168,8,6,182,211,0.839,0.863
"1230","Chuquisaca","Tarabuco","Escuela Gustavo Valdivia De Pajcha",10,4,1,2,118,7,10,1,2,155,11,4,170,206,0.761,0.825
"1231","Chuquisaca","Tarabuco","Escuela Gustavo Valdivia De Pajcha",11,4,1,1,115,5,25,3,4,169,11,15,195,227,0.68,0.859
"1232","Chuquisaca","Tarabuco","Unidad Educativa La Cienega",7,0,2,0,122,6,15,1,1,154,6,14,174,210,0.792,0.829
"1233","Chuquisaca","Tarabuco","Colegio Pampa Lupiara",15,2,5,0,117,7,2,0,3,151,22,7,180,215,0.775,0.837
"1234","Chuquisaca","Tarabuco","Colegio Pampa Lupiara",14,0,1,0,141,3,7,0,2,168,7,10,185,218,0.839,0.849
"1235","Chuquisaca","Tarabuco","Colegio Pampa Lupiara",16,2,1,1,132,4,1,1,0,158,6,10,174,200,0.835,0.87
"1236","Chuquisaca","Tarabuco","U. Edu. San José Del Paredon",3,2,2,0,147,3,5,3,2,167,8,8,183,218,0.88,0.839
"1237","Chuquisaca","Tarabuco","Escuela Alfredo Martinez Rodas",0,1,0,0,169,2,17,0,0,189,1,7,197,224,0.894,0.879
"1238","Chuquisaca","Tarabuco","Escuela Collacamani",10,2,1,1,133,3,5,3,0,158,9,7,174,222,0.842,0.784
"1239","Chuquisaca","Tarabuco","Unidad Educativa El Carmen",1,0,1,2,171,0,12,1,0,188,4,7,199,219,0.91,0.909
"1240","Chuquisaca","Tarabuco","Unidad Educativa Cayambuco",6,0,2,1,142,3,6,0,0,160,6,16,182,199,0.887,0.915
"1241","Chuquisaca","Yamparáez","Unidad Educativa Sotomayor",28,2,2,1,121,4,9,1,1,169,4,9,182,208,0.716,0.875
"1242","Chuquisaca","Yamparáez","Unidad Educativa Sotomayor",19,2,2,0,138,6,4,2,0,173,5,7,185,216,0.798,0.856
"1243","Chuquisaca","Yamparáez","Unidad Educativa Sotomayor",32,2,0,2,126,2,10,4,2,180,5,12,197,220,0.7,0.895
"1244","Chuquisaca","Yamparáez","Escuela Eduardo Sempertegui",36,2,0,3,99,8,18,4,1,171,6,14,191,214,0.579,0.893
"1245","Chuquisaca","Yamparáez","Escuela Eduardo Sempertegui",19,2,1,1,103,3,35,1,1,166,7,14,187,216,0.62,0.866
"1246","Chuquisaca","Yamparáez","Escuela Eduardo Sempertegui",32,1,0,1,79,6,29,1,2,151,12,16,179,213,0.523,0.84
"1247","Chuquisaca","Yamparáez","Escuela Eduardo Sempertegui",25,4,3,2,95,0,22,2,2,155,14,12,181,208,0.613,0.87
"1248","Chuquisaca","Yamparáez","Colegio Ana Leon de Huasa Cancha",8,4,1,0,141,1,8,2,1,166,8,7,181,214,0.849,0.846
"1249","Chuquisaca","Yamparáez","Colegio Gerardo Rios",35,0,1,4,119,4,10,0,1,174,3,7,184,209,0.684,0.88
"1250","Chuquisaca","Yamparáez","Colegio Gerardo Rios",30,0,2,0,148,2,5,1,0,188,8,4,200,231,0.787,0.866
"1251","Chuquisaca","Yamparáez","Unidad Educativa Pulki Avaroa",9,4,2,3,112,6,10,5,1,152,21,9,182,211,0.737,0.863
"1252","Chuquisaca","Yamparáez","Escuela Jatun Ckaka",1,3,0,0,155,1,6,1,2,169,5,5,179,214,0.917,0.836
"1253","Chuquisaca","Yamparáez","Unidad Educativa Sajpaya",2,1,3,2,152,3,8,2,1,174,9,16,199,212,0.874,0.939
"1254","Chuquisaca","Camargo","Colegio Bolivia",76,1,0,0,83,4,25,1,1,191,1,6,198,220,0.435,0.9
"1255","Chuquisaca","Camargo","Colegio Bolivia",73,1,1,1,76,4,9,2,1,168,3,12,183,213,0.452,0.859
"1256","Chuquisaca","Camargo","Colegio Bolivia",63,2,1,3,89,2,13,3,1,177,2,8,187,214,0.503,0.874
"1257","Chuquisaca","Camargo","Colegio Bolivia",68,0,0,1,90,6,15,1,5,186,3,16,205,222,0.484,0.923
"1258","Chuquisaca","Camargo","Colegio Bolivia",82,2,0,2,76,3,12,1,0,178,7,5,190,219,0.427,0.868
"1259","Chuquisaca","Camargo","Colegio Bolivia",87,2,1,0,84,6,12,0,0,192,1,10,203,226,0.438,0.898
"1260","Chuquisaca","Camargo","Colegio Bolivia",106,2,2,0,62,1,8,0,2,183,0,13,196,225,0.339,0.871
"1261","Chuquisaca","Camargo","Colegio Bolivia",87,1,1,0,79,3,4,1,0,176,4,6,186,216,0.449,0.861
"1262","Chuquisaca","Camargo","Colegio Bolivia",53,1,2,0,106,4,7,2,0,175,7,8,190,214,0.606,0.888
"1263","Chuquisaca","Camargo","Colegio Bolivia",93,0,2,1,65,4,12,4,0,181,4,10,195,217,0.359,0.899
"1264","Chuquisaca","Camargo","Colegio Nacional Mixto 3 De Abril",71,2,0,2,79,4,22,1,0,181,3,13,197,225,0.436,0.876
"1265","Chuquisaca","Camargo","Colegio Nacional Mixto 3 De Abril",71,2,0,1,97,2,18,2,0,193,2,8,203,225,0.503,0.902
"1266","Chuquisaca","Camargo","Colegio Nacional Mixto 3 De Abril",72,1,1,1,88,8,14,3,0,188,3,17,208,227,0.468,0.916
"1267","Chuquisaca","Camargo","Colegio Nacional Mixto 3 De Abril",62,1,5,1,92,3,14,2,0,180,3,14,197,234,0.511,0.842
"1268","Chuquisaca","Camargo","Colegio Nacional Mixto 3 De Abril",57,0,1,1,108,5,14,1,0,187,2,6,195,221,0.578,0.882
"1269","Chuquisaca","Camargo","Colegio Nacional Mixto 3 De Abril",88,0,2,1,91,5,11,2,1,201,4,3,208,232,0.453,0.897
"1270","Chuquisaca","Camargo","Colegio Nacional Mixto 3 De Abril",95,0,3,0,72,5,16,2,1,194,2,11,207,225,0.371,0.92
"1271","Chuquisaca","Camargo","Colegio Nacional Mixto 3 De Abril",76,2,1,2,78,5,14,4,1,183,1,12,196,217,0.426,0.903
"1272","Chuquisaca","Camargo","Colegio Nacional Mixto 3 De Abril",82,1,1,0,87,3,18,2,0,194,2,5,201,225,0.448,0.893
"1273","Chuquisaca","Camargo","Colegio Nacional Mixto 3 De Abril",72,1,0,2,87,8,14,1,1,186,3,8,197,228,0.468,0.864
"1274","Chuquisaca","Camargo","Colegio Nacional Mixto 3 De Abril",76,0,0,3,89,4,9,1,1,183,0,7,190,220,0.486,0.864
"1275","Chuquisaca","Camargo","Colegio Nacional Mixto 3 De Abril",89,0,1,0,69,5,12,2,0,178,1,17,196,225,0.388,0.871
"1276","Chuquisaca","Camargo","Unidad Educativa Muyuquiri",4,1,0,1,168,3,3,0,1,181,2,4,187,218,0.928,0.858
"1277","Chuquisaca","Camargo","Unidad Educativa Muyuquiri",3,0,0,1,153,3,4,2,0,166,9,9,184,218,0.922,0.844
"1278","Chuquisaca","Camargo","Unidad Educativa Suquistaca",3,0,0,1,150,0,3,1,0,158,4,8,170,208,0.949,0.817
"1279","Chuquisaca","Camargo","Unidad Educativa Palca Grande",50,0,1,1,62,23,17,2,1,157,6,9,172,195,0.395,0.882
"1280","Chuquisaca","Camargo","Unidad Educativa Higuera Huayco",28,4,2,1,122,5,7,1,0,170,11,3,184,210,0.718,0.876
"1281","Chuquisaca","Camargo","Escuela Yurac Caballo",9,2,0,2,124,0,16,3,0,156,3,3,162,200,0.795,0.81
"1282","Chuquisaca","Camargo","Unidad Educativa Cueva Pampa",2,0,0,1,160,0,3,0,0,166,3,8,177,216,0.964,0.819
"1283","Chuquisaca","San Lucas","Unidad Educativa Acchilla",5,1,0,1,147,1,3,4,0,162,12,15,189,224,0.907,0.844
"1284","Chuquisaca","San Lucas","U. Edu. Eduardo Avaroa",37,2,1,1,105,2,21,3,1,173,5,7,185,224,0.607,0.826
"1285","Chuquisaca","San Lucas","U. Edu. Eduardo Avaroa",32,1,3,0,101,3,19,0,6,165,14,18,197,220,0.612,0.895
"1286","Chuquisaca","San Lucas","U. Edu. Eduardo Avaroa",17,1,1,1,117,1,22,2,2,164,7,18,189,224,0.713,0.844
"1287","Chuquisaca","San Lucas","U. Edu. Eduardo Avaroa",15,0,4,3,129,3,18,1,7,180,5,7,192,222,0.717,0.865
"1288","Chuquisaca","San Lucas","U. Edu. Eduardo Avaroa",44,0,0,1,117,1,10,0,7,180,5,9,194,222,0.65,0.874
"1289","Chuquisaca","San Lucas","U. Edu. Eduardo Avaroa",23,1,0,1,116,3,12,1,2,159,11,5,175,208,0.73,0.841
"1290","Chuquisaca","San Lucas","U. Edu. Eduardo Avaroa",19,2,2,0,135,0,11,0,7,176,5,6,187,218,0.767,0.858
"1291","Chuquisaca","San Lucas","U. Edu. Eduardo Avaroa",23,0,0,2,122,8,10,1,2,168,3,10,181,214,0.726,0.846
"1292","Chuquisaca","San Lucas","U. Edu. Eduardo Avaroa",40,2,2,0,111,3,14,0,6,178,5,6,189,217,0.624,0.871
"1293","Chuquisaca","San Lucas","U. Edu. Eduardo Avaroa",34,1,2,0,117,2,16,0,6,178,7,9,194,221,0.657,0.878
"1294","Chuquisaca","San Lucas","U. Edu. Eduardo Avaroa",26,1,0,2,108,6,16,0,7,166,7,6,179,212,0.651,0.844
"1295","Chuquisaca","San Lucas","U. Edu. Eduardo Avaroa",30,2,2,1,118,1,16,0,1,171,3,6,180,219,0.69,0.822
"1296","Chuquisaca","San Lucas","Unidad Educativa Padcoyo",11,0,1,3,143,3,10,1,0,172,2,7,181,215,0.831,0.842
"1297","Chuquisaca","San Lucas","Unidad Educativa Padcoyo",4,1,2,1,162,2,7,1,0,180,10,4,194,219,0.9,0.886
"1298","Chuquisaca","San Lucas","Unidad Educativa Padcoyo",7,2,0,1,137,4,8,0,1,160,6,5,171,209,0.856,0.818
"1299","Chuquisaca","San Lucas","Unidad Educativa Padcoyo",5,0,1,1,151,3,12,0,1,174,5,0,179,208,0.868,0.861
"1300","Chuquisaca","San Lucas","Unidad Educativa Rosendo La Fuente",10,3,1,1,146,1,17,0,2,181,3,6,190,220,0.807,0.864
"1301","Chuquisaca","San Lucas","Unidad Educativa Rosendo La Fuente",10,1,1,1,155,2,6,2,0,178,5,1,184,220,0.871,0.836
"1302","Chuquisaca","San Lucas","Unidad Educativa Rosendo La Fuente",15,2,1,1,134,1,5,5,3,167,5,12,184,215,0.802,0.856
"1303","Chuquisaca","San Lucas","Unidad Educativa 12 de Abril",15,1,2,0,152,1,12,0,0,183,1,6,190,214,0.831,0.888
"1304","Chuquisaca","San Lucas","Unidad Educativa 12 de Abril",10,1,2,0,158,2,15,0,1,189,1,5,195,211,0.836,0.924
"1305","Chuquisaca","San Lucas","Unidad Educativa 12 de Abril",9,2,3,0,151,0,21,1,1,188,2,4,194,224,0.803,0.866
"1306","Chuquisaca","San Lucas","Unidad Educativa 12 de Abril",15,0,0,1,143,1,17,1,1,179,4,7,190,212,0.799,0.896
"1307","Chuquisaca","San Lucas","Unidad Educativa Kollpa",2,0,0,2,160,2,3,0,5,174,8,2,184,213,0.92,0.864
"1308","Chuquisaca","San Lucas","Unidad Educativa Kollpa",0,0,1,2,149,2,5,0,1,160,3,1,164,182,0.931,0.901
"1309","Chuquisaca","San Lucas","Escuela Payacota Del Carmen",7,0,4,1,133,4,17,2,0,168,9,4,181,200,0.792,0.905
"1310","Chuquisaca","San Lucas","Escuela Payacota Del Carmen",9,3,1,2,125,4,31,1,0,176,3,6,185,206,0.71,0.898
"1311","Chuquisaca","San Lucas","Unidad Educativa Tambillos",5,0,0,1,149,3,4,0,1,163,0,4,167,207,0.914,0.807
"1312","Chuquisaca","San Lucas","Unidad Educativa Pirhuani",3,4,2,1,143,2,1,1,1,158,20,6,184,227,0.905,0.811
"1313","Chuquisaca","San Lucas","Unidad Educativa Ocuri",2,1,1,1,164,0,14,3,3,189,3,9,201,224,0.868,0.897
"1314","Chuquisaca","San Lucas","Unidad Educativa Ocuri",4,0,1,1,157,1,22,0,1,187,5,6,198,220,0.84,0.9
"1315","Chuquisaca","San Lucas","Unidad Educativa Palacio Tambo",9,1,0,0,135,2,26,0,2,175,6,9,190,217,0.771,0.876
"1316","Chuquisaca","San Lucas","Unidad Educativa Palacio Tambo",6,1,0,0,139,1,11,0,6,164,10,5,179,225,0.848,0.796
"1317","Chuquisaca","San Lucas","Unidad Educativa Palacio Tambo",6,1,0,2,149,5,13,1,4,181,8,4,193,220,0.823,0.877
"1318","Chuquisaca","San Lucas","Unidad Educativa Palacio Tambo",9,2,1,1,117,3,14,2,7,156,7,18,181,219,0.75,0.826
"1319","Chuquisaca","San Lucas","Unidad Educativa Palacio Tambo",3,1,5,2,135,2,18,3,8,177,9,10,196,225,0.763,0.871
"1320","Chuquisaca","San Lucas","Unidad Educativa Huañumilla",1,1,1,0,146,1,4,0,1,155,9,18,182,224,0.942,0.812
"1321","Chuquisaca","San Lucas","Unidad Educativa Chillagua",1,0,0,1,172,2,11,2,1,190,3,1,194,217,0.905,0.894
"1322","Chuquisaca","San Lucas","Escuela Molle Pata",2,5,1,3,154,1,4,1,4,175,18,3,196,227,0.88,0.863
"1323","Chuquisaca","San Lucas","Unidad Educativa Sacavillque Chico",1,1,2,3,170,0,2,1,0,180,5,3,188,231,0.944,0.814
"1324","Chuquisaca","San Lucas","Escuela Huayllani",0,0,1,1,145,1,11,3,2,164,6,3,173,217,0.884,0.797
"1325","Chuquisaca","San Lucas","Unidad Educativa Tambo Ckasa",4,6,2,5,135,1,2,4,1,160,15,9,184,235,0.844,0.783
"1326","Chuquisaca","San Lucas","Unidad Educativa Tambo Ckasa",4,5,1,3,133,1,1,7,0,155,18,5,178,221,0.858,0.805
"1327","Chuquisaca","San Lucas","Unidad Educativa Buena Vista",1,0,0,0,148,0,7,0,1,157,3,1,161,206,0.943,0.782
"1328","Chuquisaca","San Lucas","U.E. Torre De Linares",3,4,0,0,151,1,2,1,1,163,13,12,188,229,0.926,0.821
"1329","Chuquisaca","San Lucas","U.E. Cinteño Tambo",14,0,1,1,155,2,24,0,2,199,6,7,212,228,0.779,0.93
"1330","Chuquisaca","San Lucas","U.E. Cinteño Tambo",10,1,7,0,161,0,18,0,7,204,4,3,211,237,0.789,0.89
"1331","Chuquisaca","San Lucas","Unidad Educativa San Pedro De Huanaya",0,0,0,0,162,0,1,0,0,163,0,6,169,183,0.994,0.923
"1332","Chuquisaca","Incahuasi","Unidad Educativa Eduardo Avaroa",53,1,0,2,98,4,13,0,0,171,6,13,190,226,0.573,0.841
"1333","Chuquisaca","Incahuasi","Unidad Educativa Eduardo Avaroa",49,0,0,0,103,0,13,0,0,165,11,7,183,218,0.624,0.839
"1334","Chuquisaca","Incahuasi","Unidad Educativa Eduardo Avaroa",45,0,1,0,115,1,11,1,1,175,7,8,190,223,0.657,0.852
"1335","Chuquisaca","Incahuasi","Unidad Educativa Eduardo Avaroa",39,0,2,3,107,5,17,0,2,175,10,8,193,227,0.611,0.85
"1336","Chuquisaca","Incahuasi","Unidad Educativa Eduardo Avaroa",44,1,0,1,106,0,20,3,0,175,4,7,186,222,0.606,0.838
"1337","Chuquisaca","Incahuasi","Unidad Educativa Eduardo Avaroa",35,3,2,2,118,7,9,0,1,177,8,7,192,223,0.667,0.861
"1338","Chuquisaca","Incahuasi","Unidad Educativa Eduardo Avaroa",29,0,0,2,120,4,15,1,2,173,3,6,182,221,0.694,0.824
"1339","Chuquisaca","Incahuasi","Unidad Educativa Eduardo Avaroa",56,0,1,2,107,2,10,1,2,181,3,15,199,224,0.591,0.888
"1340","Chuquisaca","Incahuasi","Escuela Huajlaya",7,0,0,2,168,1,1,1,1,181,9,6,196,228,0.928,0.86
"1341","Chuquisaca","Incahuasi","Escuela Lampazar",12,1,6,4,170,1,0,2,0,196,3,1,200,237,0.867,0.844
"1342","Chuquisaca","Incahuasi","Escuela 2 de Agosto",3,0,0,1,189,1,1,0,0,195,2,2,199,223,0.969,0.892
"1343","Chuquisaca","Incahuasi","Escuela 2 de Agosto",2,1,0,1,177,1,0,1,0,183,3,5,191,199,0.967,0.96
"1344","Chuquisaca","Incahuasi","Escuela Jolencia",11,0,1,2,137,1,17,1,0,170,8,11,189,223,0.806,0.848
"1345","Chuquisaca","Incahuasi","Escuela Jolencia",6,2,0,0,139,5,23,2,2,179,8,4,191,217,0.777,0.88
"1346","Chuquisaca","Incahuasi","Escuela El Verano",0,0,0,1,191,0,12,0,1,205,5,7,217,227,0.932,0.956
"1347","Chuquisaca","Incahuasi","U.E. Yatina",5,0,4,1,141,1,11,1,0,164,9,7,180,211,0.86,0.853
"1348","Chuquisaca","Incahuasi","Unidad Educativa El Quemado",5,1,0,0,169,0,6,0,2,183,4,18,205,230,0.923,0.891
"1349","Chuquisaca","Villa Charcas","Colegio Padre Landini Simon Bolivar",45,2,2,0,98,0,14,1,1,163,8,17,188,222,0.601,0.847
"1350","Chuquisaca","Villa Charcas","Colegio Padre Landini Simon Bolivar",21,1,2,0,128,1,7,2,0,162,8,13,183,225,0.79,0.813
"1351","Chuquisaca","Villa Charcas","Colegio Padre Landini Simon Bolivar",33,2,1,1,116,2,14,0,1,170,8,9,187,223,0.682,0.839
"1352","Chuquisaca","Villa Charcas","Colegio Padre Landini Simon Bolivar",28,0,3,2,128,1,16,0,1,179,8,10,197,230,0.715,0.857
"1353","Chuquisaca","Villa Charcas","Colegio Padre Landini Simon Bolivar",21,1,0,0,122,3,15,0,1,163,10,12,185,224,0.748,0.826
"1354","Chuquisaca","Villa Charcas","Colegio Padre Landini Simon Bolivar",42,2,3,1,125,2,5,1,0,181,8,16,205,227,0.691,0.903
"1355","Chuquisaca","Villa Charcas","Colegio Padre Landini Simon Bolivar",29,0,2,1,105,2,18,2,0,159,10,19,188,224,0.66,0.839
"1356","Chuquisaca","Villa Charcas","Colegio Padre Landini Simon Bolivar",36,2,2,0,120,1,18,0,1,180,6,8,194,222,0.667,0.874
"1357","Chuquisaca","Villa Charcas","Colegio Padre Landini Simon Bolivar",48,1,1,0,98,5,13,0,1,167,9,13,189,219,0.587,0.863
"1358","Chuquisaca","Villa Charcas","Colegio Padre Landini Simon Bolivar",30,1,1,1,123,3,10,2,0,171,8,12,191,227,0.719,0.841
"1359","Chuquisaca","Villa Charcas","Colegio Padre Landini Simon Bolivar",30,3,2,0,113,2,10,1,0,161,9,19,189,230,0.702,0.822
"1360","Chuquisaca","Villa Charcas","Colegio Padre Landini Simon Bolivar",37,1,2,3,123,1,14,1,1,183,11,13,207,226,0.672,0.916
"1361","Chuquisaca","Villa Charcas","Colegio Padre Landini Simon Bolivar",42,0,3,1,110,0,18,0,0,174,4,11,189,222,0.632,0.851
"1362","Chuquisaca","Villa Charcas","Colegio Padre Landini Simon Bolivar",37,1,1,0,127,0,8,0,1,175,7,7,189,225,0.726,0.84
"1363","Chuquisaca","Villa Charcas","Unidad Educativa Jose Antonio Zampa",7,0,2,3,148,2,5,0,2,169,8,9,186,211,0.876,0.882
"1364","Chuquisaca","Villa Charcas","Unidad Educativa Jose Antonio Zampa",5,3,2,3,137,1,4,5,3,163,11,12,186,222,0.84,0.838
"1365","Chuquisaca","Villa Charcas","Unidad Educativa Jose Antonio Zampa",4,2,0,2,143,4,6,4,1,166,7,11,184,222,0.861,0.829
"1366","Chuquisaca","Villa Charcas","Escuela Santa Elena",6,1,1,0,171,2,9,1,0,191,1,2,194,225,0.895,0.862
"1367","Chuquisaca","Villa Charcas","Escuela Santa Elena",7,1,1,0,142,0,5,0,0,156,7,3,166,196,0.91,0.847
"1368","Chuquisaca","Villa Charcas","Escuela Caiza K",0,0,0,0,191,0,0,0,0,191,0,1,192,222,1,0.865
"1369","Chuquisaca","Villa Charcas","Escuela Supas",2,0,0,0,161,0,1,1,0,165,0,0,165,222,0.976,0.743
"1370","Chuquisaca","Villa Charcas","Escuela Llujllaya",3,4,2,1,152,1,13,2,0,178,16,12,206,226,0.854,0.912
"1371","Chuquisaca","Villa Serrano","Escuela Mariscal Sucre",68,1,1,0,91,4,17,0,3,185,3,9,197,226,0.492,0.872
"1372","Chuquisaca","Villa Serrano","Escuela Mariscal Sucre",63,0,0,1,89,10,16,2,3,184,9,12,205,218,0.484,0.94
"1373","Chuquisaca","Villa Serrano","Escuela Mariscal Sucre",59,0,0,2,81,5,24,0,1,172,5,19,196,225,0.471,0.871
"1374","Chuquisaca","Villa Serrano","Escuela Mariscal Sucre",50,1,3,1,100,4,10,3,1,173,6,11,190,217,0.578,0.876
"1375","Chuquisaca","Villa Serrano","Escuela Mariscal Sucre",56,0,0,3,98,4,16,0,2,179,4,14,197,221,0.547,0.891
"1376","Chuquisaca","Villa Serrano","Escuela Mariscal Sucre",56,0,3,1,96,4,11,1,3,175,7,10,192,222,0.549,0.865
"1377","Chuquisaca","Villa Serrano","Escuela Mariscal Sucre",46,2,0,2,117,3,19,0,1,190,6,12,208,226,0.616,0.92
"1378","Chuquisaca","Villa Serrano","Escuela Mariscal Sucre",60,1,2,0,98,1,16,1,1,180,11,7,198,223,0.544,0.888
"1379","Chuquisaca","Villa Serrano","Escuela Mariscal Sucre",52,1,2,1,84,4,16,2,2,164,6,16,186,216,0.512,0.861
"1380","Chuquisaca","Villa Serrano","Escuela Mariscal Sucre",53,0,0,2,108,4,12,0,6,185,5,11,201,219,0.584,0.918
"1381","Chuquisaca","Villa Serrano","Escuela Mariscal Sucre",49,1,3,0,108,3,16,1,4,185,7,10,202,224,0.584,0.902
"1382","Chuquisaca","Villa Serrano","Escuela Mariscal Sucre",65,0,1,2,101,1,15,0,1,186,9,11,206,224,0.543,0.92
"1383","Chuquisaca","Villa Serrano","Escuela Mariscal Sucre",57,0,2,1,101,4,20,0,6,191,8,7,206,223,0.529,0.924
"1384","Chuquisaca","Villa Serrano","Escuela Mariscal Sucre",54,1,2,0,77,3,16,1,2,156,9,15,180,199,0.494,0.905
"1385","Chuquisaca","Villa Serrano","Colegio Daniel Sanchez Bustamante",6,2,2,1,125,4,15,1,1,157,13,12,182,210,0.796,0.867
"1386","Chuquisaca","Villa Serrano","Colegio Daniel Sanchez Bustamante",9,3,0,3,125,3,17,1,1,162,10,12,184,213,0.772,0.864
"1387","Chuquisaca","Villa Serrano","Escuela Elisardo Perez",17,1,3,4,104,7,14,1,2,153,14,25,192,215,0.68,0.893
"1388","Chuquisaca","Villa Serrano","Escuela Jorge Anibarro Zapata",10,1,2,1,123,2,16,1,1,157,18,16,191,215,0.783,0.888
"1389","Chuquisaca","Villa Serrano","Escuela Heroes del Chaco",11,1,1,0,158,5,4,0,1,181,4,7,192,223,0.873,0.861
"1390","Chuquisaca","Villa Abecia","Unidad Educativa 23 de Marzo",39,1,2,2,112,2,10,2,0,170,3,8,181,218,0.659,0.83
"1391","Chuquisaca","Villa Abecia","Unidad Educativa 23 de Marzo",26,0,0,0,137,5,10,2,0,180,5,8,193,224,0.761,0.862
"1392","Chuquisaca","Villa Abecia","Unidad Educativa 23 de Marzo",36,1,0,0,118,1,17,0,3,176,5,4,185,215,0.67,0.86
"1393","Chuquisaca","Villa Abecia","Unidad Educativa 23 de Marzo",53,0,0,0,105,0,9,1,0,168,5,8,181,222,0.625,0.815
"1394","Chuquisaca","Villa Abecia","Unidad Educativa 23 de Marzo",20,0,3,2,116,5,4,0,1,151,7,9,167,187,0.768,0.893
"1395","Chuquisaca","Culpina","U. Edu. Jose Antonio Zampa",27,0,3,3,112,2,18,0,0,165,8,14,187,222,0.679,0.842
"1396","Chuquisaca","Culpina","U. Edu. Jose Antonio Zampa",22,1,0,2,122,0,25,1,0,173,7,10,190,223,0.705,0.852
"1397","Chuquisaca","Culpina","U. Edu. Jose Antonio Zampa",38,3,1,0,110,2,20,1,0,175,4,10,189,227,0.629,0.833
"1398","Chuquisaca","Culpina","U. Edu. Jose Antonio Zampa",39,1,3,0,106,2,14,0,0,165,2,15,182,222,0.642,0.82
"1399","Chuquisaca","Culpina","U. Edu. Jose Antonio Zampa",18,3,2,0,119,5,17,1,1,166,8,11,185,222,0.717,0.833
"1400","Chuquisaca","Culpina","U. Edu. Jose Antonio Zampa",29,1,3,0,121,6,19,1,1,181,3,6,190,225,0.669,0.844
"1401","Chuquisaca","Culpina","U. Edu. Jose Antonio Zampa",42,2,4,1,102,5,19,0,1,176,6,17,199,228,0.58,0.873
"1402","Chuquisaca","Culpina","U. Edu. Jose Antonio Zampa",40,2,3,1,98,5,19,0,0,168,6,9,183,216,0.583,0.847
"1403","Chuquisaca","Culpina","U. Edu. Jose Antonio Zampa",26,0,2,0,119,2,20,0,0,169,6,12,187,225,0.704,0.831
"1404","Chuquisaca","Culpina","U. Edu. Jose Antonio Zampa",21,1,4,2,120,3,23,0,1,175,13,9,197,227,0.686,0.868
"1405","Chuquisaca","Culpina","U. Edu. Jose Antonio Zampa",36,1,5,5,111,4,21,0,0,183,6,2,191,227,0.607,0.841
"1406","Chuquisaca","Culpina","U. Edu. Jose Antonio Zampa",17,3,2,1,122,4,12,0,0,161,4,12,177,218,0.758,0.812
"1407","Chuquisaca","Culpina","U. Edu. Jose Antonio Zampa",29,0,2,1,126,3,18,0,0,179,3,4,186,222,0.704,0.838
"1408","Chuquisaca","Culpina","U. Edu. Jose Antonio Zampa",27,3,3,0,110,3,25,1,1,173,6,6,185,219,0.636,0.845
"1409","Chuquisaca","Culpina","U. Edu. Jose Antonio Zampa",27,2,2,2,117,3,17,1,1,172,5,5,182,217,0.68,0.839
"1410","Chuquisaca","Culpina","Unidad Educativa Tojlasa",11,2,0,1,126,3,11,2,1,157,3,8,168,216,0.803,0.778
"1411","Chuquisaca","Culpina","Unidad Educativa Tojlasa",4,2,1,0,141,5,17,2,0,172,6,8,186,226,0.82,0.823
"1412","Chuquisaca","Culpina","Unidad Educativa Sajlina",13,6,1,2,132,3,18,1,0,176,10,9,195,218,0.75,0.894
"1413","Chuquisaca","Culpina","Unidad Educativa Sajlina",30,3,1,1,121,1,11,0,1,169,5,10,184,224,0.716,0.821
"1414","Chuquisaca","Culpina","Unidad Educativa Sajlina",17,6,0,0,110,3,21,2,0,159,4,9,172,204,0.692,0.843
"1415","Chuquisaca","Culpina","Unidad Educativa La Cueva",0,2,2,1,151,2,5,0,0,163,7,8,178,232,0.926,0.767
"1416","Chuquisaca","Culpina","Unidad Educativa El Monte",12,2,2,2,126,6,6,1,0,157,10,11,178,222,0.803,0.802
"1417","Chuquisaca","Culpina","Unidad Educativa La Loma",0,2,0,3,145,0,1,4,0,155,4,7,166,219,0.935,0.758
"1418","Chuquisaca","Culpina","Unidad Educativa El Palmar",51,6,5,6,66,7,29,1,0,171,11,18,200,230,0.386,0.87
"1419","Chuquisaca","Culpina","Unidad Educativa El Palmar",63,6,2,3,72,5,28,4,0,183,7,8,198,232,0.393,0.853
"1420","Chuquisaca","Culpina","Unidad Educativa Huajlita",2,1,0,0,135,0,13,0,0,151,2,1,154,198,0.894,0.778
"1421","Chuquisaca","Las Carreras","Unidad Educativa Jaime Mendoza",37,0,2,1,121,2,20,0,1,184,2,2,188,215,0.658,0.874
"1422","Chuquisaca","Las Carreras","Unidad Educativa Jaime Mendoza",32,3,2,1,121,0,20,0,3,182,3,8,193,225,0.665,0.858
"1423","Chuquisaca","Las Carreras","Unidad Educativa San Juan",36,1,0,0,102,3,10,2,1,155,2,8,165,183,0.658,0.902
"1424","Chuquisaca","Las Carreras","Unidad Educativa Lime",9,4,1,0,148,0,3,5,2,172,6,6,184,218,0.86,0.844
"1425","Chuquisaca","Villa Vaca Guzmán","Escuela Hernando Siles",83,0,2,0,59,4,5,1,11,165,11,14,190,218,0.358,0.872
"1426","Chuquisaca","Villa Vaca Guzmán","Escuela Hernando Siles",91,1,1,2,64,6,13,1,5,184,7,13,204,227,0.348,0.899
"1427","Chuquisaca","Villa Vaca Guzmán","Escuela Hernando Siles",95,2,1,1,65,4,6,3,4,181,7,7,195,224,0.359,0.871
"1428","Chuquisaca","Villa Vaca Guzmán","Escuela Hernando Siles",75,0,3,0,71,7,7,1,2,166,6,10,182,212,0.428,0.858
"1429","Chuquisaca","Villa Vaca Guzmán","Escuela Hernando Siles",78,0,1,3,73,8,9,0,3,175,9,11,195,223,0.417,0.874
"1430","Chuquisaca","Villa Vaca Guzmán","Escuela Hernando Siles",95,1,1,0,54,8,10,0,8,177,5,5,187,224,0.305,0.835
"1431","Chuquisaca","Villa Vaca Guzmán","Escuela Hernando Siles",86,1,0,1,69,5,13,0,4,179,9,8,196,226,0.385,0.867
"1432","Chuquisaca","Villa Vaca Guzmán","Escuela Hernando Siles",87,1,4,2,50,10,6,1,3,164,7,13,184,222,0.305,0.829
"1433","Chuquisaca","Villa Vaca Guzmán","Escuela Hernando Siles",99,0,0,2,56,12,4,1,2,176,8,9,193,226,0.318,0.854
"1434","Chuquisaca","Villa Vaca Guzmán","Escuela Hernando Siles",91,2,1,1,69,4,13,1,5,187,9,10,206,228,0.369,0.904
"1435","Chuquisaca","Villa Vaca Guzmán","Escuela Hernando Siles",86,1,1,1,67,5,10,0,3,174,6,8,188,225,0.385,0.836
"1436","Chuquisaca","Villa Vaca Guzmán","Escuela Hernando Siles",111,0,0,0,54,7,8,1,2,183,3,12,198,230,0.295,0.861
"1437","Chuquisaca","Villa Vaca Guzmán","Escuela Hernando Siles",88,0,1,1,69,1,9,0,3,172,5,13,190,221,0.401,0.86
"1438","Chuquisaca","Villa Vaca Guzmán","Unidad Educativa Iguembe",59,1,0,1,91,9,4,2,0,167,9,8,184,223,0.545,0.825
"1439","Chuquisaca","Villa Vaca Guzmán","Casa Comunal Tentayapi",0,0,0,0,226,0,0,0,0,226,0,0,226,238,1,0.95
"1440","Chuquisaca","Villa Vaca Guzmán","U.E. Leo Schwarz",24,4,1,0,80,16,14,10,3,152,8,14,174,217,0.526,0.802
"1441","Chuquisaca","Villa Vaca Guzmán","Escuela Rufino Salazar",59,2,0,2,60,18,6,3,2,152,6,10,168,224,0.395,0.75
"1442","Chuquisaca","Villa Vaca Guzmán","Casa Comunal Aguairenda",28,0,0,0,152,1,4,0,3,188,3,10,201,227,0.809,0.885
"1443","Chuquisaca","Villa Vaca Guzmán","Unidad Educativa Ity",24,1,0,1,120,1,14,0,4,165,9,11,185,205,0.727,0.902
"1444","Chuquisaca","Huacaya","Escuela San Antonio",79,0,1,0,85,14,5,1,0,185,4,3,192,234,0.459,0.821
"1445","Chuquisaca","Huacaya","Escuela Fray Marcos Ozeti",54,1,1,0,113,9,5,1,1,185,5,6,196,229,0.611,0.856
"1446","Chuquisaca","Huacaya","Escuela Fray Marcos Ozeti",35,3,0,4,113,12,9,1,0,177,5,3,185,228,0.638,0.811
"1447","Chuquisaca","Macharetí","Escuela Eduardo Avaroa",99,0,0,0,74,4,3,0,3,183,2,4,189,230,0.404,0.822
"1448","Chuquisaca","Macharetí","Escuela Eduardo Avaroa",71,1,0,0,92,3,9,2,1,179,0,2,181,223,0.514,0.812
"1449","Chuquisaca","Macharetí","Escuela Eduardo Avaroa",90,1,2,0,80,5,3,0,2,183,0,4,187,228,0.437,0.82
"1450","Chuquisaca","Macharetí","Escuela Eduardo Avaroa",69,0,0,0,105,2,5,1,2,184,3,5,192,228,0.571,0.842
"1451","Chuquisaca","Macharetí","Escuela Eduardo Avaroa",112,2,0,1,63,3,4,1,1,187,3,5,195,224,0.337,0.871
"1452","Chuquisaca","Macharetí","Escuela San Juan de Camatindi",43,0,1,2,116,8,2,0,1,173,4,3,180,202,0.671,0.891
"1453","Chuquisaca","Macharetí","U. Edu. Heroes Del Chaco Hernado Siles",68,1,3,1,65,10,2,0,2,152,16,10,178,221,0.428,0.805
"1454","Chuquisaca","Macharetí","Escuela Ipati",67,0,0,3,78,5,2,1,1,157,16,4,177,200,0.497,0.885
"1455","Chuquisaca","Macharetí","Escuela 25 de Mayo",31,0,0,1,155,7,8,0,0,202,2,6,210,236,0.767,0.89
"1456","Chuquisaca","Macharetí","Escuela 25 de Mayo",41,0,2,0,148,1,5,0,0,197,3,6,206,226,0.751,0.912
"1457","Chuquisaca","Macharetí","Escuela 25 de Mayo",17,0,0,0,181,3,3,0,0,204,1,0,205,229,0.887,0.895
"1458","Chuquisaca","Macharetí","Escuela 25 de Mayo",13,0,0,1,187,4,3,1,0,209,6,4,219,235,0.895,0.932
"1459","Chuquisaca","Macharetí","Colegio 27 de Marzo",24,0,1,2,133,3,3,1,1,168,2,9,179,226,0.792,0.792
"1460","La Paz","Nuestra Señora de La Paz","Esc. Ind. Pedro Domingo Murillo",95,0,2,1,84,4,21,2,1,210,0,1,211,231,0.4,0.913
"1461","La Paz","Nuestra Señora de La Paz","Esc. Ind. Pedro Domingo Murillo",94,1,5,4,82,5,7,0,0,198,1,5,204,221,0.414,0.923
"1462","La Paz","Nuestra Señora de La Paz","Esc. Ind. Pedro Domingo Murillo",99,0,1,0,82,0,6,1,0,189,1,5,195,220,0.434,0.886
"1463","La Paz","Nuestra Señora de La Paz","Esc. Ind. Pedro Domingo Murillo",81,3,1,0,88,6,21,0,3,203,1,4,208,229,0.433,0.908
"1464","La Paz","Nuestra Señora de La Paz","Esc. Ind. Pedro Domingo Murillo",89,0,3,2,90,0,10,0,0,194,1,9,204,224,0.464,0.911
"1465","La Paz","Nuestra Señora de La Paz","Esc. Ind. Pedro Domingo Murillo",76,0,0,1,97,1,20,0,3,198,0,2,200,225,0.49,0.889
"1466","La Paz","Nuestra Señora de La Paz","Esc. Ind. Pedro Domingo Murillo",90,0,5,0,86,4,10,2,2,199,0,1,200,222,0.432,0.901
"1467","La Paz","Nuestra Señora de La Paz","Esc. Ind. Pedro Domingo Murillo",100,1,2,2,71,4,18,0,0,198,0,5,203,223,0.359,0.91
"1468","La Paz","Nuestra Señora de La Paz","Esc. Ind. Pedro Domingo Murillo",87,0,1,1,90,1,11,1,2,194,0,10,204,225,0.464,0.907
"1469","La Paz","Nuestra Señora de La Paz","Esc. Ind. Pedro Domingo Murillo",100,1,2,1,73,3,13,0,1,194,1,9,204,224,0.376,0.911
"1470","La Paz","Nuestra Señora de La Paz","Esc. Ind. Pedro Domingo Murillo",96,0,2,1,85,1,12,0,1,198,1,8,207,223,0.429,0.928
"1471","La Paz","Nuestra Señora de La Paz","Esc. Ind. Pedro Domingo Murillo",70,1,8,1,107,1,14,1,1,204,2,3,209,226,0.525,0.925
"1472","La Paz","Nuestra Señora de La Paz","Esc. Ind. Pedro Domingo Murillo",102,0,5,0,74,3,7,1,0,192,0,4,196,220,0.385,0.891
"1473","La Paz","Nuestra Señora de La Paz","Esc. Ind. Pedro Domingo Murillo",97,0,2,2,67,2,19,0,1,190,0,7,197,221,0.353,0.891
"1474","La Paz","Nuestra Señora de La Paz","Esc. Ind. Pedro Domingo Murillo",92,0,3,1,80,2,11,2,0,191,0,4,195,207,0.419,0.942
"1475","La Paz","Nuestra Señora de La Paz","Esc. Ind. Pedro Domingo Murillo",100,0,1,2,80,5,15,1,5,209,2,1,212,230,0.383,0.922
"1476","La Paz","Nuestra Señora de La Paz","Esc. Ind. Pedro Domingo Murillo",82,0,5,1,88,2,23,0,0,201,0,11,212,225,0.438,0.942
"1477","La Paz","Nuestra Señora de La Paz","Esc. Ind. Pedro Domingo Murillo",112,0,1,1,71,2,13,1,1,202,0,6,208,230,0.351,0.904
"1478","La Paz","Nuestra Señora de La Paz","Esc. Ind. Pedro Domingo Murillo",106,1,1,0,70,2,8,0,0,188,2,8,198,225,0.372,0.88
"1479","La Paz","Nuestra Señora de La Paz","Esc. Ind. Pedro Domingo Murillo",104,0,2,2,74,3,8,2,1,196,0,4,200,225,0.378,0.889
"1480","La Paz","Nuestra Señora de La Paz","Esc. Ind. Pedro Domingo Murillo",82,0,0,2,87,3,11,2,1,188,2,5,195,218,0.463,0.894
"1481","La Paz","Nuestra Señora de La Paz","Esc. Ind. Pedro Domingo Murillo",101,0,7,0,75,3,16,1,1,204,0,3,207,228,0.368,0.908
"1482","La Paz","Nuestra Señora de La Paz","Esc. Educacional Luis  Ernest",112,0,1,0,64,2,22,0,2,203,1,20,224,224,0.315,1
"1483","La Paz","Nuestra Señora de La Paz","Esc. Educacional Luis  Ernest",107,1,2,1,70,0,16,0,2,199,2,9,210,227,0.352,0.925
"1484","La Paz","Nuestra Señora de La Paz","Esc. Educacional Luis  Ernest",95,1,1,0,89,3,18,0,1,208,1,5,214,229,0.428,0.934
"1485","La Paz","Nuestra Señora de La Paz","Esc. Educacional Luis  Ernest",118,0,0,1,65,5,9,0,2,200,0,9,209,225,0.325,0.929
"1486","La Paz","Nuestra Señora de La Paz","Esc. Educacional Luis  Ernest",103,0,5,0,82,4,12,0,3,209,0,3,212,230,0.392,0.922
"1487","La Paz","Nuestra Señora de La Paz","Esc. Educacional Luis  Ernest",87,1,4,0,86,2,20,1,1,202,1,8,211,228,0.426,0.925
"1488","La Paz","Nuestra Señora de La Paz","Esc. Educacional Luis  Ernest",105,0,3,1,75,3,14,0,3,204,0,5,209,219,0.368,0.954
"1489","La Paz","Nuestra Señora de La Paz","Esc. Educacional Luis  Ernest",81,0,2,1,86,8,26,2,1,207,1,5,213,228,0.415,0.934
"1490","La Paz","Nuestra Señora de La Paz","Esc. Educacional Luis  Ernest",102,0,3,1,80,5,20,1,0,212,1,4,217,229,0.377,0.948
"1491","La Paz","Nuestra Señora de La Paz","Unidad Educativa Litoral A",90,0,0,1,92,3,17,0,2,205,2,7,214,229,0.449,0.934
"1492","La Paz","Nuestra Señora de La Paz","Unidad Educativa Litoral A",96,1,1,2,77,3,12,1,1,194,0,4,198,221,0.397,0.896
"1493","La Paz","Nuestra Señora de La Paz","Unidad Educativa Litoral A",85,0,1,0,97,2,21,0,0,206,0,5,211,227,0.471,0.93
"1494","La Paz","Nuestra Señora de La Paz","Unidad Educativa Litoral A",82,0,1,1,90,1,19,1,1,196,2,7,205,220,0.459,0.932
"1495","La Paz","Nuestra Señora de La Paz","Unidad Educativa Litoral A",90,0,2,0,88,2,23,1,2,208,0,4,212,228,0.423,0.93
"1496","La Paz","Nuestra Señora de La Paz","Unidad Educativa Litoral A",107,5,2,1,70,3,14,1,1,204,0,4,208,225,0.343,0.924
"1497","La Paz","Nuestra Señora de La Paz","Unidad Educativa Litoral A",116,0,4,0,73,2,14,0,0,209,1,3,213,225,0.349,0.947
"1498","La Paz","Nuestra Señora de La Paz","Unidad Educativa Litoral A",92,2,2,0,100,1,9,0,1,207,1,4,212,224,0.483,0.946
"1499","La Paz","Nuestra Señora de La Paz","Unidad Educativa Litoral A",80,0,3,1,91,3,11,1,1,191,0,8,199,224,0.476,0.888
"1500","La Paz","Nuestra Señora de La Paz","Unidad Educativa Litoral A",66,1,6,1,101,2,25,1,1,204,2,1,207,225,0.495,0.92
"1501","La Paz","Nuestra Señora de La Paz","Unidad Educativa Litoral A",103,0,1,1,76,2,6,1,1,191,0,3,194,226,0.398,0.858
"1502","La Paz","Nuestra Señora de La Paz","Unidad Educativa Litoral A",93,0,2,1,84,2,15,0,0,197,1,3,201,218,0.426,0.922
"1503","La Paz","Nuestra Señora de La Paz","Unidad Educativa Litoral A",73,1,3,2,88,3,29,2,0,201,2,2,205,226,0.438,0.907
"1504","La Paz","Nuestra Señora de La Paz","Unidad Educativa Litoral A",87,1,2,2,99,4,13,1,0,209,1,4,214,232,0.474,0.922
"1505","La Paz","Nuestra Señora de La Paz","Unidad Educativa Litoral A",90,1,2,1,78,6,9,2,1,190,1,5,196,217,0.411,0.903
"1506","La Paz","Nuestra Señora de La Paz","Unidad Educativa Litoral A",84,1,7,0,85,5,11,1,3,197,0,11,208,222,0.431,0.937
"1507","La Paz","Nuestra Señora de La Paz","Unidad Educativa Litoral A",101,0,4,1,71,5,12,0,0,194,0,9,203,228,0.366,0.89
"1508","La Paz","Nuestra Señora de La Paz","Sede Social Plan Autopista",91,0,4,1,83,1,11,3,1,195,3,11,209,224,0.426,0.933
"1509","La Paz","Nuestra Señora de La Paz","Sede Social Plan Autopista",62,1,1,0,108,2,28,0,0,202,1,7,210,224,0.535,0.938
"1510","La Paz","Nuestra Señora de La Paz","Sede Social Plan Autopista",69,2,1,0,108,3,18,2,2,205,1,6,212,228,0.527,0.93
"1511","La Paz","Nuestra Señora de La Paz","Sede Social Plan Autopista",87,0,2,1,95,2,21,1,1,210,0,2,212,231,0.452,0.918
"1512","La Paz","Nuestra Señora de La Paz","Sede Social Plan Autopista",67,0,6,1,107,1,16,1,3,202,5,4,211,226,0.53,0.934
"1513","La Paz","Nuestra Señora de La Paz","Sede Social Plan Autopista",88,1,2,0,89,3,30,1,1,215,4,4,223,232,0.414,0.961
"1514","La Paz","Nuestra Señora de La Paz","Sede Social Plan Autopista",62,2,3,3,109,5,15,0,2,201,2,3,206,226,0.542,0.912
"1515","La Paz","Nuestra Señora de La Paz","Sede Social Plan Autopista",89,2,4,0,87,2,14,0,2,200,4,4,208,227,0.435,0.916
"1516","La Paz","Nuestra Señora de La Paz","Esc. Limanipata 10 De Junio",30,1,4,1,145,1,26,0,2,210,3,3,216,227,0.69,0.952
"1517","La Paz","Nuestra Señora de La Paz","Esc. Limanipata 10 De Junio",30,0,6,0,158,2,15,0,0,211,4,5,220,231,0.749,0.952
"1518","La Paz","Nuestra Señora de La Paz","Esc. Limanipata 10 De Junio",38,0,8,0,152,1,12,0,3,214,0,10,224,230,0.71,0.974
"1519","La Paz","Nuestra Señora de La Paz","Esc. Limanipata 10 De Junio",42,0,4,0,137,2,21,1,3,210,6,6,222,229,0.652,0.969
"1520","La Paz","Nuestra Señora de La Paz","Esc. Limanipata 10 De Junio",25,0,7,1,159,1,15,0,1,209,5,8,222,231,0.761,0.961
"1521","La Paz","Nuestra Señora de La Paz","Esc. Limanipata 10 De Junio",35,2,10,1,133,5,16,2,2,206,1,11,218,226,0.646,0.965
"1522","La Paz","Nuestra Señora de La Paz","Esc. Limanipata 10 De Junio",29,1,5,1,157,0,13,0,3,209,4,6,219,232,0.751,0.944
"1523","La Paz","Nuestra Señora de La Paz","Esc. Limanipata 10 De Junio",37,0,8,2,137,5,22,0,1,212,0,5,217,228,0.646,0.952
"1524","La Paz","Nuestra Señora de La Paz","Esc. Abraham Lincoln",78,2,4,0,93,1,12,2,1,193,2,11,206,225,0.482,0.916
"1525","La Paz","Nuestra Señora de La Paz","Esc. Abraham Lincoln",82,0,1,0,91,1,17,0,1,193,2,9,204,221,0.472,0.923
"1526","La Paz","Nuestra Señora de La Paz","Esc. Abraham Lincoln",73,1,5,0,100,4,15,2,1,201,6,7,214,224,0.498,0.955
"1527","La Paz","Nuestra Señora de La Paz","Esc. Abraham Lincoln",58,0,3,1,113,1,16,1,4,197,1,6,204,222,0.574,0.919
"1528","La Paz","Nuestra Señora de La Paz","Esc. Abraham Lincoln",76,0,3,1,100,4,17,1,1,203,5,1,209,223,0.493,0.937
"1529","La Paz","Nuestra Señora de La Paz","Esc. Abraham Lincoln",87,0,2,0,101,0,11,2,2,205,0,6,211,226,0.493,0.934
"1530","La Paz","Nuestra Señora de La Paz","Esc. Abraham Lincoln",84,0,3,0,97,4,22,0,3,213,0,4,217,233,0.455,0.931
"1531","La Paz","Nuestra Señora de La Paz","Esc. Abraham Lincoln",81,0,3,3,93,3,14,1,1,199,4,5,208,226,0.467,0.92
"1532","La Paz","Nuestra Señora de La Paz","Esc. Abraham Lincoln",48,0,6,2,115,3,19,1,0,194,4,6,204,221,0.593,0.923
"1533","La Paz","Nuestra Señora de La Paz","Esc. Abraham Lincoln",70,0,3,0,95,6,24,0,2,200,2,8,210,226,0.475,0.929
"1534","La Paz","Nuestra Señora de La Paz","Esc. Abraham Lincoln",85,0,2,3,91,1,15,0,2,199,2,8,209,226,0.457,0.925
"1535","La Paz","Nuestra Señora de La Paz","Esc. Abraham Lincoln",82,1,5,0,75,4,23,1,2,193,6,9,208,220,0.389,0.945
"1536","La Paz","Nuestra Señora de La Paz","Esc. Abraham Lincoln",49,0,3,0,111,3,27,3,0,196,1,5,202,223,0.566,0.906
"1537","La Paz","Nuestra Señora de La Paz","Esc. Abraham Lincoln",76,0,2,1,89,2,22,0,2,194,0,6,200,225,0.459,0.889
"1538","La Paz","Nuestra Señora de La Paz","Esc. Abraham Lincoln",71,0,2,1,100,3,23,0,1,201,0,7,208,223,0.498,0.933
"1539","La Paz","Nuestra Señora de La Paz","Esc. Abraham Lincoln",80,1,8,1,95,1,18,0,3,207,1,8,216,230,0.459,0.939
"1540","La Paz","Nuestra Señora de La Paz","Escuela John F. Kennedy",92,1,2,1,72,2,14,0,0,184,1,6,191,213,0.391,0.897
"1541","La Paz","Nuestra Señora de La Paz","Escuela John F. Kennedy",96,0,1,0,85,1,19,0,1,203,1,3,207,225,0.419,0.92
"1542","La Paz","Nuestra Señora de La Paz","Escuela John F. Kennedy",109,0,1,0,65,2,17,1,1,196,0,3,199,220,0.332,0.905
"1543","La Paz","Nuestra Señora de La Paz","Escuela John F. Kennedy",99,0,2,2,71,0,13,2,2,191,1,9,201,220,0.372,0.914
"1544","La Paz","Nuestra Señora de La Paz","Escuela John F. Kennedy",104,2,0,0,76,1,14,0,0,197,2,4,203,222,0.386,0.914
"1545","La Paz","Nuestra Señora de La Paz","Escuela John F. Kennedy",113,1,1,0,68,5,15,0,3,206,0,3,209,225,0.33,0.929
"1546","La Paz","Nuestra Señora de La Paz","Kinder Flora Perez De Saavedra",117,1,2,1,64,1,14,0,1,201,1,5,207,221,0.318,0.937
"1547","La Paz","Nuestra Señora de La Paz","Kinder Flora Perez De Saavedra",89,0,5,0,92,2,16,0,2,206,1,4,211,223,0.447,0.946
"1548","La Paz","Nuestra Señora de La Paz","Kinder Flora Perez De Saavedra",106,0,1,1,71,1,11,0,1,192,1,5,198,218,0.37,0.908
"1549","La Paz","Nuestra Señora de La Paz","Kinder Flora Perez De Saavedra",93,1,2,0,87,3,12,1,2,201,1,5,207,221,0.433,0.937
"1550","La Paz","Nuestra Señora de La Paz","Kinder Flora Perez De Saavedra",88,1,2,0,83,3,17,0,1,195,1,3,199,220,0.426,0.905
"1551","La Paz","Nuestra Señora de La Paz","Kinder Flora Perez De Saavedra",117,0,3,0,80,3,8,0,2,213,0,2,215,226,0.376,0.951
"1552","La Paz","Nuestra Señora de La Paz","Kinder Flora Perez De Saavedra",99,1,2,1,70,0,9,0,2,184,2,10,196,216,0.38,0.907
"1553","La Paz","Nuestra Señora de La Paz","Kinder Flora Perez De Saavedra",108,2,4,1,74,3,13,3,0,208,0,5,213,229,0.356,0.93
"1554","La Paz","Nuestra Señora de La Paz","Esc. Nicolas  Fernandez Naranjo",60,0,0,2,118,6,24,0,0,210,2,2,214,229,0.562,0.934
"1555","La Paz","Nuestra Señora de La Paz","Esc. Nicolas  Fernandez Naranjo",73,0,3,1,98,2,12,1,1,191,5,7,203,218,0.513,0.931
"1556","La Paz","Nuestra Señora de La Paz","Esc. Nicolas  Fernandez Naranjo",78,0,6,0,101,4,25,0,1,215,0,2,217,232,0.47,0.935
"1557","La Paz","Nuestra Señora de La Paz","Esc. Nicolas  Fernandez Naranjo",82,0,0,0,112,0,17,0,0,211,1,4,216,230,0.531,0.939
"1558","La Paz","Nuestra Señora de La Paz","Esc. Nicolas  Fernandez Naranjo",85,1,0,0,95,3,14,3,1,202,4,7,213,227,0.47,0.938
"1559","La Paz","Nuestra Señora de La Paz","Esc. Nicolas  Fernandez Naranjo",56,0,1,1,102,2,22,1,3,188,0,11,199,219,0.543,0.909
"1560","La Paz","Nuestra Señora de La Paz","Esc. Nicolas  Fernandez Naranjo",55,0,7,2,127,2,11,0,2,206,2,4,212,230,0.617,0.922
"1561","La Paz","Nuestra Señora de La Paz","Esc. Nicolas  Fernandez Naranjo",82,0,3,0,110,2,14,1,1,213,1,6,220,227,0.516,0.969
"1562","La Paz","Nuestra Señora de La Paz","Esc. Nicolas  Fernandez Naranjo",69,1,3,1,94,7,20,0,0,195,0,8,203,227,0.482,0.894
"1563","La Paz","Nuestra Señora de La Paz","Esc. Nicolas  Fernandez Naranjo",67,1,6,4,97,0,13,1,3,192,1,8,201,227,0.505,0.885
"1564","La Paz","Nuestra Señora de La Paz","Esc. Nicolas  Fernandez Naranjo",58,1,4,2,107,2,19,2,2,197,1,6,204,222,0.543,0.919
"1565","La Paz","Nuestra Señora de La Paz","Esc. Nicolas  Fernandez Naranjo",74,0,5,1,99,2,16,2,0,199,1,4,204,225,0.497,0.907
"1566","La Paz","Nuestra Señora de La Paz","Esc. Nicolas  Fernandez Naranjo",99,0,1,1,90,5,10,1,0,207,0,3,210,227,0.435,0.925
"1567","La Paz","Nuestra Señora de La Paz","Esc. Nicolas  Fernandez Naranjo",92,1,6,2,80,2,16,2,0,201,1,3,205,225,0.398,0.911
"1568","La Paz","Nuestra Señora de La Paz","Esc. Nicolas  Fernandez Naranjo",73,0,2,0,103,2,16,0,1,197,0,6,203,227,0.523,0.894
"1569","La Paz","Nuestra Señora de La Paz","Esc. Nicolas  Fernandez Naranjo",88,1,3,0,88,6,17,2,2,207,1,4,212,225,0.425,0.942
"1570","La Paz","Nuestra Señora de La Paz","Esc. Nicolas  Fernandez Naranjo",79,0,3,0,87,1,16,0,2,188,1,8,197,215,0.463,0.916
"1571","La Paz","Nuestra Señora de La Paz","Esc. Nicolas  Fernandez Naranjo",79,2,2,3,92,2,16,1,1,198,2,4,204,222,0.465,0.919
"1572","La Paz","Nuestra Señora de La Paz","Esc. Nicolas  Fernandez Naranjo",76,0,2,0,100,3,13,0,0,194,1,8,203,223,0.515,0.91
"1573","La Paz","Nuestra Señora de La Paz","Esc. Nicolas  Fernandez Naranjo",95,0,2,0,93,4,15,0,1,210,2,4,216,230,0.443,0.939
"1574","La Paz","Nuestra Señora de La Paz","Esc. Nicolas  Fernandez Naranjo",55,1,4,6,115,2,15,1,2,201,1,7,209,226,0.572,0.925
"1575","La Paz","Nuestra Señora de La Paz","Esc. Nicolas  Fernandez Naranjo",59,1,4,0,111,0,12,0,2,189,0,4,193,211,0.587,0.915
"1576","La Paz","Nuestra Señora de La Paz","Esc. Nicolas  Fernandez Naranjo",57,2,1,3,112,1,22,0,4,202,0,8,210,221,0.554,0.95
"1577","La Paz","Nuestra Señora de La Paz","Esc. Nicolas  Fernandez Naranjo",75,0,7,0,97,1,22,0,2,204,0,8,212,225,0.475,0.942
"1578","La Paz","Nuestra Señora de La Paz","Esc. Nicolas  Fernandez Naranjo",73,0,4,2,112,1,13,2,2,209,1,4,214,224,0.536,0.955
"1579","La Paz","Nuestra Señora de La Paz","Esc. Nicolas  Fernandez Naranjo",84,1,4,1,83,3,14,0,3,193,2,2,197,223,0.43,0.883
"1580","La Paz","Nuestra Señora de La Paz","Esc. Nicolas  Fernandez Naranjo",73,0,2,2,100,2,22,2,5,208,1,2,211,227,0.481,0.93
"1581","La Paz","Nuestra Señora de La Paz","Esc. Nicolas  Fernandez Naranjo",63,2,4,2,99,5,15,2,0,192,0,5,197,227,0.516,0.868
"1582","La Paz","Nuestra Señora de La Paz","Esc. Nicolas  Fernandez Naranjo",80,0,7,2,101,0,11,0,1,202,0,6,208,229,0.5,0.908
"1583","La Paz","Nuestra Señora de La Paz","Esc. Nicolas  Fernandez Naranjo",86,1,2,0,94,0,16,0,1,200,4,6,210,226,0.47,0.929
"1584","La Paz","Nuestra Señora de La Paz","Esc. Nicolas  Fernandez Naranjo",57,0,4,3,116,1,15,1,1,198,0,7,205,219,0.586,0.936
"1585","La Paz","Nuestra Señora de La Paz","Esc. Nicolas  Fernandez Naranjo",39,1,2,0,129,2,22,2,0,197,3,7,207,227,0.655,0.912
"1586","La Paz","Nuestra Señora de La Paz","Esc. Nicolas  Fernandez Naranjo",75,0,4,1,98,3,9,0,1,191,1,5,197,220,0.513,0.895
"1587","La Paz","Nuestra Señora de La Paz","Esc. Nicolas  Fernandez Naranjo",83,0,2,0,82,4,24,0,2,197,2,4,203,225,0.416,0.902
"1588","La Paz","Nuestra Señora de La Paz","Esc. Nicolas  Fernandez Naranjo",79,0,3,1,88,1,21,3,2,198,2,2,202,221,0.444,0.914
"1589","La Paz","Nuestra Señora de La Paz","Esc. Nicolas  Fernandez Naranjo",89,0,4,0,80,3,22,0,2,200,0,2,202,223,0.4,0.906
"1590","La Paz","Nuestra Señora de La Paz","Esc. Nicolas  Fernandez Naranjo",53,0,4,2,115,2,20,0,3,199,3,8,210,229,0.578,0.917
"1591","La Paz","Nuestra Señora de La Paz","Esc. Nicolas  Fernandez Naranjo",83,0,1,0,87,4,24,0,1,200,1,3,204,221,0.435,0.923
"1592","La Paz","Nuestra Señora de La Paz","Esc. Nicolas  Fernandez Naranjo",85,0,2,2,87,1,10,0,1,188,0,6,194,217,0.463,0.894
"1593","La Paz","Nuestra Señora de La Paz","Esc. Nicolas  Fernandez Naranjo",92,0,3,0,75,4,26,3,1,204,1,7,212,231,0.368,0.918
"1594","La Paz","Nuestra Señora de La Paz","Esc. Nicolas  Fernandez Naranjo",64,1,4,3,111,3,19,0,3,208,1,4,213,232,0.534,0.918
"1595","La Paz","Nuestra Señora de La Paz","Esc. Sergio Suarez",60,0,5,1,107,4,14,1,1,193,2,7,202,224,0.554,0.902
"1596","La Paz","Nuestra Señora de La Paz","Esc. Sergio Suarez",84,0,4,0,92,3,17,1,1,202,1,9,212,229,0.455,0.926
"1597","La Paz","Nuestra Señora de La Paz","Esc. Sergio Suarez",87,0,7,1,94,4,10,1,0,204,0,3,207,223,0.461,0.928
"1598","La Paz","Nuestra Señora de La Paz","Esc. Sergio Suarez",91,0,3,0,93,2,15,1,2,207,0,5,212,230,0.449,0.922
"1599","La Paz","Nuestra Señora de La Paz","Esc. Sergio Suarez",68,0,1,1,107,3,20,1,1,202,4,7,213,230,0.53,0.926
"1600","La Paz","Nuestra Señora de La Paz","Esc. Sergio Suarez",68,1,3,0,95,2,28,1,1,199,0,5,204,223,0.477,0.915
"1601","La Paz","Nuestra Señora de La Paz","Esc. Sergio Suarez",61,0,3,0,98,0,27,1,0,190,2,5,197,229,0.516,0.86
"1602","La Paz","Nuestra Señora de La Paz","Esc. Sergio Suarez",58,0,3,0,109,2,27,3,1,203,0,5,208,229,0.537,0.908
"1603","La Paz","Nuestra Señora de La Paz","Esc. Sergio Suarez",48,0,5,0,121,5,18,0,3,200,2,5,207,223,0.605,0.928
"1604","La Paz","Nuestra Señora de La Paz","Esc. Sergio Suarez",73,0,1,0,105,4,14,0,4,201,4,9,214,228,0.522,0.939
"1605","La Paz","Nuestra Señora de La Paz","Esc. Sergio Suarez",83,0,2,0,105,0,14,0,2,206,2,3,211,230,0.51,0.917
"1606","La Paz","Nuestra Señora de La Paz","Esc. Sergio Suarez",71,1,6,1,107,2,9,0,1,198,3,5,206,216,0.54,0.954
"1607","La Paz","Nuestra Señora de La Paz","Esc. Sergio Suarez",88,1,1,0,98,0,14,1,0,203,1,12,216,231,0.483,0.935
"1608","La Paz","Nuestra Señora de La Paz","Esc. Sergio Suarez",66,0,2,2,108,0,14,0,1,193,3,4,200,219,0.56,0.913
"1609","La Paz","Nuestra Señora de La Paz","Esc. Sergio Suarez",67,0,2,1,107,3,15,0,1,196,3,7,206,226,0.546,0.912
"1610","La Paz","Nuestra Señora de La Paz","Esc. Sergio Suarez",67,1,4,1,108,4,12,0,0,197,3,9,209,229,0.548,0.913
"1611","La Paz","Nuestra Señora de La Paz","Esc. Sergio Suarez",63,0,7,0,107,2,21,0,2,202,1,4,207,227,0.53,0.912
"1612","La Paz","Nuestra Señora de La Paz","Esc. Sergio Suarez",60,0,7,0,93,2,5,1,1,169,0,12,181,219,0.55,0.826
"1613","La Paz","Nuestra Señora de La Paz","Esc. Sergio Suarez",41,0,3,1,131,0,18,0,0,194,3,4,201,220,0.675,0.914
"1614","La Paz","Nuestra Señora de La Paz","Esc. Sergio Suarez",39,0,5,1,124,1,22,1,4,197,0,8,205,230,0.629,0.891
"1615","La Paz","Nuestra Señora de La Paz","Esc. Sergio Suarez",76,0,4,1,112,0,13,0,0,206,0,5,211,225,0.544,0.938
"1616","La Paz","Nuestra Señora de La Paz","Esc. Sergio Suarez",84,1,2,1,99,2,12,1,2,204,2,5,211,225,0.485,0.938
"1617","La Paz","Nuestra Señora de La Paz","Esc. Sergio Suarez",69,2,2,1,116,1,14,1,2,208,2,6,216,228,0.558,0.947
"1618","La Paz","Nuestra Señora de La Paz","Esc. Sergio Suarez",87,0,3,1,99,1,13,1,0,205,1,3,209,226,0.483,0.925
"1619","La Paz","Nuestra Señora de La Paz","Esc. Sergio Suarez",57,1,1,0,108,0,20,2,2,191,1,8,200,222,0.565,0.901
"1620","La Paz","Nuestra Señora de La Paz","Esc. Sergio Suarez",56,0,2,0,118,1,21,1,1,200,0,4,204,225,0.59,0.907
"1621","La Paz","Nuestra Señora de La Paz","Esc. Sergio Suarez",43,1,4,3,115,0,21,1,3,191,3,6,200,226,0.602,0.885
"1622","La Paz","Nuestra Señora de La Paz","Esc. Sergio Suarez",75,1,0,1,101,6,15,0,1,200,1,4,205,226,0.505,0.907
"1623","La Paz","Nuestra Señora de La Paz","Esc. Sergio Suarez",75,0,3,2,95,2,21,0,1,199,0,9,208,228,0.477,0.912
"1624","La Paz","Nuestra Señora de La Paz","Esc. Sergio Suarez",82,1,4,1,90,5,14,0,3,200,0,5,205,223,0.45,0.919
"1625","La Paz","Nuestra Señora de La Paz","Esc. Sergio Suarez",77,0,4,3,96,3,24,0,0,207,1,3,211,226,0.464,0.934
"1626","La Paz","Nuestra Señora de La Paz","Esc. Sergio Suarez",59,0,3,0,99,5,26,1,2,195,0,7,202,225,0.508,0.898
"1627","La Paz","Nuestra Señora de La Paz","Esc. Sergio Suarez",95,1,3,1,93,1,11,0,5,210,0,7,217,232,0.443,0.935
"1628","La Paz","Nuestra Señora de La Paz","Esc. Sergio Suarez",67,1,2,1,101,2,24,1,4,203,1,4,208,227,0.498,0.916
"1629","La Paz","Nuestra Señora de La Paz","Liceo Tec. H. Nuestra Sra. De La Paz",109,1,4,1,69,1,13,0,2,200,0,7,207,228,0.345,0.908
"1630","La Paz","Nuestra Señora de La Paz","Liceo Tec. H. Nuestra Sra. De La Paz",115,1,0,1,60,2,6,4,0,189,1,2,192,214,0.317,0.897
"1631","La Paz","Nuestra Señora de La Paz","Liceo Tec. H. Nuestra Sra. De La Paz",124,0,1,0,57,3,12,2,0,199,1,6,206,228,0.286,0.904
"1632","La Paz","Nuestra Señora de La Paz","Liceo Tec. H. Nuestra Sra. De La Paz",115,1,2,1,49,2,13,1,2,186,1,7,194,220,0.263,0.882
"1633","La Paz","Nuestra Señora de La Paz","Liceo Tec. H. Nuestra Sra. De La Paz",126,0,1,1,57,3,8,0,1,197,0,2,199,223,0.289,0.892
"1634","La Paz","Nuestra Señora de La Paz","Liceo Tec. H. Nuestra Sra. De La Paz",103,1,6,0,59,3,8,2,0,182,0,3,185,213,0.324,0.869
"1635","La Paz","Nuestra Señora de La Paz","Liceo Tec. H. Nuestra Sra. De La Paz",114,0,1,0,64,2,9,2,1,193,1,9,203,216,0.332,0.94
"1636","La Paz","Nuestra Señora de La Paz","Liceo Tec. H. Nuestra Sra. De La Paz",126,0,1,2,53,8,9,0,0,199,2,4,205,228,0.266,0.899
"1637","La Paz","Nuestra Señora de La Paz","Liceo Tec. H. Nuestra Sra. De La Paz",121,1,0,0,48,6,10,1,0,187,2,6,195,220,0.257,0.886
"1638","La Paz","Nuestra Señora de La Paz","Colegio Antonio Diaz Villamil",104,0,0,1,69,4,7,1,1,187,1,7,195,220,0.369,0.886
"1639","La Paz","Nuestra Señora de La Paz","Colegio Antonio Diaz Villamil",113,0,1,1,62,1,6,1,1,186,0,9,195,214,0.333,0.911
"1640","La Paz","Nuestra Señora de La Paz","Colegio Antonio Diaz Villamil",120,0,0,0,57,4,11,1,0,193,0,2,195,219,0.295,0.89
"1641","La Paz","Nuestra Señora de La Paz","Colegio Antonio Diaz Villamil",104,1,1,2,81,2,14,0,1,206,1,5,212,224,0.393,0.946
"1642","La Paz","Nuestra Señora de La Paz","Colegio Antonio Diaz Villamil",125,0,2,0,53,0,8,2,0,190,2,4,196,218,0.279,0.899
"1643","La Paz","Nuestra Señora de La Paz","Colegio Antonio Diaz Villamil",128,0,0,2,54,5,13,0,1,203,0,2,205,224,0.266,0.915
"1644","La Paz","Nuestra Señora de La Paz","Colegio Antonio Diaz Villamil",120,0,0,0,65,1,3,1,1,191,1,5,197,221,0.34,0.891
"1645","La Paz","Nuestra Señora de La Paz","Colegio Antonio Diaz Villamil",93,1,1,2,81,3,14,1,0,196,0,3,199,221,0.413,0.9
"1646","La Paz","Nuestra Señora de La Paz","Colegio Antonio Diaz Villamil",118,0,1,1,66,0,8,0,1,195,0,3,198,220,0.338,0.9
"1647","La Paz","Nuestra Señora de La Paz","Colegio Antonio Diaz Villamil",102,0,2,2,69,4,10,1,1,191,1,3,195,227,0.361,0.859
"1648","La Paz","Nuestra Señora de La Paz","Colegio Antonio Diaz Villamil",123,0,0,0,53,6,12,2,2,198,0,4,202,220,0.268,0.918
"1649","La Paz","Nuestra Señora de La Paz","Colegio Antonio Diaz Villamil",111,0,5,0,68,2,12,3,0,201,1,5,207,223,0.338,0.928
"1650","La Paz","Nuestra Señora de La Paz","Colegio Antonio Diaz Villamil",135,0,3,1,51,3,7,1,0,201,0,4,205,218,0.254,0.94
"1651","La Paz","Nuestra Señora de La Paz","Colegio Antonio Diaz Villamil",99,0,2,0,82,3,10,1,0,197,2,7,206,224,0.416,0.92
"1652","La Paz","Nuestra Señora de La Paz","Colegio Antonio Diaz Villamil",128,1,2,1,53,4,4,3,0,196,0,3,199,227,0.27,0.877
"1653","La Paz","Nuestra Señora de La Paz","Colegio Antonio Diaz Villamil",133,0,0,1,57,3,7,0,2,203,0,5,208,226,0.281,0.92
"1654","La Paz","Nuestra Señora de La Paz","Colegio Antonio Diaz Villamil",122,2,3,2,58,3,5,2,1,198,0,4,202,222,0.293,0.91
"1655","La Paz","Nuestra Señora de La Paz","Colegio Antonio Diaz Villamil",134,0,4,1,50,4,7,0,0,200,2,2,204,219,0.25,0.932
"1656","La Paz","Nuestra Señora de La Paz","Colegio Luis Alberto Pabon",119,0,5,1,71,0,4,0,1,201,1,7,209,227,0.353,0.921
"1657","La Paz","Nuestra Señora de La Paz","Colegio Luis Alberto Pabon",107,0,1,0,75,1,14,0,0,198,0,5,203,225,0.379,0.902
"1658","La Paz","Nuestra Señora de La Paz","Colegio Luis Alberto Pabon",119,1,1,1,58,3,5,3,2,193,0,8,201,221,0.301,0.91
"1659","La Paz","Nuestra Señora de La Paz","Colegio Luis Alberto Pabon",98,1,1,2,84,3,10,1,1,201,0,3,204,226,0.418,0.903
"1660","La Paz","Nuestra Señora de La Paz","Colegio Luis Alberto Pabon",113,1,2,1,71,6,9,2,0,205,0,6,211,227,0.346,0.93
"1661","La Paz","Nuestra Señora de La Paz","Colegio Luis Alberto Pabon",118,1,1,0,63,2,11,0,1,197,0,5,202,213,0.32,0.948
"1662","La Paz","Nuestra Señora de La Paz","Colegio Luis Alberto Pabon",124,0,1,2,63,4,7,1,1,203,0,4,207,231,0.31,0.896
"1663","La Paz","Nuestra Señora de La Paz","Colegio Luis Alberto Pabon",111,0,1,0,47,0,7,0,1,167,0,4,171,189,0.281,0.905
"1664","La Paz","Nuestra Señora de La Paz","Col. American School",112,0,1,1,58,2,12,0,1,187,0,4,191,213,0.31,0.897
"1665","La Paz","Nuestra Señora de La Paz","Col. American School",132,0,6,0,45,2,15,1,2,203,1,3,207,224,0.222,0.924
"1666","La Paz","Nuestra Señora de La Paz","Col. American School",131,0,1,0,45,4,15,2,2,200,0,0,200,223,0.225,0.897
"1667","La Paz","Nuestra Señora de La Paz","Col. American School",110,0,0,0,63,5,17,3,1,199,0,6,205,224,0.317,0.915
"1668","La Paz","Nuestra Señora de La Paz","Col. American School",105,0,3,1,66,3,19,0,1,198,0,4,202,227,0.333,0.89
"1669","La Paz","Nuestra Señora de La Paz","Col. American School",114,2,3,3,52,2,12,0,4,192,0,4,196,215,0.271,0.912
"1670","La Paz","Nuestra Señora de La Paz","Col. American School",124,0,0,0,57,3,6,1,1,192,0,5,197,219,0.297,0.9
"1671","La Paz","Nuestra Señora de La Paz","Col. American School",106,1,3,2,71,4,16,1,0,204,1,4,209,227,0.348,0.921
"1672","La Paz","Nuestra Señora de La Paz","Esc. Natalia Palacios",128,0,1,0,43,1,9,1,3,186,2,3,191,218,0.231,0.876
"1673","La Paz","Nuestra Señora de La Paz","Esc. Natalia Palacios",107,1,1,0,61,2,11,1,0,184,1,3,188,215,0.332,0.874
"1674","La Paz","Nuestra Señora de La Paz","Esc. Natalia Palacios",125,0,1,0,51,3,11,1,2,194,0,5,199,221,0.263,0.9
"1675","La Paz","Nuestra Señora de La Paz","Esc. Natalia Palacios",114,0,1,0,52,4,13,0,0,184,1,8,193,220,0.283,0.877
"1676","La Paz","Nuestra Señora de La Paz","Esc. Natalia Palacios",124,0,0,0,49,2,17,2,1,195,0,7,202,223,0.251,0.906
"1677","La Paz","Nuestra Señora de La Paz","Esc. Natalia Palacios",117,0,1,0,60,5,10,0,1,194,0,4,198,219,0.309,0.904
"1678","La Paz","Nuestra Señora de La Paz","Esc. Natalia Palacios",123,0,1,1,53,3,17,0,2,200,1,5,206,224,0.265,0.92
"1679","La Paz","Nuestra Señora de La Paz","Esc. Natalia Palacios",125,0,1,1,48,3,11,2,0,191,1,3,195,214,0.251,0.911
"1680","La Paz","Nuestra Señora de La Paz","Esc. Natalia Palacios",118,0,1,0,38,4,10,2,2,175,1,12,188,211,0.217,0.891
"1681","La Paz","Nuestra Señora de La Paz","Esc. Natalia Palacios",104,1,1,2,59,3,9,3,2,184,1,6,191,212,0.321,0.901
"1682","La Paz","Nuestra Señora de La Paz","Esc. Natalia Palacios",132,0,2,2,51,2,8,0,1,198,1,4,203,226,0.258,0.898
"1683","La Paz","Nuestra Señora de La Paz","Esc. Natalia Palacios",129,0,0,1,55,1,12,1,1,200,2,3,205,217,0.275,0.945
"1684","La Paz","Nuestra Señora de La Paz","Esc. Natalia Palacios",141,0,0,0,38,1,12,1,2,195,2,5,202,224,0.195,0.902
"1685","La Paz","Nuestra Señora de La Paz","Unidad Educativa Republica de China",107,0,2,0,78,0,17,1,1,206,2,1,209,226,0.379,0.925
"1686","La Paz","Nuestra Señora de La Paz","Unidad Educativa Republica de China",98,0,4,0,81,3,12,2,0,200,0,3,203,222,0.405,0.914
"1687","La Paz","Nuestra Señora de La Paz","Unidad Educativa Republica de China",105,0,4,0,74,5,11,1,0,200,2,3,205,219,0.37,0.936
"1688","La Paz","Nuestra Señora de La Paz","Unidad Educativa Republica de China",103,0,5,0,76,3,16,0,1,204,0,1,205,223,0.373,0.919
"1689","La Paz","Nuestra Señora de La Paz","Unidad Educativa Republica de China",110,0,3,1,66,1,10,1,2,194,2,5,201,219,0.34,0.918
"1690","La Paz","Nuestra Señora de La Paz","Unidad Educativa Republica de China",117,0,2,2,71,2,4,1,0,199,0,2,201,227,0.357,0.885
"1691","La Paz","Nuestra Señora de La Paz","Unidad Educativa Republica de China",106,0,1,0,80,5,12,0,3,207,1,5,213,229,0.386,0.93
"1692","La Paz","Nuestra Señora de La Paz","Unidad Educativa Republica de China",102,0,4,0,80,4,16,0,1,207,0,6,213,228,0.386,0.934
"1693","La Paz","Nuestra Señora de La Paz","Unidad Educativa Republica de China",118,1,1,0,72,1,5,1,2,201,1,4,206,227,0.358,0.907
"1694","La Paz","Nuestra Señora de La Paz","Unidad Educativa Republica de China",97,1,2,0,66,6,18,0,1,191,0,10,201,221,0.346,0.91
"1695","La Paz","Nuestra Señora de La Paz","Unidad Educativa Republica de China",108,0,2,1,75,1,11,2,0,200,2,5,207,228,0.375,0.908
"1696","La Paz","Nuestra Señora de La Paz","Unidad Educativa Republica de China",116,1,0,1,61,5,6,1,1,192,1,9,202,221,0.318,0.914
"1697","La Paz","Nuestra Señora de La Paz","Unidad Educativa Republica de China",102,0,1,1,73,2,10,2,3,194,4,6,204,228,0.376,0.895
"1698","La Paz","Nuestra Señora de La Paz","Unidad Educativa Republica de China",124,0,1,1,61,3,6,0,0,196,3,8,207,222,0.311,0.932
"1699","La Paz","Nuestra Señora de La Paz","Col. Nacional Ayacucho",96,0,3,0,54,3,18,1,3,178,0,5,183,221,0.303,0.828
"1700","La Paz","Nuestra Señora de La Paz","Col. Nacional Ayacucho",105,0,1,0,51,1,22,2,9,191,1,2,194,229,0.267,0.847
"1701","La Paz","Nuestra Señora de La Paz","Col. Nacional Ayacucho",101,2,3,1,56,2,20,0,2,187,0,3,190,227,0.299,0.837
"1702","La Paz","Nuestra Señora de La Paz","Col. Nacional Ayacucho",114,0,0,1,47,3,14,1,4,184,2,7,193,222,0.255,0.869
"1703","La Paz","Nuestra Señora de La Paz","Col. Nacional Ayacucho",92,1,2,2,55,1,27,1,7,188,0,7,195,227,0.293,0.859
"1704","La Paz","Nuestra Señora de La Paz","Col. Nacional Ayacucho",104,1,3,0,52,4,18,0,1,183,2,3,188,224,0.284,0.839
"1705","La Paz","Nuestra Señora de La Paz","Col. Nacional Ayacucho",98,1,4,0,52,3,27,1,4,190,0,3,193,222,0.274,0.869
"1706","La Paz","Nuestra Señora de La Paz","Col. Nacional Ayacucho",99,0,1,0,51,2,25,1,3,182,2,4,188,228,0.28,0.825
"1707","La Paz","Nuestra Señora de La Paz","Col. Santa Ana",136,0,0,1,47,2,8,4,2,200,0,0,200,224,0.235,0.893
"1708","La Paz","Nuestra Señora de La Paz","Col. Santa Ana",118,1,0,0,58,4,14,1,5,201,0,2,203,228,0.289,0.89
"1709","La Paz","Nuestra Señora de La Paz","Col. Santa Ana",120,1,2,1,48,5,9,0,2,188,1,2,191,225,0.255,0.849
"1710","La Paz","Nuestra Señora de La Paz","Col. Santa Ana",123,0,2,0,52,2,20,1,0,200,0,3,203,227,0.26,0.894
"1711","La Paz","Nuestra Señora de La Paz","Col. Santa Ana",126,1,2,1,49,4,8,0,0,191,0,1,192,221,0.257,0.869
"1712","La Paz","Nuestra Señora de La Paz","Col. Santa Ana",138,0,1,0,36,2,16,1,1,195,1,5,201,232,0.185,0.866
"1713","La Paz","Nuestra Señora de La Paz","Col. Santa Ana",134,0,1,1,46,3,10,1,1,197,1,5,203,228,0.234,0.89
"1714","La Paz","Nuestra Señora de La Paz","Dir. Distrital de Educación",117,0,2,2,57,3,3,0,2,186,0,5,191,219,0.306,0.872
"1715","La Paz","Nuestra Señora de La Paz","Dir. Distrital de Educación",134,1,0,2,49,7,8,1,1,203,1,2,206,226,0.241,0.912
"1716","La Paz","Nuestra Señora de La Paz","Dir. Distrital de Educación",137,0,3,1,43,2,12,0,2,200,1,2,203,228,0.215,0.89
"1717","La Paz","Nuestra Señora de La Paz","Dir. Distrital de Educación",119,0,4,0,49,2,8,1,1,184,2,8,194,222,0.266,0.874
"1718","La Paz","Nuestra Señora de La Paz","Dir. Distrital de Educación",138,0,2,1,39,2,4,1,1,188,2,3,193,217,0.207,0.889
"1719","La Paz","Nuestra Señora de La Paz","Dir. Distrital de Educación",114,0,1,0,68,4,9,0,3,199,2,4,205,220,0.342,0.932
"1720","La Paz","Nuestra Señora de La Paz","Dir. Distrital de Educación",148,0,2,0,45,0,2,0,0,197,1,8,206,225,0.228,0.916
"1721","La Paz","Nuestra Señora de La Paz","Dir. Distrital de Educación",111,0,1,0,57,2,5,1,1,178,0,2,180,213,0.32,0.845
"1722","La Paz","Nuestra Señora de La Paz","Dir. Distrital de Educación",129,0,0,0,52,2,10,1,0,194,0,3,197,222,0.268,0.887
"1723","La Paz","Nuestra Señora de La Paz","Dir. Distrital de Educación",121,0,2,0,51,2,4,1,1,182,2,6,190,215,0.28,0.884
"1724","La Paz","Nuestra Señora de La Paz","Dir. Distrital de Educación",138,0,1,0,39,5,8,1,0,192,0,8,200,221,0.203,0.905
"1725","La Paz","Nuestra Señora de La Paz","Coop. Educacional San Marcos Ltda.",132,0,0,1,44,2,4,2,0,185,1,2,188,213,0.238,0.883
"1726","La Paz","Nuestra Señora de La Paz","Coop. Educacional San Marcos Ltda.",109,0,0,1,75,2,7,0,1,195,0,3,198,221,0.385,0.896
"1727","La Paz","Nuestra Señora de La Paz","Coop. Educacional San Marcos Ltda.",105,1,1,1,59,2,10,2,3,184,1,6,191,211,0.321,0.905
"1728","La Paz","Nuestra Señora de La Paz","Coop. Educacional San Marcos Ltda.",120,1,0,2,56,1,8,1,0,189,0,4,193,220,0.296,0.877
"1729","La Paz","Nuestra Señora de La Paz","U.E. Carlos Salinas",117,0,1,0,57,3,6,1,0,185,2,6,193,214,0.308,0.902
"1730","La Paz","Nuestra Señora de La Paz","U.E. Carlos Salinas",117,0,2,2,57,5,4,0,2,189,1,8,198,220,0.302,0.9
"1731","La Paz","Nuestra Señora de La Paz","Col. Experimental Hugo Davila",148,1,1,1,33,4,8,1,1,198,0,6,204,227,0.167,0.899
"1732","La Paz","Nuestra Señora de La Paz","Col. Experimental Hugo Davila",134,0,0,0,51,2,6,0,0,193,0,6,199,226,0.264,0.881
"1733","La Paz","Nuestra Señora de La Paz","Col. Experimental Hugo Davila",144,1,2,1,40,4,3,1,0,196,1,2,199,227,0.204,0.877
"1734","La Paz","Nuestra Señora de La Paz","Col. Experimental Hugo Davila",154,0,2,0,38,2,8,0,0,204,1,2,207,226,0.186,0.916
"1735","La Paz","Nuestra Señora de La Paz","Col. Experimental Hugo Davila",147,0,0,1,38,6,8,2,1,203,1,1,205,228,0.187,0.899
"1736","La Paz","Nuestra Señora de La Paz","Col. Experimental Hugo Davila",123,0,1,0,56,5,12,0,3,200,0,2,202,232,0.28,0.871
"1737","La Paz","Nuestra Señora de La Paz","Col. Experimental Hugo Davila",138,0,0,0,61,2,7,0,1,209,3,2,214,232,0.292,0.922
"1738","La Paz","Nuestra Señora de La Paz","Col. Experimental Hugo Davila",142,0,3,0,51,4,3,0,0,203,0,5,208,225,0.251,0.924
"1739","La Paz","Nuestra Señora de La Paz","Col. Experimental Hugo Davila",143,0,0,0,51,2,5,2,0,203,2,2,207,227,0.251,0.912
"1740","La Paz","Nuestra Señora de La Paz","Col. Experimental Hugo Davila",142,0,3,1,45,1,4,1,2,199,0,6,205,220,0.226,0.932
"1741","La Paz","Nuestra Señora de La Paz","Col. Experimental Hugo Davila",150,1,0,1,32,3,8,0,0,195,0,6,201,229,0.164,0.878
"1742","La Paz","Nuestra Señora de La Paz","Col. Experimental Hugo Davila",124,0,2,1,52,4,7,2,0,192,1,3,196,222,0.271,0.883
"1743","La Paz","Nuestra Señora de La Paz","Col. Experimental Hugo Davila",134,2,1,0,53,3,8,1,0,202,1,3,206,227,0.262,0.907
"1744","La Paz","Nuestra Señora de La Paz","Col. Experimental Hugo Davila",126,0,3,0,63,3,11,1,1,208,0,6,214,227,0.303,0.943
"1745","La Paz","Nuestra Señora de La Paz","Col. Experimental Hugo Davila",137,1,5,0,44,3,5,1,0,196,2,3,201,225,0.224,0.893
"1746","La Paz","Nuestra Señora de La Paz","Col. Experimental Hugo Davila",136,0,1,1,39,1,8,0,1,187,1,4,192,225,0.209,0.853
"1747","La Paz","Nuestra Señora de La Paz","Col. Experimental Hugo Davila",131,1,2,0,57,4,5,1,2,203,0,3,206,231,0.281,0.892
"1748","La Paz","Nuestra Señora de La Paz","Col. Experimental Hugo Davila",149,0,0,0,34,8,8,1,0,200,0,3,203,229,0.17,0.886
"1749","La Paz","Nuestra Señora de La Paz","Col. Experimental Hugo Davila",145,0,1,0,42,1,8,3,2,202,0,4,206,228,0.208,0.904
"1750","La Paz","Nuestra Señora de La Paz","Col. Experimental Hugo Davila",129,0,1,0,63,2,15,2,0,212,0,1,213,232,0.297,0.918
"1751","La Paz","Nuestra Señora de La Paz","Col. Experimental Hugo Davila",146,0,2,2,37,1,7,0,1,196,0,4,200,231,0.189,0.866
"1752","La Paz","Nuestra Señora de La Paz","Col. Experimental Hugo Davila",146,0,0,0,50,2,10,0,1,209,1,2,212,233,0.239,0.91
"1753","La Paz","Nuestra Señora de La Paz","Col. Experimental Hugo Davila",141,0,3,2,40,3,11,2,1,203,0,9,212,234,0.197,0.906
"1754","La Paz","Nuestra Señora de La Paz","Col. Experimental Hugo Davila",142,0,1,1,44,1,7,1,0,197,2,4,203,235,0.223,0.864
"1755","La Paz","Nuestra Señora de La Paz","Col. Cervantes",149,0,1,1,30,5,7,1,1,195,0,1,196,226,0.154,0.867
"1756","La Paz","Nuestra Señora de La Paz","Col. Cervantes",161,0,0,1,30,2,6,2,0,202,0,1,203,225,0.149,0.902
"1757","La Paz","Nuestra Señora de La Paz","Col. Cervantes",143,0,0,1,46,4,7,0,0,201,1,4,206,230,0.229,0.896
"1758","La Paz","Nuestra Señora de La Paz","Col. Cervantes",145,1,2,0,31,3,5,0,1,188,3,2,193,226,0.165,0.854
"1759","La Paz","Nuestra Señora de La Paz","Col. Cervantes",151,2,1,0,34,3,5,1,0,197,3,7,207,226,0.173,0.916
"1760","La Paz","Nuestra Señora de La Paz","Col. Cervantes",162,0,0,3,25,5,6,2,0,203,0,0,203,230,0.123,0.883
"1761","La Paz","Nuestra Señora de La Paz","Col. Cervantes",144,0,0,0,44,2,2,2,1,195,1,2,198,222,0.226,0.892
"1762","La Paz","Nuestra Señora de La Paz","Col. Cervantes",151,0,0,3,37,0,6,1,0,198,0,2,200,219,0.187,0.913
"1763","La Paz","Nuestra Señora de La Paz","Col. Cervantes",146,1,2,1,34,3,6,0,0,193,0,3,196,230,0.176,0.852
"1764","La Paz","Nuestra Señora de La Paz","Col. Cervantes",175,1,0,0,21,4,3,0,1,205,1,6,212,230,0.102,0.922
"1765","La Paz","Nuestra Señora de La Paz","Col. Cervantes",170,0,1,0,23,6,3,2,0,205,1,2,208,234,0.112,0.889
"1766","La Paz","Nuestra Señora de La Paz","Col. Cervantes",150,0,2,2,37,3,4,1,0,199,1,3,203,230,0.186,0.883
"1767","La Paz","Nuestra Señora de La Paz","Esc. Panama",135,0,0,2,37,4,10,0,0,188,1,3,192,218,0.197,0.881
"1768","La Paz","Nuestra Señora de La Paz","Esc. Panama",129,2,1,1,40,2,7,2,1,185,1,14,200,221,0.216,0.905
"1769","La Paz","Nuestra Señora de La Paz","Esc. Panama",138,0,3,1,38,4,4,0,0,188,0,2,190,223,0.202,0.852
"1770","La Paz","Nuestra Señora de La Paz","Esc. Panama",134,0,0,0,46,5,11,3,2,201,2,6,209,226,0.229,0.925
"1771","La Paz","Nuestra Señora de La Paz","Esc. Panama",142,0,4,2,38,3,5,1,0,195,0,2,197,222,0.195,0.887
"1772","La Paz","Nuestra Señora de La Paz","Esc. Panama",156,0,0,1,36,2,4,0,0,199,0,1,200,225,0.181,0.889
"1773","La Paz","Nuestra Señora de La Paz","Esc. Panama",132,0,0,0,38,2,9,0,1,182,0,5,187,207,0.209,0.903
"1774","La Paz","Nuestra Señora de La Paz","Esc. Panama",147,0,1,4,32,2,6,2,1,195,0,2,197,219,0.164,0.9
"1775","La Paz","Nuestra Señora de La Paz","Esc. Panama",154,0,0,0,23,6,8,1,1,193,1,3,197,223,0.119,0.883
"1776","La Paz","Nuestra Señora de La Paz","Esc. Panama",139,0,1,2,43,3,5,0,1,194,0,4,198,219,0.222,0.904
"1777","La Paz","Nuestra Señora de La Paz","Esc. Panama",147,0,0,2,31,3,6,1,0,190,3,9,202,224,0.163,0.902
"1778","La Paz","Nuestra Señora de La Paz","Esc. Panama",159,0,1,0,24,5,4,1,0,194,3,2,199,220,0.124,0.905
"1779","La Paz","Nuestra Señora de La Paz","Esc. Panama",137,0,1,1,41,4,10,2,0,196,0,2,198,226,0.209,0.876
"1780","La Paz","Nuestra Señora de La Paz","Esc. Panama",147,0,0,2,37,2,3,1,0,192,0,4,196,218,0.193,0.899
"1781","La Paz","Nuestra Señora de La Paz","Esc. Panama",148,0,1,1,33,2,2,0,0,187,0,7,194,215,0.176,0.902
"1782","La Paz","Nuestra Señora de La Paz","Esc. Panama",139,0,1,1,45,2,5,2,0,195,0,7,202,224,0.231,0.902
"1783","La Paz","Nuestra Señora de La Paz","Esc. Panama",153,1,0,1,34,1,4,0,0,194,1,6,201,225,0.175,0.893
"1784","La Paz","Nuestra Señora de La Paz","Esc. Panama",136,0,0,1,36,4,2,0,2,181,1,5,187,201,0.199,0.93
"1785","La Paz","Nuestra Señora de La Paz","E.N.S.A.F.",138,0,1,0,41,2,5,0,4,191,0,4,195,216,0.215,0.903
"1786","La Paz","Nuestra Señora de La Paz","E.N.S.A.F.",152,0,1,0,36,2,5,4,0,200,1,1,202,221,0.18,0.914
"1787","La Paz","Nuestra Señora de La Paz","E.N.S.A.F.",125,0,0,1,44,2,10,2,2,186,1,5,192,219,0.237,0.877
"1788","La Paz","Nuestra Señora de La Paz","E.N.S.A.F.",147,0,0,1,32,4,5,1,1,191,1,3,195,218,0.168,0.894
"1789","La Paz","Nuestra Señora de La Paz","E.N.S.A.F.",144,0,2,0,38,3,2,3,0,192,0,4,196,226,0.198,0.867
"1790","La Paz","Nuestra Señora de La Paz","E.N.S.A.F.",143,1,0,1,43,1,6,5,0,200,0,2,202,222,0.215,0.91
"1791","La Paz","Nuestra Señora de La Paz","E.N.S.A.F.",136,0,1,3,33,5,12,3,2,195,0,2,197,217,0.169,0.908
"1792","La Paz","Nuestra Señora de La Paz","E.N.S.A.F.",154,0,1,1,29,1,8,1,0,195,1,1,197,217,0.149,0.908
"1793","La Paz","Nuestra Señora de La Paz","E.N.S.A.F.",131,1,1,0,49,2,6,0,0,190,2,5,197,220,0.258,0.895
"1794","La Paz","Nuestra Señora de La Paz","E.N.S.A.F.",139,0,2,1,32,3,4,1,0,182,2,1,185,207,0.176,0.894
"1795","La Paz","Nuestra Señora de La Paz","Col. Felipe 2do. Guzman",133,0,1,1,57,2,9,1,2,206,0,4,210,227,0.277,0.925
"1796","La Paz","Nuestra Señora de La Paz","Col. Felipe 2do. Guzman",119,0,0,0,52,2,10,0,1,184,1,2,187,217,0.283,0.862
"1797","La Paz","Nuestra Señora de La Paz","Col. Felipe 2do. Guzman",91,0,1,0,88,1,13,0,2,196,0,4,200,222,0.449,0.901
"1798","La Paz","Nuestra Señora de La Paz","Col. Felipe 2do. Guzman",135,0,2,0,51,4,10,2,1,205,2,2,209,230,0.249,0.909
"1799","La Paz","Nuestra Señora de La Paz","Col. Felipe 2do. Guzman",139,0,1,1,45,1,5,1,0,193,0,7,200,224,0.233,0.893
"1800","La Paz","Nuestra Señora de La Paz","Col. Felipe 2do. Guzman",121,0,2,0,43,2,9,2,2,181,1,6,188,221,0.238,0.851
"1801","La Paz","Nuestra Señora de La Paz","Col. Felipe 2do. Guzman",104,0,2,0,69,0,18,0,1,194,0,2,196,228,0.356,0.86
"1802","La Paz","Nuestra Señora de La Paz","Col. Felipe 2do. Guzman",119,0,0,0,55,2,8,1,0,185,1,12,198,221,0.297,0.896
"1803","La Paz","Nuestra Señora de La Paz","Col. Felipe 2do. Guzman",123,1,3,3,49,1,11,1,1,193,1,4,198,229,0.254,0.865
"1804","La Paz","Nuestra Señora de La Paz","Col. Felipe 2do. Guzman",102,0,0,2,59,1,14,1,1,180,2,8,190,230,0.328,0.826
"1805","La Paz","Nuestra Señora de La Paz","Col. Felipe 2do. Guzman",122,0,4,0,49,0,7,0,1,183,2,4,189,229,0.268,0.825
"1806","La Paz","Nuestra Señora de La Paz","Col. Felipe 2do. Guzman",130,1,1,2,43,4,13,2,0,196,0,2,198,228,0.219,0.868
"1807","La Paz","Nuestra Señora de La Paz","Esc. Alonzo De Mendoza",135,0,0,0,39,3,5,0,1,183,0,3,186,212,0.213,0.877
"1808","La Paz","Nuestra Señora de La Paz","Esc. Alonzo De Mendoza",132,0,1,1,44,5,7,0,1,191,0,2,193,217,0.23,0.889
"1809","La Paz","Nuestra Señora de La Paz","Esc. Alonzo De Mendoza",134,2,1,0,43,2,3,0,1,186,2,6,194,212,0.231,0.915
"1810","La Paz","Nuestra Señora de La Paz","Esc. Alonzo De Mendoza",117,0,2,0,26,0,5,1,1,152,1,3,156,173,0.171,0.902
"1811","La Paz","Nuestra Señora de La Paz","Escuela Piloto Naciones Unidas",137,2,2,0,68,2,6,0,0,217,0,4,221,234,0.313,0.944
"1812","La Paz","Nuestra Señora de La Paz","Escuela Piloto Naciones Unidas",145,0,6,0,44,0,11,3,0,209,0,7,216,234,0.211,0.923
"1813","La Paz","Nuestra Señora de La Paz","Escuela Piloto Naciones Unidas",132,1,1,0,40,3,5,2,1,185,0,4,189,220,0.216,0.859
"1814","La Paz","Nuestra Señora de La Paz","Escuela Piloto Naciones Unidas",131,0,2,3,41,1,7,4,1,190,1,2,193,220,0.216,0.877
"1815","La Paz","Nuestra Señora de La Paz","Escuela Piloto Naciones Unidas",123,0,0,0,47,1,5,0,2,178,0,5,183,215,0.264,0.851
"1816","La Paz","Nuestra Señora de La Paz","Escuela Piloto Naciones Unidas",142,0,0,0,43,0,10,2,1,198,0,2,200,221,0.217,0.905
"1817","La Paz","Nuestra Señora de La Paz","Colegio Dora Schmidt",146,1,0,0,37,5,10,0,2,201,1,2,204,228,0.184,0.895
"1818","La Paz","Nuestra Señora de La Paz","Colegio Dora Schmidt",136,0,0,0,43,1,12,0,1,193,1,7,201,229,0.223,0.878
"1819","La Paz","Nuestra Señora de La Paz","Colegio Dora Schmidt",139,0,3,2,41,4,4,1,1,195,0,8,203,227,0.21,0.894
"1820","La Paz","Nuestra Señora de La Paz","Colegio Dora Schmidt",137,1,1,3,36,2,7,0,2,189,1,4,194,219,0.19,0.886
"1821","La Paz","Nuestra Señora de La Paz","Colegio Dora Schmidt",122,0,1,1,49,7,14,0,1,195,1,4,200,233,0.251,0.858
"1822","La Paz","Nuestra Señora de La Paz","Colegio Dora Schmidt",149,0,2,3,37,3,7,1,0,202,0,5,207,228,0.183,0.908
"1823","La Paz","Nuestra Señora de La Paz","Colegio Dora Schmidt",143,0,0,0,43,3,7,0,0,196,1,2,199,218,0.219,0.913
"1824","La Paz","Nuestra Señora de La Paz","Colegio Dora Schmidt",133,0,0,2,43,1,8,0,1,188,1,3,192,224,0.229,0.857
"1825","La Paz","Nuestra Señora de La Paz","Colegio Dora Schmidt",158,0,0,0,33,3,7,0,0,201,1,3,205,229,0.164,0.895
"1826","La Paz","Nuestra Señora de La Paz","Colegio Dora Schmidt",135,1,2,0,37,2,19,0,0,196,0,5,201,225,0.189,0.893
"1827","La Paz","Nuestra Señora de La Paz","Colegio Dora Schmidt",157,1,0,2,30,4,5,1,1,201,2,4,207,234,0.149,0.885
"1828","La Paz","Nuestra Señora de La Paz","Colegio Dora Schmidt",149,0,0,3,34,3,7,3,1,200,0,3,203,232,0.17,0.875
"1829","La Paz","Nuestra Señora de La Paz","Colegio Dora Schmidt",131,0,0,1,54,2,14,1,2,205,2,3,210,229,0.263,0.917
"1830","La Paz","Nuestra Señora de La Paz","Colegio Dora Schmidt",159,1,0,0,33,0,7,0,0,200,0,6,206,229,0.165,0.9
"1831","La Paz","Nuestra Señora de La Paz","Colegio Dora Schmidt",150,0,1,0,34,0,10,3,0,198,0,5,203,228,0.172,0.89
"1832","La Paz","Nuestra Señora de La Paz","Colegio Dora Schmidt",132,1,2,0,48,5,8,0,0,196,1,5,202,224,0.245,0.902
"1833","La Paz","Nuestra Señora de La Paz","Colegio Dora Schmidt",152,0,2,0,37,1,6,1,1,200,0,6,206,231,0.185,0.892
"1834","La Paz","Nuestra Señora de La Paz","Colegio Dora Schmidt",153,0,2,1,37,3,8,3,0,207,1,4,212,230,0.179,0.922
"1835","La Paz","Nuestra Señora de La Paz","Esc. Alfredo Vargas",110,1,4,4,72,2,12,1,1,207,2,4,213,229,0.348,0.93
"1836","La Paz","Nuestra Señora de La Paz","Esc. Alfredo Vargas",113,0,1,1,62,4,16,0,0,197,3,3,203,224,0.315,0.906
"1837","La Paz","Nuestra Señora de La Paz","Esc. Alfredo Vargas",114,1,0,0,73,3,8,0,0,199,1,6,206,225,0.367,0.916
"1838","La Paz","Nuestra Señora de La Paz","Esc. Alfredo Vargas",95,1,0,0,69,4,15,3,4,191,3,4,198,227,0.361,0.872
"1839","La Paz","Nuestra Señora de La Paz","Esc. Alfredo Vargas",105,0,0,0,67,3,19,0,2,196,1,3,200,221,0.342,0.905
"1840","La Paz","Nuestra Señora de La Paz","Esc. Alfredo Vargas",95,1,5,2,83,1,12,0,3,202,0,7,209,225,0.411,0.929
"1841","La Paz","Nuestra Señora de La Paz","Esc. Alfredo Vargas",91,1,2,1,90,6,14,0,1,206,0,5,211,230,0.437,0.917
"1842","La Paz","Nuestra Señora de La Paz","Esc. Alfredo Vargas",109,2,1,1,68,2,8,0,0,191,0,6,197,224,0.356,0.879
"1843","La Paz","Nuestra Señora de La Paz","Esc. Alfredo Vargas",113,1,0,1,71,3,5,1,4,199,0,2,201,219,0.357,0.918
"1844","La Paz","Nuestra Señora de La Paz","Esc. Alfredo Vargas",117,0,3,1,47,5,8,2,3,186,1,3,190,216,0.253,0.88
"1845","La Paz","Nuestra Señora de La Paz","Esc. Alfredo Vargas",105,1,1,2,60,1,13,1,1,185,2,11,198,221,0.324,0.896
"1846","La Paz","Nuestra Señora de La Paz","Esc. Alfredo Vargas",99,0,3,1,72,1,11,2,0,189,1,9,199,220,0.381,0.905
"1847","La Paz","Nuestra Señora de La Paz","Esc. Alfredo Vargas",64,0,0,0,96,5,18,0,3,186,0,7,193,218,0.516,0.885
"1848","La Paz","Nuestra Señora de La Paz","Esc. Alfredo Vargas",92,2,3,1,73,3,14,1,1,190,1,8,199,223,0.384,0.892
"1849","La Paz","Nuestra Señora de La Paz","Esc. Alfredo Vargas",104,0,0,0,79,7,7,0,0,197,0,5,202,227,0.401,0.89
"1850","La Paz","Nuestra Señora de La Paz","Esc. Alfredo Vargas",105,0,1,2,74,2,9,1,2,196,1,6,203,219,0.378,0.927
"1851","La Paz","Nuestra Señora de La Paz","Esc. Alfredo Vargas",102,1,0,0,71,5,12,0,1,192,0,4,196,219,0.37,0.895
"1852","La Paz","Nuestra Señora de La Paz","Esc. Alfredo Vargas",63,0,3,0,107,3,13,0,1,190,5,8,203,226,0.563,0.898
"1853","La Paz","Nuestra Señora de La Paz","Esc. Alfredo Vargas",111,1,0,2,58,3,12,0,0,187,3,8,198,222,0.31,0.892
"1854","La Paz","Nuestra Señora de La Paz","Esc. Alfredo Vargas",117,0,2,0,71,1,6,1,1,199,0,5,204,227,0.357,0.899
"1855","La Paz","Nuestra Señora de La Paz","Esc. Alfredo Vargas",117,0,2,0,62,5,9,0,0,195,1,14,210,225,0.318,0.933
"1856","La Paz","Nuestra Señora de La Paz","Esc. Alfredo Vargas",95,0,3,0,68,0,18,0,3,187,0,9,196,220,0.364,0.891
"1857","La Paz","Nuestra Señora de La Paz","Esc. Alfredo Vargas",122,0,2,1,55,5,6,1,3,195,0,4,199,221,0.282,0.9
"1858","La Paz","Nuestra Señora de La Paz","Esc. Alfredo Vargas",94,0,0,0,60,2,6,0,2,164,1,2,167,184,0.366,0.908
"1859","La Paz","Nuestra Señora de La Paz","Tecnico Ayacucho - 505",130,0,2,1,51,5,6,3,5,203,1,7,211,220,0.251,0.959
"1860","La Paz","Nuestra Señora de La Paz","Tecnico Ayacucho - 505",126,0,0,1,58,1,11,1,0,198,0,3,201,221,0.293,0.91
"1861","La Paz","Nuestra Señora de La Paz","Tecnico Ayacucho - 505",124,1,0,2,47,4,3,1,2,184,0,4,188,218,0.255,0.862
"1862","La Paz","Nuestra Señora de La Paz","Tecnico Ayacucho - 505",109,0,3,3,63,3,9,2,2,194,2,0,196,222,0.325,0.883
"1863","La Paz","Nuestra Señora de La Paz","Tecnico Ayacucho - 505",129,0,3,1,59,3,4,1,1,201,0,5,206,216,0.294,0.954
"1864","La Paz","Nuestra Señora de La Paz","Tecnico Ayacucho - 505",142,0,0,0,48,0,11,0,1,202,0,4,206,224,0.238,0.92
"1865","La Paz","Nuestra Señora de La Paz","Tecnico Ayacucho - 505",138,0,2,0,40,0,11,0,1,192,0,5,197,217,0.208,0.908
"1866","La Paz","Nuestra Señora de La Paz","Tecnico Ayacucho - 505",124,0,4,2,44,1,10,2,2,189,3,3,195,221,0.233,0.882
"1867","La Paz","Nuestra Señora de La Paz","Tecnico Ayacucho - 505",131,1,1,0,56,3,14,0,2,208,1,3,212,225,0.269,0.942
"1868","La Paz","Nuestra Señora de La Paz","Tecnico Ayacucho - 505",156,1,1,0,36,0,4,1,1,200,1,4,205,224,0.18,0.915
"1869","La Paz","Nuestra Señora de La Paz","Tecnico Ayacucho - 505",125,2,2,2,50,2,4,2,0,189,0,5,194,220,0.265,0.882
"1870","La Paz","Nuestra Señora de La Paz","Tecnico Ayacucho - 505",113,0,1,1,61,9,10,4,1,200,0,3,203,217,0.305,0.935
"1871","La Paz","Nuestra Señora de La Paz","Tecnico Ayacucho - 505",100,0,0,0,88,4,12,0,1,205,1,0,206,220,0.429,0.936
"1872","La Paz","Nuestra Señora de La Paz","Tecnico Ayacucho - 505",101,1,2,0,81,1,9,1,2,198,2,4,204,216,0.409,0.944
"1873","La Paz","Nuestra Señora de La Paz","Tecnico Ayacucho - 505",130,2,3,0,53,5,6,2,0,201,1,3,205,228,0.264,0.899
"1874","La Paz","Nuestra Señora de La Paz","Tecnico Ayacucho - 505",142,0,0,0,46,1,3,1,0,193,0,5,198,221,0.238,0.896
"1875","La Paz","Nuestra Señora de La Paz","Tecnico Ayacucho - 505",138,1,2,0,40,3,7,3,0,194,0,4,198,223,0.206,0.888
"1876","La Paz","Nuestra Señora de La Paz","Tecnico Ayacucho - 505",144,0,1,1,44,2,6,2,0,200,1,2,203,225,0.22,0.902
"1877","La Paz","Nuestra Señora de La Paz","Tecnico Ayacucho - 505",134,0,2,1,47,2,5,0,0,191,0,4,195,218,0.246,0.894
"1878","La Paz","Nuestra Señora de La Paz","Tecnico Ayacucho - 505",147,0,1,2,40,2,13,1,1,207,0,1,208,231,0.193,0.9
"1879","La Paz","Nuestra Señora de La Paz","Tecnico Ayacucho - 505",148,0,0,0,29,4,5,0,2,188,0,7,195,219,0.154,0.89
"1880","La Paz","Nuestra Señora de La Paz","Tecnico Ayacucho - 505",147,2,0,1,40,0,7,0,0,197,0,6,203,221,0.203,0.919
"1881","La Paz","Nuestra Señora de La Paz","Tecnico Ayacucho - 505",138,1,0,0,48,2,9,0,0,198,1,5,204,223,0.242,0.915
"1882","La Paz","Nuestra Señora de La Paz","Tecnico Ayacucho - 505",110,0,3,0,66,2,10,0,0,191,0,7,198,218,0.346,0.908
"1883","La Paz","Nuestra Señora de La Paz","Tecnico Ayacucho - 505",132,0,1,0,47,0,8,1,0,189,1,2,192,218,0.249,0.881
"1884","La Paz","Nuestra Señora de La Paz","Tecnico Ayacucho - 505",141,1,0,0,36,2,2,1,2,185,0,6,191,223,0.195,0.857
"1885","La Paz","Nuestra Señora de La Paz","Tecnico Ayacucho - 505",117,1,2,1,52,3,5,3,1,185,3,3,191,215,0.281,0.888
"1886","La Paz","Nuestra Señora de La Paz","Tecnico Ayacucho - 505",131,0,4,1,52,7,9,1,0,205,1,2,208,221,0.254,0.941
"1887","La Paz","Nuestra Señora de La Paz","Tecnico Ayacucho - 505",83,0,3,0,83,3,11,0,1,184,2,3,189,212,0.451,0.892
"1888","La Paz","Nuestra Señora de La Paz","Tecnico Ayacucho - 505",114,0,1,0,57,4,9,1,1,187,1,8,196,222,0.305,0.883
"1889","La Paz","Nuestra Señora de La Paz","Tecnico Ayacucho - 505",155,1,1,0,38,1,6,1,2,205,0,4,209,230,0.185,0.909
"1890","La Paz","Nuestra Señora de La Paz","Tecnico Ayacucho - 505",141,0,0,1,40,3,5,1,1,192,1,4,197,224,0.208,0.879
"1891","La Paz","Nuestra Señora de La Paz","Tecnico Ayacucho - 505",111,1,0,0,58,4,4,2,1,181,0,2,183,212,0.32,0.863
"1892","La Paz","Nuestra Señora de La Paz","Tecnico Ayacucho - 505",134,1,1,0,49,4,6,1,0,196,1,8,205,227,0.25,0.903
"1893","La Paz","Nuestra Señora de La Paz","Tecnico Ayacucho - 505",149,1,0,1,40,3,4,0,0,198,0,8,206,224,0.202,0.92
"1894","La Paz","Nuestra Señora de La Paz","Tecnico Ayacucho - 505",106,0,3,1,62,3,6,1,1,183,0,3,186,213,0.339,0.873
"1895","La Paz","Nuestra Señora de La Paz","Tecnico Ayacucho - 505",139,0,0,1,41,5,2,1,0,189,0,1,190,213,0.217,0.892
"1896","La Paz","Nuestra Señora de La Paz","Tecnico Ayacucho - 505",153,0,1,0,45,0,9,1,0,209,0,4,213,228,0.215,0.934
"1897","La Paz","Nuestra Señora de La Paz","Tecnico Ayacucho - 505",122,1,1,2,50,1,6,2,0,185,2,8,195,219,0.27,0.89
"1898","La Paz","Nuestra Señora de La Paz","Tecnico Ayacucho - 505",82,1,5,0,89,3,16,2,0,198,2,10,210,227,0.449,0.925
"1899","La Paz","Nuestra Señora de La Paz","Tecnico Ayacucho - 505",133,0,1,1,49,6,7,1,1,199,0,5,204,223,0.246,0.915
"1900","La Paz","Nuestra Señora de La Paz","Tecnico Ayacucho - 505",133,0,0,0,42,1,7,1,1,185,1,5,191,222,0.227,0.86
"1901","La Paz","Nuestra Señora de La Paz","Tecnico Ayacucho - 505",131,2,1,0,40,4,7,3,1,189,2,3,194,218,0.212,0.89
"1902","La Paz","Nuestra Señora de La Paz","Tecnico Ayacucho - 505",154,0,0,0,39,3,5,0,0,201,0,3,204,226,0.194,0.903
"1903","La Paz","Nuestra Señora de La Paz","Tecnico Ayacucho - 505",126,0,2,0,44,2,8,1,0,183,0,4,187,216,0.24,0.866
"1904","La Paz","Nuestra Señora de La Paz","Tecnico Ayacucho - 505",151,0,1,2,46,4,4,1,0,209,0,4,213,231,0.22,0.922
"1905","La Paz","Nuestra Señora de La Paz","Tecnico Ayacucho - 505",134,0,1,1,52,2,9,1,0,200,0,3,203,223,0.26,0.91
"1906","La Paz","Nuestra Señora de La Paz","Tecnico Ayacucho - 505",138,2,2,1,42,2,6,1,0,194,1,5,200,226,0.216,0.885
"1907","La Paz","Nuestra Señora de La Paz","Tecnico Ayacucho - 505",136,1,1,0,53,4,7,1,3,206,0,2,208,229,0.257,0.908
"1908","La Paz","Nuestra Señora de La Paz","Tecnico Ayacucho - 505",130,2,1,0,43,2,6,4,3,191,0,4,195,218,0.225,0.894
"1909","La Paz","Nuestra Señora de La Paz","Tecnico Ayacucho - 505",145,0,0,0,36,0,9,1,0,191,1,7,199,217,0.188,0.917
"1910","La Paz","Nuestra Señora de La Paz","Tecnico Ayacucho - 505",135,0,1,0,47,0,10,2,0,195,0,2,197,217,0.241,0.908
"1911","La Paz","Nuestra Señora de La Paz","Tecnico Ayacucho - 505",133,0,2,3,43,1,8,1,0,191,1,6,198,223,0.225,0.888
"1912","La Paz","Nuestra Señora de La Paz","Tecnico Ayacucho - 505",124,2,1,1,49,4,7,1,2,191,0,3,194,215,0.257,0.902
"1913","La Paz","Nuestra Señora de La Paz","Tecnico Ayacucho - 501",138,0,2,2,58,1,11,4,0,216,1,3,220,237,0.269,0.928
"1914","La Paz","Nuestra Señora de La Paz","Tecnico Ayacucho - 501",127,0,0,1,65,1,17,2,1,214,1,5,220,238,0.304,0.924
"1915","La Paz","Nuestra Señora de La Paz","Tecnico Ayacucho - 501",120,0,2,0,64,5,13,3,1,208,0,5,213,232,0.308,0.918
"1916","La Paz","Nuestra Señora de La Paz","Tecnico Ayacucho - 501",136,0,1,0,50,1,19,1,0,208,1,3,212,234,0.24,0.906
"1917","La Paz","Nuestra Señora de La Paz","Tecnico Ayacucho - 501",107,0,1,0,49,4,14,1,1,177,1,3,181,193,0.277,0.938
"1918","La Paz","Nuestra Señora de La Paz","U.E. Bicentenario",111,1,3,0,56,6,12,3,1,193,2,4,199,216,0.29,0.921
"1919","La Paz","Nuestra Señora de La Paz","U.E. Bicentenario",118,1,3,0,57,2,14,0,2,197,0,4,201,220,0.289,0.914
"1920","La Paz","Nuestra Señora de La Paz","U.E. Bicentenario",89,3,2,0,78,3,13,2,3,193,2,7,202,216,0.404,0.935
"1921","La Paz","Nuestra Señora de La Paz","U.E. Bicentenario",104,0,2,0,71,3,12,2,3,197,2,2,201,220,0.36,0.914
"1922","La Paz","Nuestra Señora de La Paz","U.E. Bicentenario",125,1,4,0,51,1,11,0,2,195,0,6,201,218,0.262,0.922
"1923","La Paz","Nuestra Señora de La Paz","U.E. Bicentenario",98,0,0,1,79,0,11,0,2,191,4,5,200,224,0.414,0.893
"1924","La Paz","Nuestra Señora de La Paz","U.E. Bicentenario",79,0,2,0,76,0,12,1,1,171,0,10,181,212,0.444,0.854
"1925","La Paz","Nuestra Señora de La Paz","U.E. Bicentenario",92,0,4,0,74,2,9,1,1,183,1,9,193,210,0.404,0.919
"1926","La Paz","Nuestra Señora de La Paz","U.E. Bicentenario",101,1,2,1,72,0,21,1,2,201,1,7,209,224,0.358,0.933
"1927","La Paz","Nuestra Señora de La Paz","U.E. Bicentenario",99,0,0,2,62,1,6,3,0,173,1,7,181,212,0.358,0.854
"1928","La Paz","Nuestra Señora de La Paz","U.E. Bicentenario",94,4,3,0,64,1,12,1,0,179,4,9,192,215,0.358,0.893
"1929","La Paz","Nuestra Señora de La Paz","U.E. Bicentenario",112,1,1,0,59,1,6,1,1,182,1,8,191,211,0.324,0.905
"1930","La Paz","Nuestra Señora de La Paz","Colegio  Adolfo  Costa Du Rels",57,3,4,1,121,1,17,1,5,210,0,3,213,225,0.576,0.947
"1931","La Paz","Nuestra Señora de La Paz","Colegio  Adolfo  Costa Du Rels",62,1,3,1,107,5,19,1,3,202,0,10,212,229,0.53,0.926
"1932","La Paz","Nuestra Señora de La Paz","Colegio  Adolfo  Costa Du Rels",50,1,2,1,125,1,21,1,4,206,2,3,211,230,0.607,0.917
"1933","La Paz","Nuestra Señora de La Paz","Colegio  Adolfo  Costa Du Rels",57,0,1,0,124,2,12,0,3,199,0,6,205,225,0.623,0.911
"1934","La Paz","Nuestra Señora de La Paz","Colegio  Adolfo  Costa Du Rels",59,1,8,0,112,4,13,1,6,204,1,2,207,228,0.549,0.908
"1935","La Paz","Nuestra Señora de La Paz","Colegio  Adolfo  Costa Du Rels",60,1,3,2,106,1,25,1,4,203,1,8,212,227,0.522,0.934
"1936","La Paz","Nuestra Señora de La Paz","Colegio  Adolfo  Costa Du Rels",49,2,3,0,126,3,16,1,2,202,2,8,212,227,0.624,0.934
"1937","La Paz","Nuestra Señora de La Paz","Colegio  Adolfo  Costa Du Rels",53,0,4,0,121,0,17,0,1,196,0,10,206,224,0.617,0.92
"1938","La Paz","Nuestra Señora de La Paz","Colegio  Adolfo  Costa Du Rels",52,0,4,1,116,1,24,0,4,202,1,9,212,228,0.574,0.93
"1939","La Paz","Nuestra Señora de La Paz","Colegio  Adolfo  Costa Du Rels",47,1,7,0,130,1,23,1,2,212,0,6,218,231,0.613,0.944
"1940","La Paz","Nuestra Señora de La Paz","Colegio  Adolfo  Costa Du Rels",55,0,3,0,130,0,9,0,3,200,0,9,209,230,0.65,0.909
"1941","La Paz","Nuestra Señora de La Paz","Colegio  Adolfo  Costa Du Rels",42,0,8,1,113,0,26,0,0,190,3,11,204,227,0.595,0.899
"1942","La Paz","Nuestra Señora de La Paz","Colegio  Adolfo  Costa Du Rels",48,0,3,2,129,1,16,0,3,202,2,10,214,225,0.639,0.951
"1943","La Paz","Nuestra Señora de La Paz","Colegio  Adolfo  Costa Du Rels",47,1,2,0,122,2,26,0,2,202,2,7,211,226,0.604,0.934
"1944","La Paz","Nuestra Señora de La Paz","Colegio  Adolfo  Costa Du Rels",56,0,4,0,124,2,18,0,2,206,1,6,213,231,0.602,0.922
"1945","La Paz","Nuestra Señora de La Paz","Colegio  Adolfo  Costa Du Rels",83,1,2,1,106,2,12,2,3,212,2,4,218,230,0.5,0.948
"1946","La Paz","Nuestra Señora de La Paz","Colegio  Adolfo  Costa Du Rels",65,0,3,1,116,5,14,0,0,204,0,5,209,231,0.569,0.905
"1947","La Paz","Nuestra Señora de La Paz","Colegio  Adolfo  Costa Du Rels",73,0,0,1,117,0,14,0,0,205,0,12,217,228,0.571,0.952
"1948","La Paz","Nuestra Señora de La Paz","Colegio  Adolfo  Costa Du Rels",72,0,2,1,107,3,17,1,2,205,2,5,212,229,0.522,0.926
"1949","La Paz","Nuestra Señora de La Paz","Colegio  Adolfo  Costa Du Rels",50,1,2,1,129,2,23,1,2,211,2,6,219,228,0.611,0.961
"1950","La Paz","Nuestra Señora de La Paz","Colegio  Adolfo  Costa Du Rels",61,0,3,2,114,1,22,1,3,207,0,10,217,232,0.551,0.935
"1951","La Paz","Nuestra Señora de La Paz","Colegio  Adolfo  Costa Du Rels",58,1,3,0,113,0,17,2,2,196,4,9,209,231,0.577,0.905
"1952","La Paz","Nuestra Señora de La Paz","Colegio  Adolfo  Costa Du Rels",49,1,2,0,144,2,18,0,2,218,1,5,224,232,0.661,0.966
"1953","La Paz","Nuestra Señora de La Paz","Colegio  Adolfo  Costa Du Rels",48,1,3,0,129,1,13,0,4,199,1,7,207,225,0.648,0.92
"1954","La Paz","Nuestra Señora de La Paz","Colegio  Adolfo  Costa Du Rels",49,0,3,1,120,1,19,0,3,196,2,8,206,230,0.612,0.896
"1955","La Paz","Nuestra Señora de La Paz","Colegio  Adolfo  Costa Du Rels",38,2,3,1,122,1,28,1,3,199,4,7,210,227,0.613,0.925
"1956","La Paz","Nuestra Señora de La Paz","Colegio  Adolfo  Costa Du Rels",34,0,4,0,137,2,22,1,1,201,0,8,209,229,0.682,0.913
"1957","La Paz","Nuestra Señora de La Paz","Colegio  Adolfo  Costa Du Rels",35,0,8,1,128,3,17,0,1,193,2,3,198,226,0.663,0.876
"1958","La Paz","Nuestra Señora de La Paz","Colegio  Adolfo  Costa Du Rels",50,1,3,0,135,1,19,1,2,212,1,4,217,234,0.637,0.927
"1959","La Paz","Nuestra Señora de La Paz","Colegio  Adolfo  Costa Du Rels",50,1,1,0,129,2,20,5,5,213,3,5,221,233,0.606,0.948
"1960","La Paz","Nuestra Señora de La Paz","Colegio  Adolfo  Costa Du Rels",54,1,1,1,133,0,12,0,4,206,1,8,215,232,0.646,0.927
"1961","La Paz","Nuestra Señora de La Paz","Colegio  Adolfo  Costa Du Rels",62,0,5,0,113,5,17,0,3,205,1,6,212,226,0.551,0.938
"1962","La Paz","Nuestra Señora de La Paz","Colegio  Adolfo  Costa Du Rels",55,0,4,0,117,3,19,1,1,200,2,5,207,227,0.585,0.912
"1963","La Paz","Nuestra Señora de La Paz","Colegio  Adolfo  Costa Du Rels",71,2,1,3,108,1,24,0,1,211,2,4,217,227,0.512,0.956
"1964","La Paz","Nuestra Señora de La Paz","Colegio  Adolfo  Costa Du Rels",49,0,2,1,123,6,15,1,5,202,1,10,213,231,0.609,0.922
"1965","La Paz","Nuestra Señora de La Paz","Colegio  Adolfo  Costa Du Rels",49,1,1,0,109,3,26,1,4,194,2,7,203,217,0.562,0.935
"1966","La Paz","Nuestra Señora de La Paz","Colegio  Adolfo  Costa Du Rels",34,2,3,0,130,1,25,0,2,197,2,7,206,224,0.66,0.92
"1967","La Paz","Nuestra Señora de La Paz","Colegio  Adolfo  Costa Du Rels",32,0,8,0,143,1,27,1,2,214,1,5,220,229,0.668,0.961
"1968","La Paz","Nuestra Señora de La Paz","Colegio  Adolfo  Costa Du Rels",53,1,6,0,104,0,21,1,4,190,3,10,203,223,0.547,0.91
"1969","La Paz","Nuestra Señora de La Paz","Colegio  Adolfo  Costa Du Rels",77,0,3,0,89,6,27,0,3,205,1,8,214,232,0.434,0.922
"1970","La Paz","Nuestra Señora de La Paz","Colegio  Adolfo  Costa Du Rels",75,1,4,1,92,0,22,0,1,196,2,7,205,223,0.469,0.919
"1971","La Paz","Nuestra Señora de La Paz","Colegio  Adolfo  Costa Du Rels",68,2,0,0,105,5,24,0,2,206,0,8,214,229,0.51,0.934
"1972","La Paz","Nuestra Señora de La Paz","Colegio  Adolfo  Costa Du Rels",57,1,6,1,107,1,15,0,3,191,7,12,210,224,0.56,0.938
"1973","La Paz","Nuestra Señora de La Paz","Colegio  Adolfo  Costa Du Rels",40,0,3,0,131,4,21,0,4,203,3,8,214,231,0.645,0.926
"1974","La Paz","Nuestra Señora de La Paz","Colegio  Adolfo  Costa Du Rels",58,0,2,1,123,1,17,0,4,206,0,5,211,235,0.597,0.898
"1975","La Paz","Nuestra Señora de La Paz","Colegio  Adolfo  Costa Du Rels",65,0,0,1,112,1,14,0,2,195,1,7,203,223,0.574,0.91
"1976","La Paz","Nuestra Señora de La Paz","Colegio  Adolfo  Costa Du Rels",36,0,13,2,133,1,19,1,1,206,2,6,214,232,0.646,0.922
"1977","La Paz","Nuestra Señora de La Paz","Esc. Pablo Iturri",53,0,0,0,133,3,15,1,1,206,0,2,208,226,0.646,0.92
"1978","La Paz","Nuestra Señora de La Paz","Esc. Pablo Iturri",49,0,2,0,120,3,25,1,2,202,2,12,216,230,0.594,0.939
"1979","La Paz","Nuestra Señora de La Paz","Esc. Pablo Iturri",62,0,5,0,120,3,12,1,0,203,1,5,209,229,0.591,0.913
"1980","La Paz","Nuestra Señora de La Paz","Esc. Pablo Iturri",39,0,8,2,130,2,15,0,2,198,1,8,207,226,0.657,0.916
"1981","La Paz","Nuestra Señora de La Paz","Esc. Pablo Iturri",45,0,8,1,127,0,28,0,1,210,2,10,222,228,0.605,0.974
"1982","La Paz","Nuestra Señora de La Paz","Esc. Pablo Iturri",68,2,4,0,106,4,20,0,2,206,4,5,215,229,0.515,0.939
"1983","La Paz","Nuestra Señora de La Paz","Esc. Pablo Iturri",39,0,2,0,122,2,25,0,7,197,2,11,210,229,0.619,0.917
"1984","La Paz","Nuestra Señora de La Paz","Esc. Pablo Iturri",39,3,4,0,122,1,22,2,1,194,2,6,202,222,0.629,0.91
"1985","La Paz","Nuestra Señora de La Paz","Esc. Pablo Iturri",75,1,4,0,90,3,23,0,2,198,0,5,203,228,0.455,0.89
"1986","La Paz","Nuestra Señora de La Paz","Esc. Pablo Iturri",54,2,3,0,103,6,14,0,2,184,3,5,192,220,0.56,0.873
"1987","La Paz","Nuestra Señora de La Paz","Esc. Pablo Iturri",42,0,4,1,143,3,17,0,5,215,2,4,221,234,0.665,0.944
"1988","La Paz","Nuestra Señora de La Paz","Esc. Pablo Iturri",55,0,2,1,114,4,23,0,0,199,4,8,211,228,0.573,0.925
"1989","La Paz","Nuestra Señora de La Paz","Esc. Pablo Iturri",66,0,4,0,109,2,14,1,2,198,1,6,205,226,0.551,0.907
"1990","La Paz","Nuestra Señora de La Paz","Esc. Pablo Iturri",51,0,8,1,116,4,19,1,4,204,1,7,212,227,0.569,0.934
"1991","La Paz","Nuestra Señora de La Paz","Esc. Pablo Iturri",59,0,8,1,120,3,16,0,0,207,2,8,217,232,0.58,0.935
"1992","La Paz","Nuestra Señora de La Paz","Esc. Pablo Iturri",38,0,4,0,131,0,28,1,2,204,1,3,208,225,0.642,0.924
"1993","La Paz","Nuestra Señora de La Paz","Esc. Pablo Iturri",43,0,6,0,122,3,17,0,3,194,5,6,205,229,0.629,0.895
"1994","La Paz","Nuestra Señora de La Paz","Esc. Pablo Iturri",73,1,5,0,107,1,21,0,1,209,0,8,217,234,0.512,0.927
"1995","La Paz","Nuestra Señora de La Paz","Esc. Pablo Iturri",48,0,4,0,108,3,22,1,0,186,1,9,196,230,0.581,0.852
"1996","La Paz","Nuestra Señora de La Paz","Esc. Pablo Iturri",58,0,4,1,116,3,20,0,1,203,1,4,208,229,0.571,0.908
"1997","La Paz","Nuestra Señora de La Paz","Esc. Pablo Iturri",58,1,1,0,106,6,21,0,0,193,0,8,201,223,0.549,0.901
"1998","La Paz","Nuestra Señora de La Paz","Esc. Pablo Iturri",44,2,3,1,129,7,17,0,2,205,0,4,209,226,0.629,0.925
"1999","La Paz","Nuestra Señora de La Paz","Esc. Pablo Iturri",41,0,6,2,117,5,20,0,4,195,0,9,204,226,0.6,0.903
"2000","La Paz","Nuestra Señora de La Paz","Esc. Pablo Iturri",64,0,4,0,117,2,17,2,1,207,2,3,212,227,0.565,0.934
"2001","La Paz","Nuestra Señora de La Paz","Esc. Pablo Iturri",71,0,0,0,106,2,24,1,1,205,1,8,214,227,0.517,0.943
"2002","La Paz","Nuestra Señora de La Paz","Esc. Pablo Iturri",64,2,1,0,107,1,24,0,0,199,0,10,209,227,0.538,0.921
"2003","La Paz","Nuestra Señora de La Paz","Esc. Pablo Iturri",40,2,2,2,121,4,30,0,2,203,4,7,214,230,0.596,0.93
"2004","La Paz","Nuestra Señora de La Paz","Esc. Pablo Iturri",74,2,5,1,93,4,23,1,2,205,1,10,216,230,0.454,0.939
"2005","La Paz","Nuestra Señora de La Paz","Complejo Deportivo Camiri",117,1,1,0,61,4,7,1,1,193,1,3,197,221,0.316,0.891
"2006","La Paz","Nuestra Señora de La Paz","Complejo Deportivo Camiri",117,1,1,0,54,6,13,2,2,196,1,2,199,223,0.276,0.892
"2007","La Paz","Nuestra Señora de La Paz","Complejo Deportivo Camiri",132,0,2,0,57,3,12,1,1,208,1,8,217,228,0.274,0.952
"2008","La Paz","Nuestra Señora de La Paz","Complejo Deportivo Camiri",131,0,2,0,57,2,8,0,0,200,1,6,207,228,0.285,0.908
"2009","La Paz","Nuestra Señora de La Paz","Complejo Deportivo Camiri",139,1,1,0,39,7,7,3,2,199,0,1,200,223,0.196,0.897
"2010","La Paz","Nuestra Señora de La Paz","Complejo Deportivo Camiri",120,0,0,1,58,1,17,0,0,197,0,3,200,227,0.294,0.881
"2011","La Paz","Nuestra Señora de La Paz","Complejo Deportivo Camiri",144,0,3,0,48,5,3,0,0,203,1,2,206,221,0.236,0.932
"2012","La Paz","Nuestra Señora de La Paz","Complejo Deportivo Camiri",129,1,2,1,53,3,9,1,3,202,0,3,205,224,0.262,0.915
"2013","La Paz","Nuestra Señora de La Paz","Complejo Deportivo Camiri",124,1,2,1,62,2,13,0,2,207,0,3,210,229,0.3,0.917
"2014","La Paz","Nuestra Señora de La Paz","Complejo Deportivo Camiri",129,2,1,1,56,2,10,0,0,201,0,3,204,222,0.279,0.919
"2015","La Paz","Nuestra Señora de La Paz","Complejo Deportivo Camiri",118,0,0,4,59,1,11,2,1,196,2,3,201,216,0.301,0.931
"2016","La Paz","Nuestra Señora de La Paz","Colegio Simon Rodriguez",90,0,2,2,84,2,15,3,0,198,1,3,202,224,0.424,0.902
"2017","La Paz","Nuestra Señora de La Paz","Colegio Simon Rodriguez",90,0,5,0,84,2,16,2,2,201,2,3,206,229,0.418,0.9
"2018","La Paz","Nuestra Señora de La Paz","Colegio Simon Rodriguez",109,1,0,0,65,3,16,0,1,195,1,13,209,231,0.333,0.905
"2019","La Paz","Nuestra Señora de La Paz","Colegio Simon Rodriguez",94,0,2,0,78,4,25,0,0,203,0,7,210,232,0.384,0.905
"2020","La Paz","Nuestra Señora de La Paz","Colegio Simon Rodriguez",64,0,3,1,100,5,14,1,4,192,2,7,201,228,0.521,0.882
"2021","La Paz","Nuestra Señora de La Paz","Colegio Simon Rodriguez",90,0,4,2,75,3,25,2,2,203,1,5,209,227,0.369,0.921
"2022","La Paz","Nuestra Señora de La Paz","Colegio Simon Rodriguez",105,0,3,1,68,3,10,0,2,192,1,4,197,223,0.354,0.883
"2023","La Paz","Nuestra Señora de La Paz","Colegio Simon Rodriguez",100,0,1,0,73,2,17,3,1,197,4,2,203,226,0.371,0.898
"2024","La Paz","Nuestra Señora de La Paz","Colegio Simon Rodriguez",92,0,3,1,86,1,13,0,2,198,0,5,203,227,0.434,0.894
"2025","La Paz","Nuestra Señora de La Paz","Colegio Simon Rodriguez",89,1,4,0,90,1,14,0,1,200,1,9,210,230,0.45,0.913
"2026","La Paz","Nuestra Señora de La Paz","Colegio Simon Rodriguez",82,0,2,0,101,2,16,0,4,207,0,3,210,228,0.488,0.921
"2027","La Paz","Nuestra Señora de La Paz","Colegio Simon Rodriguez",75,0,4,1,106,2,12,0,1,201,0,5,206,226,0.527,0.912
"2028","La Paz","Nuestra Señora de La Paz","Colegio Simon Rodriguez",88,2,1,0,86,1,20,2,2,202,2,19,223,223,0.426,1
"2029","La Paz","Nuestra Señora de La Paz","Colegio Simon Rodriguez",89,1,2,1,82,2,22,0,4,203,2,3,208,231,0.404,0.9
"2030","La Paz","Nuestra Señora de La Paz","Colegio Simon Rodriguez",100,0,2,2,70,3,10,1,3,191,1,3,195,224,0.366,0.871
"2031","La Paz","Nuestra Señora de La Paz","Colegio Simon Rodriguez",68,1,5,1,100,1,23,2,3,204,2,3,209,217,0.49,0.963
"2032","La Paz","Nuestra Señora de La Paz","Colegio Simon Rodriguez",109,0,0,0,67,7,18,0,3,204,0,3,207,229,0.328,0.904
"2033","La Paz","Nuestra Señora de La Paz","Colegio Simon Rodriguez",99,1,1,0,83,3,13,1,2,203,1,9,213,232,0.409,0.918
"2034","La Paz","Nuestra Señora de La Paz","Colegio Simon Rodriguez",109,1,3,0,67,4,17,1,0,202,2,8,212,229,0.332,0.926
"2035","La Paz","Nuestra Señora de La Paz","Colegio Simon Rodriguez",94,0,2,0,78,2,19,2,0,197,3,9,209,228,0.396,0.917
"2036","La Paz","Nuestra Señora de La Paz","Colegio Ave Maria - 604",114,0,2,0,65,2,13,0,2,198,3,9,210,231,0.328,0.909
"2037","La Paz","Nuestra Señora de La Paz","Colegio Ave Maria - 604",95,0,1,1,69,6,20,0,3,195,1,3,199,220,0.354,0.905
"2038","La Paz","Nuestra Señora de La Paz","Colegio Ave Maria - 604",124,0,2,1,60,4,8,2,2,203,2,4,209,231,0.296,0.905
"2039","La Paz","Nuestra Señora de La Paz","Colegio Ave Maria - 604",119,1,0,1,61,1,16,1,0,200,1,7,208,226,0.305,0.92
"2040","La Paz","Nuestra Señora de La Paz","Colegio Ave Maria - 604",129,0,1,0,54,2,15,0,0,201,1,5,207,228,0.269,0.908
"2041","La Paz","Nuestra Señora de La Paz","Colegio Ave Maria - 604",123,0,0,0,60,4,11,0,2,200,1,5,206,226,0.3,0.912
"2042","La Paz","Nuestra Señora de La Paz","Colegio Ave Maria - 604",92,1,1,2,82,3,15,1,2,199,1,7,207,223,0.412,0.928
"2043","La Paz","Nuestra Señora de La Paz","Colegio Ave Maria - 604",114,0,1,2,60,2,13,0,1,193,3,8,204,227,0.311,0.899
"2044","La Paz","Nuestra Señora de La Paz","Colegio Ave Maria - 604",99,0,3,0,84,1,13,3,1,204,1,7,212,231,0.412,0.918
"2045","La Paz","Nuestra Señora de La Paz","Colegio Ave Maria - 604",68,0,3,0,99,4,12,0,5,191,0,12,203,225,0.518,0.902
"2046","La Paz","Nuestra Señora de La Paz","Colegio Ave Maria - 604",70,1,5,1,97,2,21,0,2,199,1,5,205,225,0.487,0.911
"2047","La Paz","Nuestra Señora de La Paz","Colegio Ave Maria - 604",101,0,2,0,72,3,14,0,2,194,1,4,199,223,0.371,0.892
"2048","La Paz","Nuestra Señora de La Paz","Colegio Ave Maria - 604",136,0,4,0,50,3,9,1,1,204,1,2,207,226,0.245,0.916
"2049","La Paz","Nuestra Señora de La Paz","Colegio Ave Maria - 604",108,3,1,2,70,2,11,0,2,199,1,4,204,227,0.352,0.899
"2050","La Paz","Nuestra Señora de La Paz","Colegio Ave Maria - 604",96,1,1,0,80,0,11,2,2,193,1,4,198,227,0.415,0.872
"2051","La Paz","Nuestra Señora de La Paz","Colegio Ave Maria - 604",128,3,0,1,53,2,11,2,0,200,0,3,203,227,0.265,0.894
"2052","La Paz","Nuestra Señora de La Paz","Colegio Ave Maria - 604",111,1,1,0,71,3,8,0,3,198,0,6,204,228,0.359,0.895
"2053","La Paz","Nuestra Señora de La Paz","Colegio Ave Maria - 604",110,1,1,2,63,2,16,1,2,198,0,5,203,229,0.318,0.886
"2054","La Paz","Nuestra Señora de La Paz","Colegio Ave Maria - 604",122,0,1,0,52,1,8,3,0,187,1,8,196,225,0.278,0.871
"2055","La Paz","Nuestra Señora de La Paz","Colegio Ave Maria - 604",96,0,1,0,85,0,12,1,1,196,2,4,202,224,0.434,0.902
"2056","La Paz","Nuestra Señora de La Paz","Colegio Ave Maria - 604",101,1,0,1,67,4,18,0,1,193,0,3,196,225,0.347,0.871
"2057","La Paz","Nuestra Señora de La Paz","Colegio Ave Maria - 604",89,0,3,0,81,3,10,3,3,192,3,6,201,219,0.422,0.918
"2058","La Paz","Nuestra Señora de La Paz","Colegio Ave Maria - 604",97,0,5,1,75,1,16,2,2,199,2,6,207,228,0.377,0.908
"2059","La Paz","Nuestra Señora de La Paz","Colegio Ave Maria - 604",106,0,3,0,86,3,7,1,1,207,3,6,216,229,0.415,0.943
"2060","La Paz","Nuestra Señora de La Paz","Colegio Ave Maria - 604",129,1,0,0,57,1,16,2,0,206,0,5,211,226,0.277,0.934
"2061","La Paz","Nuestra Señora de La Paz","Colegio Ave Maria - 604",131,0,0,0,55,3,12,2,1,204,0,3,207,225,0.27,0.92
"2062","La Paz","Nuestra Señora de La Paz","Colegio Ave Maria - 604",104,1,2,0,72,0,14,1,0,194,1,7,202,230,0.371,0.878
"2063","La Paz","Nuestra Señora de La Paz","Colegio Ave Maria - 604",94,1,2,0,80,2,21,1,0,201,0,4,205,228,0.398,0.899
"2064","La Paz","Nuestra Señora de La Paz","Colegio Ave Maria - 604",111,2,2,1,57,3,12,0,1,189,2,4,195,228,0.302,0.855
"2065","La Paz","Nuestra Señora de La Paz","Colegio Ave Maria - 604",107,0,2,0,84,4,5,0,0,202,3,4,209,227,0.416,0.921
"2066","La Paz","Nuestra Señora de La Paz","Colegio Ave Maria - 604",86,0,3,1,89,3,13,1,2,198,1,7,206,234,0.449,0.88
"2067","La Paz","Nuestra Señora de La Paz","Colegio Ave Maria - 604",81,0,6,1,89,5,20,0,1,203,1,1,205,227,0.438,0.903
"2068","La Paz","Nuestra Señora de La Paz","Colegio Ave Maria - 604",117,0,1,2,41,4,14,1,1,181,1,6,188,226,0.227,0.832
"2069","La Paz","Nuestra Señora de La Paz","Colegio Ave Maria - 604",119,0,3,0,64,2,10,1,0,199,0,5,204,225,0.322,0.907
"2070","La Paz","Nuestra Señora de La Paz","Colegio Ave Maria - 604",134,1,4,0,48,3,11,0,1,202,0,5,207,229,0.238,0.904
"2071","La Paz","Nuestra Señora de La Paz","Colegio Ave Maria - 604",111,0,4,3,61,1,15,0,0,195,0,5,200,228,0.313,0.877
"2072","La Paz","Nuestra Señora de La Paz","Colegio Ave Maria - 604",109,0,1,1,69,2,10,0,1,193,2,3,198,221,0.358,0.896
"2073","La Paz","Nuestra Señora de La Paz","Colegio Ave Maria - 604",116,0,1,2,71,1,10,0,1,202,3,6,211,230,0.351,0.917
"2074","La Paz","Nuestra Señora de La Paz","Colegio Ave Maria - 604",101,0,2,0,75,4,20,0,0,202,1,4,207,233,0.371,0.888
"2075","La Paz","Nuestra Señora de La Paz","Colegio Ave Maria - 604",113,0,2,1,56,5,12,1,3,193,1,9,203,225,0.29,0.902
"2076","La Paz","Nuestra Señora de La Paz","Colegio Ave Maria - 604",97,0,1,1,77,3,12,0,1,192,2,7,201,228,0.401,0.882
"2077","La Paz","Nuestra Señora de La Paz","Colegio Nuestra Señora de Fatima",83,1,4,0,84,4,19,2,1,198,0,3,201,219,0.424,0.918
"2078","La Paz","Nuestra Señora de La Paz","Colegio Nuestra Señora de Fatima",102,1,4,0,63,5,13,1,0,189,2,7,198,224,0.333,0.884
"2079","La Paz","Nuestra Señora de La Paz","Colegio Nuestra Señora de Fatima",70,0,2,0,108,3,24,0,0,207,0,7,214,227,0.522,0.943
"2080","La Paz","Nuestra Señora de La Paz","Colegio Nuestra Señora de Fatima",83,1,2,1,71,1,26,1,1,187,1,11,199,221,0.38,0.9
"2081","La Paz","Nuestra Señora de La Paz","Colegio Nuestra Señora de Fatima",101,0,3,0,66,3,11,0,1,185,1,9,195,220,0.357,0.886
"2082","La Paz","Nuestra Señora de La Paz","Colegio Nuestra Señora de Fatima",90,0,1,1,83,1,13,1,0,190,1,10,201,221,0.437,0.91
"2083","La Paz","Nuestra Señora de La Paz","Colegio Nuestra Señora de Fatima",77,1,4,0,95,2,18,0,0,197,1,6,204,223,0.482,0.915
"2084","La Paz","Nuestra Señora de La Paz","Colegio Nuestra Señora de Fatima",95,0,6,2,70,3,19,0,2,197,0,6,203,229,0.355,0.886
"2085","La Paz","Nuestra Señora de La Paz","Colegio Nuestra Señora de Fatima",78,0,5,1,84,1,15,1,1,186,2,9,197,215,0.452,0.916
"2086","La Paz","Nuestra Señora de La Paz","Colegio Nuestra Señora de Fatima",88,0,0,0,85,1,16,2,4,196,2,12,210,230,0.434,0.913
"2087","La Paz","Nuestra Señora de La Paz","Colegio Nuestra Señora de Fatima",101,2,1,0,73,5,11,1,3,197,0,8,205,228,0.371,0.899
"2088","La Paz","Nuestra Señora de La Paz","Colegio Ave Maria - 606",107,1,3,0,73,1,14,0,2,201,0,7,208,230,0.363,0.904
"2089","La Paz","Nuestra Señora de La Paz","Colegio Ave Maria - 606",110,1,3,1,66,5,17,1,1,205,18,6,229,229,0.322,1
"2090","La Paz","Nuestra Señora de La Paz","Colegio Ave Maria - 606",111,1,0,0,71,2,11,2,1,199,3,12,214,234,0.357,0.915
"2091","La Paz","Nuestra Señora de La Paz","Colegio Ave Maria - 606",112,0,1,1,64,3,21,0,1,203,2,7,212,227,0.315,0.934
"2092","La Paz","Nuestra Señora de La Paz","Esc. La Merced",75,0,3,1,94,3,25,0,1,202,0,4,206,226,0.465,0.912
"2093","La Paz","Nuestra Señora de La Paz","Esc. La Merced",60,0,7,0,108,4,24,0,3,206,3,4,213,231,0.524,0.922
"2094","La Paz","Nuestra Señora de La Paz","Esc. La Merced",73,1,4,1,91,4,16,1,4,195,2,9,206,223,0.467,0.924
"2095","La Paz","Nuestra Señora de La Paz","Esc. La Merced",64,1,6,0,103,2,16,0,0,192,2,19,213,230,0.536,0.926
"2096","La Paz","Nuestra Señora de La Paz","Esc. La Merced",63,0,1,3,103,0,22,0,2,194,2,6,202,230,0.531,0.878
"2097","La Paz","Nuestra Señora de La Paz","Esc. La Merced",53,1,7,0,113,2,17,0,2,195,0,9,204,233,0.579,0.876
"2098","La Paz","Nuestra Señora de La Paz","Esc. La Merced",47,1,9,1,118,0,18,0,4,198,1,13,212,228,0.596,0.93
"2099","La Paz","Nuestra Señora de La Paz","Esc. La Merced",46,1,6,0,125,0,16,1,2,197,2,8,207,226,0.635,0.916
"2100","La Paz","Nuestra Señora de La Paz","Esc. La Merced",60,0,5,0,108,2,23,0,2,200,2,12,214,231,0.54,0.926
"2101","La Paz","Nuestra Señora de La Paz","Esc. La Merced",58,2,3,1,119,3,14,0,1,201,0,8,209,224,0.592,0.933
"2102","La Paz","Nuestra Señora de La Paz","Esc. La Merced",79,1,6,0,93,4,21,0,4,208,1,5,214,230,0.447,0.93
"2103","La Paz","Nuestra Señora de La Paz","Esc. La Merced",50,0,0,0,133,1,17,1,1,203,1,5,209,229,0.655,0.913
"2104","La Paz","Nuestra Señora de La Paz","Esc. La Merced",71,2,2,0,101,0,13,0,3,192,1,11,204,226,0.526,0.903
"2105","La Paz","Nuestra Señora de La Paz","Esc. La Merced",65,3,6,3,110,1,16,0,0,204,2,7,213,225,0.539,0.947
"2106","La Paz","Nuestra Señora de La Paz","Esc. La Merced",44,0,7,1,111,0,17,2,1,183,3,7,193,228,0.607,0.846
"2107","La Paz","Nuestra Señora de La Paz","Esc. La Merced",62,1,4,1,103,2,26,0,3,202,2,9,213,232,0.51,0.918
"2108","La Paz","Nuestra Señora de La Paz","Esc. La Merced",58,1,4,0,109,1,22,1,2,198,1,5,204,224,0.551,0.911
"2109","La Paz","Nuestra Señora de La Paz","Esc. La Merced",44,2,6,1,116,1,29,1,0,200,6,2,208,226,0.58,0.92
"2110","La Paz","Nuestra Señora de La Paz","Esc. La Merced",57,2,3,0,119,3,16,0,2,202,0,10,212,231,0.589,0.918
"2111","La Paz","Nuestra Señora de La Paz","Esc. La Merced",54,1,2,0,106,5,22,1,3,194,0,5,199,224,0.546,0.888
"2112","La Paz","Nuestra Señora de La Paz","Esc. La Merced",66,0,1,1,110,5,17,0,0,200,0,8,208,230,0.55,0.904
"2113","La Paz","Nuestra Señora de La Paz","Esc. La Merced",68,0,2,1,113,2,23,0,3,212,1,3,216,232,0.533,0.931
"2114","La Paz","Nuestra Señora de La Paz","Esc. La Merced",57,4,3,0,122,2,15,1,0,204,1,7,212,229,0.598,0.926
"2115","La Paz","Nuestra Señora de La Paz","Esc. La Merced",68,2,3,2,97,1,19,0,1,193,1,6,200,221,0.503,0.905
"2116","La Paz","Nuestra Señora de La Paz","Esc. La Merced",57,2,3,0,114,2,20,0,0,198,1,8,207,228,0.576,0.908
"2117","La Paz","Nuestra Señora de La Paz","Esc. La Merced",62,1,1,0,121,0,14,0,2,201,4,4,209,226,0.602,0.925
"2118","La Paz","Nuestra Señora de La Paz","Esc. La Merced",52,0,4,0,122,2,19,0,0,199,5,9,213,228,0.613,0.934
"2119","La Paz","Nuestra Señora de La Paz","Esc. La Merced",64,2,2,0,96,4,28,0,3,199,4,9,212,227,0.482,0.934
"2120","La Paz","Nuestra Señora de La Paz","Esc. La Merced",78,2,4,0,103,1,9,1,2,200,0,2,202,227,0.515,0.89
"2121","La Paz","Nuestra Señora de La Paz","Esc. La Merced",79,0,3,0,84,4,11,2,4,187,4,4,195,225,0.449,0.867
"2122","La Paz","Nuestra Señora de La Paz","Esc. La Merced",75,0,3,1,109,2,17,1,3,211,1,5,217,232,0.517,0.935
"2123","La Paz","Nuestra Señora de La Paz","Esc. La Merced",65,1,4,1,96,5,18,1,1,192,2,13,207,229,0.5,0.904
"2124","La Paz","Nuestra Señora de La Paz","Esc. La Merced",69,1,8,0,96,5,22,0,1,202,5,4,211,229,0.475,0.921
"2125","La Paz","Nuestra Señora de La Paz","Esc. La Merced",56,1,2,0,118,3,15,0,2,197,0,11,208,225,0.599,0.924
"2126","La Paz","Nuestra Señora de La Paz","Colegio Irene Nava",91,0,2,1,82,2,12,2,2,194,2,4,200,224,0.423,0.893
"2127","La Paz","Nuestra Señora de La Paz","Colegio Irene Nava",107,1,3,0,83,4,14,0,1,213,2,4,219,230,0.39,0.952
"2128","La Paz","Nuestra Señora de La Paz","Colegio Irene Nava",86,1,2,1,77,3,15,0,2,187,2,5,194,218,0.412,0.89
"2129","La Paz","Nuestra Señora de La Paz","Colegio Irene Nava",101,0,3,2,75,2,16,0,1,200,2,3,205,226,0.375,0.907
"2130","La Paz","Nuestra Señora de La Paz","Colegio Irene Nava",86,1,1,0,88,3,16,0,1,196,0,8,204,224,0.449,0.911
"2131","La Paz","Nuestra Señora de La Paz","Colegio Irene Nava",85,0,2,1,91,7,21,0,0,207,0,1,208,223,0.44,0.933
"2132","La Paz","Nuestra Señora de La Paz","Colegio Irene Nava",76,2,1,0,93,3,8,0,2,185,2,6,193,228,0.503,0.846
"2133","La Paz","Nuestra Señora de La Paz","Colegio Irene Nava",92,3,4,0,76,4,15,0,2,196,2,2,200,222,0.388,0.901
"2134","La Paz","Nuestra Señora de La Paz","Colegio Irene Nava",106,0,7,0,70,1,10,0,1,195,1,11,207,227,0.359,0.912
"2135","La Paz","Nuestra Señora de La Paz","Colegio Irene Nava",77,1,5,3,96,1,14,0,3,200,2,10,212,225,0.48,0.942
"2136","La Paz","Nuestra Señora de La Paz","Colegio Irene Nava",77,3,2,1,90,3,22,0,0,198,3,11,212,223,0.455,0.951
"2137","La Paz","Nuestra Señora de La Paz","Colegio Irene Nava",95,0,4,1,77,1,21,0,0,199,0,3,202,233,0.387,0.867
"2138","La Paz","Nuestra Señora de La Paz","Colegio Irene Nava",97,0,2,0,82,3,10,0,0,194,1,4,199,225,0.423,0.884
"2139","La Paz","Nuestra Señora de La Paz","Colegio Irene Nava",80,0,3,0,98,4,10,2,1,198,1,6,205,226,0.495,0.907
"2140","La Paz","Nuestra Señora de La Paz","Colegio Irene Nava",105,0,2,0,67,4,14,0,5,197,0,3,200,223,0.34,0.897
"2141","La Paz","Nuestra Señora de La Paz","Colegio Irene Nava",117,0,0,1,66,5,14,1,1,205,1,5,211,224,0.322,0.942
"2142","La Paz","Nuestra Señora de La Paz","Colegio Irene Nava",88,1,2,0,82,4,12,0,2,191,3,15,209,231,0.429,0.905
"2143","La Paz","Nuestra Señora de La Paz","Colegio Irene Nava",69,0,5,0,104,1,14,2,0,195,2,6,203,219,0.533,0.927
"2144","La Paz","Nuestra Señora de La Paz","Colegio Irene Nava",93,0,2,1,72,3,13,1,3,188,0,8,196,221,0.383,0.887
"2145","La Paz","Nuestra Señora de La Paz","Colegio Irene Nava",73,2,3,0,97,2,21,2,0,200,1,9,210,225,0.485,0.933
"2146","La Paz","Nuestra Señora de La Paz","Colegio Irene Nava",109,1,2,2,66,3,12,0,1,196,1,2,199,223,0.337,0.892
"2147","La Paz","Nuestra Señora de La Paz","Colegio Irene Nava",67,1,5,0,92,3,17,0,3,188,2,6,196,222,0.489,0.883
"2148","La Paz","Nuestra Señora de La Paz","Colegio Irene Nava",76,2,3,1,94,2,19,0,2,199,2,11,212,228,0.472,0.93
"2149","La Paz","Nuestra Señora de La Paz","Colegio Irene Nava",97,0,1,2,76,3,16,1,2,198,5,4,207,222,0.384,0.932
"2150","La Paz","Nuestra Señora de La Paz","Colegio Irene Nava",86,3,1,0,95,0,10,0,0,195,0,11,206,224,0.487,0.92
"2151","La Paz","Nuestra Señora de La Paz","Colegio Irene Nava",95,1,5,0,83,1,17,0,0,202,1,8,211,227,0.411,0.93
"2152","La Paz","Nuestra Señora de La Paz","Colegio Irene Nava",99,1,2,0,68,1,17,0,1,189,2,3,194,226,0.36,0.858
"2153","La Paz","Nuestra Señora de La Paz","Colegio Irene Nava",86,3,4,0,81,4,11,0,2,191,2,8,201,225,0.424,0.893
"2154","La Paz","Nuestra Señora de La Paz","Colegio Irene Nava",99,0,3,0,75,1,11,0,1,190,2,5,197,218,0.395,0.904
"2155","La Paz","Nuestra Señora de La Paz","Colegio Irene Nava",68,1,3,1,116,2,6,1,2,200,2,8,210,228,0.58,0.921
"2156","La Paz","Nuestra Señora de La Paz","Colegio Irene Nava",66,1,4,0,111,3,20,2,1,208,3,5,216,231,0.534,0.935
"2157","La Paz","Nuestra Señora de La Paz","Colegio Irene Nava",97,2,3,0,97,2,16,1,1,219,2,5,226,236,0.443,0.958
"2158","La Paz","Nuestra Señora de La Paz","Colegio Irene Nava",93,1,2,2,84,5,15,1,2,205,2,8,215,235,0.41,0.915
"2159","La Paz","Nuestra Señora de La Paz","Colegio Irene Nava",90,0,0,1,101,4,18,0,0,214,0,3,217,232,0.472,0.935
"2160","La Paz","Nuestra Señora de La Paz","U. E. Andina",104,0,2,1,74,2,25,1,1,210,1,6,217,236,0.352,0.919
"2161","La Paz","Nuestra Señora de La Paz","U. E. Andina",79,1,0,0,92,6,22,1,1,202,0,7,209,233,0.455,0.897
"2162","La Paz","Nuestra Señora de La Paz","U. E. Andina",90,0,5,0,85,0,12,1,2,195,2,10,207,236,0.436,0.877
"2163","La Paz","Nuestra Señora de La Paz","U. E. Andina",55,1,4,2,112,5,17,0,1,197,2,8,207,227,0.569,0.912
"2164","La Paz","Nuestra Señora de La Paz","U. E. Andina",87,1,1,1,76,2,26,1,4,199,2,3,204,224,0.382,0.911
"2165","La Paz","Nuestra Señora de La Paz","U. E. Andina",86,0,2,0,84,5,17,0,2,196,2,4,202,217,0.429,0.931
"2166","La Paz","Nuestra Señora de La Paz","U. E. Andina",108,0,4,0,67,7,15,0,2,203,1,6,210,226,0.33,0.929
"2167","La Paz","Nuestra Señora de La Paz","U. E. Andina",90,2,1,1,83,2,17,0,1,197,0,6,203,219,0.421,0.927
"2168","La Paz","Nuestra Señora de La Paz","U. E. Andina",107,0,1,1,73,3,11,0,1,197,2,5,204,217,0.371,0.94
"2169","La Paz","Nuestra Señora de La Paz","U. E. Andina",115,2,1,3,65,3,10,1,1,201,1,12,214,243,0.323,0.881
"2170","La Paz","Nuestra Señora de La Paz","Col. Copacabana",114,1,0,0,76,1,11,2,0,205,0,2,207,224,0.371,0.924
"2171","La Paz","Nuestra Señora de La Paz","Col. Copacabana",111,0,3,0,71,2,8,0,2,197,0,8,205,226,0.36,0.907
"2172","La Paz","Nuestra Señora de La Paz","Col. Copacabana",117,0,0,0,69,6,7,0,1,200,1,6,207,228,0.345,0.908
"2173","La Paz","Nuestra Señora de La Paz","Col. Copacabana",102,0,4,1,72,1,7,0,0,187,1,7,195,213,0.385,0.915
"2174","La Paz","Nuestra Señora de La Paz","Col. Copacabana",107,2,1,2,62,4,24,1,7,210,0,4,214,228,0.295,0.939
"2175","La Paz","Nuestra Señora de La Paz","Col. Copacabana",109,0,2,0,69,2,13,1,2,198,1,9,208,228,0.348,0.912
"2176","La Paz","Nuestra Señora de La Paz","Col. Copacabana",87,1,2,0,90,4,13,1,2,200,2,9,211,228,0.45,0.925
"2177","La Paz","Nuestra Señora de La Paz","Col. Copacabana",94,1,2,1,86,1,8,1,3,197,1,6,204,224,0.437,0.911
"2178","La Paz","Nuestra Señora de La Paz","Col. Copacabana",109,0,1,3,74,0,10,0,1,198,1,4,203,222,0.374,0.914
"2179","La Paz","Nuestra Señora de La Paz","Col. Copacabana",113,0,3,0,60,2,9,2,1,190,0,5,195,221,0.316,0.882
"2180","La Paz","Nuestra Señora de La Paz","Col. Copacabana",137,2,2,0,55,1,10,1,0,208,1,2,211,224,0.264,0.942
"2181","La Paz","Nuestra Señora de La Paz","Col. Copacabana",112,0,3,1,54,3,11,2,3,189,1,9,199,227,0.286,0.877
"2182","La Paz","Nuestra Señora de La Paz","Col. Copacabana",105,0,0,2,73,2,16,3,4,205,2,6,213,227,0.356,0.938
"2183","La Paz","Nuestra Señora de La Paz","Col. Copacabana",92,0,2,0,74,2,15,0,0,185,0,11,196,220,0.4,0.891
"2184","La Paz","Nuestra Señora de La Paz","Col. Copacabana",110,1,5,0,65,1,12,0,1,195,1,12,208,225,0.333,0.924
"2185","La Paz","Nuestra Señora de La Paz","Col. Copacabana",90,0,1,1,89,5,11,1,1,199,1,7,207,227,0.447,0.912
"2186","La Paz","Nuestra Señora de La Paz","Col. Copacabana",72,0,5,1,101,2,14,2,0,197,4,3,204,227,0.513,0.899
"2187","La Paz","Nuestra Señora de La Paz","Col. Copacabana",91,0,3,1,84,1,7,1,1,189,0,7,196,221,0.444,0.887
"2188","La Paz","Nuestra Señora de La Paz","Col. Copacabana",131,1,1,1,60,1,5,2,2,204,0,6,210,223,0.294,0.942
"2189","La Paz","Nuestra Señora de La Paz","Col. Copacabana",121,3,0,1,65,2,5,0,2,199,1,10,210,228,0.327,0.921
"2190","La Paz","Nuestra Señora de La Paz","Col. Copacabana",100,1,1,0,73,3,10,2,3,193,0,12,205,221,0.378,0.928
"2191","La Paz","Nuestra Señora de La Paz","Col. Copacabana",117,1,1,0,69,3,8,1,1,201,1,7,209,222,0.343,0.941
"2192","La Paz","Nuestra Señora de La Paz","Col. Copacabana",82,0,6,0,89,4,12,1,1,195,2,8,205,228,0.456,0.899
"2193","La Paz","Nuestra Señora de La Paz","Col. Copacabana",119,0,2,0,47,2,5,0,4,179,0,11,190,214,0.263,0.888
"2194","La Paz","Nuestra Señora de La Paz","Col. Copacabana",108,0,3,1,68,1,11,1,0,193,1,8,202,222,0.352,0.91
"2195","La Paz","Nuestra Señora de La Paz","Col. Copacabana",118,1,4,0,61,4,10,2,4,204,1,4,209,232,0.299,0.901
"2196","La Paz","Nuestra Señora de La Paz","Col. Copacabana",124,1,2,0,58,3,8,1,3,200,0,6,206,229,0.29,0.9
"2197","La Paz","Nuestra Señora de La Paz","Col. Copacabana",99,0,0,0,75,4,18,5,1,202,1,9,212,229,0.371,0.926
"2198","La Paz","Nuestra Señora de La Paz","Col. Copacabana",124,0,3,0,59,3,10,0,1,200,1,1,202,224,0.295,0.902
"2199","La Paz","Nuestra Señora de La Paz","Col. Copacabana",118,0,2,1,63,3,12,0,0,199,1,4,204,221,0.317,0.923
"2200","La Paz","Nuestra Señora de La Paz","Col. Copacabana",99,1,2,0,80,3,14,2,3,204,3,5,212,224,0.392,0.946
"2201","La Paz","Nuestra Señora de La Paz","Unidad Educativa Cristiana Vida Nueva",127,0,1,0,60,2,8,1,1,200,2,4,206,227,0.3,0.907
"2202","La Paz","Nuestra Señora de La Paz","Unidad Educativa Cristiana Vida Nueva",120,3,0,2,70,2,7,0,2,206,0,6,212,224,0.34,0.946
"2203","La Paz","Nuestra Señora de La Paz","Unidad Educativa Cristiana Vida Nueva",101,0,3,1,75,1,8,0,0,189,3,6,198,218,0.397,0.908
"2204","La Paz","Nuestra Señora de La Paz","Unidad Educativa Cristiana Vida Nueva",102,0,8,0,79,1,9,3,0,202,2,3,207,224,0.391,0.924
"2205","La Paz","Nuestra Señora de La Paz","Unidad Educativa Cristiana Vida Nueva",145,0,0,0,50,1,9,0,2,207,0,4,211,227,0.242,0.93
"2206","La Paz","Nuestra Señora de La Paz","Unidad Educativa Cristiana Vida Nueva",111,0,3,0,65,1,12,2,0,194,1,11,206,219,0.335,0.941
"2207","La Paz","Nuestra Señora de La Paz","Unidad Educativa Cristiana Vida Nueva",107,1,1,0,75,0,9,2,1,196,1,8,205,220,0.383,0.932
"2208","La Paz","Nuestra Señora de La Paz","Unidad Educativa Cristiana Vida Nueva",93,0,4,0,82,1,14,1,4,199,1,8,208,223,0.412,0.933
"2209","La Paz","Nuestra Señora de La Paz","Unidad Educativa Cristiana Vida Nueva",122,0,2,2,59,4,3,0,2,194,0,4,198,219,0.304,0.904
"2210","La Paz","Nuestra Señora de La Paz","Unidad Educativa Cristiana Vida Nueva",120,2,2,0,71,2,10,1,1,209,2,3,214,230,0.34,0.93
"2211","La Paz","Nuestra Señora de La Paz","Unidad Educativa Cristiana Vida Nueva",100,0,4,0,79,3,7,0,3,196,3,5,204,229,0.403,0.891
"2212","La Paz","Nuestra Señora de La Paz","Unidad Educativa Cristiana Vida Nueva",126,0,1,1,50,2,8,1,1,190,2,10,202,216,0.263,0.935
"2213","La Paz","Nuestra Señora de La Paz","Unidad Educativa Cristiana Vida Nueva",122,0,5,0,57,1,13,0,0,198,1,5,204,224,0.288,0.911
"2214","La Paz","Nuestra Señora de La Paz","Unidad Educativa Cristiana Vida Nueva",107,1,2,0,67,5,7,1,2,192,1,7,200,221,0.349,0.905
"2215","La Paz","Nuestra Señora de La Paz","Col. Cristo Rey",120,0,4,0,69,1,11,1,1,207,2,2,211,231,0.333,0.913
"2216","La Paz","Nuestra Señora de La Paz","Col. Cristo Rey",107,0,5,0,85,1,12,1,0,211,2,4,217,233,0.403,0.931
"2217","La Paz","Nuestra Señora de La Paz","Col. Cristo Rey",111,1,2,0,70,3,13,2,1,203,1,7,211,228,0.345,0.925
"2218","La Paz","Nuestra Señora de La Paz","Col. Cristo Rey",89,2,4,1,94,1,7,1,2,201,1,11,213,225,0.468,0.947
"2219","La Paz","Nuestra Señora de La Paz","Col. Cristo Rey",101,0,2,2,75,2,14,6,1,203,0,8,211,230,0.369,0.917
"2220","La Paz","Nuestra Señora de La Paz","Col. Cristo Rey",68,1,1,1,101,2,14,0,3,191,1,11,203,217,0.529,0.935
"2221","La Paz","Nuestra Señora de La Paz","Col. Cristo Rey",73,1,3,3,93,1,22,2,1,199,3,12,214,231,0.467,0.926
"2222","La Paz","Nuestra Señora de La Paz","Col. Cristo Rey",126,0,0,0,70,2,7,1,1,207,1,6,214,232,0.338,0.922
"2223","La Paz","Nuestra Señora de La Paz","Col. Cristo Rey",100,2,3,2,77,5,10,5,2,206,3,3,212,226,0.374,0.938
"2224","La Paz","Nuestra Señora de La Paz","Col. Cristo Rey",96,0,7,0,69,2,11,1,0,186,0,6,192,218,0.371,0.881
"2225","La Paz","Nuestra Señora de La Paz","Col. Cristo Rey",94,0,5,1,85,2,15,0,1,203,3,3,209,227,0.419,0.921
"2226","La Paz","Nuestra Señora de La Paz","Col. Cristo Rey",91,2,3,1,91,1,8,0,2,199,2,8,209,225,0.457,0.929
"2227","La Paz","Nuestra Señora de La Paz","Col. Cristo Rey",78,0,3,1,100,1,16,1,1,201,4,15,220,229,0.498,0.961
"2228","La Paz","Nuestra Señora de La Paz","Col. Cristo Rey",63,0,3,0,86,1,25,0,0,178,3,29,210,225,0.483,0.933
"2229","La Paz","Nuestra Señora de La Paz","Col. Cristo Rey",112,0,2,0,74,2,8,1,1,200,0,3,203,220,0.37,0.923
"2230","La Paz","Nuestra Señora de La Paz","Col. Cristo Rey",96,0,2,1,80,3,10,0,0,192,2,12,206,225,0.417,0.916
"2231","La Paz","Nuestra Señora de La Paz","Col. Cristo Rey",85,0,2,0,80,6,17,0,3,193,3,10,206,223,0.415,0.924
"2232","La Paz","Nuestra Señora de La Paz","Col. Cristo Rey",84,1,1,0,102,4,17,0,1,210,2,6,218,232,0.486,0.94
"2233","La Paz","Nuestra Señora de La Paz","Col. Cristo Rey",79,1,2,0,110,1,15,2,2,212,0,6,218,233,0.519,0.936
"2234","La Paz","Nuestra Señora de La Paz","Col. Cristo Rey",119,0,0,0,64,4,9,6,0,202,3,5,210,225,0.317,0.933
"2235","La Paz","Nuestra Señora de La Paz","Col. Cristo Rey",126,0,2,1,60,2,8,1,0,200,0,11,211,229,0.3,0.921
"2236","La Paz","Nuestra Señora de La Paz","Col. Cristo Rey",111,0,4,0,70,2,14,1,0,202,5,4,211,231,0.347,0.913
"2237","La Paz","Nuestra Señora de La Paz","Col. Cristo Rey",98,0,5,2,83,1,13,0,0,202,1,4,207,225,0.411,0.92
"2238","La Paz","Nuestra Señora de La Paz","Col. Cristo Rey",122,0,0,1,64,5,3,0,2,197,2,13,212,229,0.325,0.926
"2239","La Paz","Nuestra Señora de La Paz","Col. Cristo Rey",91,1,2,0,44,1,13,0,2,154,0,12,166,175,0.286,0.949
"2240","La Paz","Nuestra Señora de La Paz","Unidad Educativa Valle Hermoso",63,1,4,0,112,1,15,0,3,199,0,9,208,221,0.563,0.941
"2241","La Paz","Nuestra Señora de La Paz","Unidad Educativa Valle Hermoso",88,1,5,0,89,4,17,0,3,207,0,6,213,226,0.43,0.942
"2242","La Paz","Nuestra Señora de La Paz","Unidad Educativa Valle Hermoso",67,1,4,0,116,0,14,1,5,208,0,2,210,224,0.558,0.938
"2243","La Paz","Nuestra Señora de La Paz","Unidad Educativa Valle Hermoso",66,0,6,0,104,2,26,1,0,205,0,9,214,231,0.507,0.926
"2244","La Paz","Nuestra Señora de La Paz","Unidad Educativa Valle Hermoso",82,0,3,0,105,3,10,2,1,206,0,8,214,225,0.51,0.951
"2245","La Paz","Nuestra Señora de La Paz","Unidad Educativa Valle Hermoso",82,0,6,2,87,4,11,3,1,196,1,7,204,223,0.444,0.915
"2246","La Paz","Nuestra Señora de La Paz","Unidad Educativa Valle Hermoso",91,2,2,0,87,4,20,0,2,208,0,7,215,231,0.418,0.931
"2247","La Paz","Nuestra Señora de La Paz","Unidad Educativa Valle Hermoso",65,0,2,1,126,2,11,1,4,212,0,8,220,233,0.594,0.944
"2248","La Paz","Nuestra Señora de La Paz","Unidad Educativa Valle Hermoso",76,0,4,0,103,4,12,1,2,202,4,7,213,224,0.51,0.951
"2249","La Paz","Nuestra Señora de La Paz","Unidad Educativa Valle Hermoso",84,0,1,3,100,2,8,1,0,199,1,6,206,228,0.503,0.904
"2250","La Paz","Nuestra Señora de La Paz","Unidad Educativa Valle Hermoso",73,1,4,1,103,1,14,1,1,199,1,9,209,223,0.518,0.937
"2251","La Paz","Nuestra Señora de La Paz","Unidad Educativa Valle Hermoso",53,0,3,0,127,4,12,0,3,202,2,9,213,227,0.629,0.938
"2252","La Paz","Nuestra Señora de La Paz","Unidad Educativa Valle Hermoso",96,1,3,0,87,0,8,1,1,197,0,13,210,224,0.442,0.938
"2253","La Paz","Nuestra Señora de La Paz","Unidad Educativa Valle Hermoso",73,1,3,0,110,3,18,0,1,209,1,1,211,225,0.526,0.938
"2254","La Paz","Nuestra Señora de La Paz","Unidad Educativa Valle Hermoso",78,0,5,0,92,0,18,4,1,198,0,9,207,216,0.465,0.958
"2255","La Paz","Nuestra Señora de La Paz","Esc. Genoveva Rios",71,2,0,0,86,6,14,0,4,183,3,6,192,218,0.47,0.881
"2256","La Paz","Nuestra Señora de La Paz","Esc. Genoveva Rios",74,1,3,1,98,2,12,1,1,193,2,9,204,222,0.508,0.919
"2257","La Paz","Nuestra Señora de La Paz","Esc. Genoveva Rios",103,0,0,0,90,3,8,0,0,204,1,5,210,224,0.441,0.938
"2258","La Paz","Nuestra Señora de La Paz","Esc. Genoveva Rios",71,1,4,0,105,1,17,1,2,202,1,4,207,221,0.52,0.937
"2259","La Paz","Nuestra Señora de La Paz","Esc. Genoveva Rios",86,3,2,1,91,7,17,0,1,208,0,5,213,224,0.438,0.951
"2260","La Paz","Nuestra Señora de La Paz","Esc. Genoveva Rios",72,0,3,0,103,5,17,1,2,203,1,12,216,227,0.507,0.952
"2261","La Paz","Nuestra Señora de La Paz","Esc. Genoveva Rios",67,0,3,0,101,1,18,0,2,192,1,6,199,216,0.526,0.921
"2262","La Paz","Nuestra Señora de La Paz","Esc. Genoveva Rios",70,1,5,0,99,1,15,0,4,195,1,10,206,225,0.508,0.916
"2263","La Paz","Nuestra Señora de La Paz","Esc. Genoveva Rios",91,0,3,0,85,3,13,0,1,196,3,6,205,225,0.434,0.911
"2264","La Paz","Nuestra Señora de La Paz","Esc. Genoveva Rios",103,1,0,0,74,3,8,1,0,190,2,14,206,218,0.389,0.945
"2265","La Paz","Nuestra Señora de La Paz","Esc. Genoveva Rios",102,0,1,0,80,5,19,0,1,208,2,0,210,225,0.385,0.933
"2266","La Paz","Nuestra Señora de La Paz","Esc. Genoveva Rios",86,1,3,0,86,3,14,0,2,195,2,7,204,222,0.441,0.919
"2267","La Paz","Nuestra Señora de La Paz","Esc. Genoveva Rios",83,1,3,0,90,2,23,0,2,204,0,4,208,228,0.441,0.912
"2268","La Paz","Nuestra Señora de La Paz","Esc. Genoveva Rios",85,1,5,4,87,1,13,1,1,198,2,6,206,222,0.439,0.928
"2269","La Paz","Nuestra Señora de La Paz","Esc. Genoveva Rios",63,0,2,0,113,4,15,0,1,198,3,6,207,222,0.571,0.932
"2270","La Paz","Nuestra Señora de La Paz","Esc. Genoveva Rios",91,1,2,1,87,1,13,1,1,198,1,8,207,225,0.439,0.92
"2271","La Paz","Nuestra Señora de La Paz","Esc. Genoveva Rios",88,1,1,0,91,5,15,0,0,201,3,6,210,231,0.453,0.909
"2272","La Paz","Nuestra Señora de La Paz","Esc. Genoveva Rios",87,0,8,1,87,2,8,1,1,195,2,6,203,225,0.446,0.902
"2273","La Paz","Nuestra Señora de La Paz","Esc. Genoveva Rios",102,2,3,1,77,6,9,0,0,200,0,4,204,224,0.385,0.911
"2274","La Paz","Nuestra Señora de La Paz","Esc. Genoveva Rios",88,1,1,1,93,0,18,1,2,205,1,5,211,221,0.454,0.955
"2275","La Paz","Nuestra Señora de La Paz","Esc. Genoveva Rios",63,0,2,0,110,3,17,0,1,196,0,5,201,218,0.561,0.922
"2276","La Paz","Nuestra Señora de La Paz","Esc. Genoveva Rios",81,3,2,1,91,3,16,2,2,201,0,1,202,221,0.453,0.914
"2277","La Paz","Nuestra Señora de La Paz","Esc. Genoveva Rios",99,2,2,1,74,3,8,2,0,191,0,3,194,214,0.387,0.907
"2278","La Paz","Nuestra Señora de La Paz","Esc. Genoveva Rios",81,0,3,0,86,3,12,0,1,186,1,7,194,222,0.462,0.874
"2279","La Paz","Nuestra Señora de La Paz","Esc. Genoveva Rios",90,0,0,0,88,8,14,4,1,205,1,4,210,224,0.429,0.938
"2280","La Paz","Nuestra Señora de La Paz","Esc. Genoveva Rios",115,1,2,0,77,2,8,2,0,207,2,4,213,229,0.372,0.93
"2281","La Paz","Nuestra Señora de La Paz","Esc. Genoveva Rios",103,4,4,3,76,4,9,1,0,204,2,0,206,230,0.373,0.896
"2282","La Paz","Nuestra Señora de La Paz","Cancha Deportiva - 3026",89,3,2,2,86,3,11,1,3,200,0,4,204,223,0.43,0.915
"2283","La Paz","Nuestra Señora de La Paz","Cancha Deportiva - 3026",62,0,2,0,109,3,13,1,3,193,3,3,199,217,0.565,0.917
"2284","La Paz","Nuestra Señora de La Paz","Cancha Deportiva - 3026",99,2,1,1,80,1,12,1,1,198,0,5,203,226,0.404,0.898
"2285","La Paz","Nuestra Señora de La Paz","Cancha Deportiva - 3026",81,1,3,0,78,2,23,0,4,192,1,12,205,221,0.406,0.928
"2286","La Paz","Nuestra Señora de La Paz","Cancha Deportiva - 3026",98,0,2,1,73,3,10,0,6,193,0,4,197,222,0.378,0.887
"2287","La Paz","Nuestra Señora de La Paz","Cancha Deportiva - 3026",75,2,5,2,101,0,10,2,2,199,3,6,208,226,0.508,0.92
"2288","La Paz","Nuestra Señora de La Paz","Cancha Deportiva - 3026",107,0,2,0,76,1,13,0,0,199,3,3,205,222,0.382,0.923
"2289","La Paz","Nuestra Señora de La Paz","Esc. San Martin",133,0,2,0,55,1,5,3,0,199,1,5,205,224,0.276,0.915
"2290","La Paz","Nuestra Señora de La Paz","Esc. San Martin",121,0,0,1,60,2,10,1,1,196,2,3,201,219,0.306,0.918
"2291","La Paz","Nuestra Señora de La Paz","Esc. San Martin",104,0,0,0,79,2,16,1,1,203,1,6,210,222,0.389,0.946
"2292","La Paz","Nuestra Señora de La Paz","Esc. San Martin",118,0,1,0,66,5,6,0,3,199,0,6,205,224,0.332,0.915
"2293","La Paz","Nuestra Señora de La Paz","Esc. San Martin",101,0,2,2,63,1,11,1,6,187,2,33,222,222,0.337,1
"2294","La Paz","Nuestra Señora de La Paz","Esc. San Martin",112,1,1,1,67,5,12,0,1,200,1,6,207,226,0.335,0.916
"2295","La Paz","Nuestra Señora de La Paz","Esc. San Martin",104,0,0,1,66,0,19,1,2,193,1,2,196,221,0.342,0.887
"2296","La Paz","Nuestra Señora de La Paz","Esc. San Martin",97,0,2,2,84,2,12,0,3,202,1,7,210,230,0.416,0.913
"2297","La Paz","Nuestra Señora de La Paz","Esc. San Martin",81,1,0,3,84,4,20,1,0,194,1,5,200,225,0.433,0.889
"2298","La Paz","Nuestra Señora de La Paz","Esc. San Martin",120,0,2,2,74,1,10,1,0,210,1,2,213,225,0.352,0.947
"2299","La Paz","Nuestra Señora de La Paz","Esc. San Martin",113,1,5,0,60,3,10,1,1,194,0,8,202,224,0.309,0.902
"2300","La Paz","Nuestra Señora de La Paz","Esc. San Martin",116,0,0,1,64,3,11,2,1,198,0,9,207,222,0.323,0.932
"2301","La Paz","Nuestra Señora de La Paz","Esc. San Martin",133,0,0,1,51,2,13,1,0,201,3,4,208,228,0.254,0.912
"2302","La Paz","Nuestra Señora de La Paz","Esc. San Martin",107,0,2,1,67,2,12,0,2,193,0,7,200,229,0.347,0.873
"2303","La Paz","Nuestra Señora de La Paz","Esc. San Martin",131,0,1,0,57,2,6,0,0,197,1,9,207,224,0.289,0.924
"2304","La Paz","Nuestra Señora de La Paz","Esc. San Martin",130,0,0,0,59,2,16,0,2,209,1,2,212,226,0.282,0.938
"2305","La Paz","Nuestra Señora de La Paz","Esc. San Martin",123,1,0,0,73,0,10,0,0,207,1,2,210,226,0.353,0.929
"2306","La Paz","Nuestra Señora de La Paz","Esc. San Martin",95,0,1,1,78,4,11,3,1,194,1,6,201,227,0.402,0.885
"2307","La Paz","Nuestra Señora de La Paz","Esc. San Martin",138,0,1,1,53,4,6,0,1,204,0,5,209,231,0.26,0.905
"2308","La Paz","Nuestra Señora de La Paz","Esc. San Martin",133,0,1,1,45,3,7,2,2,194,0,7,201,220,0.232,0.914
"2309","La Paz","Nuestra Señora de La Paz","Esc. San Martin",140,0,1,0,42,2,10,0,0,195,1,4,200,226,0.215,0.885
"2310","La Paz","Nuestra Señora de La Paz","Esc. San Martin",110,0,1,2,61,1,19,0,3,197,1,4,202,223,0.31,0.906
"2311","La Paz","Nuestra Señora de La Paz","Esc. San Martin",110,2,1,0,57,2,13,2,3,190,2,8,200,225,0.3,0.889
"2312","La Paz","Nuestra Señora de La Paz","Esc. San Martin",94,0,1,1,82,5,7,0,1,191,0,12,203,222,0.429,0.914
"2313","La Paz","Nuestra Señora de La Paz","Esc. San Martin",129,1,5,3,61,3,5,0,1,208,1,5,214,225,0.293,0.951
"2314","La Paz","Nuestra Señora de La Paz","Esc. San Martin",130,0,0,0,39,1,11,0,0,181,1,7,189,215,0.215,0.879
"2315","La Paz","Nuestra Señora de La Paz","Esc. San Martin",147,0,4,1,40,2,5,1,0,200,0,5,205,224,0.2,0.915
"2316","La Paz","Nuestra Señora de La Paz","Esc. San Martin",119,0,1,0,69,0,7,0,0,196,0,9,205,226,0.352,0.907
"2317","La Paz","Nuestra Señora de La Paz","Esc. San Martin",116,1,4,1,59,1,14,0,1,197,0,7,204,229,0.299,0.891
"2318","La Paz","Nuestra Señora de La Paz","Esc. San Martin",112,0,3,0,59,3,10,4,0,191,2,9,202,223,0.309,0.906
"2319","La Paz","Nuestra Señora de La Paz","Esc. San Martin",140,0,2,1,45,5,13,2,1,209,0,2,211,224,0.215,0.942
"2320","La Paz","Nuestra Señora de La Paz","Esc. San Martin",110,0,1,0,64,3,13,1,0,192,0,5,197,223,0.333,0.883
"2321","La Paz","Nuestra Señora de La Paz","Sede Junta Vecinal",82,0,3,0,102,0,10,0,1,198,1,3,202,222,0.515,0.91
"2322","La Paz","Nuestra Señora de La Paz","Sede Junta Vecinal",70,2,1,0,113,5,4,2,1,198,3,6,207,222,0.571,0.932
"2323","La Paz","Nuestra Señora de La Paz","Sede Junta Vecinal",75,0,4,2,77,3,7,0,1,169,1,7,177,191,0.456,0.927
"2324","La Paz","Nuestra Señora de La Paz","Col. Sergio Almaraz",89,0,1,0,88,2,13,2,1,196,2,11,209,223,0.449,0.937
"2325","La Paz","Nuestra Señora de La Paz","Col. Sergio Almaraz",95,0,5,0,83,2,17,2,4,208,0,6,214,228,0.399,0.939
"2326","La Paz","Nuestra Señora de La Paz","Col. Sergio Almaraz",122,2,1,0,52,4,9,1,1,192,0,5,197,218,0.271,0.904
"2327","La Paz","Nuestra Señora de La Paz","Col. Sergio Almaraz",96,1,2,0,87,0,13,1,3,203,1,8,212,231,0.429,0.918
"2328","La Paz","Nuestra Señora de La Paz","Col. Sergio Almaraz",94,1,2,0,70,2,22,2,1,194,5,8,207,229,0.361,0.904
"2329","La Paz","Nuestra Señora de La Paz","Col. Sergio Almaraz",84,2,3,0,87,5,17,1,1,200,0,5,205,223,0.435,0.919
"2330","La Paz","Nuestra Señora de La Paz","Col. Sergio Almaraz",114,1,1,1,63,4,14,0,1,199,1,3,203,224,0.317,0.906
"2331","La Paz","Nuestra Señora de La Paz","Col. Sergio Almaraz",103,0,1,0,71,2,7,1,0,185,2,10,197,216,0.384,0.912
"2332","La Paz","Nuestra Señora de La Paz","Col. Sergio Almaraz",97,1,0,0,87,3,12,1,1,202,2,1,205,226,0.431,0.907
"2333","La Paz","Nuestra Señora de La Paz","Col. Sergio Almaraz",117,0,0,0,69,2,10,0,3,201,4,2,207,223,0.343,0.928
"2334","La Paz","Nuestra Señora de La Paz","Col. Sergio Almaraz",81,0,1,1,90,1,19,2,3,198,2,7,207,225,0.455,0.92
"2335","La Paz","Nuestra Señora de La Paz","Col. Sergio Almaraz",74,0,1,0,103,2,6,2,1,189,2,8,199,220,0.545,0.905
"2336","La Paz","Nuestra Señora de La Paz","Col. Sergio Almaraz",117,0,2,2,69,2,12,0,1,205,1,7,213,231,0.337,0.922
"2337","La Paz","Nuestra Señora de La Paz","Col. Sergio Almaraz",114,0,2,1,74,2,8,1,0,202,0,5,207,224,0.366,0.924
"2338","La Paz","Nuestra Señora de La Paz","Col. Sergio Almaraz",117,0,2,0,63,1,18,1,0,202,1,4,207,225,0.312,0.92
"2339","La Paz","Nuestra Señora de La Paz","Col. Sergio Almaraz",90,0,6,3,90,2,9,1,1,202,1,4,207,225,0.446,0.92
"2340","La Paz","Nuestra Señora de La Paz","Col. Sergio Almaraz",105,0,0,1,80,2,9,0,0,197,0,4,201,222,0.406,0.905
"2341","La Paz","Nuestra Señora de La Paz","Col. Sergio Almaraz",119,2,2,1,66,2,9,3,2,206,0,3,209,226,0.32,0.925
"2342","La Paz","Nuestra Señora de La Paz","Col. Sergio Almaraz",102,2,2,0,80,3,13,0,0,202,2,3,207,222,0.396,0.932
"2343","La Paz","Nuestra Señora de La Paz","Col. Sergio Almaraz",97,1,2,0,72,4,15,1,0,192,3,8,203,224,0.375,0.906
"2344","La Paz","Nuestra Señora de La Paz","Escuela 6 de Agosto",111,1,6,0,62,2,8,2,0,192,2,3,197,219,0.323,0.9
"2345","La Paz","Nuestra Señora de La Paz","Escuela 6 de Agosto",131,0,0,0,55,0,11,0,1,198,0,5,203,213,0.278,0.953
"2346","La Paz","Nuestra Señora de La Paz","Escuela 6 de Agosto",106,0,1,0,68,0,14,1,1,191,3,3,197,217,0.356,0.908
"2347","La Paz","Nuestra Señora de La Paz","Escuela 6 de Agosto",123,0,2,0,58,1,7,3,2,196,0,4,200,223,0.296,0.897
"2348","La Paz","Nuestra Señora de La Paz","Escuela 6 de Agosto",127,0,2,0,53,2,13,1,0,198,0,13,211,225,0.268,0.938
"2349","La Paz","Nuestra Señora de La Paz","Escuela 6 de Agosto",113,1,2,1,65,0,9,1,0,192,0,5,197,216,0.339,0.912
"2350","La Paz","Nuestra Señora de La Paz","Escuela 6 de Agosto",125,1,2,0,54,5,13,1,2,203,1,5,209,224,0.266,0.933
"2351","La Paz","Nuestra Señora de La Paz","Escuela 6 de Agosto",117,0,3,1,58,0,9,3,0,191,0,9,200,222,0.304,0.901
"2352","La Paz","Nuestra Señora de La Paz","Escuela 6 de Agosto",115,0,0,1,73,3,10,1,2,205,4,7,216,227,0.356,0.952
"2353","La Paz","Nuestra Señora de La Paz","Escuela 6 de Agosto",131,0,1,0,51,0,17,0,1,201,0,6,207,221,0.254,0.937
"2354","La Paz","Nuestra Señora de La Paz","Escuela 6 de Agosto",121,0,0,0,53,0,13,1,6,194,0,6,200,222,0.273,0.901
"2355","La Paz","Nuestra Señora de La Paz","Col. Caracas",89,1,2,1,81,3,24,1,1,203,2,8,213,225,0.399,0.947
"2356","La Paz","Nuestra Señora de La Paz","Col. Caracas",67,1,3,0,108,1,24,0,3,207,1,4,212,230,0.522,0.922
"2357","La Paz","Nuestra Señora de La Paz","Col. Caracas",72,1,4,0,107,2,18,1,4,209,1,0,210,223,0.512,0.942
"2358","La Paz","Nuestra Señora de La Paz","Col. Caracas",78,1,1,0,103,5,16,1,1,206,0,7,213,227,0.5,0.938
"2359","La Paz","Nuestra Señora de La Paz","Col. Caracas",62,0,3,0,125,2,17,1,3,213,2,3,218,228,0.587,0.956
"2360","La Paz","Nuestra Señora de La Paz","Col. Caracas",60,2,6,0,117,3,15,3,2,208,4,9,221,228,0.562,0.969
"2361","La Paz","Nuestra Señora de La Paz","Col. Caracas",62,0,6,1,106,1,25,1,1,203,1,8,212,224,0.522,0.946
"2362","La Paz","Nuestra Señora de La Paz","Col. Caracas",73,1,4,1,102,2,19,1,2,205,1,7,213,230,0.498,0.926
"2363","La Paz","Nuestra Señora de La Paz","Col. Caracas",78,1,6,0,106,2,17,3,1,214,1,4,219,228,0.495,0.961
"2364","La Paz","Nuestra Señora de La Paz","Col. Caracas",70,3,2,1,95,4,21,2,2,200,2,5,207,229,0.475,0.904
"2365","La Paz","Nuestra Señora de La Paz","Escuela Pedro Poveda - 1002",99,1,4,0,82,2,11,0,1,200,0,7,207,224,0.41,0.924
"2366","La Paz","Nuestra Señora de La Paz","Escuela Pedro Poveda - 1002",79,0,1,0,88,1,15,2,6,192,2,5,199,224,0.458,0.888
"2367","La Paz","Nuestra Señora de La Paz","Escuela Pedro Poveda - 1002",95,0,3,1,82,3,10,2,3,199,0,10,209,226,0.412,0.925
"2368","La Paz","Nuestra Señora de La Paz","Escuela Pedro Poveda - 1002",103,1,1,1,77,1,15,0,5,204,0,6,210,229,0.377,0.917
"2369","La Paz","Nuestra Señora de La Paz","Escuela Pedro Poveda - 1002",100,1,1,3,83,2,11,0,0,201,1,5,207,225,0.413,0.92
"2370","La Paz","Nuestra Señora de La Paz","Escuela Pedro Poveda - 1002",109,0,1,0,75,4,10,2,1,202,1,4,207,227,0.371,0.912
"2371","La Paz","Nuestra Señora de La Paz","Escuela Pedro Poveda - 1002",107,0,1,0,71,1,17,1,1,199,3,5,207,225,0.357,0.92
"2372","La Paz","Nuestra Señora de La Paz","Escuela Pedro Poveda - 1002",74,0,2,1,91,1,13,1,2,185,1,6,192,221,0.492,0.869
"2373","La Paz","Nuestra Señora de La Paz","Escuela Pedro Poveda - 1002",105,1,3,0,70,0,16,2,1,198,1,9,208,230,0.354,0.904
"2374","La Paz","Nuestra Señora de La Paz","Escuela Pedro Poveda - 1002",104,0,0,2,73,5,8,1,0,193,0,3,196,220,0.378,0.891
"2375","La Paz","Nuestra Señora de La Paz","Escuela Pedro Poveda - 1002",106,0,1,0,70,6,13,1,1,198,2,3,203,229,0.354,0.886
"2376","La Paz","Nuestra Señora de La Paz","Escuela Pedro Poveda - 1002",73,1,3,0,92,4,16,2,5,196,0,8,204,227,0.469,0.899
"2377","La Paz","Nuestra Señora de La Paz","Escuela Pedro Poveda - 1002",104,1,2,1,73,0,9,1,2,193,0,6,199,224,0.378,0.888
"2378","La Paz","Nuestra Señora de La Paz","Escuela Pedro Poveda - 1002",105,1,1,0,71,0,14,0,3,195,1,8,204,224,0.364,0.911
"2379","La Paz","Nuestra Señora de La Paz","Escuela Pedro Poveda - 1002",96,0,0,0,84,1,14,2,2,199,1,7,207,227,0.422,0.912
"2380","La Paz","Nuestra Señora de La Paz","Escuela Pedro Poveda - 1002",102,1,0,0,68,4,13,0,1,189,1,5,195,223,0.36,0.874
"2381","La Paz","Nuestra Señora de La Paz","U.E. Waldo Ballivian",93,0,3,1,83,4,15,1,0,200,1,6,207,223,0.415,0.928
"2382","La Paz","Nuestra Señora de La Paz","U.E. Waldo Ballivian",105,0,0,1,80,2,17,0,0,205,2,10,217,229,0.39,0.948
"2383","La Paz","Nuestra Señora de La Paz","U.E. Waldo Ballivian",118,0,0,0,76,2,5,1,1,203,0,4,207,225,0.374,0.92
"2384","La Paz","Nuestra Señora de La Paz","U.E. Waldo Ballivian",100,0,0,0,85,1,10,0,2,198,2,9,209,225,0.429,0.929
"2385","La Paz","Nuestra Señora de La Paz","U.E. Waldo Ballivian",104,0,1,0,79,1,11,0,0,196,1,3,200,215,0.403,0.93
"2386","La Paz","Nuestra Señora de La Paz","U.E. Waldo Ballivian",93,0,4,0,79,3,18,0,1,198,2,8,208,221,0.399,0.941
"2387","La Paz","Nuestra Señora de La Paz","U.E. Waldo Ballivian",91,3,6,1,78,1,17,1,1,199,2,7,208,224,0.392,0.929
"2388","La Paz","Nuestra Señora de La Paz","U.E. Waldo Ballivian",107,1,0,0,67,1,10,3,1,190,3,4,197,213,0.353,0.925
"2389","La Paz","Nuestra Señora de La Paz","U.E. Waldo Ballivian",122,1,2,0,54,3,19,0,2,203,2,4,209,226,0.266,0.925
"2390","La Paz","Nuestra Señora de La Paz","U.E. Waldo Ballivian",120,0,0,0,64,3,6,3,0,196,0,3,199,222,0.327,0.896
"2391","La Paz","Nuestra Señora de La Paz","U.E. Waldo Ballivian",89,0,2,1,99,0,8,0,1,200,0,8,208,223,0.495,0.933
"2392","La Paz","Nuestra Señora de La Paz","U.E. Waldo Ballivian",122,0,2,1,68,1,9,0,1,204,3,3,210,229,0.333,0.917
"2393","La Paz","Nuestra Señora de La Paz","U.E. Waldo Ballivian",98,1,5,1,83,2,15,1,1,207,0,1,208,227,0.401,0.916
"2394","La Paz","Nuestra Señora de La Paz","U.E. Waldo Ballivian",81,0,6,0,95,1,10,3,3,199,2,4,205,220,0.477,0.932
"2395","La Paz","Nuestra Señora de La Paz","U.E. Waldo Ballivian",111,0,1,2,65,3,8,3,3,196,0,7,203,225,0.332,0.902
"2396","La Paz","Nuestra Señora de La Paz","U.E. Waldo Ballivian",92,0,2,0,83,5,8,0,2,192,1,5,198,222,0.432,0.892
"2397","La Paz","Nuestra Señora de La Paz","U.E. Waldo Ballivian",115,0,6,4,54,4,22,2,1,208,0,4,212,224,0.26,0.946
"2398","La Paz","Nuestra Señora de La Paz","U.E. Waldo Ballivian",112,0,0,1,66,5,17,2,2,205,3,10,218,229,0.322,0.952
"2399","La Paz","Nuestra Señora de La Paz","U.E. Waldo Ballivian",85,1,2,0,104,2,8,1,1,204,0,8,212,222,0.51,0.955
"2400","La Paz","Nuestra Señora de La Paz","U.E. Waldo Ballivian",110,0,2,0,74,0,6,2,1,195,1,7,203,219,0.379,0.927
"2401","La Paz","Nuestra Señora de La Paz","U.E. Waldo Ballivian",103,1,3,1,68,0,10,1,3,190,1,7,198,219,0.358,0.904
"2402","La Paz","Nuestra Señora de La Paz","U.E. Waldo Ballivian",108,1,2,0,73,3,8,1,2,198,0,4,202,216,0.369,0.935
"2403","La Paz","Nuestra Señora de La Paz","U.E. Waldo Ballivian",82,0,3,1,83,5,16,2,4,196,0,7,203,219,0.423,0.927
"2404","La Paz","Nuestra Señora de La Paz","U.E. Waldo Ballivian",104,0,2,1,63,3,11,0,3,187,0,5,192,216,0.337,0.889
"2405","La Paz","Nuestra Señora de La Paz","U.E. Waldo Ballivian",101,0,0,0,81,1,10,2,1,196,1,9,206,223,0.413,0.924
"2406","La Paz","Nuestra Señora de La Paz","Casa Comunal Villa Litoral",84,0,6,0,86,3,13,0,1,193,1,11,205,220,0.446,0.932
"2407","La Paz","Nuestra Señora de La Paz","Casa Comunal Villa Litoral",90,0,4,0,84,1,9,0,3,191,0,4,195,220,0.44,0.886
"2408","La Paz","Nuestra Señora de La Paz","Casa Comunal Villa Litoral",52,0,3,0,119,3,14,0,2,193,3,4,200,222,0.617,0.901
"2409","La Paz","Nuestra Señora de La Paz","Casa Comunal Villa Litoral",76,0,0,0,108,4,8,1,3,200,0,8,208,219,0.54,0.95
"2410","La Paz","Nuestra Señora de La Paz","Escuela Superior de Formación de Maestros Simon Bolivar",133,0,1,0,51,1,10,2,0,198,0,7,205,229,0.258,0.895
"2411","La Paz","Nuestra Señora de La Paz","Escuela Superior de Formación de Maestros Simon Bolivar",145,0,1,2,48,4,7,0,1,208,1,8,217,229,0.231,0.948
"2412","La Paz","Nuestra Señora de La Paz","Escuela Superior de Formación de Maestros Simon Bolivar",123,1,2,1,65,1,6,3,1,203,2,2,207,227,0.32,0.912
"2413","La Paz","Nuestra Señora de La Paz","Escuela Superior de Formación de Maestros Simon Bolivar",120,0,3,1,69,0,8,0,0,201,0,7,208,225,0.343,0.924
"2414","La Paz","Nuestra Señora de La Paz","Escuela Superior de Formación de Maestros Simon Bolivar",137,0,0,1,51,3,9,0,0,201,0,4,205,222,0.254,0.923
"2415","La Paz","Nuestra Señora de La Paz","Escuela Superior de Formación de Maestros Simon Bolivar",125,0,1,1,68,2,12,2,0,211,1,2,214,227,0.322,0.943
"2416","La Paz","Nuestra Señora de La Paz","Escuela Superior de Formación de Maestros Simon Bolivar",143,0,2,1,49,2,16,1,1,215,0,2,217,228,0.228,0.952
"2417","La Paz","Nuestra Señora de La Paz","Escuela Superior de Formación de Maestros Simon Bolivar",113,1,0,1,68,3,8,0,3,197,3,5,205,224,0.345,0.915
"2418","La Paz","Nuestra Señora de La Paz","Escuela Superior de Formación de Maestros Simon Bolivar",125,0,0,0,55,3,7,2,0,192,4,4,200,220,0.286,0.909
"2419","La Paz","Nuestra Señora de La Paz","Escuela Superior de Formación de Maestros Simon Bolivar",141,0,2,2,54,3,4,0,0,206,0,1,207,222,0.262,0.932
"2420","La Paz","Nuestra Señora de La Paz","Escuela Superior de Formación de Maestros Simon Bolivar",113,1,5,0,73,1,11,3,0,207,0,7,214,231,0.353,0.926
"2421","La Paz","Nuestra Señora de La Paz","Escuela Superior de Formación de Maestros Simon Bolivar",136,0,2,0,49,1,12,0,1,201,3,6,210,227,0.244,0.925
"2422","La Paz","Nuestra Señora de La Paz","Escuela Superior de Formación de Maestros Simon Bolivar",114,1,4,1,69,2,16,0,0,207,0,6,213,224,0.333,0.951
"2423","La Paz","Nuestra Señora de La Paz","Escuela Superior de Formación de Maestros Simon Bolivar",125,0,1,0,63,1,9,1,1,201,0,2,203,218,0.313,0.931
"2424","La Paz","Nuestra Señora de La Paz","Escuela Pedro Poveda - 1005",100,1,2,2,80,2,16,2,3,208,2,9,219,233,0.385,0.94
"2425","La Paz","Nuestra Señora de La Paz","Colegio Topater",75,2,4,2,95,2,20,1,3,204,0,9,213,228,0.466,0.934
"2426","La Paz","Nuestra Señora de La Paz","Colegio Topater",94,0,3,0,98,5,10,0,1,211,0,1,212,229,0.464,0.926
"2427","La Paz","Nuestra Señora de La Paz","Colegio Topater",81,0,3,2,95,2,20,0,3,206,0,5,211,226,0.461,0.934
"2428","La Paz","Nuestra Señora de La Paz","Colegio Topater",49,0,1,3,127,1,22,1,2,206,1,5,212,231,0.617,0.918
"2429","La Paz","Nuestra Señora de La Paz","Colegio Topater",57,1,1,2,132,2,16,0,4,215,0,7,222,230,0.614,0.965
"2430","La Paz","Nuestra Señora de La Paz","Colegio Topater",82,1,4,0,91,1,17,0,1,197,1,9,207,228,0.462,0.908
"2431","La Paz","Nuestra Señora de La Paz","Colegio Topater",70,0,4,2,115,0,18,1,1,211,1,2,214,232,0.545,0.922
"2432","La Paz","Nuestra Señora de La Paz","Colegio Topater",72,1,4,1,101,2,24,1,3,209,2,3,214,230,0.483,0.93
"2433","La Paz","Nuestra Señora de La Paz","Colegio Topater",76,2,2,1,103,3,15,0,2,204,2,6,212,225,0.505,0.942
"2434","La Paz","Nuestra Señora de La Paz","Colegio Topater",70,2,3,0,115,1,18,0,3,212,2,3,217,231,0.542,0.939
"2435","La Paz","Nuestra Señora de La Paz","Colegio Topater",90,0,1,0,103,2,13,0,1,210,0,4,214,225,0.49,0.951
"2436","La Paz","Nuestra Señora de La Paz","Colegio Topater",84,0,2,0,97,0,16,2,0,201,1,4,206,226,0.483,0.912
"2437","La Paz","Nuestra Señora de La Paz","Colegio Topater",59,2,3,0,126,1,11,0,1,203,0,3,206,225,0.621,0.916
"2438","La Paz","Nuestra Señora de La Paz","Colegio Topater",65,0,1,0,118,0,20,0,0,204,2,8,214,231,0.578,0.926
"2439","La Paz","Nuestra Señora de La Paz","Colegio Topater",94,0,1,1,93,2,23,0,0,214,2,3,219,233,0.435,0.94
"2440","La Paz","Nuestra Señora de La Paz","Colegio Topater",99,1,3,0,80,6,16,0,1,206,0,10,216,232,0.388,0.931
"2441","La Paz","Nuestra Señora de La Paz","Colegio Topater",82,2,2,1,107,2,12,0,2,210,2,3,215,227,0.51,0.947
"2442","La Paz","Nuestra Señora de La Paz","Unidad Educativa 24 de Junio",87,0,2,0,98,2,16,3,3,211,4,3,218,231,0.464,0.944
"2443","La Paz","Nuestra Señora de La Paz","Unidad Educativa 24 de Junio",82,0,3,2,95,1,17,2,2,204,2,4,210,234,0.466,0.897
"2444","La Paz","Nuestra Señora de La Paz","Unidad Educativa 24 de Junio",105,0,0,2,79,3,13,0,0,202,1,3,206,227,0.391,0.907
"2445","La Paz","Nuestra Señora de La Paz","Unidad Educativa 24 de Junio",82,0,1,0,103,3,17,1,2,209,0,5,214,226,0.493,0.947
"2446","La Paz","Nuestra Señora de La Paz","Unidad Educativa 24 de Junio",88,2,2,0,94,2,13,1,1,203,0,2,205,223,0.463,0.919
"2447","La Paz","Nuestra Señora de La Paz","Unidad Educativa 24 de Junio",72,0,3,1,113,0,13,1,1,204,2,4,210,227,0.554,0.925
"2448","La Paz","Nuestra Señora de La Paz","Unidad Educativa 24 de Junio",44,0,5,1,131,2,18,1,2,204,0,5,209,226,0.642,0.925
"2449","La Paz","Nuestra Señora de La Paz","Unidad Educativa 24 de Junio",56,1,3,0,121,2,16,0,1,200,0,8,208,226,0.605,0.92
"2450","La Paz","Nuestra Señora de La Paz","Unidad Educativa 24 de Junio",52,0,4,1,108,1,29,1,4,200,0,14,214,234,0.54,0.915
"2451","La Paz","Nuestra Señora de La Paz","Unidad Educativa 24 de Junio",99,0,3,1,78,1,10,1,1,194,2,5,201,227,0.402,0.885
"2452","La Paz","Nuestra Señora de La Paz","Unidad Educativa 24 de Junio",80,0,1,1,91,0,23,2,2,200,0,7,207,231,0.455,0.896
"2453","La Paz","Nuestra Señora de La Paz","Unidad Educativa 24 de Junio",87,1,4,1,89,0,16,2,0,200,2,7,209,223,0.445,0.937
"2454","La Paz","Nuestra Señora de La Paz","Unidad Educativa 24 de Junio",70,0,2,0,104,3,19,1,3,202,0,7,209,228,0.515,0.917
"2455","La Paz","Nuestra Señora de La Paz","Unidad Educativa 24 de Junio",98,0,2,0,74,1,15,0,3,193,0,9,202,222,0.383,0.91
"2456","La Paz","Nuestra Señora de La Paz","Unidad Educativa 24 de Junio",77,0,10,0,91,3,17,1,1,200,0,6,206,229,0.455,0.9
"2457","La Paz","Nuestra Señora de La Paz","Unidad Educativa 24 de Junio",55,0,4,0,118,2,18,1,1,199,2,4,205,221,0.593,0.928
"2458","La Paz","Nuestra Señora de La Paz","Unidad Educativa 24 de Junio",58,0,3,1,110,1,21,1,2,197,1,10,208,227,0.558,0.916
"2459","La Paz","Nuestra Señora de La Paz","Unidad Educativa 24 de Junio",92,0,3,0,89,2,13,4,0,203,1,9,213,228,0.438,0.934
"2460","La Paz","Nuestra Señora de La Paz","Unidad Educativa 24 de Junio",95,0,1,3,83,1,11,0,2,196,1,3,200,224,0.423,0.893
"2461","La Paz","Nuestra Señora de La Paz","Unidad Educativa 24 de Junio",89,2,2,5,86,2,18,2,0,206,1,4,211,225,0.417,0.938
"2462","La Paz","Nuestra Señora de La Paz","Unidad Educativa 24 de Junio",87,0,1,1,95,3,8,0,0,195,1,5,201,221,0.487,0.91
"2463","La Paz","Nuestra Señora de La Paz","Unidad Educativa 24 de Junio",43,0,2,0,128,0,22,1,1,197,4,4,205,222,0.65,0.923
"2464","La Paz","Nuestra Señora de La Paz","Unidad Educativa 24 de Junio",67,1,2,0,129,0,14,1,0,214,1,1,216,234,0.603,0.923
"2465","La Paz","Nuestra Señora de La Paz","Unidad Educativa 24 de Junio",96,0,1,0,79,1,25,1,0,203,2,5,210,223,0.389,0.942
"2466","La Paz","Nuestra Señora de La Paz","Unidad Educativa 24 de Junio",102,0,0,1,76,1,14,1,1,196,1,3,200,224,0.388,0.893
"2467","La Paz","Nuestra Señora de La Paz","Unidad Educativa 24 de Junio",92,0,3,1,85,2,12,2,2,199,1,4,204,222,0.427,0.919
"2468","La Paz","Nuestra Señora de La Paz","Unidad Educativa 24 de Junio",77,0,2,1,112,2,14,0,1,209,2,9,220,228,0.536,0.965
"2469","La Paz","Nuestra Señora de La Paz","Unidad Educativa 24 de Junio",89,1,5,0,83,2,12,0,2,194,4,11,209,230,0.428,0.909
"2470","La Paz","Nuestra Señora de La Paz","Unidad Educativa 24 de Junio",82,0,3,1,97,4,20,4,0,211,3,4,218,232,0.46,0.94
"2471","La Paz","Nuestra Señora de La Paz","Colegio Don Bosco",109,0,0,0,81,5,12,4,4,215,1,0,216,230,0.377,0.939
"2472","La Paz","Nuestra Señora de La Paz","Colegio Don Bosco",99,1,2,1,89,1,14,0,2,209,1,1,211,232,0.426,0.909
"2473","La Paz","Nuestra Señora de La Paz","Colegio Don Bosco",97,1,1,4,82,3,9,0,0,197,0,5,202,225,0.416,0.898
"2474","La Paz","Nuestra Señora de La Paz","Colegio Don Bosco",90,0,1,1,85,1,16,3,3,200,4,7,211,226,0.425,0.934
"2475","La Paz","Nuestra Señora de La Paz","Colegio Don Bosco",71,0,5,0,109,0,4,2,1,192,2,2,196,226,0.568,0.867
"2476","La Paz","Nuestra Señora de La Paz","Colegio Don Bosco",63,2,2,0,97,0,24,0,0,188,1,7,196,218,0.516,0.899
"2477","La Paz","Nuestra Señora de La Paz","Colegio Don Bosco",77,1,6,1,107,3,16,0,1,212,0,6,218,233,0.505,0.936
"2478","La Paz","Nuestra Señora de La Paz","Colegio Don Bosco",90,0,1,0,98,5,9,0,0,203,0,8,211,227,0.483,0.93
"2479","La Paz","Nuestra Señora de La Paz","Colegio Don Bosco",100,0,0,1,83,1,16,0,2,203,2,5,210,227,0.409,0.925
"2480","La Paz","Nuestra Señora de La Paz","Colegio Don Bosco",114,1,2,0,70,2,9,1,2,201,2,7,210,230,0.348,0.913
"2481","La Paz","Nuestra Señora de La Paz","Colegio Don Bosco",92,1,2,1,91,4,7,2,1,201,0,8,209,224,0.453,0.933
"2482","La Paz","Nuestra Señora de La Paz","Colegio Don Bosco",82,1,7,1,85,5,18,2,1,202,1,6,209,227,0.421,0.921
"2483","La Paz","Nuestra Señora de La Paz","Colegio Don Bosco",64,1,4,0,114,2,18,0,0,203,1,7,211,227,0.562,0.93
"2484","La Paz","Nuestra Señora de La Paz","Colegio Don Bosco",66,0,4,4,107,6,24,0,2,213,1,4,218,230,0.502,0.948
"2485","La Paz","Nuestra Señora de La Paz","Colegio Don Bosco",88,2,0,1,97,6,9,0,0,203,3,2,208,225,0.478,0.924
"2486","La Paz","Nuestra Señora de La Paz","Colegio Don Bosco",110,0,1,0,60,3,21,1,1,197,0,8,205,223,0.305,0.919
"2487","La Paz","Nuestra Señora de La Paz","Colegio Don Bosco",99,0,1,2,79,1,15,0,0,197,1,6,204,226,0.401,0.903
"2488","La Paz","Nuestra Señora de La Paz","Colegio Don Bosco",92,2,2,1,76,3,17,0,2,195,0,9,204,227,0.39,0.899
"2489","La Paz","Nuestra Señora de La Paz","Colegio Don Bosco",52,0,1,1,136,0,12,0,3,205,1,7,213,227,0.663,0.938
"2490","La Paz","Nuestra Señora de La Paz","Colegio Don Bosco",104,0,0,0,77,3,15,3,1,203,1,3,207,228,0.379,0.908
"2491","La Paz","Nuestra Señora de La Paz","Colegio Don Bosco",90,0,2,0,76,3,19,2,2,194,1,6,201,221,0.392,0.91
"2492","La Paz","Nuestra Señora de La Paz","Colegio Don Bosco",93,1,1,2,76,1,20,1,3,198,2,8,208,231,0.384,0.9
"2493","La Paz","Nuestra Señora de La Paz","Colegio Don Bosco",106,1,5,2,79,0,13,0,3,209,0,11,220,235,0.378,0.936
"2494","La Paz","Nuestra Señora de La Paz","Colegio Don Bosco",112,0,3,2,78,1,8,1,1,206,1,4,211,227,0.379,0.93
"2495","La Paz","Nuestra Señora de La Paz","Colegio Don Bosco",93,1,2,1,72,1,15,1,3,189,1,10,200,212,0.381,0.943
"2496","La Paz","Nuestra Señora de La Paz","Colegio Jerusalem",92,1,1,0,90,0,17,1,3,205,6,0,211,225,0.439,0.938
"2497","La Paz","Nuestra Señora de La Paz","Colegio Jerusalem",87,0,1,1,82,0,22,0,1,194,0,5,199,226,0.423,0.881
"2498","La Paz","Nuestra Señora de La Paz","Colegio Jerusalem",79,1,6,0,104,3,19,1,1,214,2,2,218,228,0.486,0.956
"2499","La Paz","Nuestra Señora de La Paz","Colegio Jerusalem",65,0,4,1,106,3,14,2,6,201,2,4,207,231,0.527,0.896
"2500","La Paz","Nuestra Señora de La Paz","Colegio Jerusalem",58,0,2,0,126,1,20,0,3,210,1,2,213,225,0.6,0.947
"2501","La Paz","Nuestra Señora de La Paz","Colegio Jerusalem",77,0,3,1,114,0,16,0,0,211,1,5,217,231,0.54,0.939
"2502","La Paz","Nuestra Señora de La Paz","Colegio Jerusalem",73,1,4,3,94,4,17,0,4,200,1,4,205,219,0.47,0.936
"2503","La Paz","Nuestra Señora de La Paz","Colegio Jerusalem",68,1,5,2,93,5,19,1,1,195,0,7,202,224,0.477,0.902
"2504","La Paz","Nuestra Señora de La Paz","Colegio Jerusalem",88,0,2,3,99,1,9,0,1,203,2,7,212,232,0.488,0.914
"2505","La Paz","Nuestra Señora de La Paz","Colegio Jerusalem",66,0,5,4,101,1,14,0,4,195,2,7,204,219,0.518,0.932
"2506","La Paz","Nuestra Señora de La Paz","Colegio Jerusalem",75,0,0,0,91,0,19,1,1,187,2,1,190,216,0.487,0.88
"2507","La Paz","Nuestra Señora de La Paz","Colegio Jerusalem",97,0,1,0,90,2,14,1,0,205,1,5,211,225,0.439,0.938
"2508","La Paz","Nuestra Señora de La Paz","Colegio Jerusalem",48,0,2,1,138,3,14,1,1,208,0,5,213,223,0.663,0.955
"2509","La Paz","Nuestra Señora de La Paz","Colegio Jerusalem",95,1,5,1,80,0,25,0,2,209,1,6,216,229,0.383,0.943
"2510","La Paz","Nuestra Señora de La Paz","Colegio Jerusalem",86,0,0,0,101,0,12,1,0,200,0,8,208,231,0.505,0.9
"2511","La Paz","Nuestra Señora de La Paz","Colegio Jerusalem",79,1,1,0,97,2,24,1,1,206,1,7,214,225,0.471,0.951
"2512","La Paz","Nuestra Señora de La Paz","Colegio Jerusalem",88,0,3,0,60,1,22,0,2,176,1,5,182,194,0.341,0.938
"2513","La Paz","Nuestra Señora de La Paz","Colegio Delia Gambarte",64,0,3,2,104,4,17,1,4,199,2,1,202,230,0.523,0.878
"2514","La Paz","Nuestra Señora de La Paz","Colegio Delia Gambarte",72,0,2,1,106,1,17,0,0,199,0,8,207,230,0.533,0.9
"2515","La Paz","Nuestra Señora de La Paz","Colegio Delia Gambarte",68,0,4,0,110,1,21,0,3,207,0,4,211,228,0.531,0.925
"2516","La Paz","Nuestra Señora de La Paz","Colegio Delia Gambarte",58,0,4,1,118,2,17,1,1,202,1,6,209,227,0.584,0.921
"2517","La Paz","Nuestra Señora de La Paz","Colegio Delia Gambarte",44,0,3,0,131,1,21,2,0,202,1,6,209,231,0.649,0.905
"2518","La Paz","Nuestra Señora de La Paz","Colegio Delia Gambarte",80,0,3,2,95,1,19,0,3,203,0,4,207,229,0.468,0.904
"2519","La Paz","Nuestra Señora de La Paz","Colegio Delia Gambarte",70,0,2,1,96,5,15,7,4,200,5,4,209,230,0.48,0.909
"2520","La Paz","Nuestra Señora de La Paz","Colegio Delia Gambarte",76,0,4,1,98,1,12,2,2,196,2,8,206,224,0.5,0.92
"2521","La Paz","Nuestra Señora de La Paz","Colegio Delia Gambarte",71,0,5,0,100,5,20,1,0,202,1,10,213,241,0.495,0.884
"2522","La Paz","Nuestra Señora de La Paz","Escuela Ciudad Del Niño",102,1,2,0,80,4,14,0,2,205,2,8,215,233,0.39,0.923
"2523","La Paz","Nuestra Señora de La Paz","Escuela Ciudad Del Niño",96,1,3,0,97,3,15,0,1,216,0,11,227,238,0.449,0.954
"2524","La Paz","Nuestra Señora de La Paz","Escuela Ciudad Del Niño",84,0,2,0,101,3,18,1,1,210,4,3,217,231,0.481,0.939
"2525","La Paz","Nuestra Señora de La Paz","Escuela Ciudad Del Niño",94,1,4,0,92,2,16,0,2,211,0,5,216,230,0.436,0.939
"2526","La Paz","Nuestra Señora de La Paz","Escuela Ciudad Del Niño",91,1,4,0,85,1,17,0,5,204,0,7,211,227,0.417,0.93
"2527","La Paz","Nuestra Señora de La Paz","Escuela Ciudad Del Niño",89,0,3,1,93,1,25,0,1,213,3,10,226,236,0.437,0.958
"2528","La Paz","Nuestra Señora de La Paz","Escuela Ciudad Del Niño",69,0,2,2,124,0,13,0,1,211,1,6,218,229,0.588,0.952
"2529","La Paz","Nuestra Señora de La Paz","Escuela Ciudad Del Niño",93,0,2,1,100,0,10,0,2,208,2,5,215,231,0.481,0.931
"2530","La Paz","Nuestra Señora de La Paz","Escuela Ciudad Del Niño",93,0,2,1,90,0,19,0,1,206,1,5,212,229,0.437,0.926
"2531","La Paz","Nuestra Señora de La Paz","Escuela Ciudad Del Niño",66,0,1,0,132,1,9,2,0,211,1,5,217,229,0.626,0.948
"2532","La Paz","Nuestra Señora de La Paz","Escuela Ciudad Del Niño",107,0,3,0,72,2,18,1,0,203,1,5,209,224,0.355,0.933
"2533","La Paz","Nuestra Señora de La Paz","Escuela Ciudad Del Niño",94,1,3,0,86,1,12,1,0,198,1,9,208,230,0.434,0.904
"2534","La Paz","Nuestra Señora de La Paz","Escuela 13 de Junio Chinchaya",38,1,0,1,140,3,12,2,0,197,3,7,207,226,0.711,0.916
"2535","La Paz","Nuestra Señora de La Paz","Escuela 13 de Junio Chinchaya",20,2,3,1,164,1,11,2,2,206,3,6,215,226,0.796,0.951
"2536","La Paz","Nuestra Señora de La Paz","Escuela 13 de Junio Chinchaya",26,1,3,0,157,0,14,0,0,201,5,5,211,224,0.781,0.942
"2537","La Paz","Nuestra Señora de La Paz","Esc. Mscal. Antonio Jose De Sucre",32,0,2,0,158,1,15,0,1,209,2,5,216,225,0.756,0.96
"2538","La Paz","Nuestra Señora de La Paz","Esc. Mscal. Antonio Jose De Sucre",22,0,3,0,156,3,16,0,1,201,1,4,206,219,0.776,0.941
"2539","La Paz","Nuestra Señora de La Paz","Esc. Mscal. Antonio Jose De Sucre",20,1,3,0,173,3,12,0,1,213,1,7,221,229,0.812,0.965
"2540","La Paz","Nuestra Señora de La Paz","Esc. Mscal. Antonio Jose De Sucre",27,0,0,1,115,1,15,1,0,160,0,2,162,173,0.719,0.936
"2541","La Paz","Nuestra Señora de La Paz","Polifuncional San Isidro (Iglesia San Isidro)",108,1,1,2,72,1,12,0,0,197,2,7,206,221,0.365,0.932
"2542","La Paz","Nuestra Señora de La Paz","Polifuncional San Isidro (Iglesia San Isidro)",93,1,5,0,75,3,19,2,0,198,1,2,201,217,0.379,0.926
"2543","La Paz","Nuestra Señora de La Paz","Polifuncional San Isidro (Iglesia San Isidro)",92,0,6,0,77,5,12,0,0,192,0,6,198,223,0.401,0.888
"2544","La Paz","Nuestra Señora de La Paz","Polifuncional San Isidro (Iglesia San Isidro)",92,0,3,0,91,2,15,0,0,203,2,6,211,226,0.448,0.934
"2545","La Paz","Nuestra Señora de La Paz","Polifuncional San Isidro (Iglesia San Isidro)",93,0,2,0,85,3,9,1,3,196,1,6,203,227,0.434,0.894
"2546","La Paz","Nuestra Señora de La Paz","Polifuncional San Isidro (Iglesia San Isidro)",104,0,1,1,78,0,18,0,1,203,0,4,207,225,0.384,0.92
"2547","La Paz","Nuestra Señora de La Paz","Polifuncional San Isidro (Iglesia San Isidro)",97,1,4,1,73,2,11,1,3,193,1,5,199,219,0.378,0.909
"2548","La Paz","Nuestra Señora de La Paz","Polifuncional San Isidro (Iglesia San Isidro)",88,0,1,0,68,0,13,1,1,172,2,4,178,198,0.395,0.899
"2549","La Paz","Nuestra Señora de La Paz","Colegio Sergio Villegas",81,0,4,1,103,2,17,1,2,211,1,1,213,228,0.488,0.934
"2550","La Paz","Nuestra Señora de La Paz","Colegio Sergio Villegas",79,0,4,1,95,8,13,0,0,200,0,10,210,227,0.475,0.925
"2551","La Paz","Nuestra Señora de La Paz","Colegio Sergio Villegas",70,0,4,2,98,2,20,0,1,197,3,8,208,227,0.497,0.916
"2552","La Paz","Nuestra Señora de La Paz","Colegio Sergio Villegas",70,1,2,1,104,5,21,2,4,210,2,5,217,233,0.495,0.931
"2553","La Paz","Nuestra Señora de La Paz","Colegio Sergio Villegas",78,0,2,1,100,3,21,0,1,206,0,9,215,232,0.485,0.927
"2554","La Paz","Nuestra Señora de La Paz","Colegio Sergio Villegas",64,4,2,1,98,1,19,1,1,191,1,8,200,222,0.513,0.901
"2555","La Paz","Nuestra Señora de La Paz","Colegio Sergio Villegas",49,0,6,1,115,3,19,0,1,194,0,11,205,229,0.593,0.895
"2556","La Paz","Nuestra Señora de La Paz","Colegio Sergio Villegas",96,0,4,0,72,3,17,1,0,193,0,9,202,222,0.373,0.91
"2557","La Paz","Nuestra Señora de La Paz","Colegio Sergio Villegas",75,0,5,4,95,2,16,1,2,200,1,6,207,226,0.475,0.916
"2558","La Paz","Nuestra Señora de La Paz","Colegio Sergio Villegas",62,1,3,0,112,1,18,0,3,200,0,6,206,228,0.56,0.904
"2559","La Paz","Nuestra Señora de La Paz","Colegio Sergio Villegas",73,0,4,2,107,1,15,0,1,203,1,4,208,227,0.527,0.916
"2560","La Paz","Nuestra Señora de La Paz","Colegio Sergio Villegas",70,0,2,1,96,6,8,1,1,185,3,10,198,217,0.519,0.912
"2561","La Paz","Nuestra Señora de La Paz","Colegio Sergio Villegas",40,0,2,0,129,0,20,0,3,194,1,7,202,224,0.665,0.902
"2562","La Paz","Nuestra Señora de La Paz","Colegio Sergio Villegas",88,0,2,2,95,1,14,0,1,203,3,5,211,228,0.468,0.925
"2563","La Paz","Nuestra Señora de La Paz","Colegio Sergio Villegas",72,2,3,1,108,2,13,0,3,204,0,5,209,230,0.529,0.909
"2564","La Paz","Nuestra Señora de La Paz","Colegio Sergio Villegas",85,1,4,0,93,5,13,1,1,203,2,6,211,229,0.458,0.921
"2565","La Paz","Nuestra Señora de La Paz","Colegio Sergio Villegas",63,0,2,1,110,2,23,0,1,202,1,6,209,225,0.545,0.929
"2566","La Paz","Nuestra Señora de La Paz","Colegio Sergio Villegas",63,1,4,0,114,1,26,2,1,212,1,4,217,230,0.538,0.943
"2567","La Paz","Nuestra Señora de La Paz","Colegio Sergio Villegas",46,0,2,0,130,0,23,2,3,206,0,6,212,232,0.631,0.914
"2568","La Paz","Nuestra Señora de La Paz","Colegio Sergio Villegas",79,0,1,1,98,2,13,3,2,199,2,5,206,228,0.492,0.904
"2569","La Paz","Nuestra Señora de La Paz","Colegio Sergio Villegas",64,1,3,1,115,5,15,0,3,207,1,3,211,227,0.556,0.93
"2570","La Paz","Nuestra Señora de La Paz","Colegio Sergio Villegas",82,0,1,0,103,1,10,1,2,200,1,5,206,226,0.515,0.912
"2571","La Paz","Nuestra Señora de La Paz","Colegio Sergio Villegas",86,1,3,0,84,3,20,0,1,198,1,8,207,226,0.424,0.916
"2572","La Paz","Nuestra Señora de La Paz","Colegio Sergio Villegas",63,0,2,1,108,3,20,1,3,201,0,5,206,222,0.537,0.928
"2573","La Paz","Nuestra Señora de La Paz","Colegio 6 de Junio",154,0,2,0,38,0,6,0,1,201,0,6,207,229,0.189,0.904
"2574","La Paz","Nuestra Señora de La Paz","Colegio 6 de Junio",116,1,2,1,75,0,1,0,4,200,0,7,207,229,0.375,0.904
"2575","La Paz","Nuestra Señora de La Paz","Colegio 6 de Junio",146,1,1,0,37,2,2,0,1,190,0,3,193,218,0.195,0.885
"2576","La Paz","Nuestra Señora de La Paz","Colegio 6 de Junio",137,0,1,0,56,4,8,0,1,207,0,3,210,226,0.271,0.929
"2577","La Paz","Nuestra Señora de La Paz","Colegio 6 de Junio",140,0,0,1,38,3,7,1,0,190,1,6,197,216,0.2,0.912
"2578","La Paz","Nuestra Señora de La Paz","Colegio 6 de Junio",132,1,3,0,52,6,12,1,0,207,0,4,211,228,0.251,0.925
"2579","La Paz","Nuestra Señora de La Paz","Colegio 6 de Junio",139,0,1,0,48,4,12,0,1,205,2,7,214,230,0.234,0.93
"2580","La Paz","Nuestra Señora de La Paz","Colegio 6 de Junio",120,1,3,0,61,3,10,1,2,201,1,1,203,221,0.303,0.919
"2581","La Paz","Nuestra Señora de La Paz","Colegio 6 de Junio",94,0,5,0,90,2,13,0,3,207,0,7,214,229,0.435,0.934
"2582","La Paz","Nuestra Señora de La Paz","Colegio 6 de Junio",121,0,3,0,61,3,14,0,1,203,1,8,212,225,0.3,0.942
"2583","La Paz","Nuestra Señora de La Paz","Colegio 6 de Junio",130,1,3,1,55,4,7,1,0,202,2,3,207,223,0.272,0.928
"2584","La Paz","Nuestra Señora de La Paz","Colegio 6 de Junio",139,2,2,1,49,2,3,3,0,201,4,2,207,220,0.244,0.941
"2585","La Paz","Nuestra Señora de La Paz","Colegio 6 de Junio",133,0,1,0,54,2,10,0,0,200,1,1,202,227,0.27,0.89
"2586","La Paz","Nuestra Señora de La Paz","Colegio 6 de Junio",129,0,2,2,44,3,4,1,0,185,0,5,190,219,0.238,0.868
"2587","La Paz","Nuestra Señora de La Paz","Colegio 6 de Junio",129,2,0,2,65,1,3,1,1,204,1,6,211,233,0.319,0.906
"2588","La Paz","Nuestra Señora de La Paz","Colegio 6 de Junio",122,0,1,1,63,5,5,2,0,199,1,5,205,225,0.317,0.911
"2589","La Paz","Nuestra Señora de La Paz","Colegio 6 de Junio",140,0,2,0,50,0,5,0,2,199,0,8,207,224,0.251,0.924
"2590","La Paz","Nuestra Señora de La Paz","Colegio 6 de Junio",133,1,1,0,48,0,8,1,1,193,0,3,196,223,0.249,0.879
"2591","La Paz","Nuestra Señora de La Paz","Colegio 6 de Junio",116,0,1,0,62,2,9,0,2,192,4,7,203,221,0.323,0.919
"2592","La Paz","Nuestra Señora de La Paz","Colegio 6 de Junio",100,1,3,0,88,2,10,0,0,204,0,5,209,221,0.431,0.946
"2593","La Paz","Nuestra Señora de La Paz","Colegio 6 de Junio",142,0,1,1,46,5,1,0,0,196,3,6,205,222,0.235,0.923
"2594","La Paz","Nuestra Señora de La Paz","Colegio 6 de Junio",135,1,0,1,46,1,8,1,0,193,0,3,196,217,0.238,0.903
"2595","La Paz","Nuestra Señora de La Paz","Colegio 6 de Junio",149,1,0,1,43,3,5,1,0,203,1,5,209,228,0.212,0.917
"2596","La Paz","Nuestra Señora de La Paz","Colegio 6 de Junio",145,0,2,0,56,1,5,2,0,211,0,1,212,235,0.265,0.902
"2597","La Paz","Nuestra Señora de La Paz","Colegio 6 de Junio",137,0,0,1,50,3,10,0,1,202,0,4,206,223,0.248,0.924
"2598","La Paz","Nuestra Señora de La Paz","Colegio 6 de Junio",133,0,6,0,52,2,9,1,0,203,0,5,208,225,0.256,0.924
"2599","La Paz","Nuestra Señora de La Paz","Colegio 6 de Junio",112,1,2,1,63,4,8,3,0,194,2,6,202,226,0.325,0.894
"2600","La Paz","Nuestra Señora de La Paz","Colegio 6 de Junio",109,1,1,1,59,1,8,3,1,184,2,4,190,217,0.321,0.876
"2601","La Paz","Nuestra Señora de La Paz","Colegio 6 de Junio",145,0,0,0,41,0,4,0,1,191,0,5,196,213,0.215,0.92
"2602","La Paz","Nuestra Señora de La Paz","Colegio 6 de Junio",143,0,1,1,39,0,11,0,2,197,1,2,200,231,0.198,0.866
"2603","La Paz","Nuestra Señora de La Paz","Colegio 6 de Junio",145,1,2,0,34,0,7,0,0,189,2,5,196,220,0.18,0.891
"2604","La Paz","Nuestra Señora de La Paz","Colegio 6 de Junio",131,0,0,1,46,4,7,0,0,189,0,4,193,218,0.243,0.885
"2605","La Paz","Nuestra Señora de La Paz","Colegio 6 de Junio",132,0,1,1,56,3,7,0,0,200,1,2,203,220,0.28,0.923
"2606","La Paz","Nuestra Señora de La Paz","Colegio 6 de Junio",129,1,2,1,46,3,9,0,2,193,1,7,201,221,0.238,0.91
"2607","La Paz","Nuestra Señora de La Paz","Colegio 6 de Junio",126,0,0,1,61,1,4,0,1,194,1,2,197,215,0.314,0.916
"2608","La Paz","Nuestra Señora de La Paz","Colegio 6 de Junio",134,0,0,2,55,4,7,0,0,202,0,8,210,224,0.272,0.938
"2609","La Paz","Nuestra Señora de La Paz","Colegio 6 de Junio",140,1,0,1,41,1,11,1,0,196,0,5,201,222,0.209,0.905
"2610","La Paz","Nuestra Señora de La Paz","U.E. Gran Bretaña",122,0,2,4,69,2,14,1,3,217,0,2,219,236,0.318,0.928
"2611","La Paz","Nuestra Señora de La Paz","U.E. Gran Bretaña",119,1,0,0,90,3,11,0,0,224,0,2,226,237,0.402,0.954
"2612","La Paz","Nuestra Señora de La Paz","U.E. Gran Bretaña",132,0,0,0,75,5,17,1,0,230,0,5,235,246,0.326,0.955
"2613","La Paz","Nuestra Señora de La Paz","Escuela Callapa (Plaza De Callapa)",36,0,0,1,142,2,20,0,0,201,2,8,211,231,0.706,0.913
"2614","La Paz","Nuestra Señora de La Paz","Escuela Callapa (Plaza De Callapa)",53,0,4,0,129,2,23,0,1,212,3,6,221,230,0.608,0.961
"2615","La Paz","Nuestra Señora de La Paz","Escuela Callapa (Plaza De Callapa)",39,0,2,0,126,4,25,1,1,198,2,8,208,223,0.636,0.933
"2616","La Paz","Nuestra Señora de La Paz","Escuela Callapa (Plaza De Callapa)",32,0,6,3,148,1,14,0,2,206,2,6,214,230,0.718,0.93
"2617","La Paz","Nuestra Señora de La Paz","Escuela Callapa (Plaza De Callapa)",30,0,4,0,151,3,15,2,0,205,2,5,212,227,0.737,0.934
"2618","La Paz","Nuestra Señora de La Paz","Escuela Callapa (Plaza De Callapa)",44,0,2,2,139,0,12,1,1,201,3,8,212,226,0.692,0.938
"2619","La Paz","Nuestra Señora de La Paz","Escuela Callapa (Plaza De Callapa)",35,0,5,1,144,2,16,0,1,204,0,6,210,225,0.706,0.933
"2620","La Paz","Nuestra Señora de La Paz","Escuela Callapa (Plaza De Callapa)",49,1,1,0,149,1,17,0,0,218,0,10,228,243,0.683,0.938
"2621","La Paz","Nuestra Señora de La Paz","U. E. Ff. Aa. De La Nación",116,1,2,2,76,1,10,1,0,209,0,3,212,225,0.364,0.942
"2622","La Paz","Nuestra Señora de La Paz","U. E. Ff. Aa. De La Nación",121,2,0,0,64,5,9,0,0,201,0,5,206,231,0.318,0.892
"2623","La Paz","Nuestra Señora de La Paz","U. E. Ff. Aa. De La Nación",93,1,4,0,84,1,7,4,3,197,2,3,202,227,0.426,0.89
"2624","La Paz","Nuestra Señora de La Paz","U. E. Ff. Aa. De La Nación",74,2,0,4,100,4,12,3,0,199,1,6,206,225,0.503,0.916
"2625","La Paz","Nuestra Señora de La Paz","U. E. Ff. Aa. De La Nación",103,0,1,0,75,1,13,0,0,193,3,0,196,219,0.389,0.895
"2626","La Paz","Nuestra Señora de La Paz","U. E. Ff. Aa. De La Nación",117,0,3,0,64,2,11,1,1,199,0,7,206,228,0.322,0.904
"2627","La Paz","Nuestra Señora de La Paz","U. E. Ff. Aa. De La Nación",77,0,0,0,113,2,9,0,2,203,1,8,212,226,0.557,0.938
"2628","La Paz","Nuestra Señora de La Paz","U. E. Ff. Aa. De La Nación",86,0,2,1,93,5,9,0,0,196,2,7,205,228,0.474,0.899
"2629","La Paz","Nuestra Señora de La Paz","U. E. Ff. Aa. De La Nación",54,0,1,1,131,2,11,1,2,203,3,7,213,226,0.645,0.942
"2630","La Paz","Nuestra Señora de La Paz","U. E. Ff. Aa. De La Nación",122,0,1,2,56,5,10,1,1,198,0,4,202,222,0.283,0.91
"2631","La Paz","Nuestra Señora de La Paz","U. E. Ff. Aa. De La Nación",132,0,1,0,52,3,6,1,1,196,0,2,198,218,0.265,0.908
"2632","La Paz","Nuestra Señora de La Paz","U. E. Ff. Aa. De La Nación",78,0,4,0,103,3,4,3,0,195,1,2,198,222,0.528,0.892
"2633","La Paz","Nuestra Señora de La Paz","U. E. Ff. Aa. De La Nación",91,0,2,2,84,4,8,0,0,191,2,2,195,225,0.44,0.867
"2634","La Paz","Nuestra Señora de La Paz","U. E. Ff. Aa. De La Nación",120,0,1,2,60,3,8,1,1,196,0,0,196,221,0.306,0.887
"2635","La Paz","Nuestra Señora de La Paz","U. E. Ff. Aa. De La Nación",124,0,2,0,70,6,4,0,0,206,1,9,216,230,0.34,0.939
"2636","La Paz","Nuestra Señora de La Paz","U. E. Ff. Aa. De La Nación",120,1,1,0,60,1,10,2,1,196,1,5,202,223,0.306,0.906
"2637","La Paz","Nuestra Señora de La Paz","Escuela Rosemari de Barrientos",142,0,0,2,40,2,6,0,1,193,2,8,203,224,0.207,0.906
"2638","La Paz","Nuestra Señora de La Paz","Escuela Rosemari de Barrientos",150,0,0,1,31,4,7,3,0,196,1,4,201,229,0.158,0.878
"2639","La Paz","Nuestra Señora de La Paz","Escuela Rosemari de Barrientos",135,0,1,1,53,2,11,0,0,203,0,1,204,227,0.261,0.899
"2640","La Paz","Nuestra Señora de La Paz","Escuela Rosemari de Barrientos",159,0,0,0,28,1,4,1,0,193,0,4,197,228,0.145,0.864
"2641","La Paz","Nuestra Señora de La Paz","Escuela Rosemari de Barrientos",166,0,0,0,19,1,4,2,0,192,0,1,193,226,0.099,0.854
"2642","La Paz","Nuestra Señora de La Paz","Escuela Rosemari de Barrientos",153,0,0,0,37,1,6,1,0,198,0,3,201,229,0.187,0.878
"2643","La Paz","Nuestra Señora de La Paz","Escuela Rosemari de Barrientos",136,1,1,1,47,1,8,1,0,196,1,3,200,228,0.24,0.877
"2644","La Paz","Nuestra Señora de La Paz","Escuela Rosemari de Barrientos",164,0,1,0,28,1,6,1,1,202,2,1,205,224,0.139,0.915
"2645","La Paz","Nuestra Señora de La Paz","Escuela Rosemari de Barrientos",146,0,2,0,34,2,10,1,0,195,1,3,199,225,0.174,0.884
"2646","La Paz","Nuestra Señora de La Paz","Escuela Rosemari de Barrientos",95,1,5,1,80,1,20,1,0,204,0,1,205,232,0.392,0.884
"2647","La Paz","Nuestra Señora de La Paz","Escuela Rosemari de Barrientos",127,1,0,0,56,0,5,0,0,189,1,7,197,230,0.296,0.857
"2648","La Paz","Nuestra Señora de La Paz","Escuela Rosemari de Barrientos",154,0,2,0,32,2,1,0,0,191,1,5,197,228,0.168,0.864
"2649","La Paz","Nuestra Señora de La Paz","Escuela Rosemari de Barrientos",161,0,0,3,25,6,7,1,0,203,0,1,204,227,0.123,0.899
"2650","La Paz","Nuestra Señora de La Paz","Escuela Rosemari de Barrientos",151,0,1,0,42,4,2,0,0,200,0,1,201,222,0.21,0.905
"2651","La Paz","Nuestra Señora de La Paz","Escuela Rosemari de Barrientos",132,0,1,0,59,1,0,3,1,197,0,4,201,230,0.299,0.874
"2652","La Paz","Nuestra Señora de La Paz","Escuela Rosemari de Barrientos",173,0,0,0,19,1,5,1,3,202,1,4,207,234,0.094,0.885
"2653","La Paz","Nuestra Señora de La Paz","Escuela Rosemari de Barrientos",146,0,1,0,34,5,8,0,1,195,0,4,199,225,0.174,0.884
"2654","La Paz","Nuestra Señora de La Paz","Escuela Rosemari de Barrientos",121,1,1,0,67,3,6,1,0,200,1,6,207,223,0.335,0.928
"2655","La Paz","Nuestra Señora de La Paz","Escuela Rosemari de Barrientos",173,0,0,0,29,0,9,0,1,212,0,2,214,231,0.137,0.926
"2656","La Paz","Nuestra Señora de La Paz","Escuela Rosemari de Barrientos",141,0,0,0,47,2,6,0,0,196,2,3,201,224,0.24,0.897
"2657","La Paz","Nuestra Señora de La Paz","Escuela Rosemari de Barrientos",160,0,0,3,31,2,4,2,0,202,1,4,207,230,0.153,0.9
"2658","La Paz","Nuestra Señora de La Paz","Escuela Rosemari de Barrientos",106,0,4,0,82,0,9,0,0,201,1,4,206,231,0.408,0.892
"2659","La Paz","Nuestra Señora de La Paz","Escuela Rosemari de Barrientos",118,1,3,1,76,0,10,0,1,210,1,2,213,230,0.362,0.926
"2660","La Paz","Nuestra Señora de La Paz","Escuela Rosemari de Barrientos",145,1,1,0,35,3,4,2,0,191,2,4,197,231,0.183,0.853
"2661","La Paz","Nuestra Señora de La Paz","Escuela Rosemari de Barrientos",166,0,0,2,26,3,0,1,1,199,0,1,200,225,0.131,0.889
"2662","La Paz","Nuestra Señora de La Paz","Escuela Rosemari de Barrientos",152,0,0,1,31,1,11,0,1,197,0,4,201,227,0.157,0.885
"2663","La Paz","Nuestra Señora de La Paz","Escuela Rosemari de Barrientos",163,1,0,0,34,3,4,0,0,205,1,1,207,232,0.166,0.892
"2664","La Paz","Nuestra Señora de La Paz","Escuela Rosemari de Barrientos",147,0,1,0,24,3,6,0,1,182,0,3,185,219,0.132,0.845
"2665","La Paz","Nuestra Señora de La Paz","Escuela Rosemari de Barrientos",141,0,3,0,39,1,12,0,0,196,2,1,199,227,0.199,0.877
"2666","La Paz","Nuestra Señora de La Paz","Escuela Rosemari de Barrientos",153,0,0,2,33,2,9,0,0,199,0,4,203,227,0.166,0.894
"2667","La Paz","Nuestra Señora de La Paz","Escuela Rosemari de Barrientos",137,1,2,0,41,1,2,2,1,187,1,6,194,223,0.219,0.87
"2668","La Paz","Nuestra Señora de La Paz","Escuela Rosemari de Barrientos",152,0,0,0,34,3,5,1,1,196,2,1,199,228,0.173,0.873
"2669","La Paz","Nuestra Señora de La Paz","Escuela Rosemari de Barrientos",152,0,0,0,33,2,6,0,0,193,0,4,197,228,0.171,0.864
"2670","La Paz","Nuestra Señora de La Paz","Escuela Rosemari de Barrientos",168,0,1,1,30,1,6,1,0,208,1,1,210,229,0.144,0.917
"2671","La Paz","Nuestra Señora de La Paz","Escuela Rosemari de Barrientos",151,0,1,0,29,1,5,2,0,189,0,6,195,225,0.153,0.867
"2672","La Paz","Nuestra Señora de La Paz","Escuela Rosemari de Barrientos",156,0,0,1,32,3,3,1,0,196,1,3,200,226,0.163,0.885
"2673","La Paz","Nuestra Señora de La Paz","Escuela Rosemari de Barrientos",140,1,1,0,44,1,5,1,0,193,1,4,198,227,0.228,0.872
"2674","La Paz","Nuestra Señora de La Paz","Escuela Rosemari de Barrientos",152,0,0,1,37,0,7,0,0,197,0,6,203,228,0.188,0.89
"2675","La Paz","Nuestra Señora de La Paz","Escuela Rosemari de Barrientos",120,1,2,0,57,1,7,0,0,188,1,4,193,222,0.303,0.869
"2676","La Paz","Nuestra Señora de La Paz","Escuela Rosemari de Barrientos",148,1,0,0,29,1,10,1,1,191,1,3,195,226,0.152,0.863
"2677","La Paz","Nuestra Señora de La Paz","Escuela Rosemari de Barrientos",154,0,1,1,32,3,6,0,1,198,0,6,204,223,0.162,0.915
"2678","La Paz","Nuestra Señora de La Paz","Escuela Rosemari de Barrientos",150,0,0,2,24,1,3,2,0,182,0,5,187,224,0.132,0.835
"2679","La Paz","Nuestra Señora de La Paz","Escuela Rosemari de Barrientos",149,1,2,1,38,1,6,1,1,200,0,6,206,227,0.19,0.907
"2680","La Paz","Nuestra Señora de La Paz","Escuela Victor Paz Estensoro",100,0,4,0,79,1,10,0,0,194,3,7,204,222,0.407,0.919
"2681","La Paz","Nuestra Señora de La Paz","Escuela Victor Paz Estensoro",109,0,4,1,83,3,10,0,1,211,1,5,217,232,0.393,0.935
"2682","La Paz","Nuestra Señora de La Paz","Escuela Victor Paz Estensoro",81,3,13,1,104,0,9,0,0,211,0,4,215,229,0.493,0.939
"2683","La Paz","Nuestra Señora de La Paz","Escuela Victor Paz Estensoro",70,0,5,0,103,4,14,3,1,200,0,2,202,231,0.515,0.874
"2684","La Paz","Nuestra Señora de La Paz","Escuela Victor Paz Estensoro",84,0,2,0,110,1,7,0,0,204,2,6,212,231,0.539,0.918
"2685","La Paz","Nuestra Señora de La Paz","Escuela Victor Paz Estensoro",150,0,4,0,41,5,7,1,0,208,1,0,209,233,0.197,0.897
"2686","La Paz","Nuestra Señora de La Paz","Escuela Victor Paz Estensoro",126,0,2,1,59,2,12,0,1,203,2,5,210,226,0.291,0.929
"2687","La Paz","Nuestra Señora de La Paz","Escuela Victor Paz Estensoro",117,0,5,1,80,1,11,2,1,218,1,3,222,233,0.367,0.953
"2688","La Paz","Nuestra Señora de La Paz","Escuela Victor Paz Estensoro",57,0,8,0,124,1,11,0,0,201,0,6,207,227,0.617,0.912
"2689","La Paz","Nuestra Señora de La Paz","Escuela Victor Paz Estensoro",69,0,2,1,115,4,6,0,1,198,2,9,209,225,0.581,0.929
"2690","La Paz","Nuestra Señora de La Paz","Escuela Victor Paz Estensoro",123,0,3,0,63,1,13,1,1,205,1,1,207,223,0.307,0.928
"2691","La Paz","Nuestra Señora de La Paz","Escuela Victor Paz Estensoro",62,0,12,0,115,2,11,0,0,202,0,5,207,227,0.569,0.912
"2692","La Paz","Nuestra Señora de La Paz","Escuela Victor Paz Estensoro",62,0,3,0,117,3,17,0,3,205,1,10,216,231,0.571,0.935
"2693","La Paz","Nuestra Señora de La Paz","Escuela Victor Paz Estensoro",134,0,1,1,47,3,7,2,0,195,0,6,201,230,0.241,0.874
"2694","La Paz","Nuestra Señora de La Paz","Escuela Victor Paz Estensoro",91,0,8,1,101,2,8,0,0,211,0,1,212,232,0.479,0.914
"2695","La Paz","Nuestra Señora de La Paz","Escuela Victor Paz Estensoro",101,1,4,1,78,0,14,1,2,202,1,4,207,227,0.386,0.912
"2696","La Paz","Nuestra Señora de La Paz","Instituto Domingo Savio",126,0,0,0,46,2,8,1,1,184,0,5,189,230,0.25,0.822
"2697","La Paz","Nuestra Señora de La Paz","Instituto Domingo Savio",140,0,2,1,44,4,9,1,0,201,0,3,204,233,0.219,0.876
"2698","La Paz","Nuestra Señora de La Paz","Instituto Domingo Savio",114,0,1,1,75,1,14,2,4,212,1,3,216,231,0.354,0.935
"2699","La Paz","Nuestra Señora de La Paz","Instituto Domingo Savio",146,1,1,1,32,1,6,0,2,190,4,2,196,227,0.168,0.863
"2700","La Paz","Nuestra Señora de La Paz","Instituto Domingo Savio",129,2,1,0,53,3,10,0,1,199,2,6,207,227,0.266,0.912
"2701","La Paz","Nuestra Señora de La Paz","Instituto Domingo Savio",130,0,0,0,51,3,7,4,0,195,0,3,198,227,0.262,0.872
"2702","La Paz","Nuestra Señora de La Paz","Instituto Domingo Savio",104,0,1,1,76,1,7,0,0,190,0,5,195,231,0.4,0.844
"2703","La Paz","Nuestra Señora de La Paz","Instituto Domingo Savio",135,0,2,0,45,5,6,0,1,194,4,5,203,227,0.232,0.894
"2704","La Paz","Nuestra Señora de La Paz","Instituto Domingo Savio",119,1,2,2,55,0,14,0,0,193,3,3,199,226,0.285,0.881
"2705","La Paz","Nuestra Señora de La Paz","Instituto Domingo Savio",152,1,1,1,41,2,6,1,0,205,2,1,208,227,0.2,0.916
"2706","La Paz","Nuestra Señora de La Paz","Instituto Domingo Savio",139,0,2,0,45,6,7,4,1,204,1,1,206,227,0.221,0.907
"2707","La Paz","Nuestra Señora de La Paz","Instituto Domingo Savio",137,0,1,0,47,4,5,1,2,197,1,5,203,231,0.239,0.879
"2708","La Paz","Nuestra Señora de La Paz","Colegio Franco Boliviano",149,0,2,0,44,2,2,0,1,200,0,1,201,227,0.22,0.885
"2709","La Paz","Nuestra Señora de La Paz","Colegio Franco Boliviano",167,0,0,2,21,2,1,1,0,194,1,1,196,225,0.108,0.871
"2710","La Paz","Nuestra Señora de La Paz","Colegio Franco Boliviano",131,1,1,0,66,0,5,1,0,205,0,2,207,225,0.322,0.92
"2711","La Paz","Nuestra Señora de La Paz","Colegio Franco Boliviano",147,0,0,2,31,3,3,2,0,188,0,6,194,226,0.165,0.858
"2712","La Paz","Nuestra Señora de La Paz","Colegio Franco Boliviano",138,0,2,1,28,0,3,1,0,173,1,3,177,216,0.162,0.819
"2713","La Paz","Nuestra Señora de La Paz","Colegio Franco Boliviano",164,0,2,1,20,2,4,0,0,193,1,3,197,226,0.104,0.872
"2714","La Paz","Nuestra Señora de La Paz","Colegio Franco Boliviano",146,0,0,0,35,2,3,0,0,186,1,0,187,224,0.188,0.835
"2715","La Paz","Nuestra Señora de La Paz","Colegio Franco Boliviano",130,0,0,2,20,13,2,1,0,168,15,1,184,215,0.119,0.856
"2716","La Paz","Nuestra Señora de La Paz","Colegio Franco Boliviano",129,0,0,0,54,0,6,1,1,191,1,1,193,222,0.283,0.869
"2717","La Paz","Nuestra Señora de La Paz","Colegio Franco Boliviano",151,0,0,0,38,1,5,0,0,195,1,5,201,231,0.195,0.87
"2718","La Paz","Nuestra Señora de La Paz","Colegio Franco Boliviano",157,1,0,1,25,1,3,0,0,188,1,3,192,217,0.133,0.885
"2719","La Paz","Nuestra Señora de La Paz","Colegio Franco Boliviano",107,0,2,1,80,4,6,1,2,203,1,5,209,227,0.394,0.921
"2720","La Paz","Nuestra Señora de La Paz","Colegio Franco Boliviano",118,0,1,0,74,0,10,1,2,206,1,0,207,226,0.359,0.916
"2721","La Paz","Nuestra Señora de La Paz","Colegio Franco Boliviano",138,0,0,0,46,3,5,0,0,192,0,4,196,225,0.24,0.871
"2722","La Paz","Nuestra Señora de La Paz","Colegio Franco Boliviano",155,0,0,1,18,3,1,2,0,180,0,0,180,219,0.1,0.822
"2723","La Paz","Nuestra Señora de La Paz","Colegio Franco Boliviano",160,0,0,0,21,3,2,1,1,188,0,3,191,227,0.112,0.841
"2724","La Paz","Nuestra Señora de La Paz","Colegio Franco Boliviano",147,0,2,0,33,0,6,0,1,189,0,2,191,224,0.175,0.853
"2725","La Paz","Nuestra Señora de La Paz","Colegio Franco Boliviano",147,0,0,1,40,2,4,0,1,195,1,1,197,225,0.205,0.876
"2726","La Paz","Nuestra Señora de La Paz","Colegio Franco Boliviano",156,1,1,0,21,0,5,0,0,184,0,5,189,223,0.114,0.848
"2727","La Paz","Nuestra Señora de La Paz","Colegio Franco Boliviano",151,0,1,0,25,2,2,0,0,181,0,3,184,226,0.138,0.814
"2728","La Paz","Nuestra Señora de La Paz","Colegio Franco Boliviano",133,0,0,1,42,3,8,1,0,188,1,3,192,229,0.223,0.838
"2729","La Paz","Nuestra Señora de La Paz","Colegio Franco Boliviano",110,1,0,0,54,3,10,1,0,179,1,5,185,222,0.302,0.833
"2730","La Paz","Nuestra Señora de La Paz","Colegio Franco Boliviano",142,0,1,0,31,0,6,2,0,182,0,5,187,227,0.17,0.824
"2731","La Paz","Nuestra Señora de La Paz","Colegio Franco Boliviano",154,0,2,0,24,3,7,2,0,192,0,0,192,225,0.125,0.853
"2732","La Paz","Nuestra Señora de La Paz","Colegio Franco Boliviano",127,0,3,1,48,1,6,0,1,187,0,4,191,218,0.257,0.876
"2733","La Paz","Nuestra Señora de La Paz","Colegio Franco Boliviano",157,0,1,1,36,1,4,1,1,202,0,2,204,226,0.178,0.903
"2734","La Paz","Nuestra Señora de La Paz","Colegio Franco Boliviano",111,0,0,0,67,1,8,0,0,187,0,3,190,227,0.358,0.837
"2735","La Paz","Nuestra Señora de La Paz","Colegio Franco Boliviano",90,0,3,0,93,5,6,0,1,198,0,9,207,229,0.47,0.904
"2736","La Paz","Nuestra Señora de La Paz","Colegio Franco Boliviano",153,0,0,3,39,2,3,0,0,200,2,1,203,233,0.195,0.871
"2737","La Paz","Nuestra Señora de La Paz","Colegio Franco Boliviano",143,0,0,0,44,0,1,0,0,188,1,9,198,233,0.234,0.85
"2738","La Paz","Nuestra Señora de La Paz","Colegio Franco Boliviano",155,0,0,0,37,2,3,1,0,198,1,5,204,221,0.187,0.923
"2739","La Paz","Nuestra Señora de La Paz","Colegio Franco Boliviano",158,0,1,0,14,4,4,2,0,183,0,4,187,226,0.077,0.827
"2740","La Paz","Nuestra Señora de La Paz","Colegio Franco Boliviano",141,0,2,0,33,2,2,0,1,181,0,1,182,221,0.182,0.824
"2741","La Paz","Nuestra Señora de La Paz","Colegio Franco Boliviano",142,0,0,1,28,4,11,1,0,187,2,5,194,230,0.15,0.843
"2742","La Paz","Nuestra Señora de La Paz","Colegio Franco Boliviano",145,0,1,2,40,2,3,0,1,194,0,4,198,226,0.206,0.876
"2743","La Paz","Nuestra Señora de La Paz","Colegio Franco Boliviano",157,0,1,1,29,3,5,0,0,196,1,2,199,231,0.148,0.861
"2744","La Paz","Nuestra Señora de La Paz","Colegio Franco Boliviano",128,0,1,1,47,0,5,3,0,185,2,6,193,229,0.254,0.843
"2745","La Paz","Nuestra Señora de La Paz","Colegio Franco Boliviano",92,0,1,1,95,1,7,0,0,197,0,5,202,228,0.482,0.886
"2746","La Paz","Nuestra Señora de La Paz","Colegio Franco Boliviano",162,0,1,0,26,5,1,0,1,196,0,2,198,227,0.133,0.872
"2747","La Paz","Nuestra Señora de La Paz","Colegio Franco Boliviano",152,0,0,0,16,4,2,4,0,178,1,2,181,225,0.09,0.804
"2748","La Paz","Nuestra Señora de La Paz","Colegio Franco Boliviano",155,0,2,1,22,4,5,2,1,192,0,4,196,226,0.115,0.867
"2749","La Paz","Nuestra Señora de La Paz","Colegio Franco Boliviano",166,0,0,0,20,4,2,1,0,193,0,4,197,227,0.104,0.868
"2750","La Paz","Nuestra Señora de La Paz","Colegio Franco Boliviano",156,0,0,0,36,0,6,2,0,200,0,4,204,227,0.18,0.899
"2751","La Paz","Nuestra Señora de La Paz","Colegio Franco Boliviano",158,0,1,1,33,3,1,2,0,199,3,2,204,231,0.166,0.883
"2752","La Paz","Nuestra Señora de La Paz","Colegio Franco Boliviano",151,0,1,0,30,1,4,3,0,190,0,3,193,228,0.158,0.846
"2753","La Paz","Nuestra Señora de La Paz","Colegio Franco Boliviano",105,1,4,0,64,2,9,0,0,185,0,6,191,222,0.346,0.86
"2754","La Paz","Nuestra Señora de La Paz","Colegio Franco Boliviano",149,1,0,0,34,3,12,2,0,201,1,5,207,226,0.169,0.916
"2755","La Paz","Nuestra Señora de La Paz","Colegio Franco Boliviano",150,0,0,0,25,2,1,1,0,179,1,4,184,224,0.14,0.821
"2756","La Paz","Nuestra Señora de La Paz","Colegio Franco Boliviano",147,0,0,1,28,2,7,1,0,186,0,1,187,220,0.151,0.85
"2757","La Paz","Nuestra Señora de La Paz","Colegio Franco Boliviano",154,0,1,1,18,4,12,0,0,190,0,2,192,228,0.095,0.842
"2758","La Paz","Nuestra Señora de La Paz","Colegio Franco Boliviano",157,0,1,0,24,1,3,1,0,187,0,0,187,223,0.128,0.839
"2759","La Paz","Nuestra Señora de La Paz","Colegio Franco Boliviano",138,0,0,1,39,1,4,1,0,184,1,6,191,222,0.212,0.86
"2760","La Paz","Nuestra Señora de La Paz","U.E. Cesar Patiño",126,0,0,0,67,1,7,0,0,201,1,3,205,222,0.333,0.923
"2761","La Paz","Nuestra Señora de La Paz","Escuela Alto Achumani",123,0,3,1,69,1,12,0,0,209,2,3,214,233,0.33,0.918
"2762","La Paz","Nuestra Señora de La Paz","Escuela Alto Achumani",100,2,0,0,97,3,8,0,1,211,2,2,215,231,0.46,0.931
"2763","La Paz","Nuestra Señora de La Paz","Escuela Alto Achumani",130,0,1,0,65,2,10,2,0,210,1,4,215,231,0.31,0.931
"2764","La Paz","Nuestra Señora de La Paz","Escuela Alto Achumani",155,0,0,0,36,1,2,1,0,195,4,3,202,230,0.185,0.878
"2765","La Paz","Nuestra Señora de La Paz","Escuela Alto Achumani",145,0,2,0,46,1,11,0,0,205,1,6,212,237,0.224,0.895
"2766","La Paz","Nuestra Señora de La Paz","Escuela Alto Achumani",116,0,2,0,85,2,9,0,0,214,0,0,214,232,0.397,0.922
"2767","La Paz","Nuestra Señora de La Paz","Escuela Alto Achumani",79,0,2,0,114,3,11,1,0,210,1,6,217,229,0.543,0.948
"2768","La Paz","Nuestra Señora de La Paz","Escuela Alto Achumani",49,1,0,0,147,2,15,0,0,214,1,3,218,232,0.687,0.94
"2769","La Paz","Nuestra Señora de La Paz","Escuela Alto Achumani",74,0,2,1,104,1,21,0,0,203,4,6,213,232,0.512,0.918
"2770","La Paz","Nuestra Señora de La Paz","Escuela Alto Achumani",88,0,3,1,100,2,11,0,0,205,2,3,210,230,0.488,0.913
"2771","La Paz","Nuestra Señora de La Paz","Escuela Alto Achumani",178,0,0,0,26,1,6,0,0,211,0,5,216,235,0.123,0.919
"2772","La Paz","Nuestra Señora de La Paz","Escuela Alto Achumani",134,0,0,1,54,2,5,0,2,198,1,2,201,232,0.273,0.866
"2773","La Paz","Nuestra Señora de La Paz","Escuela Alto Achumani",139,1,1,2,64,2,3,1,1,214,0,2,216,234,0.299,0.923
"2774","La Paz","Nuestra Señora de La Paz","Escuela Alto Achumani",156,0,1,0,39,2,6,0,0,204,0,6,210,233,0.191,0.901
"2775","La Paz","Nuestra Señora de La Paz","Escuela Alto Achumani",91,0,4,0,97,2,8,0,1,203,1,5,209,227,0.478,0.921
"2776","La Paz","Nuestra Señora de La Paz","Escuela Alto Achumani",132,0,1,0,59,2,6,0,0,200,1,3,204,234,0.295,0.872
"2777","La Paz","Nuestra Señora de La Paz","Escuela Alto Achumani",97,0,1,0,91,0,11,1,0,201,1,7,209,224,0.453,0.933
"2778","La Paz","Nuestra Señora de La Paz","Escuela Alto Achumani",96,0,4,1,94,2,6,0,0,203,0,6,209,229,0.463,0.913
"2779","La Paz","Nuestra Señora de La Paz","Escuela Alto Achumani",23,0,5,0,165,2,17,0,0,212,0,9,221,237,0.778,0.932
"2780","La Paz","Nuestra Señora de La Paz","Escuela Alto Achumani",53,0,2,0,122,3,18,1,1,200,1,11,212,228,0.61,0.93
"2781","La Paz","Nuestra Señora de La Paz","Escuela Alto Achumani",139,0,1,0,48,2,7,1,2,200,1,5,206,234,0.24,0.88
"2782","La Paz","Nuestra Señora de La Paz","Escuela Alto Achumani",150,1,2,0,35,2,7,1,1,199,0,3,202,227,0.176,0.89
"2783","La Paz","Nuestra Señora de La Paz","Escuela Alto Achumani",151,0,0,0,44,0,5,0,1,201,0,7,208,231,0.219,0.9
"2784","La Paz","Nuestra Señora de La Paz","Escuela Alto Achumani",105,0,1,0,82,2,12,1,0,203,1,4,208,226,0.404,0.92
"2785","La Paz","Nuestra Señora de La Paz","Escuela Alto Achumani",123,0,3,0,76,1,6,2,0,211,1,4,216,229,0.36,0.943
"2786","La Paz","Nuestra Señora de La Paz","Escuela Alto Achumani",102,0,1,0,83,2,10,0,0,198,1,4,203,231,0.419,0.879
"2787","La Paz","Nuestra Señora de La Paz","Escuela Alto Achumani",54,2,1,2,143,2,8,0,1,213,3,5,221,233,0.671,0.948
"2788","La Paz","Nuestra Señora de La Paz","Escuela Alto Achumani",115,1,4,0,84,2,5,0,1,212,2,5,219,235,0.396,0.932
"2789","La Paz","Nuestra Señora de La Paz","Escuela Alto Achumani",140,0,1,1,51,2,9,0,0,204,1,2,207,230,0.25,0.9
"2790","La Paz","Nuestra Señora de La Paz","Escuela Alto Achumani",107,0,3,0,85,1,8,1,1,206,4,3,213,231,0.413,0.922
"2791","La Paz","Nuestra Señora de La Paz","Escuela Alto Achumani",147,0,2,2,52,2,3,0,0,208,0,3,211,232,0.25,0.909
"2792","La Paz","Nuestra Señora de La Paz","Escuela Alto Achumani",119,0,1,0,70,0,12,0,0,202,2,3,207,228,0.347,0.908
"2793","La Paz","Nuestra Señora de La Paz","Escuela Alto Achumani",112,0,1,1,82,4,7,0,0,207,2,3,212,232,0.396,0.914
"2794","La Paz","Nuestra Señora de La Paz","Escuela Alto Achumani",153,0,0,0,37,4,8,1,1,204,2,3,209,232,0.181,0.901
"2795","La Paz","Nuestra Señora de La Paz","Escuela Alto Achumani",150,0,1,0,42,2,14,0,2,211,1,4,216,234,0.199,0.923
"2796","La Paz","Nuestra Señora de La Paz","Escuela Alto Achumani",133,0,0,0,65,0,3,1,0,202,1,1,204,227,0.322,0.899
"2797","La Paz","Nuestra Señora de La Paz","U.E. Pantini",15,1,29,0,165,1,16,0,0,227,6,12,245,252,0.727,0.972
"2798","La Paz","Nuestra Señora de La Paz","Escuela Santa Rosa La Florida",106,0,1,2,56,0,15,2,5,187,0,7,194,225,0.299,0.862
"2799","La Paz","Nuestra Señora de La Paz","Escuela Santa Rosa La Florida",132,0,0,0,33,2,8,1,4,180,1,1,182,220,0.183,0.827
"2800","La Paz","Nuestra Señora de La Paz","Escuela Santa Rosa La Florida",134,1,2,1,32,1,9,0,1,181,0,5,186,219,0.177,0.849
"2801","La Paz","Nuestra Señora de La Paz","Escuela Santa Rosa La Florida",103,1,1,0,63,1,18,0,3,190,1,3,194,225,0.332,0.862
"2802","La Paz","Nuestra Señora de La Paz","Escuela Santa Rosa La Florida",92,0,2,0,83,0,12,1,2,192,1,6,199,220,0.432,0.905
"2803","La Paz","Nuestra Señora de La Paz","Escuela Santa Rosa La Florida",128,0,2,0,44,1,9,1,1,186,2,4,192,228,0.237,0.842
"2804","La Paz","Nuestra Señora de La Paz","Escuela Santa Rosa La Florida",99,0,2,0,56,3,13,0,1,174,1,5,180,217,0.322,0.829
"2805","La Paz","Nuestra Señora de La Paz","Escuela Santa Rosa La Florida",116,0,3,1,43,1,11,0,4,179,0,3,182,222,0.24,0.82
"2806","La Paz","Nuestra Señora de La Paz","Escuela Santa Rosa La Florida",123,0,0,0,38,2,7,1,0,171,0,2,173,222,0.222,0.779
"2807","La Paz","Nuestra Señora de La Paz","Escuela Santa Rosa La Florida",100,0,4,1,70,2,11,0,2,190,0,4,194,222,0.368,0.874
"2808","La Paz","Nuestra Señora de La Paz","Escuela Santa Rosa La Florida",83,1,1,1,86,2,16,2,7,199,0,5,204,229,0.432,0.891
"2809","La Paz","Nuestra Señora de La Paz","Escuela Santa Rosa La Florida",127,0,1,0,48,5,8,0,1,190,0,3,193,227,0.253,0.85
"2810","La Paz","Nuestra Señora de La Paz","Escuela Santa Rosa La Florida",115,0,1,1,53,3,12,1,2,188,1,3,192,224,0.282,0.857
"2811","La Paz","Nuestra Señora de La Paz","Escuela Santa Rosa La Florida",121,0,0,0,46,0,8,2,1,178,0,7,185,220,0.258,0.841
"2812","La Paz","Nuestra Señora de La Paz","Escuela Santa Rosa La Florida",75,1,2,0,70,2,24,2,11,187,2,3,192,225,0.374,0.853
"2813","La Paz","Nuestra Señora de La Paz","Escuela Santa Rosa La Florida",144,0,0,1,19,0,11,1,1,177,1,6,184,222,0.107,0.829
"2814","La Paz","Nuestra Señora de La Paz","Escuela Santa Rosa La Florida",122,2,1,0,38,4,9,2,1,179,0,2,181,219,0.212,0.826
"2815","La Paz","Nuestra Señora de La Paz","Escuela Santa Rosa La Florida",109,0,0,0,54,2,8,2,5,180,2,4,186,220,0.3,0.845
"2816","La Paz","Nuestra Señora de La Paz","Escuela Santa Rosa La Florida",127,0,0,0,44,1,10,0,0,182,1,4,187,227,0.242,0.824
"2817","La Paz","Nuestra Señora de La Paz","Colegio Rene Barrientos",158,0,0,2,25,3,3,1,0,192,0,5,197,220,0.13,0.895
"2818","La Paz","Nuestra Señora de La Paz","Colegio Rene Barrientos",146,0,2,1,33,1,4,0,0,187,1,1,189,223,0.176,0.848
"2819","La Paz","Nuestra Señora de La Paz","Colegio Rene Barrientos",145,0,0,0,25,2,4,0,0,176,1,6,183,223,0.142,0.821
"2820","La Paz","Nuestra Señora de La Paz","Colegio Rene Barrientos",123,1,4,0,54,2,7,0,0,191,0,3,194,231,0.283,0.84
"2821","La Paz","Nuestra Señora de La Paz","Colegio Rene Barrientos",148,1,0,0,29,2,5,0,1,186,1,5,192,227,0.156,0.846
"2822","La Paz","Nuestra Señora de La Paz","Colegio Rene Barrientos",146,0,0,0,28,6,6,0,1,187,1,1,189,224,0.15,0.844
"2823","La Paz","Nuestra Señora de La Paz","Colegio Rene Barrientos",138,0,1,2,28,2,5,0,0,176,1,2,179,213,0.159,0.84
"2824","La Paz","Nuestra Señora de La Paz","Colegio Rene Barrientos",144,1,1,0,43,1,9,1,0,200,2,5,207,234,0.215,0.885
"2825","La Paz","Nuestra Señora de La Paz","Colegio Rene Barrientos",150,1,0,0,30,2,5,2,0,190,0,0,190,227,0.158,0.837
"2826","La Paz","Nuestra Señora de La Paz","Colegio Rene Barrientos",149,0,0,0,31,2,1,1,1,185,0,5,190,225,0.168,0.844
"2827","La Paz","Nuestra Señora de La Paz","Colegio Rene Barrientos",138,0,3,0,34,0,6,0,1,182,0,3,185,221,0.187,0.837
"2828","La Paz","Nuestra Señora de La Paz","Colegio Rene Barrientos",137,0,2,0,41,2,6,0,1,189,0,3,192,220,0.217,0.873
"2829","La Paz","Nuestra Señora de La Paz","Colegio Rene Barrientos",151,0,0,0,27,4,2,0,0,184,0,2,186,218,0.147,0.853
"2830","La Paz","Nuestra Señora de La Paz","Colegio Rene Barrientos",149,1,0,0,26,1,6,0,0,183,0,3,186,228,0.142,0.816
"2831","La Paz","Nuestra Señora de La Paz","Colegio Rene Barrientos",151,0,0,1,37,2,6,0,0,197,0,1,198,230,0.188,0.861
"2832","La Paz","Nuestra Señora de La Paz","Esc. Walter Straub",120,0,2,1,61,2,6,0,0,192,0,2,194,226,0.318,0.858
"2833","La Paz","Nuestra Señora de La Paz","Esc. Walter Straub",116,0,2,0,61,3,11,2,1,196,1,2,199,232,0.311,0.858
"2834","La Paz","Nuestra Señora de La Paz","Esc. Walter Straub",139,0,0,0,55,2,11,0,0,207,0,2,209,225,0.266,0.929
"2835","La Paz","Nuestra Señora de La Paz","Esc. Walter Straub",113,0,2,0,64,2,14,1,1,197,1,2,200,223,0.325,0.897
"2836","La Paz","Nuestra Señora de La Paz","Esc. Walter Straub",108,0,2,0,79,1,4,1,1,196,2,8,206,226,0.403,0.912
"2837","La Paz","Nuestra Señora de La Paz","Esc. Walter Straub",83,0,0,3,99,6,9,1,1,202,0,7,209,224,0.49,0.933
"2838","La Paz","Nuestra Señora de La Paz","Esc. Walter Straub",117,1,6,0,72,0,7,0,0,203,1,5,209,229,0.355,0.913
"2839","La Paz","Nuestra Señora de La Paz","Esc. Walter Straub",142,0,1,1,42,1,5,0,0,192,0,1,193,223,0.219,0.865
"2840","La Paz","Nuestra Señora de La Paz","Esc. Walter Straub",128,0,0,0,54,2,6,0,0,190,1,5,196,229,0.284,0.856
"2841","La Paz","Nuestra Señora de La Paz","Esc. Walter Straub",139,1,0,0,59,2,7,0,1,209,1,2,212,232,0.282,0.914
"2842","La Paz","Nuestra Señora de La Paz","Esc. Walter Straub",109,0,2,0,71,3,12,2,0,199,0,4,203,225,0.357,0.902
"2843","La Paz","Nuestra Señora de La Paz","Esc. Walter Straub",79,2,0,1,88,4,8,0,1,183,4,6,193,220,0.481,0.877
"2844","La Paz","Nuestra Señora de La Paz","Esc. Walter Straub",82,0,3,2,102,1,6,0,2,198,1,3,202,227,0.515,0.89
"2845","La Paz","Nuestra Señora de La Paz","Esc. Walter Straub",98,0,1,3,75,6,16,1,2,202,1,3,206,227,0.371,0.907
"2846","La Paz","Nuestra Señora de La Paz","Esc. Walter Straub",148,0,0,1,41,2,5,0,0,197,1,1,199,224,0.208,0.888
"2847","La Paz","Nuestra Señora de La Paz","Esc. Walter Straub",140,0,1,0,48,0,5,2,0,196,0,4,200,226,0.245,0.885
"2848","La Paz","Nuestra Señora de La Paz","Esc. Walter Straub",118,0,3,1,61,2,4,1,0,190,1,5,196,220,0.321,0.891
"2849","La Paz","Nuestra Señora de La Paz","Esc. Walter Straub",103,0,1,0,71,1,9,2,0,187,1,7,195,224,0.38,0.871
"2850","La Paz","Nuestra Señora de La Paz","Esc. Walter Straub",93,0,1,0,83,5,16,2,1,201,0,5,206,231,0.413,0.892
"2851","La Paz","Nuestra Señora de La Paz","Esc. Walter Straub",146,0,1,0,43,2,5,0,0,197,0,0,197,227,0.218,0.868
"2852","La Paz","Nuestra Señora de La Paz","Esc. Walter Straub",131,0,1,2,55,2,7,1,3,202,1,2,205,231,0.272,0.887
"2853","La Paz","Nuestra Señora de La Paz","Esc. Walter Straub",127,0,1,1,66,1,7,0,0,203,0,2,205,229,0.325,0.895
"2854","La Paz","Nuestra Señora de La Paz","Esc. Walter Straub",105,0,2,1,83,2,9,1,0,203,0,9,212,234,0.409,0.906
"2855","La Paz","Nuestra Señora de La Paz","Esc. Walter Straub",128,1,2,3,40,2,12,2,1,191,0,16,207,231,0.209,0.896
"2856","La Paz","Nuestra Señora de La Paz","Esc. Walter Straub",120,0,0,1,65,2,7,0,2,197,0,4,201,228,0.33,0.882
"2857","La Paz","Nuestra Señora de La Paz","U.E. San Andrés",144,1,4,0,43,0,7,1,0,200,0,3,203,221,0.215,0.919
"2858","La Paz","Nuestra Señora de La Paz","U.E. San Andrés",147,2,0,0,29,0,7,0,0,185,0,2,187,219,0.157,0.854
"2859","La Paz","Nuestra Señora de La Paz","U.E. San Andrés",119,1,3,1,63,2,8,0,0,197,0,5,202,225,0.32,0.898
"2860","La Paz","Nuestra Señora de La Paz","U.E. San Andrés",122,0,0,1,41,3,8,0,1,176,0,5,181,215,0.233,0.842
"2861","La Paz","Nuestra Señora de La Paz","U.E. San Andrés",116,0,4,0,38,2,10,2,0,172,2,4,178,217,0.221,0.82
"2862","La Paz","Nuestra Señora de La Paz","U.E. San Andrés",112,0,2,0,65,2,9,2,0,192,0,6,198,221,0.339,0.896
"2863","La Paz","Nuestra Señora de La Paz","U.E. San Andrés",163,0,0,0,26,2,6,1,0,198,2,1,201,224,0.131,0.897
"2864","La Paz","Nuestra Señora de La Paz","U.E. San Andrés",140,0,1,1,34,2,5,1,0,184,1,2,187,221,0.185,0.846
"2865","La Paz","Nuestra Señora de La Paz","U.E. San Andrés",115,0,2,2,53,1,5,0,1,179,2,3,184,214,0.296,0.86
"2866","La Paz","Nuestra Señora de La Paz","U.E. San Andrés",142,0,0,0,32,2,4,0,1,181,2,3,186,211,0.177,0.882
"2867","La Paz","Nuestra Señora de La Paz","U.E. San Andrés",134,1,1,0,49,2,5,0,2,194,0,3,197,225,0.253,0.876
"2868","La Paz","Nuestra Señora de La Paz","Unidad Educativa Los Pinos",164,0,0,1,22,4,1,1,0,193,1,5,199,229,0.114,0.869
"2869","La Paz","Nuestra Señora de La Paz","Unidad Educativa Los Pinos",152,0,0,0,27,1,4,0,0,184,0,2,186,226,0.147,0.823
"2870","La Paz","Nuestra Señora de La Paz","Unidad Educativa Los Pinos",160,0,0,1,21,2,3,1,0,188,0,3,191,221,0.112,0.864
"2871","La Paz","Nuestra Señora de La Paz","Unidad Educativa Los Pinos",171,0,0,1,15,3,2,0,0,192,2,2,196,225,0.078,0.871
"2872","La Paz","Nuestra Señora de La Paz","Unidad Educativa Los Pinos",165,0,0,0,23,0,3,1,1,193,1,6,200,230,0.119,0.87
"2873","La Paz","Nuestra Señora de La Paz","Unidad Educativa Los Pinos",140,0,0,0,45,3,3,0,0,191,1,4,196,231,0.236,0.848
"2874","La Paz","Nuestra Señora de La Paz","Unidad Educativa Los Pinos",146,0,0,0,30,2,3,1,0,182,2,4,188,224,0.165,0.839
"2875","La Paz","Nuestra Señora de La Paz","Unidad Educativa Los Pinos",158,0,1,1,16,1,5,1,1,184,1,2,187,218,0.087,0.858
"2876","La Paz","Nuestra Señora de La Paz","Unidad Educativa Los Pinos",166,0,0,2,19,1,2,1,0,191,0,1,192,229,0.099,0.838
"2877","La Paz","Nuestra Señora de La Paz","Unidad Educativa Los Pinos",159,0,0,0,21,1,5,0,0,186,5,4,195,222,0.113,0.878
"2878","La Paz","Nuestra Señora de La Paz","Unidad Educativa Los Pinos",160,0,1,0,25,3,4,1,0,194,0,3,197,227,0.129,0.868
"2879","La Paz","Nuestra Señora de La Paz","Unidad Educativa Los Pinos",143,0,0,1,31,2,0,0,0,177,0,1,178,220,0.175,0.809
"2880","La Paz","Nuestra Señora de La Paz","Unidad Educativa Los Pinos",161,0,0,1,31,1,6,0,1,201,0,3,204,225,0.154,0.907
"2881","La Paz","Nuestra Señora de La Paz","Unidad Educativa Los Pinos",162,0,1,0,22,5,4,2,0,196,1,2,199,222,0.112,0.896
"2882","La Paz","Nuestra Señora de La Paz","Unidad Educativa Los Pinos",155,0,0,0,29,2,5,1,0,192,0,0,192,223,0.151,0.861
"2883","La Paz","Nuestra Señora de La Paz","Unidad Educativa Los Pinos",157,0,1,1,17,6,4,0,0,186,0,4,190,219,0.091,0.868
"2884","La Paz","Nuestra Señora de La Paz","Unidad Educativa Los Pinos",142,0,1,0,30,1,2,1,0,177,0,6,183,218,0.169,0.839
"2885","La Paz","Nuestra Señora de La Paz","Unidad Educativa Los Pinos",146,0,0,0,23,3,2,0,0,174,2,4,180,223,0.132,0.807
"2886","La Paz","Nuestra Señora de La Paz","Unidad Educativa Los Pinos",152,0,0,0,29,6,1,1,0,189,1,5,195,223,0.153,0.874
"2887","La Paz","Nuestra Señora de La Paz","Unidad Educativa Los Pinos",155,0,0,1,17,2,1,0,1,177,0,6,183,219,0.096,0.836
"2888","La Paz","Nuestra Señora de La Paz","Unidad Educativa Los Pinos",165,1,0,0,18,4,5,0,0,193,1,3,197,223,0.093,0.883
"2889","La Paz","Nuestra Señora de La Paz","Unidad Educativa Los Pinos",146,1,1,0,27,3,6,0,0,184,1,4,189,223,0.147,0.848
"2890","La Paz","Nuestra Señora de La Paz","Unidad Educativa Los Pinos",165,0,0,0,12,3,6,2,1,189,1,5,195,227,0.063,0.859
"2891","La Paz","Nuestra Señora de La Paz","Unidad Educativa Los Pinos",157,0,0,0,17,1,6,2,0,183,1,3,187,219,0.093,0.854
"2892","La Paz","Nuestra Señora de La Paz","Unidad Educativa Los Pinos",150,0,0,0,24,2,3,1,0,180,1,5,186,219,0.133,0.849
"2893","La Paz","Nuestra Señora de La Paz","Col. Loretto",156,0,0,0,25,4,5,1,0,191,1,0,192,224,0.131,0.857
"2894","La Paz","Nuestra Señora de La Paz","Col. Loretto",153,0,0,0,17,1,3,0,0,174,0,0,174,214,0.098,0.813
"2895","La Paz","Nuestra Señora de La Paz","Col. Loretto",147,1,1,1,28,4,4,0,1,187,1,1,189,217,0.15,0.871
"2896","La Paz","Nuestra Señora de La Paz","Col. Loretto",159,0,0,0,22,0,9,0,0,190,0,3,193,219,0.116,0.881
"2897","La Paz","Nuestra Señora de La Paz","Col. Loretto",160,0,0,1,27,0,4,0,0,192,0,1,193,227,0.141,0.85
"2898","La Paz","Nuestra Señora de La Paz","Col. Loretto",156,1,0,0,24,2,2,1,0,186,2,6,194,224,0.129,0.866
"2899","La Paz","Nuestra Señora de La Paz","Col. Loretto",159,0,0,0,13,0,3,1,0,176,1,2,179,216,0.074,0.829
"2900","La Paz","Nuestra Señora de La Paz","Col. Loretto",138,0,2,1,41,3,7,0,0,192,0,4,196,222,0.214,0.883
"2901","La Paz","Nuestra Señora de La Paz","Col. Loretto",163,0,0,0,26,1,3,0,0,193,0,2,195,224,0.135,0.871
"2902","La Paz","Nuestra Señora de La Paz","Col. Loretto",144,0,1,3,25,1,3,0,0,177,0,5,182,211,0.141,0.863
"2903","La Paz","Nuestra Señora de La Paz","Col. Loretto",146,1,0,0,26,0,4,2,2,181,2,2,185,219,0.144,0.845
"2904","La Paz","Nuestra Señora de La Paz","Col. Loretto",149,0,1,0,19,1,5,1,0,176,0,5,181,218,0.108,0.83
"2905","La Paz","Nuestra Señora de La Paz","Col. Loretto",156,0,0,0,23,1,2,1,0,183,0,1,184,222,0.126,0.829
"2906","La Paz","Nuestra Señora de La Paz","Col. Loretto",153,0,0,0,18,3,2,3,0,179,0,1,180,221,0.101,0.814
"2907","La Paz","Nuestra Señora de La Paz","Unid. Educ. Joaquin Hernann",15,0,3,1,166,0,20,0,0,205,3,8,216,229,0.81,0.943
"2908","La Paz","Nuestra Señora de La Paz","Unid. Educ. Joaquin Hernann",18,0,3,1,167,3,17,0,0,209,2,6,217,230,0.799,0.943
"2909","La Paz","Nuestra Señora de La Paz","Unid. Educ. Joaquin Hernann",20,0,3,1,182,2,10,2,0,220,0,5,225,234,0.827,0.962
"2910","La Paz","Nuestra Señora de La Paz","Unid. Educ. Joaquin Hernann",11,0,3,0,172,2,13,0,1,202,5,6,213,226,0.851,0.942
"2911","La Paz","Nuestra Señora de La Paz","Unid. Educ. Joaquin Hernann",16,1,3,0,171,1,7,1,2,202,3,6,211,229,0.847,0.921
"2912","La Paz","Nuestra Señora de La Paz","Unid. Educ. Joaquin Hernann",19,0,0,1,185,2,10,0,1,218,1,2,221,233,0.849,0.948
"2913","La Paz","Nuestra Señora de La Paz","Esc. Santa Rosa De Lima",32,0,5,1,150,0,22,0,0,210,2,6,218,223,0.714,0.978
"2914","La Paz","Nuestra Señora de La Paz","Esc. Santa Rosa De Lima",28,0,6,0,151,5,16,0,5,211,0,8,219,235,0.716,0.932
"2915","La Paz","Nuestra Señora de La Paz","Esc. Santa Rosa De Lima",56,0,2,1,127,3,20,0,1,210,1,6,217,235,0.605,0.923
"2916","La Paz","Nuestra Señora de La Paz","Esc. Santa Rosa De Lima",33,0,1,1,144,1,24,0,0,204,0,10,214,228,0.706,0.939
"2917","La Paz","Nuestra Señora de La Paz","Esc. Santa Rosa De Lima",32,0,6,2,139,1,21,2,1,204,3,6,213,225,0.681,0.947
"2918","La Paz","Nuestra Señora de La Paz","Esc. Santa Rosa De Lima",19,0,7,0,178,3,11,0,0,218,1,6,225,234,0.817,0.962
"2919","La Paz","Nuestra Señora de La Paz","Esc. Santa Rosa De Lima",24,0,4,0,162,2,14,1,4,211,2,10,223,231,0.768,0.965
"2920","La Paz","Nuestra Señora de La Paz","Esc. Santa Rosa De Lima",23,0,1,0,175,3,11,1,1,215,1,7,223,231,0.814,0.965
"2921","La Paz","Nuestra Señora de La Paz","Esc. Santa Rosa De Lima",54,2,4,0,128,2,12,0,1,203,5,6,214,226,0.631,0.947
"2922","La Paz","Nuestra Señora de La Paz","Esc. Santa Rosa De Lima",43,0,2,1,144,2,10,1,1,204,2,7,213,226,0.706,0.942
"2923","La Paz","Nuestra Señora de La Paz","Esc. Santa Rosa De Lima",38,0,0,2,132,3,18,0,1,194,8,6,208,224,0.68,0.929
"2924","La Paz","Nuestra Señora de La Paz","Esc. Santa Rosa De Lima",29,0,5,1,161,1,16,0,0,213,2,6,221,233,0.756,0.948
"2925","La Paz","Nuestra Señora de La Paz","Esc. Santa Rosa De Lima",28,0,8,0,167,3,13,0,1,220,1,3,224,234,0.759,0.957
"2926","La Paz","Nuestra Señora de La Paz","Esc. Santa Rosa De Lima",27,0,4,0,158,1,20,0,0,210,3,8,221,234,0.752,0.944
"2927","La Paz","Nuestra Señora de La Paz","Esc. Santa Rosa De Lima",18,0,8,1,158,0,12,2,4,203,0,9,212,227,0.778,0.934
"2928","La Paz","Nuestra Señora de La Paz","Esc. Santa Rosa De Lima",22,0,2,1,173,2,11,1,3,215,4,6,225,235,0.805,0.957
"2929","La Paz","Nuestra Señora de La Paz","Esc. Santa Rosa De Lima",35,0,4,1,144,2,16,0,2,204,3,7,214,226,0.706,0.947
"2930","La Paz","Nuestra Señora de La Paz","Esc. Santa Rosa De Lima",51,0,2,1,129,0,19,0,1,203,2,3,208,227,0.635,0.916
"2931","La Paz","Nuestra Señora de La Paz","Esc. Santa Rosa De Lima",44,0,8,0,131,0,10,0,2,195,1,11,207,222,0.672,0.932
"2932","La Paz","Nuestra Señora de La Paz","Esc. Santa Rosa De Lima",27,0,4,0,160,0,14,0,0,205,1,4,210,228,0.78,0.921
"2933","La Paz","Nuestra Señora de La Paz","Esc. Santa Rosa De Lima",17,0,6,2,177,0,12,1,1,216,1,4,221,229,0.819,0.965
"2934","La Paz","Nuestra Señora de La Paz","Esc. Santa Rosa De Lima",37,1,3,2,153,2,14,0,1,213,2,6,221,232,0.718,0.953
"2935","La Paz","Nuestra Señora de La Paz","Esc. Santa Rosa De Lima",33,0,3,0,145,1,18,0,2,202,1,10,213,229,0.718,0.93
"2936","La Paz","Nuestra Señora de La Paz","Esc. Santa Rosa De Lima",22,0,4,0,163,1,21,0,0,211,1,6,218,232,0.773,0.94
"2937","La Paz","Nuestra Señora de La Paz","Esc. Santa Rosa De Lima",44,0,1,1,152,1,13,1,1,214,5,2,221,232,0.71,0.953
"2938","La Paz","Nuestra Señora de La Paz","Esc. Santa Rosa De Lima",27,0,2,0,114,6,12,0,3,164,2,3,169,188,0.695,0.899
"2939","La Paz","Nuestra Señora de La Paz","U.E. Jacha Uru",42,0,1,1,148,1,33,1,2,229,1,4,234,239,0.646,0.979
"2940","La Paz","Nuestra Señora de La Paz","U.E. Jacha Uru",38,1,6,1,149,2,16,0,0,213,3,6,222,237,0.7,0.937
"2941","La Paz","Nuestra Señora de La Paz","U.E. Jacha Uru",40,1,0,0,158,0,22,1,4,226,1,5,232,240,0.699,0.967
"2942","La Paz","Nuestra Señora de La Paz","U.E. Jacha Uru",40,0,3,0,157,3,16,1,0,220,0,6,226,239,0.714,0.946
"2943","La Paz","Nuestra Señora de La Paz","U.E. Jacha Uru",41,1,6,0,130,3,23,0,3,207,0,4,211,220,0.628,0.959
"2944","La Paz","Nuestra Señora de La Paz","U.E. Betesta",56,1,6,0,130,7,13,2,0,215,1,4,220,233,0.605,0.944
"2945","La Paz","Nuestra Señora de La Paz","U.E. Betesta",66,0,0,0,122,1,18,3,0,210,1,5,216,230,0.581,0.939
"2946","La Paz","Nuestra Señora de La Paz","U.E. Betesta",61,0,3,1,126,1,14,0,0,206,2,7,215,231,0.612,0.931
"2947","La Paz","Nuestra Señora de La Paz","U.E. Betesta",37,0,1,0,150,1,20,0,2,211,1,7,219,230,0.711,0.952
"2948","La Paz","Nuestra Señora de La Paz","U.E. Betesta",62,1,5,1,122,0,20,0,2,213,5,3,221,235,0.573,0.94
"2949","La Paz","Nuestra Señora de La Paz","U.E. Betesta",67,0,2,0,119,2,12,0,0,202,2,10,214,232,0.589,0.922
"2950","La Paz","Nuestra Señora de La Paz","U.E. Betesta",48,0,5,1,130,2,21,1,1,209,0,3,212,225,0.622,0.942
"2951","La Paz","Nuestra Señora de La Paz","U.E. Betesta",35,0,5,1,138,2,23,0,2,206,0,11,217,232,0.67,0.935
"2952","La Paz","Nuestra Señora de La Paz","U.E. Betesta",50,0,5,1,129,1,18,0,0,204,2,5,211,230,0.632,0.917
"2953","La Paz","Nuestra Señora de La Paz","U.E. Betesta",82,0,3,0,114,4,8,0,1,212,3,5,220,226,0.538,0.973
"2954","La Paz","Nuestra Señora de La Paz","U.E. Betesta",55,1,1,2,132,1,14,0,5,211,2,6,219,227,0.626,0.965
"2955","La Paz","Nuestra Señora de La Paz","U.E. Betesta",76,1,4,1,111,0,19,0,0,212,0,6,218,234,0.524,0.932
"2956","La Paz","Nuestra Señora de La Paz","U.E. Betesta",65,0,4,0,101,4,28,1,1,204,2,4,210,229,0.495,0.917
"2957","La Paz","Nuestra Señora de La Paz","U.E. Betesta",70,0,6,0,109,1,21,0,0,207,0,6,213,230,0.527,0.926
"2958","La Paz","Nuestra Señora de La Paz","U.E. El Pedregal (Urb. Pedregal)",58,0,1,0,129,6,20,3,1,218,4,5,227,234,0.592,0.97
"2959","La Paz","Nuestra Señora de La Paz","U.E. El Pedregal (Urb. Pedregal)",64,0,2,0,124,3,22,0,1,216,1,7,224,236,0.574,0.949
"2960","La Paz","Nuestra Señora de La Paz","U.E. El Pedregal (Urb. Pedregal)",75,0,3,2,120,7,11,0,2,220,1,5,226,235,0.545,0.962
"2961","La Paz","Nuestra Señora de La Paz","U.E. El Pedregal (Urb. Pedregal)",50,1,6,0,128,4,18,2,2,211,2,11,224,234,0.607,0.957
"2962","La Paz","Nuestra Señora de La Paz","U.E. El Pedregal (Urb. Pedregal)",73,1,3,0,116,3,12,1,2,211,3,11,225,235,0.55,0.957
"2963","La Paz","Nuestra Señora de La Paz","U.E. El Pedregal (Urb. Pedregal)",53,4,4,0,141,1,13,0,1,217,0,5,222,235,0.65,0.945
"2964","La Paz","Nuestra Señora de La Paz","U.E. El Pedregal (Urb. Pedregal)",84,0,0,1,106,1,20,0,2,214,0,5,219,233,0.495,0.94
"2965","La Paz","Nuestra Señora de La Paz","Escuela Chasquipampa",60,0,2,3,117,2,14,0,1,199,2,5,206,223,0.588,0.924
"2966","La Paz","Nuestra Señora de La Paz","Escuela Chasquipampa",75,0,1,0,109,6,11,2,0,204,2,5,211,227,0.534,0.93
"2967","La Paz","Nuestra Señora de La Paz","Escuela Chasquipampa",54,0,4,1,127,0,15,0,1,202,2,5,209,225,0.629,0.929
"2968","La Paz","Nuestra Señora de La Paz","Escuela Chasquipampa",63,1,1,2,122,2,16,1,0,208,1,3,212,230,0.587,0.922
"2969","La Paz","Nuestra Señora de La Paz","Escuela Chasquipampa",80,0,2,0,100,1,14,2,1,200,0,6,206,228,0.5,0.904
"2970","La Paz","Nuestra Señora de La Paz","Escuela Chasquipampa",101,0,3,0,85,3,8,1,1,202,0,5,207,229,0.421,0.904
"2971","La Paz","Nuestra Señora de La Paz","Escuela Chasquipampa",64,1,3,0,122,2,9,1,1,203,1,4,208,221,0.601,0.941
"2972","La Paz","Nuestra Señora de La Paz","Escuela Chasquipampa",45,1,5,1,132,2,13,0,0,199,1,13,213,232,0.663,0.918
"2973","La Paz","Nuestra Señora de La Paz","Escuela Chasquipampa",50,0,2,0,135,3,15,1,0,206,0,7,213,226,0.655,0.942
"2974","La Paz","Nuestra Señora de La Paz","Escuela Chasquipampa",53,0,5,1,122,3,12,1,2,199,1,6,206,230,0.613,0.896
"2975","La Paz","Nuestra Señora de La Paz","Escuela Chasquipampa",29,2,5,0,149,4,23,0,1,213,3,4,220,230,0.7,0.957
"2976","La Paz","Nuestra Señora de La Paz","Escuela Chasquipampa",44,0,4,0,150,3,10,1,1,213,2,3,218,235,0.704,0.928
"2977","La Paz","Nuestra Señora de La Paz","Escuela Chasquipampa",48,0,4,3,127,3,9,0,4,198,2,8,208,232,0.641,0.897
"2978","La Paz","Nuestra Señora de La Paz","Escuela Chasquipampa",32,1,2,0,159,2,12,0,1,209,2,4,215,227,0.761,0.947
"2979","La Paz","Nuestra Señora de La Paz","Escuela Chasquipampa",59,0,3,0,135,0,12,1,0,210,2,6,218,230,0.643,0.948
"2980","La Paz","Nuestra Señora de La Paz","Escuela Chasquipampa",74,0,4,1,99,3,17,0,1,199,0,6,205,223,0.497,0.919
"2981","La Paz","Nuestra Señora de La Paz","Escuela Chasquipampa",96,0,1,1,79,2,19,2,0,200,1,5,206,225,0.395,0.916
"2982","La Paz","Nuestra Señora de La Paz","Escuela Chasquipampa",73,0,2,2,106,5,21,0,2,211,1,6,218,233,0.502,0.936
"2983","La Paz","Nuestra Señora de La Paz","Escuela Chasquipampa",91,1,1,0,85,3,18,0,1,200,0,6,206,226,0.425,0.912
"2984","La Paz","Nuestra Señora de La Paz","Escuela Chasquipampa",77,0,0,0,107,1,10,0,1,196,0,9,205,226,0.546,0.907
"2985","La Paz","Nuestra Señora de La Paz","Escuela Chasquipampa",80,1,3,1,108,1,16,3,0,213,0,5,218,230,0.507,0.948
"2986","La Paz","Nuestra Señora de La Paz","Escuela Chasquipampa",57,1,3,0,120,6,11,0,1,199,2,2,203,225,0.603,0.902
"2987","La Paz","Nuestra Señora de La Paz","Escuela Chasquipampa",80,0,3,0,103,2,9,0,0,197,1,9,207,224,0.523,0.924
"2988","La Paz","Nuestra Señora de La Paz","Escuela Chasquipampa",58,2,1,1,125,1,11,1,2,202,2,10,214,227,0.619,0.943
"2989","La Paz","Nuestra Señora de La Paz","Escuela Chasquipampa",51,0,3,1,133,1,12,1,0,202,3,3,208,224,0.658,0.929
"2990","La Paz","Nuestra Señora de La Paz","Escuela Chasquipampa",70,0,2,0,105,3,11,0,1,192,3,7,202,226,0.547,0.894
"2991","La Paz","Nuestra Señora de La Paz","Escuela Chasquipampa",51,1,3,2,136,4,15,0,2,214,0,4,218,233,0.636,0.936
"2992","La Paz","Nuestra Señora de La Paz","Escuela Chasquipampa",32,0,2,0,153,4,21,0,1,213,2,6,221,234,0.718,0.944
"2993","La Paz","Nuestra Señora de La Paz","Escuela Chasquipampa",30,0,2,0,158,1,14,0,0,205,3,1,209,230,0.771,0.909
"2994","La Paz","Nuestra Señora de La Paz","Escuela Chasquipampa",37,1,3,0,154,1,12,1,3,212,3,3,218,230,0.726,0.948
"2995","La Paz","Nuestra Señora de La Paz","Escuela Chasquipampa",63,0,2,0,108,3,12,0,0,188,3,5,196,216,0.574,0.907
"2996","La Paz","Nuestra Señora de La Paz","Escuela Chasquipampa",82,0,2,0,109,1,9,0,0,203,1,6,210,228,0.537,0.921
"2997","La Paz","Nuestra Señora de La Paz","Escuela Chasquipampa",95,1,2,1,88,2,12,0,0,201,2,10,213,227,0.438,0.938
"2998","La Paz","Nuestra Señora de La Paz","Escuela Chasquipampa",80,1,2,0,101,3,16,2,2,207,1,4,212,225,0.488,0.942
"2999","La Paz","Nuestra Señora de La Paz","Escuela Chasquipampa",96,0,6,0,78,2,12,1,1,196,2,6,204,229,0.398,0.891
"3000","La Paz","Nuestra Señora de La Paz","Escuela Chasquipampa",48,3,5,1,122,0,16,1,1,197,1,6,204,230,0.619,0.887
"3001","La Paz","Nuestra Señora de La Paz","Escuela Chasquipampa",48,0,8,7,136,1,7,1,0,208,0,7,215,226,0.654,0.951
"3002","La Paz","Nuestra Señora de La Paz","Escuela Chasquipampa",60,0,3,0,123,2,22,1,0,211,0,3,214,228,0.583,0.939
"3003","La Paz","Nuestra Señora de La Paz","Escuela Chasquipampa",73,0,4,0,106,4,17,0,5,209,0,6,215,228,0.507,0.943
"3004","La Paz","Nuestra Señora de La Paz","Escuela Chasquipampa",43,0,1,0,154,2,15,0,1,216,0,4,220,232,0.713,0.948
"3005","La Paz","Nuestra Señora de La Paz","Escuela Chasquipampa",31,2,4,0,153,5,17,0,0,212,0,6,218,232,0.722,0.94
"3006","La Paz","Nuestra Señora de La Paz","Escuela Chasquipampa",63,2,2,0,131,3,13,2,1,217,1,0,218,231,0.604,0.944
"3007","La Paz","Nuestra Señora de La Paz","Escuela Chasquipampa",90,0,1,0,93,4,13,0,0,201,1,6,208,225,0.463,0.924
"3008","La Paz","Nuestra Señora de La Paz","Escuela Chasquipampa",61,0,4,0,112,1,18,0,0,196,2,8,206,223,0.571,0.924
"3009","La Paz","Nuestra Señora de La Paz","Escuela Chasquipampa",81,0,3,0,106,2,6,0,0,198,0,4,202,226,0.535,0.894
"3010","La Paz","Nuestra Señora de La Paz","Escuela Chasquipampa",86,0,2,1,104,1,12,0,1,207,0,9,216,233,0.502,0.927
"3011","La Paz","Nuestra Señora de La Paz","Escuela Chasquipampa",82,0,7,0,92,2,20,0,2,205,1,8,214,226,0.449,0.947
"3012","La Paz","Nuestra Señora de La Paz","Escuela Chasquipampa",35,0,5,0,148,2,11,0,2,203,11,10,224,228,0.729,0.982
"3013","La Paz","Nuestra Señora de La Paz","Escuela Chasquipampa",70,0,2,1,122,3,10,0,0,208,0,6,214,228,0.587,0.939
"3014","La Paz","Nuestra Señora de La Paz","Escuela Chasquipampa",83,1,2,0,92,2,16,2,0,198,2,5,205,227,0.465,0.903
"3015","La Paz","Nuestra Señora de La Paz","Escuela Chasquipampa",113,0,2,2,76,1,10,2,0,206,1,4,211,231,0.369,0.913
"3016","La Paz","Nuestra Señora de La Paz","Escuela Chasquipampa",56,1,4,1,121,2,14,0,1,200,0,9,209,229,0.605,0.913
"3017","La Paz","Nuestra Señora de La Paz","U.E. Bolivian High School",72,0,2,0,124,1,19,0,0,218,0,9,227,237,0.569,0.958
"3018","La Paz","Nuestra Señora de La Paz","U.E. Bolivian High School",95,0,2,0,105,0,21,3,0,226,1,5,232,239,0.465,0.971
"3019","La Paz","Nuestra Señora de La Paz","U.E. Bolivian High School",71,0,3,1,110,3,27,4,0,219,2,11,232,239,0.502,0.971
"3020","La Paz","Nuestra Señora de La Paz","U.E. Bolivian High School",88,0,2,1,100,1,23,0,1,216,0,13,229,239,0.463,0.958
"3021","La Paz","Nuestra Señora de La Paz","Seminario Nazareno",134,0,1,0,39,0,7,2,1,184,0,2,186,226,0.212,0.823
"3022","La Paz","Nuestra Señora de La Paz","Seminario Nazareno",134,0,0,1,46,0,3,1,0,185,0,5,190,227,0.249,0.837
"3023","La Paz","Nuestra Señora de La Paz","Seminario Nazareno",133,0,0,1,27,2,10,0,0,173,0,3,176,228,0.156,0.772
"3024","La Paz","Nuestra Señora de La Paz","Centro de Capacitacion Inti Paxsi",133,0,1,1,49,3,12,1,0,200,1,8,209,229,0.245,0.913
"3025","La Paz","Nuestra Señora de La Paz","Centro de Capacitacion Inti Paxsi",115,0,2,0,76,2,10,0,0,205,4,4,213,233,0.371,0.914
"3026","La Paz","Nuestra Señora de La Paz","Centro de Capacitacion Inti Paxsi",117,0,1,0,81,1,4,0,0,204,2,3,209,228,0.397,0.917
"3027","La Paz","Nuestra Señora de La Paz","Centro de Capacitacion Inti Paxsi",106,0,0,2,79,0,12,1,1,201,3,7,211,232,0.393,0.909
"3028","La Paz","Nuestra Señora de La Paz","Centro de Capacitacion Inti Paxsi",80,0,1,0,100,3,19,1,0,204,0,4,208,223,0.49,0.933
"3029","La Paz","Nuestra Señora de La Paz","Centro de Capacitacion Inti Paxsi",129,0,1,3,53,1,9,0,0,196,0,5,201,229,0.27,0.878
"3030","La Paz","Nuestra Señora de La Paz","Centro de Capacitacion Inti Paxsi",93,1,1,1,98,0,10,0,1,205,2,5,212,230,0.478,0.922
"3031","La Paz","Nuestra Señora de La Paz","Centro de Capacitacion Inti Paxsi",130,1,3,0,60,3,8,0,0,205,1,5,211,232,0.293,0.909
"3032","La Paz","Nuestra Señora de La Paz","Centro de Capacitacion Inti Paxsi",71,0,1,1,96,0,6,2,0,177,1,1,179,191,0.542,0.937
"3033","La Paz","Nuestra Señora de La Paz","Unidad Educativa Mallasa",87,0,4,1,79,2,14,1,0,188,3,7,198,228,0.42,0.868
"3034","La Paz","Nuestra Señora de La Paz","Unidad Educativa Mallasa",72,0,3,0,101,0,18,0,0,194,1,3,198,224,0.521,0.884
"3035","La Paz","Nuestra Señora de La Paz","Unidad Educativa Mallasa",68,0,1,0,103,4,26,0,2,204,1,8,213,230,0.505,0.926
"3036","La Paz","Nuestra Señora de La Paz","Unidad Educativa Mallasa",93,0,3,0,86,3,19,0,1,205,0,4,209,227,0.42,0.921
"3037","La Paz","Nuestra Señora de La Paz","Unidad Educativa Mallasa",62,0,2,0,113,1,23,0,0,201,2,3,206,220,0.562,0.936
"3038","La Paz","Nuestra Señora de La Paz","Unidad Educativa Mallasa",82,0,3,1,88,1,17,1,3,196,2,3,201,226,0.449,0.889
"3039","La Paz","Nuestra Señora de La Paz","Unidad Educativa Mallasa",38,0,3,0,147,0,24,1,0,213,1,2,216,229,0.69,0.943
"3040","La Paz","Nuestra Señora de La Paz","Unidad Educativa Mallasa",93,0,1,1,90,3,15,1,0,204,1,3,208,228,0.441,0.912
"3041","La Paz","Nuestra Señora de La Paz","Unidad Educativa Jupapina",100,0,2,0,84,1,11,2,0,200,1,3,204,228,0.42,0.895
"3042","La Paz","Nuestra Señora de La Paz","Unidad Educativa Jupapina",61,2,2,0,125,1,13,0,1,205,1,4,210,232,0.61,0.905
"3043","La Paz","Nuestra Señora de La Paz","Unidad Educativa Jupapina",100,1,2,1,81,0,10,0,0,195,1,4,200,222,0.415,0.901
"3044","La Paz","Nuestra Señora de La Paz","Unidad Educativa Jupapina",63,0,2,0,118,0,20,0,0,203,0,4,207,229,0.581,0.904
"3045","La Paz","Nuestra Señora de La Paz","Unidad Educativa Jupapina",59,0,7,0,108,2,17,0,0,193,1,3,197,226,0.56,0.872
"3046","La Paz","Nuestra Señora de La Paz","Unidad Educativa Jupapina",58,0,5,1,110,1,21,0,0,196,6,10,212,234,0.561,0.906
"3047","La Paz","Nuestra Señora de La Paz","Col. Herschell",116,0,1,1,52,3,10,2,0,185,0,4,189,217,0.281,0.871
"3048","La Paz","Nuestra Señora de La Paz","Col. Herschell",120,0,2,0,48,1,13,0,2,186,1,3,190,220,0.258,0.864
"3049","La Paz","Nuestra Señora de La Paz","Col. Herschell",148,0,3,0,28,1,13,2,1,196,0,3,199,225,0.143,0.884
"3050","La Paz","Nuestra Señora de La Paz","Col. Herschell",133,0,0,0,44,1,6,0,0,184,0,7,191,226,0.239,0.845
"3051","La Paz","Nuestra Señora de La Paz","Col. Herschell",126,0,2,0,50,1,8,3,0,190,1,6,197,222,0.263,0.887
"3052","La Paz","Nuestra Señora de La Paz","Col. Herschell",94,1,2,0,72,4,14,2,1,190,3,9,202,225,0.379,0.898
"3053","La Paz","Nuestra Señora de La Paz","Col. Herschell",131,0,5,0,61,4,7,0,1,209,0,4,213,230,0.292,0.926
"3054","La Paz","Nuestra Señora de La Paz","Col. Herschell",140,0,2,0,35,2,8,2,0,189,1,9,199,231,0.185,0.861
"3055","La Paz","Nuestra Señora de La Paz","Col. Herschell",134,0,0,1,42,3,8,4,0,192,1,7,200,225,0.219,0.889
"3056","La Paz","Nuestra Señora de La Paz","Col. Herschell",153,0,1,0,32,1,7,3,0,197,0,5,202,224,0.162,0.902
"3057","La Paz","Nuestra Señora de La Paz","Col. Herschell",135,0,1,0,49,1,5,1,0,192,1,3,196,218,0.255,0.899
"3058","La Paz","Nuestra Señora de La Paz","Col. Herschell",122,0,3,0,50,4,7,1,2,189,0,4,193,226,0.265,0.854
"3059","La Paz","Nuestra Señora de La Paz","Col. Herschell",97,0,4,0,81,0,14,2,1,199,1,3,203,226,0.407,0.898
"3060","La Paz","Nuestra Señora de La Paz","Col. Herschell",124,1,0,1,58,5,11,0,0,200,1,4,205,227,0.29,0.903
"3061","La Paz","Nuestra Señora de La Paz","Col. Herschell",156,0,1,0,29,3,5,1,1,196,0,10,206,228,0.148,0.904
"3062","La Paz","Nuestra Señora de La Paz","Col. Herschell",142,1,0,0,36,1,7,3,1,191,1,0,192,220,0.188,0.873
"3063","La Paz","Nuestra Señora de La Paz","Col. Herschell",129,0,0,0,60,0,8,1,0,198,2,1,201,223,0.303,0.901
"3064","La Paz","Nuestra Señora de La Paz","Col. Herschell",123,0,4,0,58,3,8,0,0,196,0,6,202,230,0.296,0.878
"3065","La Paz","Nuestra Señora de La Paz","Col. Herschell",132,0,5,2,42,1,7,1,0,190,0,6,196,223,0.221,0.879
"3066","La Paz","Nuestra Señora de La Paz","Col. Herschell",132,0,0,0,42,4,9,1,1,189,1,4,194,228,0.222,0.851
"3067","La Paz","Nuestra Señora de La Paz","Col. Herschell",137,0,1,1,41,4,7,1,1,193,2,6,201,226,0.212,0.889
"3068","La Paz","Nuestra Señora de La Paz","Col. Herschell",140,1,1,2,42,0,11,0,1,198,1,1,200,224,0.212,0.893
"3069","La Paz","Nuestra Señora de La Paz","Col. Herschell",134,0,2,0,38,0,9,2,2,187,1,3,191,233,0.203,0.82
"3070","La Paz","Nuestra Señora de La Paz","Col. Herschell",139,0,1,0,34,1,4,3,1,183,0,4,187,218,0.186,0.858
"3071","La Paz","Nuestra Señora de La Paz","Instituto Americano Obrajes",148,1,1,0,44,2,6,0,1,203,0,3,206,235,0.217,0.877
"3072","La Paz","Nuestra Señora de La Paz","Instituto Americano Obrajes",156,1,0,1,41,0,6,3,0,208,1,2,211,228,0.197,0.925
"3073","La Paz","Nuestra Señora de La Paz","Instituto Americano Obrajes",156,0,1,0,41,2,6,0,0,206,0,6,212,232,0.199,0.914
"3074","La Paz","Nuestra Señora de La Paz","Instituto Americano Obrajes",128,0,0,4,48,2,10,0,1,193,1,4,198,222,0.249,0.892
"3075","La Paz","Nuestra Señora de La Paz","Instituto Americano Obrajes",130,1,1,1,49,5,12,2,1,202,1,3,206,227,0.243,0.907
"3076","La Paz","Nuestra Señora de La Paz","Instituto Americano Obrajes",137,1,1,0,49,3,3,0,1,195,2,4,201,227,0.251,0.885
"3077","La Paz","Nuestra Señora de La Paz","Instituto Americano Obrajes",151,0,0,1,32,1,7,0,0,192,1,8,201,233,0.167,0.863
"3078","La Paz","Nuestra Señora de La Paz","Instituto Americano Obrajes",146,0,0,2,34,5,9,2,0,198,1,5,204,227,0.172,0.899
"3079","La Paz","Nuestra Señora de La Paz","Instituto Americano Obrajes",161,0,1,1,41,2,4,1,0,211,1,0,212,230,0.194,0.922
"3080","La Paz","Nuestra Señora de La Paz","Instituto Americano Obrajes",150,0,2,1,41,2,6,3,0,205,0,4,209,230,0.2,0.909
"3081","La Paz","Nuestra Señora de La Paz","Instituto Americano Obrajes",152,0,0,1,44,1,8,1,0,207,2,4,213,227,0.213,0.938
"3082","La Paz","Nuestra Señora de La Paz","Instituto Americano Obrajes",135,0,1,0,42,4,9,1,5,197,2,4,203,234,0.213,0.868
"3083","La Paz","Nuestra Señora de La Paz","Instituto Americano Obrajes",162,0,0,0,33,1,4,0,0,200,0,1,201,228,0.165,0.882
"3084","La Paz","Nuestra Señora de La Paz","Instituto Americano Obrajes",157,0,0,2,22,2,6,1,0,190,1,6,197,229,0.116,0.86
"3085","La Paz","Nuestra Señora de La Paz","Instituto Americano Obrajes",129,0,0,1,45,1,4,2,0,182,2,6,190,222,0.247,0.856
"3086","La Paz","Nuestra Señora de La Paz","Instituto Americano Obrajes",120,0,2,1,47,2,12,2,0,186,1,13,200,222,0.253,0.901
"3087","La Paz","Nuestra Señora de La Paz","Instituto Americano Obrajes",144,0,1,1,35,4,2,1,0,188,2,6,196,220,0.186,0.891
"3088","La Paz","Nuestra Señora de La Paz","Instituto Americano Obrajes",167,0,0,2,24,2,5,1,1,202,0,3,205,226,0.119,0.907
"3089","La Paz","Nuestra Señora de La Paz","Instituto Americano Obrajes",150,0,1,1,45,3,2,0,1,203,1,1,205,230,0.222,0.891
"3090","La Paz","Nuestra Señora de La Paz","Instituto Americano Obrajes",145,0,1,1,37,0,8,1,2,195,2,6,203,224,0.19,0.906
"3091","La Paz","Nuestra Señora de La Paz","Instituto Americano Obrajes",162,0,1,0,32,0,7,0,1,203,2,3,208,227,0.158,0.916
"3092","La Paz","Nuestra Señora de La Paz","Instituto Americano Obrajes",158,0,0,1,34,0,5,0,1,199,1,2,202,233,0.171,0.867
"3093","La Paz","Nuestra Señora de La Paz","Cancha Deportiva - 1603",106,0,3,1,75,2,11,1,1,200,4,2,206,223,0.375,0.924
"3094","La Paz","Nuestra Señora de La Paz","Cancha Deportiva - 1603",123,0,2,2,61,1,6,3,2,200,1,6,207,220,0.305,0.941
"3095","La Paz","Nuestra Señora de La Paz","Cancha Deportiva - 1603",94,0,1,8,72,3,16,3,1,198,1,8,207,228,0.364,0.908
"3096","La Paz","Nuestra Señora de La Paz","Cancha Deportiva - 1603",61,1,6,0,109,0,16,0,2,195,0,7,202,226,0.559,0.894
"3097","La Paz","Nuestra Señora de La Paz","Cancha Deportiva - 1603",118,1,1,2,66,1,5,0,0,194,1,9,204,223,0.34,0.915
"3098","La Paz","Nuestra Señora de La Paz","Cancha Deportiva - 1603",91,2,0,1,83,0,10,0,0,187,2,6,195,221,0.444,0.882
"3099","La Paz","Nuestra Señora de La Paz","Cancha Deportiva - 1603",73,1,4,2,95,1,13,2,2,193,3,9,205,225,0.492,0.911
"3100","La Paz","Nuestra Señora de La Paz","Cancha Deportiva - 1603",83,0,5,2,109,1,7,1,1,209,0,3,212,223,0.522,0.951
"3101","La Paz","Nuestra Señora de La Paz","Cancha Deportiva - 1603",80,0,3,1,94,2,14,0,3,197,0,6,203,224,0.477,0.906
"3102","La Paz","Nuestra Señora de La Paz","Cancha Deportiva - 1603",117,0,1,2,52,6,11,1,0,190,0,10,200,222,0.274,0.901
"3103","La Paz","Nuestra Señora de La Paz","Cancha Deportiva - 1603",96,1,5,0,71,4,11,2,3,193,1,6,200,221,0.368,0.905
"3104","La Paz","Nuestra Señora de La Paz","Cancha Deportiva - 1603",107,2,5,0,65,4,13,0,1,197,1,8,206,224,0.33,0.92
"3105","La Paz","Nuestra Señora de La Paz","Cancha Deportiva - 1603",123,0,1,0,52,5,11,0,2,194,3,6,203,227,0.268,0.894
"3106","La Paz","Nuestra Señora de La Paz","Cancha Deportiva - 1603",106,0,5,0,83,2,7,2,1,206,2,2,210,224,0.403,0.938
"3107","La Paz","Nuestra Señora de La Paz","Cancha Deportiva - 1603",80,1,2,0,62,4,4,0,1,154,1,5,160,177,0.403,0.904
"3108","La Paz","Nuestra Señora de La Paz","Esc. Francisco De Miranda",81,0,4,0,101,0,19,1,0,206,3,8,217,232,0.49,0.935
"3109","La Paz","Nuestra Señora de La Paz","Esc. Francisco De Miranda",83,0,4,1,106,0,15,0,0,209,1,3,213,235,0.507,0.906
"3110","La Paz","Nuestra Señora de La Paz","Esc. Francisco De Miranda",76,0,3,0,99,2,15,2,4,201,1,5,207,227,0.493,0.912
"3111","La Paz","Nuestra Señora de La Paz","Esc. Francisco De Miranda",65,0,0,1,103,3,29,0,2,203,3,4,210,227,0.507,0.925
"3112","La Paz","Nuestra Señora de La Paz","Esc. Francisco De Miranda",50,0,5,1,123,2,17,1,1,200,1,9,210,227,0.615,0.925
"3113","La Paz","Nuestra Señora de La Paz","Esc. Francisco De Miranda",58,0,6,1,123,5,13,0,2,208,3,3,214,233,0.591,0.918
"3114","La Paz","Nuestra Señora de La Paz","Esc. Francisco De Miranda",84,1,6,1,96,0,22,0,2,212,0,6,218,232,0.453,0.94
"3115","La Paz","Nuestra Señora de La Paz","Esc. Francisco De Miranda",84,0,2,0,83,3,18,1,0,191,2,6,199,226,0.435,0.881
"3116","La Paz","Nuestra Señora de La Paz","Esc. Francisco De Miranda",64,1,3,2,128,2,6,0,0,206,1,3,210,230,0.621,0.913
"3117","La Paz","Nuestra Señora de La Paz","Esc. Francisco De Miranda",57,0,3,0,124,0,22,0,0,206,2,6,214,227,0.602,0.943
"3118","La Paz","Nuestra Señora de La Paz","Esc. Francisco De Miranda",76,1,3,0,103,1,11,1,4,200,2,5,207,230,0.515,0.9
"3119","La Paz","Nuestra Señora de La Paz","Esc. Francisco De Miranda",67,0,7,3,97,2,11,0,1,188,1,5,194,221,0.516,0.878
"3120","La Paz","Nuestra Señora de La Paz","Esc. Francisco De Miranda",44,0,3,1,134,5,17,1,1,206,3,8,217,231,0.65,0.939
"3121","La Paz","Nuestra Señora de La Paz","Esc. Francisco De Miranda",85,0,5,1,105,2,12,0,2,212,1,2,215,233,0.495,0.923
"3122","La Paz","Nuestra Señora de La Paz","Esc. Francisco De Miranda",78,0,9,0,85,1,16,7,0,196,1,10,207,228,0.434,0.908
"3123","La Paz","Nuestra Señora de La Paz","Esc. Francisco De Miranda",65,0,3,0,114,1,19,1,1,204,3,7,214,229,0.559,0.934
"3124","La Paz","Nuestra Señora de La Paz","Esc. Francisco De Miranda",60,2,5,0,109,5,23,2,1,207,1,6,214,230,0.527,0.93
"3125","La Paz","Nuestra Señora de La Paz","Esc. Francisco De Miranda",48,0,6,0,128,5,17,0,3,207,4,11,222,231,0.618,0.961
"3126","La Paz","Nuestra Señora de La Paz","Esc. Francisco De Miranda",84,0,3,2,99,3,9,0,0,200,0,7,207,225,0.495,0.92
"3127","La Paz","Nuestra Señora de La Paz","Esc. Francisco De Miranda",88,1,2,1,92,0,18,0,2,204,3,5,212,231,0.451,0.918
"3128","La Paz","Nuestra Señora de La Paz","Esc. Francisco De Miranda",81,1,4,1,97,0,9,0,3,196,3,8,207,225,0.495,0.92
"3129","La Paz","Nuestra Señora de La Paz","Esc. Francisco De Miranda",77,2,3,2,106,4,12,0,2,208,0,4,212,228,0.51,0.93
"3130","La Paz","Nuestra Señora de La Paz","Esc. Francisco De Miranda",76,0,2,1,91,3,18,1,3,195,1,10,206,234,0.467,0.88
"3131","La Paz","Nuestra Señora de La Paz","Plaza Daniel Rodriguez",90,1,3,0,86,1,14,0,1,196,2,5,203,217,0.439,0.935
"3132","La Paz","Nuestra Señora de La Paz","Plaza Daniel Rodriguez",90,0,1,0,78,4,16,1,0,190,0,7,197,223,0.411,0.883
"3133","La Paz","Nuestra Señora de La Paz","Plaza Daniel Rodriguez",80,0,3,2,100,3,14,1,0,203,0,5,208,229,0.493,0.908
"3134","La Paz","Nuestra Señora de La Paz","Plaza Daniel Rodriguez",122,0,0,0,70,3,12,1,3,211,1,2,214,225,0.332,0.951
"3135","La Paz","Nuestra Señora de La Paz","Plaza Daniel Rodriguez",104,1,2,0,79,0,9,2,1,198,0,4,202,221,0.399,0.914
"3136","La Paz","Nuestra Señora de La Paz","Plaza Daniel Rodriguez",88,1,4,0,88,5,7,0,0,193,2,9,204,223,0.456,0.915
"3137","La Paz","Nuestra Señora de La Paz","Plaza Daniel Rodriguez",92,1,3,1,85,2,12,0,2,198,1,8,207,227,0.429,0.912
"3138","La Paz","Nuestra Señora de La Paz","Plaza Daniel Rodriguez",94,0,4,1,76,3,13,3,1,195,1,5,201,227,0.39,0.885
"3139","La Paz","Nuestra Señora de La Paz","Plaza Daniel Rodriguez",64,1,1,0,97,2,14,1,2,182,0,10,192,207,0.533,0.928
"3140","La Paz","Nuestra Señora de La Paz","Plaza Daniel Rodriguez",106,1,2,0,73,0,12,0,2,196,0,5,201,215,0.372,0.935
"3141","La Paz","Nuestra Señora de La Paz","Plaza Daniel Rodriguez",96,0,3,1,74,3,10,1,1,189,1,6,196,220,0.392,0.891
"3142","La Paz","Nuestra Señora de La Paz","Escuela Juan Pablo II",133,0,2,0,50,6,8,0,0,199,2,3,204,225,0.251,0.907
"3143","La Paz","Nuestra Señora de La Paz","Escuela Juan Pablo II",164,0,1,0,30,2,4,0,0,201,1,5,207,222,0.149,0.932
"3144","La Paz","Nuestra Señora de La Paz","Escuela Juan Pablo II",128,0,0,1,56,0,3,0,0,188,0,4,192,219,0.298,0.877
"3145","La Paz","Nuestra Señora de La Paz","Escuela Juan Pablo II",122,0,1,0,55,1,10,0,1,190,2,3,195,222,0.289,0.878
"3146","La Paz","Nuestra Señora de La Paz","Escuela Juan Pablo II",140,0,1,0,45,2,11,1,1,201,2,2,205,227,0.224,0.903
"3147","La Paz","Nuestra Señora de La Paz","Escuela Juan Pablo II",145,0,1,1,39,1,6,2,1,196,0,6,202,225,0.199,0.898
"3148","La Paz","Nuestra Señora de La Paz","Escuela Juan Pablo II",110,1,2,0,73,1,9,2,1,199,1,7,207,231,0.367,0.896
"3149","La Paz","Nuestra Señora de La Paz","Escuela Juan Pablo II",126,0,2,1,57,3,9,3,1,202,1,2,205,227,0.282,0.903
"3150","La Paz","Nuestra Señora de La Paz","Escuela Juan Pablo II",144,0,1,1,39,1,7,0,1,194,1,2,197,226,0.201,0.872
"3151","La Paz","Nuestra Señora de La Paz","Escuela Juan Pablo II",143,2,2,0,48,2,4,0,0,201,0,3,204,222,0.239,0.919
"3152","La Paz","Nuestra Señora de La Paz","Escuela Juan Pablo II",137,0,0,0,51,2,14,1,0,205,0,2,207,233,0.249,0.888
"3153","La Paz","Nuestra Señora de La Paz","Escuela Juan Pablo II",145,0,0,1,44,3,5,0,0,198,0,6,204,223,0.222,0.915
"3154","La Paz","Nuestra Señora de La Paz","Escuela Juan Pablo II",146,0,0,0,39,2,8,1,2,198,1,3,202,222,0.197,0.91
"3155","La Paz","Nuestra Señora de La Paz","Escuela Juan Pablo II",128,0,0,0,47,6,10,1,0,192,2,3,197,224,0.245,0.879
"3156","La Paz","Nuestra Señora de La Paz","Unidad Educativa Rosario (Urb. El Rosario)",97,1,2,1,94,2,14,0,6,217,2,6,225,236,0.433,0.953
"3157","La Paz","Nuestra Señora de La Paz","Unidad Educativa Rosario (Urb. El Rosario)",94,0,5,0,102,2,11,1,4,219,1,5,225,237,0.466,0.949
"3158","La Paz","Nuestra Señora de La Paz","Unidad Educativa Rosario (Urb. El Rosario)",101,2,0,0,90,1,28,0,2,224,1,1,226,239,0.402,0.946
"3159","La Paz","Nuestra Señora de La Paz","Unidad Educativa Rosario (Urb. El Rosario)",115,1,2,1,92,1,12,0,2,226,1,1,228,239,0.407,0.954
"3160","La Paz","Nuestra Señora de La Paz","Unidad Educativa Rosario (Urb. El Rosario)",124,0,2,0,71,6,17,1,0,221,1,7,229,237,0.321,0.966
"3161","La Paz","Nuestra Señora de La Paz","Colegio San Ignacio",128,1,0,0,37,1,16,0,3,186,1,0,187,229,0.199,0.817
"3162","La Paz","Nuestra Señora de La Paz","Colegio San Ignacio",134,0,1,2,39,5,16,1,0,198,1,3,202,231,0.197,0.874
"3163","La Paz","Nuestra Señora de La Paz","Colegio San Ignacio",142,0,1,2,19,1,22,0,2,189,0,0,189,230,0.101,0.822
"3164","La Paz","Nuestra Señora de La Paz","Colegio San Ignacio",112,1,3,0,43,0,21,2,3,185,1,1,187,231,0.232,0.81
"3165","La Paz","Nuestra Señora de La Paz","Colegio San Ignacio",123,0,0,1,29,1,26,0,1,181,0,3,184,229,0.16,0.803
"3166","La Paz","Nuestra Señora de La Paz","Colegio San Ignacio",119,0,1,1,33,5,16,0,0,175,0,2,177,226,0.189,0.783
"3167","La Paz","Nuestra Señora de La Paz","Colegio San Ignacio",128,0,0,0,39,2,18,0,0,187,1,7,195,234,0.209,0.833
"3168","La Paz","Nuestra Señora de La Paz","Colegio San Ignacio",113,0,1,1,40,3,16,2,0,176,0,6,182,227,0.227,0.802
"3169","La Paz","Nuestra Señora de La Paz","Colegio San Ignacio",106,0,2,1,41,3,27,0,1,181,3,4,188,229,0.227,0.821
"3170","La Paz","Nuestra Señora de La Paz","Colegio San Ignacio",128,0,1,3,29,1,19,0,1,182,0,3,185,225,0.159,0.822
"3171","La Paz","Nuestra Señora de La Paz","Colegio San Ignacio",135,0,0,0,31,5,9,1,0,181,1,2,184,227,0.171,0.811
"3172","La Paz","Nuestra Señora de La Paz","Colegio San Ignacio",88,0,0,0,56,1,27,0,1,173,0,0,173,231,0.324,0.749
"3173","La Paz","Nuestra Señora de La Paz","Colegio San Ignacio",143,0,0,1,18,1,18,0,0,181,0,3,184,232,0.099,0.793
"3174","La Paz","Nuestra Señora de La Paz","Colegio San Ignacio",117,0,1,0,23,4,18,1,3,167,1,5,173,222,0.138,0.779
"3175","La Paz","Nuestra Señora de La Paz","Colegio San Ignacio",143,0,1,0,33,3,11,0,1,192,0,0,192,227,0.172,0.846
"3176","La Paz","Nuestra Señora de La Paz","Colegio Amoretti",130,1,1,2,44,1,6,0,2,187,0,14,201,222,0.235,0.905
"3177","La Paz","Nuestra Señora de La Paz","Colegio Amoretti",142,0,1,0,42,3,5,1,1,195,0,7,202,227,0.215,0.89
"3178","La Paz","Nuestra Señora de La Paz","Colegio Amoretti",141,0,2,1,49,3,9,0,0,205,0,3,208,227,0.239,0.916
"3179","La Paz","Nuestra Señora de La Paz","Colegio Amoretti",119,0,1,0,56,6,10,0,1,193,0,4,197,218,0.29,0.904
"3180","La Paz","Nuestra Señora de La Paz","Colegio Amoretti",117,1,3,0,51,2,10,0,1,185,0,11,196,217,0.276,0.903
"3181","La Paz","Nuestra Señora de La Paz","Colegio Amoretti",118,0,3,0,51,3,8,1,2,186,3,3,192,218,0.274,0.881
"3182","La Paz","Nuestra Señora de La Paz","Colegio Amoretti",116,0,0,1,51,4,11,0,1,184,0,3,187,227,0.277,0.824
"3183","La Paz","Nuestra Señora de La Paz","Colegio Amoretti",104,0,2,1,64,3,10,0,1,185,1,1,187,215,0.346,0.87
"3184","La Paz","Nuestra Señora de La Paz","Colegio Amoretti",119,0,0,0,54,2,7,1,1,184,0,8,192,221,0.293,0.869
"3185","La Paz","Nuestra Señora de La Paz","Colegio Amoretti",117,1,3,0,60,1,11,0,3,196,0,2,198,217,0.306,0.912
"3186","La Paz","Nuestra Señora de La Paz","Colegio Amoretti",153,0,0,0,34,0,8,1,1,197,2,4,203,220,0.173,0.923
"3187","La Paz","Nuestra Señora de La Paz","Colegio Amoretti",133,1,3,1,38,2,8,0,0,186,1,2,189,215,0.204,0.879
"3188","La Paz","Nuestra Señora de La Paz","Colegio Amoretti",149,0,1,1,32,1,7,0,0,191,1,6,198,224,0.168,0.884
"3189","La Paz","Nuestra Señora de La Paz","Kinder Nazario Pardo",113,1,0,0,68,1,14,0,1,198,2,4,204,229,0.343,0.891
"3190","La Paz","Nuestra Señora de La Paz","Kinder Nazario Pardo",90,1,4,1,81,4,14,1,2,198,1,9,208,225,0.409,0.924
"3191","La Paz","Nuestra Señora de La Paz","Kinder Nazario Pardo",101,0,4,0,77,0,16,0,2,200,0,7,207,228,0.385,0.908
"3192","La Paz","Nuestra Señora de La Paz","Kinder Nazario Pardo",113,0,3,1,62,5,5,0,0,189,0,7,196,221,0.328,0.887
"3193","La Paz","Nuestra Señora de La Paz","Kinder Nazario Pardo",99,0,3,2,72,1,18,0,1,196,1,4,201,226,0.367,0.889
"3194","La Paz","Nuestra Señora de La Paz","Kinder Nazario Pardo",92,0,1,1,80,2,0,0,0,176,2,4,182,224,0.455,0.812
"3195","La Paz","Nuestra Señora de La Paz","Kinder Nazario Pardo",89,5,5,2,83,3,11,2,0,200,1,16,217,227,0.415,0.956
"3196","La Paz","Nuestra Señora de La Paz","Kinder Nazario Pardo",110,0,2,1,72,2,5,0,0,192,0,13,205,219,0.375,0.936
"3197","La Paz","Nuestra Señora de La Paz","Kinder Nazario Pardo",101,1,3,0,69,2,14,1,1,192,0,9,201,227,0.359,0.885
"3198","La Paz","Nuestra Señora de La Paz","Col. Gregorio Reynolds",111,0,0,1,58,3,13,3,2,191,0,12,203,223,0.304,0.91
"3199","La Paz","Nuestra Señora de La Paz","Col. Gregorio Reynolds",141,1,1,1,38,2,11,0,2,197,0,9,206,228,0.193,0.904
"3200","La Paz","Nuestra Señora de La Paz","Col. Gregorio Reynolds",130,1,2,2,52,3,11,0,0,201,0,2,203,225,0.259,0.902
"3201","La Paz","Nuestra Señora de La Paz","Col. Gregorio Reynolds",128,0,1,0,51,2,10,0,0,192,2,7,201,227,0.266,0.885
"3202","La Paz","Nuestra Señora de La Paz","Col. Gregorio Reynolds",114,0,1,0,72,3,11,2,0,203,1,8,212,227,0.355,0.934
"3203","La Paz","Nuestra Señora de La Paz","Col. Gregorio Reynolds",140,0,3,0,54,1,4,0,2,204,2,4,210,230,0.265,0.913
"3204","La Paz","Nuestra Señora de La Paz","Col. Gregorio Reynolds",134,1,1,1,49,4,11,1,0,202,1,7,210,229,0.243,0.917
"3205","La Paz","Nuestra Señora de La Paz","Col. Gregorio Reynolds",112,0,3,0,72,0,11,0,0,198,1,7,206,227,0.364,0.907
"3206","La Paz","Nuestra Señora de La Paz","Col. Gregorio Reynolds",126,0,0,0,61,3,5,0,1,196,2,1,199,228,0.311,0.873
"3207","La Paz","Nuestra Señora de La Paz","Col. Gregorio Reynolds",106,0,3,0,65,2,11,1,1,189,0,7,196,221,0.344,0.887
"3208","La Paz","Nuestra Señora de La Paz","Col. Gregorio Reynolds",137,0,1,0,50,2,7,0,0,197,4,9,210,229,0.254,0.917
"3209","La Paz","Nuestra Señora de La Paz","Col. Gregorio Reynolds",135,0,0,3,44,3,2,0,1,188,1,2,191,223,0.234,0.857
"3210","La Paz","Nuestra Señora de La Paz","Col. Gregorio Reynolds",147,2,1,1,36,1,12,0,1,201,1,6,208,228,0.179,0.912
"3211","La Paz","Nuestra Señora de La Paz","Col. Gregorio Reynolds",106,0,1,0,73,4,11,1,1,197,2,7,206,225,0.371,0.916
"3212","La Paz","Nuestra Señora de La Paz","Col. Gregorio Reynolds",150,2,1,0,40,2,8,0,2,205,0,9,214,227,0.195,0.943
"3213","La Paz","Nuestra Señora de La Paz","Col. Gregorio Reynolds",144,0,1,0,44,3,10,1,1,204,1,6,211,226,0.216,0.934
"3214","La Paz","Nuestra Señora de La Paz","Col. Gregorio Reynolds",132,0,0,2,47,4,12,0,0,197,0,7,204,228,0.239,0.895
"3215","La Paz","Nuestra Señora de La Paz","Col. Gregorio Reynolds",158,0,0,0,47,3,5,0,1,214,1,2,217,228,0.22,0.952
"3216","La Paz","Nuestra Señora de La Paz","Col. Gregorio Reynolds",107,1,1,1,60,0,10,0,0,180,2,2,184,192,0.333,0.958
"3217","La Paz","Nuestra Señora de La Paz","Escuela Agustin Aspiazu",158,1,0,0,43,2,4,0,0,208,0,6,214,234,0.207,0.915
"3218","La Paz","Nuestra Señora de La Paz","Escuela Agustin Aspiazu",123,0,2,1,44,2,9,1,2,184,0,7,191,229,0.239,0.834
"3219","La Paz","Nuestra Señora de La Paz","Escuela Agustin Aspiazu",137,0,0,1,36,2,3,2,0,181,0,5,186,223,0.199,0.834
"3220","La Paz","Nuestra Señora de La Paz","Escuela Agustin Aspiazu",133,0,3,3,46,3,10,1,1,200,1,2,203,224,0.23,0.906
"3221","La Paz","Nuestra Señora de La Paz","Escuela Agustin Aspiazu",140,0,0,1,35,1,5,1,1,184,1,6,191,222,0.19,0.86
"3222","La Paz","Nuestra Señora de La Paz","Escuela Agustin Aspiazu",142,0,1,0,41,0,2,2,0,188,2,1,191,225,0.218,0.849
"3223","La Paz","Nuestra Señora de La Paz","Escuela Agustin Aspiazu",137,0,2,1,45,3,7,0,1,196,0,3,199,228,0.23,0.873
"3224","La Paz","Nuestra Señora de La Paz","Escuela Agustin Aspiazu",134,0,0,0,40,3,6,0,1,184,2,2,188,221,0.217,0.851
"3225","La Paz","Nuestra Señora de La Paz","Escuela Agustin Aspiazu",142,0,2,1,29,2,7,0,0,183,3,4,190,223,0.158,0.852
"3226","La Paz","Nuestra Señora de La Paz","Escuela Agustin Aspiazu",120,0,2,1,49,2,9,1,3,187,0,2,189,228,0.262,0.829
"3227","La Paz","Nuestra Señora de La Paz","Escuela Agustin Aspiazu",155,0,1,0,26,1,7,3,3,196,2,7,205,229,0.133,0.895
"3228","La Paz","Nuestra Señora de La Paz","Escuela Agustin Aspiazu",136,1,1,3,42,4,5,1,0,193,0,7,200,229,0.218,0.873
"3229","La Paz","Nuestra Señora de La Paz","Escuela Agustin Aspiazu",137,0,1,0,43,2,7,1,0,191,0,4,195,229,0.225,0.852
"3230","La Paz","Nuestra Señora de La Paz","Escuela Agustin Aspiazu",129,0,3,0,54,1,6,0,0,193,1,4,198,231,0.28,0.857
"3231","La Paz","Nuestra Señora de La Paz","Escuela Agustin Aspiazu",142,0,0,0,39,2,7,0,1,191,1,7,199,234,0.204,0.85
"3232","La Paz","Nuestra Señora de La Paz","Escuela Agustin Aspiazu",136,0,0,0,43,3,5,0,1,188,1,2,191,225,0.229,0.849
"3233","La Paz","Nuestra Señora de La Paz","Escuela Agustin Aspiazu",137,0,1,1,51,1,5,0,0,196,0,3,199,227,0.26,0.877
"3234","La Paz","Nuestra Señora de La Paz","Escuela Agustin Aspiazu",151,0,2,0,33,5,9,0,0,200,1,3,204,229,0.165,0.891
"3235","La Paz","Nuestra Señora de La Paz","Esc. Ecuador",117,0,3,3,39,3,4,1,1,171,0,6,177,213,0.228,0.831
"3236","La Paz","Nuestra Señora de La Paz","Esc. Ecuador",132,0,1,0,28,2,9,2,0,174,1,3,178,213,0.161,0.836
"3237","La Paz","Nuestra Señora de La Paz","Esc. Ecuador",126,1,1,1,47,4,12,1,0,193,0,3,196,221,0.244,0.887
"3238","La Paz","Nuestra Señora de La Paz","Esc. Ecuador",126,0,3,0,36,5,9,1,0,180,0,5,185,212,0.2,0.873
"3239","La Paz","Nuestra Señora de La Paz","Esc. Ecuador",131,0,1,0,38,1,6,1,0,178,1,7,186,214,0.213,0.869
"3240","La Paz","Nuestra Señora de La Paz","Esc. Ecuador",125,0,0,0,42,6,5,1,1,180,2,5,187,220,0.233,0.85
"3241","La Paz","Nuestra Señora de La Paz","Esc. Ecuador",135,0,2,0,39,3,10,0,0,189,0,1,190,219,0.206,0.868
"3242","La Paz","Nuestra Señora de La Paz","Esc. Ecuador",156,0,0,2,28,1,4,0,0,191,0,3,194,219,0.147,0.886
"3243","La Paz","Nuestra Señora de La Paz","Esc. Ecuador",147,0,0,1,25,1,3,3,0,180,0,4,184,215,0.139,0.856
"3244","La Paz","Nuestra Señora de La Paz","Esc. Ecuador",120,0,0,0,40,5,6,0,2,173,0,6,179,215,0.231,0.833
"3245","La Paz","Nuestra Señora de La Paz","Esc. Ecuador",135,0,0,2,28,2,3,2,1,173,0,5,178,214,0.162,0.832
"3246","La Paz","Nuestra Señora de La Paz","Esc. Ecuador",123,2,2,1,44,3,4,0,0,179,0,4,183,214,0.246,0.855
"3247","La Paz","Nuestra Señora de La Paz","Esc. Ecuador",131,0,1,1,34,6,4,1,0,178,0,2,180,217,0.191,0.829
"3248","La Paz","Nuestra Señora de La Paz","Col. Amor de Dios",136,1,3,0,36,3,4,0,0,183,2,2,187,219,0.197,0.854
"3249","La Paz","Nuestra Señora de La Paz","Col. Amor de Dios",140,0,0,0,30,3,3,2,0,178,0,3,181,224,0.169,0.808
"3250","La Paz","Nuestra Señora de La Paz","Col. Amor de Dios",136,0,1,2,31,2,4,1,1,178,0,4,182,223,0.174,0.816
"3251","La Paz","Nuestra Señora de La Paz","Col. Amor de Dios",130,0,0,0,55,3,12,1,2,203,0,5,208,228,0.271,0.912
"3252","La Paz","Nuestra Señora de La Paz","Col. Amor de Dios",162,0,1,1,26,1,1,0,1,193,0,5,198,223,0.135,0.888
"3253","La Paz","Nuestra Señora de La Paz","Col. Amor de Dios",140,0,2,3,47,1,4,1,0,198,0,1,199,229,0.237,0.869
"3254","La Paz","Nuestra Señora de La Paz","Col. Amor de Dios",118,1,0,1,56,1,9,4,0,190,0,7,197,223,0.295,0.883
"3255","La Paz","Nuestra Señora de La Paz","Col. Amor de Dios",130,1,1,1,35,3,6,0,0,177,1,5,183,219,0.198,0.836
"3256","La Paz","Nuestra Señora de La Paz","Col. Amor de Dios",139,0,1,3,42,3,9,0,2,199,0,2,201,227,0.211,0.885
"3257","La Paz","Nuestra Señora de La Paz","Col. Amor de Dios",131,0,0,1,32,3,7,1,0,175,3,6,184,225,0.183,0.818
"3258","La Paz","Nuestra Señora de La Paz","Col. Amor de Dios",115,0,2,2,45,4,5,1,0,174,1,5,180,221,0.259,0.814
"3259","La Paz","Nuestra Señora de La Paz","Col. Amor de Dios",134,1,0,0,48,3,7,0,0,193,1,3,197,221,0.249,0.891
"3260","La Paz","Nuestra Señora de La Paz","Col. Amor de Dios",134,0,0,1,52,5,6,2,1,201,0,0,201,230,0.259,0.874
"3261","La Paz","Nuestra Señora de La Paz","Col. Amor de Dios",142,0,3,0,40,2,5,0,1,193,0,1,194,225,0.207,0.862
"3262","La Paz","Nuestra Señora de La Paz","Col. Amor de Dios",121,0,0,1,39,3,15,1,2,182,0,2,184,215,0.214,0.856
"3263","La Paz","Nuestra Señora de La Paz","Col. Amor de Dios",139,0,0,1,42,3,7,1,0,193,1,3,197,224,0.218,0.879
"3264","La Paz","Nuestra Señora de La Paz","Col. Amor de Dios",123,1,1,2,46,2,6,1,0,182,0,9,191,224,0.253,0.853
"3265","La Paz","Nuestra Señora de La Paz","Facultad de Tecnologia (U.M.S.A)",137,0,0,0,29,2,4,5,0,177,0,4,181,218,0.164,0.83
"3266","La Paz","Nuestra Señora de La Paz","Facultad de Tecnologia (U.M.S.A)",120,0,0,2,41,1,10,1,2,177,0,1,178,219,0.232,0.813
"3267","La Paz","Nuestra Señora de La Paz","Facultad de Tecnologia (U.M.S.A)",129,0,3,1,31,5,11,0,1,181,0,5,186,217,0.171,0.857
"3268","La Paz","Nuestra Señora de La Paz","Facultad de Tecnologia (U.M.S.A)",140,0,1,2,38,3,8,1,0,193,0,6,199,230,0.197,0.865
"3269","La Paz","Nuestra Señora de La Paz","Facultad de Tecnologia (U.M.S.A)",132,0,0,1,32,0,8,2,0,175,2,5,182,217,0.183,0.839
"3270","La Paz","Nuestra Señora de La Paz","Facultad de Tecnologia (U.M.S.A)",118,0,1,0,19,5,4,2,2,151,0,4,155,180,0.126,0.861
"3271","La Paz","Nuestra Señora de La Paz","Esc. Republica Del Peru",123,0,4,0,34,5,6,5,0,177,1,5,183,212,0.192,0.863
"3272","La Paz","Nuestra Señora de La Paz","Esc. Republica Del Peru",124,0,3,0,37,5,10,0,2,181,1,1,183,214,0.204,0.855
"3273","La Paz","Nuestra Señora de La Paz","Esc. Republica Del Peru",147,0,0,0,30,0,8,0,0,185,0,6,191,220,0.162,0.868
"3274","La Paz","Nuestra Señora de La Paz","Instituto Americano - 2109",136,1,2,0,39,2,3,3,1,187,0,8,195,228,0.209,0.855
"3275","La Paz","Nuestra Señora de La Paz","Instituto Americano - 2109",138,0,3,1,32,1,4,0,1,180,0,8,188,220,0.178,0.855
"3276","La Paz","Nuestra Señora de La Paz","Instituto Americano - 2109",122,1,0,0,50,2,12,0,0,187,1,6,194,215,0.267,0.902
"3277","La Paz","Nuestra Señora de La Paz","Instituto Americano - 2109",137,0,0,1,31,2,10,2,1,184,0,7,191,221,0.168,0.864
"3278","La Paz","Nuestra Señora de La Paz","Instituto Americano - 2109",127,0,2,0,31,5,13,0,0,178,3,11,192,218,0.174,0.881
"3279","La Paz","Nuestra Señora de La Paz","Instituto Americano - 2109",132,1,1,0,37,1,10,0,1,183,1,8,192,216,0.202,0.889
"3280","La Paz","Nuestra Señora de La Paz","Instituto Americano - 2109",125,0,0,1,42,6,4,1,0,179,1,9,189,216,0.235,0.875
"3281","La Paz","Nuestra Señora de La Paz","Instituto Americano - 2109",140,0,0,2,33,2,7,0,0,184,0,2,186,216,0.179,0.861
"3282","La Paz","Nuestra Señora de La Paz","Instituto Americano - 2109",143,0,0,1,32,2,4,0,0,182,2,6,190,213,0.176,0.892
"3283","La Paz","Nuestra Señora de La Paz","Instituto Americano - 2109",136,0,0,0,49,2,10,0,0,197,2,2,201,230,0.249,0.874
"3284","La Paz","Nuestra Señora de La Paz","Instituto Americano - 2109",139,0,1,1,29,0,7,1,2,180,3,6,189,217,0.161,0.871
"3285","La Paz","Nuestra Señora de La Paz","Instituto Americano - 2109",137,0,0,0,27,3,13,1,1,182,0,7,189,221,0.148,0.855
"3286","La Paz","Nuestra Señora de La Paz","Esc. San Jose",107,1,6,1,82,0,12,1,1,211,1,6,218,234,0.389,0.932
"3287","La Paz","Nuestra Señora de La Paz","Esc. San Jose",101,0,2,0,79,3,13,1,2,201,2,2,205,222,0.393,0.923
"3288","La Paz","Nuestra Señora de La Paz","Esc. San Jose",94,0,3,1,77,5,16,1,2,199,1,7,207,231,0.387,0.896
"3289","La Paz","Nuestra Señora de La Paz","Esc. San Jose",115,1,3,0,70,2,20,1,2,214,1,2,217,231,0.327,0.939
"3290","La Paz","Nuestra Señora de La Paz","Esc. San Jose",54,0,3,0,108,5,21,0,4,195,3,14,212,226,0.554,0.938
"3291","La Paz","Nuestra Señora de La Paz","Esc. San Jose",93,0,6,0,85,1,18,0,2,205,0,3,208,229,0.415,0.908
"3292","La Paz","Nuestra Señora de La Paz","Esc. San Jose",136,0,1,1,58,2,10,1,0,209,23,1,233,233,0.278,1
"3293","La Paz","Nuestra Señora de La Paz","Esc. San Jose",98,0,2,2,86,1,16,0,1,206,1,5,212,229,0.417,0.926
"3294","La Paz","Nuestra Señora de La Paz","Esc. San Jose",96,0,4,0,74,4,23,0,1,202,0,11,213,229,0.366,0.93
"3295","La Paz","Nuestra Señora de La Paz","Esc. San Jose",110,1,6,1,72,2,15,0,0,207,0,4,211,223,0.348,0.946
"3296","La Paz","Nuestra Señora de La Paz","Esc. San Jose",83,0,5,0,94,1,21,3,1,208,0,6,214,229,0.452,0.934
"3297","La Paz","Nuestra Señora de La Paz","Esc. San Jose",92,0,5,2,88,6,14,1,1,209,0,4,213,225,0.421,0.947
"3298","La Paz","Nuestra Señora de La Paz","Esc. San Jose",107,0,1,1,72,3,13,0,2,199,0,10,209,227,0.362,0.921
"3299","La Paz","Nuestra Señora de La Paz","Esc. San Jose",94,0,2,1,93,0,9,0,0,199,0,2,201,227,0.467,0.885
"3300","La Paz","Nuestra Señora de La Paz","Esc. San Jose",105,0,4,0,77,2,16,0,1,205,1,7,213,229,0.376,0.93
"3301","La Paz","Nuestra Señora de La Paz","Esc. San Jose",72,0,8,0,111,4,0,0,0,195,0,2,197,220,0.569,0.895
"3302","La Paz","Nuestra Señora de La Paz","Esc. San Jose",96,1,2,0,88,4,17,4,0,212,1,5,218,230,0.415,0.948
"3303","La Paz","Nuestra Señora de La Paz","Esc. San Jose",123,0,1,0,61,3,14,2,1,205,1,2,208,227,0.298,0.916
"3304","La Paz","Nuestra Señora de La Paz","Esc. San Jose",123,0,0,1,72,1,0,0,2,199,0,5,204,235,0.362,0.868
"3305","La Paz","Nuestra Señora de La Paz","Esc. San Jose",95,1,2,0,87,1,24,1,2,213,0,7,220,229,0.408,0.961
"3306","La Paz","Nuestra Señora de La Paz","Esc. San Jose",127,1,0,0,67,2,14,0,0,211,1,7,219,233,0.318,0.94
"3307","La Paz","Nuestra Señora de La Paz","Unid. Educ. Jorge Vargas",75,2,7,3,102,0,18,1,0,208,1,8,217,233,0.49,0.931
"3308","La Paz","Nuestra Señora de La Paz","Unid. Educ. Jorge Vargas",84,0,3,1,98,2,11,0,2,201,3,6,210,231,0.488,0.909
"3309","La Paz","Nuestra Señora de La Paz","Unid. Educ. Jorge Vargas",76,1,1,0,112,2,22,1,0,215,2,5,222,238,0.521,0.933
"3310","La Paz","Nuestra Señora de La Paz","Unid. Educ. Jorge Vargas",117,0,1,1,74,0,19,1,2,215,0,5,220,236,0.344,0.932
"3311","La Paz","Nuestra Señora de La Paz","Unid. Educ. Jorge Vargas",105,0,2,2,86,0,8,1,0,204,0,5,209,230,0.422,0.909
"3312","La Paz","Nuestra Señora de La Paz","Unid. Educ. Jorge Vargas",74,1,2,0,113,2,16,0,2,210,0,4,214,230,0.538,0.93
"3313","La Paz","Nuestra Señora de La Paz","Unid. Educ. Jorge Vargas",64,0,3,0,118,2,21,0,1,209,1,7,217,233,0.565,0.931
"3314","La Paz","Nuestra Señora de La Paz","Unid. Educ. Jorge Vargas",105,0,1,0,65,5,11,0,1,188,1,12,201,222,0.346,0.905
"3315","La Paz","Nuestra Señora de La Paz","Unid. Educ. Jorge Vargas",72,0,1,1,101,0,20,0,1,196,0,11,207,230,0.515,0.9
"3316","La Paz","Nuestra Señora de La Paz","Unid. Educ. Jorge Vargas",95,1,0,0,91,0,15,1,0,203,1,6,210,233,0.448,0.901
"3317","La Paz","Nuestra Señora de La Paz","Unid. Educ. Jorge Vargas",96,0,2,1,91,1,17,3,1,212,1,8,221,231,0.429,0.957
"3318","La Paz","Nuestra Señora de La Paz","Unid. Educ. Jorge Vargas",95,0,2,1,102,1,15,0,2,218,0,7,225,237,0.468,0.949
"3319","La Paz","Nuestra Señora de La Paz","Esc. Jose Santos",59,0,0,0,105,3,18,1,0,186,2,13,201,222,0.565,0.905
"3320","La Paz","Nuestra Señora de La Paz","Esc. Jose Santos",54,0,5,1,109,1,19,1,3,193,3,18,214,232,0.565,0.922
"3321","La Paz","Nuestra Señora de La Paz","Esc. Jose Santos",55,2,3,0,111,1,30,1,0,203,0,7,210,228,0.547,0.921
"3322","La Paz","Nuestra Señora de La Paz","Esc. Jose Santos",43,0,4,0,111,3,19,0,1,181,2,8,191,226,0.613,0.845
"3323","La Paz","Nuestra Señora de La Paz","Esc. Jose Santos",38,2,6,1,132,1,22,0,3,205,1,8,214,229,0.644,0.934
"3324","La Paz","Nuestra Señora de La Paz","Esc. Jose Santos",44,0,4,0,135,2,25,1,1,212,2,6,220,231,0.637,0.952
"3325","La Paz","Nuestra Señora de La Paz","Esc. Jose Santos",77,1,2,0,108,1,14,0,2,205,2,9,216,233,0.527,0.927
"3326","La Paz","Nuestra Señora de La Paz","Esc. Jose Santos",70,0,5,0,106,3,21,0,2,207,2,8,217,234,0.512,0.927
"3327","La Paz","Nuestra Señora de La Paz","Esc. Jose Santos",57,1,4,0,111,1,24,1,0,199,0,8,207,221,0.558,0.937
"3328","La Paz","Nuestra Señora de La Paz","Esc. Jose Santos",48,0,0,0,126,0,20,1,0,195,3,8,206,225,0.646,0.916
"3329","La Paz","Nuestra Señora de La Paz","Esc. Jose Santos",38,0,4,0,120,5,28,0,3,198,1,9,208,229,0.606,0.908
"3330","La Paz","Nuestra Señora de La Paz","Esc. Jose Santos",60,0,3,0,115,0,32,0,3,213,1,6,220,228,0.54,0.965
"3331","La Paz","Nuestra Señora de La Paz","Esc. Jose Santos",59,0,4,1,109,1,21,0,2,197,1,6,204,224,0.553,0.911
"3332","La Paz","Nuestra Señora de La Paz","Esc. Jose Santos",55,1,6,0,115,2,17,1,2,199,0,4,203,224,0.578,0.906
"3333","La Paz","Nuestra Señora de La Paz","Esc. Jose Santos",58,1,8,0,110,1,25,0,3,206,0,8,214,231,0.534,0.926
"3334","La Paz","Nuestra Señora de La Paz","Esc. Jose Santos",32,0,5,0,126,3,28,1,4,199,3,10,212,224,0.633,0.946
"3335","La Paz","Nuestra Señora de La Paz","Esc. Jose Santos",80,0,2,1,102,2,17,1,1,206,1,8,215,231,0.495,0.931
"3336","La Paz","Nuestra Señora de La Paz","Esc. Jose Santos",67,0,1,1,96,0,19,1,0,185,5,14,204,230,0.519,0.887
"3337","La Paz","Nuestra Señora de La Paz","Esc. Jose Santos",67,0,7,0,114,2,16,0,2,208,2,5,215,226,0.548,0.951
"3338","La Paz","Nuestra Señora de La Paz","Esc. Jose Santos",49,1,5,2,115,1,18,0,1,192,0,4,196,205,0.599,0.956
"3339","La Paz","Nuestra Señora de La Paz","Esc. San Miguel",19,1,5,1,162,3,20,1,1,213,0,2,215,233,0.761,0.923
"3340","La Paz","Nuestra Señora de La Paz","Esc. San Miguel",23,0,7,0,161,2,22,2,1,218,2,6,226,231,0.739,0.978
"3341","La Paz","Nuestra Señora de La Paz","Esc. San Miguel",33,1,6,0,151,1,18,0,0,210,1,6,217,232,0.719,0.935
"3342","La Paz","Nuestra Señora de La Paz","Escuela Republica de Japon - 1901",71,1,5,0,101,4,12,1,3,198,0,8,206,230,0.51,0.896
"3343","La Paz","Nuestra Señora de La Paz","Escuela Republica de Japon - 1901",78,0,2,1,103,6,14,0,1,205,1,2,208,222,0.502,0.937
"3344","La Paz","Nuestra Señora de La Paz","Escuela Republica de Japon - 1901",83,1,0,1,101,3,15,2,2,208,0,5,213,230,0.486,0.926
"3345","La Paz","Nuestra Señora de La Paz","Escuela Republica de Japon - 1901",60,0,2,1,108,1,24,0,1,197,2,6,205,225,0.548,0.911
"3346","La Paz","Nuestra Señora de La Paz","Escuela Republica de Japon - 1901",71,1,5,1,103,0,18,1,3,203,2,3,208,227,0.507,0.916
"3347","La Paz","Nuestra Señora de La Paz","Escuela Republica de Japon - 1901",98,0,1,1,92,0,14,0,2,208,0,7,215,234,0.442,0.919
"3348","La Paz","Nuestra Señora de La Paz","Escuela Republica de Japon - 1901",79,0,3,0,94,1,16,1,1,195,2,4,201,223,0.482,0.901
"3349","La Paz","Nuestra Señora de La Paz","Escuela Republica de Japon - 1901",86,2,1,0,93,0,18,1,4,205,3,3,211,231,0.454,0.913
"3350","La Paz","Nuestra Señora de La Paz","Escuela Republica de Japon - 1901",54,0,3,0,109,4,18,2,1,191,1,3,195,219,0.571,0.89
"3351","La Paz","Nuestra Señora de La Paz","Escuela Republica de Japon - 1901",86,0,1,0,86,2,17,0,2,194,3,3,200,230,0.443,0.87
"3352","La Paz","Nuestra Señora de La Paz","Escuela Republica de Japon - 1901",71,2,1,0,108,1,17,0,3,203,2,6,211,230,0.532,0.917
"3353","La Paz","Nuestra Señora de La Paz","Escuela Republica de Japon - 1901",58,2,0,0,116,6,22,0,2,206,1,5,212,227,0.563,0.934
"3354","La Paz","Nuestra Señora de La Paz","Escuela Republica de Japon - 1901",87,0,0,0,100,3,16,0,0,206,1,5,212,230,0.485,0.922
"3355","La Paz","Nuestra Señora de La Paz","Escuela Republica de Japon - 1901",79,1,2,0,110,4,11,2,3,212,1,4,217,232,0.519,0.935
"3356","La Paz","Nuestra Señora de La Paz","Escuela Republica de Japon - 1901",83,0,0,0,97,3,12,0,2,197,1,3,201,222,0.492,0.905
"3357","La Paz","Nuestra Señora de La Paz","Col. Luis Espinal Camps",61,0,7,2,110,4,16,0,3,203,0,3,206,226,0.542,0.912
"3358","La Paz","Nuestra Señora de La Paz","Col. Luis Espinal Camps",55,0,7,0,114,3,28,1,2,210,1,6,217,231,0.543,0.939
"3359","La Paz","Nuestra Señora de La Paz","Col. Luis Espinal Camps",54,1,4,1,114,4,21,2,1,202,0,2,204,218,0.564,0.936
"3360","La Paz","Nuestra Señora de La Paz","Col. Luis Espinal Camps",69,2,5,0,94,5,21,1,2,199,1,6,206,225,0.472,0.916
"3361","La Paz","Nuestra Señora de La Paz","Col. Luis Espinal Camps",59,1,5,2,114,4,16,0,4,205,0,7,212,231,0.556,0.918
"3362","La Paz","Nuestra Señora de La Paz","Col. Luis Espinal Camps",42,0,9,0,127,2,19,0,2,201,3,4,208,221,0.632,0.941
"3363","La Paz","Nuestra Señora de La Paz","Col. Luis Espinal Camps",51,0,5,1,135,4,15,0,1,212,1,5,218,228,0.637,0.956
"3364","La Paz","Nuestra Señora de La Paz","Col. Luis Espinal Camps",38,0,8,1,131,2,21,0,4,205,0,4,209,226,0.639,0.925
"3365","La Paz","Nuestra Señora de La Paz","Col. Luis Espinal Camps",47,0,10,0,105,4,30,1,1,198,2,5,205,225,0.53,0.911
"3366","La Paz","Nuestra Señora de La Paz","Col. Luis Espinal Camps",42,0,6,2,118,3,29,1,1,202,1,7,210,225,0.584,0.933
"3367","La Paz","Nuestra Señora de La Paz","Col. Luis Espinal Camps",52,0,7,0,114,0,29,2,0,204,0,12,216,229,0.559,0.943
"3368","La Paz","Nuestra Señora de La Paz","Col. Luis Espinal Camps",63,1,6,0,107,3,19,0,4,203,4,9,216,231,0.527,0.935
"3369","La Paz","Nuestra Señora de La Paz","Col. Luis Espinal Camps",64,1,8,0,115,0,18,1,0,207,1,5,213,227,0.556,0.938
"3370","La Paz","Nuestra Señora de La Paz","Col. Luis Espinal Camps",72,1,5,1,93,4,21,1,0,198,0,5,203,226,0.47,0.898
"3371","La Paz","Nuestra Señora de La Paz","Col. Luis Espinal Camps",50,1,4,0,122,2,17,0,4,200,2,7,209,228,0.61,0.917
"3372","La Paz","Nuestra Señora de La Paz","Col. Luis Espinal Camps",47,0,2,1,112,1,36,1,1,201,0,7,208,229,0.557,0.908
"3373","La Paz","Nuestra Señora de La Paz","Col. Luis Espinal Camps",56,1,6,0,110,1,21,3,1,199,3,8,210,228,0.553,0.921
"3374","La Paz","Nuestra Señora de La Paz","Col. Luis Espinal Camps",53,1,2,2,110,1,27,1,0,197,1,5,203,222,0.558,0.914
"3375","La Paz","Nuestra Señora de La Paz","Col. Luis Espinal Camps",43,1,6,1,130,3,18,1,1,204,3,6,213,224,0.637,0.951
"3376","La Paz","Nuestra Señora de La Paz","Col. Luis Espinal Camps",48,0,4,0,119,2,31,0,2,206,2,0,208,226,0.578,0.92
"3377","La Paz","Nuestra Señora de La Paz","Col. Luis Espinal Camps",55,1,5,1,108,2,22,0,0,194,2,3,199,229,0.557,0.869
"3378","La Paz","Nuestra Señora de La Paz","Col. Luis Espinal Camps",48,0,7,1,116,1,22,0,0,195,2,12,209,224,0.595,0.933
"3379","La Paz","Nuestra Señora de La Paz","Col. Luis Espinal Camps",58,2,4,0,103,3,24,0,2,196,2,7,205,223,0.526,0.919
"3380","La Paz","Nuestra Señora de La Paz","Col. Luis Espinal Camps",53,0,2,0,125,2,21,0,1,204,2,4,210,228,0.613,0.921
"3381","La Paz","Nuestra Señora de La Paz","Col. Luis Espinal Camps",50,0,6,0,125,5,23,0,1,210,1,5,216,228,0.595,0.947
"3382","La Paz","Nuestra Señora de La Paz","Col. Luis Espinal Camps",50,0,6,0,99,1,38,1,1,196,3,5,204,230,0.505,0.887
"3383","La Paz","Nuestra Señora de La Paz","Col. Luis Espinal Camps",64,0,4,1,112,3,19,2,0,205,1,4,210,228,0.546,0.921
"3384","La Paz","Nuestra Señora de La Paz","Col. Luis Espinal Camps",44,0,8,0,127,1,26,1,0,207,2,5,214,226,0.614,0.947
"3385","La Paz","Nuestra Señora de La Paz","Col. Luis Espinal Camps",44,1,4,0,135,3,26,0,2,215,3,3,221,232,0.628,0.953
"3386","La Paz","Nuestra Señora de La Paz","Col. Luis Espinal Camps",46,1,8,0,108,2,30,0,1,196,1,12,209,227,0.551,0.921
"3387","La Paz","Nuestra Señora de La Paz","Col. Luis Espinal Camps",78,1,0,1,104,0,21,1,2,208,3,1,212,230,0.5,0.922
"3388","La Paz","Nuestra Señora de La Paz","Col. Luis Espinal Camps",48,1,10,0,115,3,25,0,1,203,1,5,209,231,0.567,0.905
"3389","La Paz","Nuestra Señora de La Paz","Col. Luis Espinal Camps",47,0,8,1,121,3,16,1,2,199,1,10,210,228,0.608,0.921
"3390","La Paz","Nuestra Señora de La Paz","Col. Luis Espinal Camps",62,3,6,1,103,0,24,0,1,200,0,8,208,227,0.515,0.916
"3391","La Paz","Nuestra Señora de La Paz","Col. Luis Espinal Camps",57,2,6,0,109,2,17,0,0,193,1,7,201,221,0.565,0.91
"3392","La Paz","Nuestra Señora de La Paz","Col. Luis Espinal Camps",52,2,5,2,115,0,29,0,2,207,3,0,210,230,0.556,0.913
"3393","La Paz","Nuestra Señora de La Paz","U.E. Alto Pasankeri Sur",57,0,0,0,126,5,29,0,3,220,1,5,226,240,0.573,0.942
"3394","La Paz","Nuestra Señora de La Paz","U.E. Alto Pasankeri Sur",37,1,2,0,130,4,41,0,0,215,1,5,221,237,0.605,0.932
"3395","La Paz","Nuestra Señora de La Paz","Escuela Republica de Japon - 1903",94,0,5,0,89,1,9,0,2,200,0,3,203,217,0.445,0.935
"3396","La Paz","Nuestra Señora de La Paz","Escuela Republica de Japon - 1903",82,0,1,1,93,7,13,0,0,197,0,6,203,220,0.472,0.923
"3397","La Paz","Nuestra Señora de La Paz","Escuela Republica de Japon - 1903",60,1,4,1,104,3,20,1,2,196,5,3,204,224,0.531,0.911
"3398","La Paz","Nuestra Señora de La Paz","Escuela Republica de Japon - 1903",63,2,2,0,101,0,17,0,2,187,1,9,197,212,0.54,0.929
"3399","La Paz","Nuestra Señora de La Paz","Escuela Republica de Japon - 1903",80,0,6,1,88,2,14,1,1,193,1,5,199,220,0.456,0.905
"3400","La Paz","Nuestra Señora de La Paz","Escuela Republica de Japon - 1903",76,1,2,0,95,1,13,1,1,190,0,4,194,220,0.5,0.882
"3401","La Paz","Nuestra Señora de La Paz","Escuela Republica de Japon - 1903",58,0,7,0,92,5,14,1,5,182,1,3,186,211,0.505,0.882
"3402","La Paz","Nuestra Señora de La Paz","Escuela Republica de Japon - 1903",84,1,1,1,104,1,10,1,0,203,1,4,208,225,0.512,0.924
"3403","La Paz","Nuestra Señora de La Paz","Escuela Republica de Japon - 1903",66,0,8,0,100,2,16,1,1,194,0,8,202,222,0.515,0.91
"3404","La Paz","Nuestra Señora de La Paz","Escuela Republica de Japon - 1903",64,2,5,0,96,4,10,1,4,186,0,8,194,213,0.516,0.911
"3405","La Paz","Nuestra Señora de La Paz","Escuela Republica de Japon - 1903",74,0,4,1,88,3,12,0,4,186,0,5,191,215,0.473,0.888
"3406","La Paz","Nuestra Señora de La Paz","Escuela Republica de Japon - 1903",67,0,2,0,110,2,14,0,2,197,1,2,200,211,0.558,0.948
"3407","La Paz","Nuestra Señora de La Paz","Escuela Republica de Japon - 1903",92,2,3,1,72,6,18,2,3,199,0,3,202,220,0.362,0.918
"3408","La Paz","Nuestra Señora de La Paz","Escuela Republica de Japon - 1903",89,0,3,1,89,1,14,0,4,201,3,3,207,222,0.443,0.932
"3409","La Paz","Nuestra Señora de La Paz","Escuela Republica de Japon - 1903",81,0,4,1,89,4,14,0,3,196,2,9,207,221,0.454,0.937
"3410","La Paz","Nuestra Señora de La Paz","Unid. Educ. Jaime Escalante",63,0,4,1,93,1,31,0,3,196,3,4,203,220,0.474,0.923
"3411","La Paz","Nuestra Señora de La Paz","Unid. Educ. Jaime Escalante",63,2,5,0,105,2,15,0,0,192,0,5,197,223,0.547,0.883
"3412","La Paz","Nuestra Señora de La Paz","Unid. Educ. Jaime Escalante",54,0,6,2,109,0,16,0,5,192,0,15,207,223,0.568,0.928
"3413","La Paz","Nuestra Señora de La Paz","Unid. Educ. Jaime Escalante",59,0,2,0,99,3,38,1,2,204,0,5,209,223,0.485,0.937
"3414","La Paz","Nuestra Señora de La Paz","Unid. Educ. Jaime Escalante",61,2,6,0,107,0,21,1,0,198,2,6,206,224,0.54,0.92
"3415","La Paz","Nuestra Señora de La Paz","Unid. Educ. Jaime Escalante",40,2,7,0,131,4,20,0,4,208,4,6,218,226,0.63,0.965
"3416","La Paz","Nuestra Señora de La Paz","Unid. Educ. Jaime Escalante",48,1,3,0,120,2,21,1,2,198,4,10,212,232,0.606,0.914
"3417","La Paz","Nuestra Señora de La Paz","Unid. Educ. Jaime Escalante",48,2,3,1,118,0,24,1,3,200,0,3,203,224,0.59,0.906
"3418","La Paz","Nuestra Señora de La Paz","Unid. Educ. Jaime Escalante",45,1,3,1,126,1,23,0,5,205,0,8,213,228,0.615,0.934
"3419","La Paz","Nuestra Señora de La Paz","Unid. Educ. Jaime Escalante",48,0,7,0,105,3,37,0,4,204,0,5,209,226,0.515,0.925
"3420","La Paz","Nuestra Señora de La Paz","Unid. Educ. Jaime Escalante",51,0,4,1,105,3,23,3,1,191,2,5,198,225,0.55,0.88
"3421","La Paz","Nuestra Señora de La Paz","Unid. Educ. Jaime Escalante",40,0,5,1,140,3,17,0,2,208,1,7,216,228,0.673,0.947
"3422","La Paz","Nuestra Señora de La Paz","Unid. Educ. Jaime Escalante",38,0,2,0,115,0,33,0,1,189,2,8,199,225,0.608,0.884
"3423","La Paz","Nuestra Señora de La Paz","Unid. Educ. Jaime Escalante",49,0,12,1,114,1,21,1,0,199,4,2,205,219,0.573,0.936
"3424","La Paz","Nuestra Señora de La Paz","Unid. Educ. Jaime Escalante",47,1,5,0,127,4,24,0,0,208,0,7,215,225,0.611,0.956
"3425","La Paz","Nuestra Señora de La Paz","Unid. Educ. Jaime Escalante",54,2,1,1,128,2,13,0,3,204,0,5,209,218,0.627,0.959
"3426","La Paz","Nuestra Señora de La Paz","Unid. Educ. Jaime Escalante",70,0,3,0,109,1,15,0,1,199,3,5,207,218,0.548,0.95
"3427","La Paz","Nuestra Señora de La Paz","Unid. Educ. Jaime Escalante",55,0,3,0,121,3,15,0,0,197,2,8,207,224,0.614,0.924
"3428","La Paz","Nuestra Señora de La Paz","Unid. Educ. Jaime Escalante",67,1,9,0,103,3,19,1,2,205,2,4,211,230,0.502,0.917
"3429","La Paz","Nuestra Señora de La Paz","Esc. Alto Tembladerani",38,0,2,3,127,0,21,0,1,192,0,3,195,222,0.661,0.878
"3430","La Paz","Nuestra Señora de La Paz","Esc. Alto Tembladerani",45,0,2,0,133,0,20,1,1,202,2,8,212,223,0.658,0.951
"3431","La Paz","Nuestra Señora de La Paz","Esc. Alto Tembladerani",40,1,3,1,123,1,16,0,1,186,2,7,195,219,0.661,0.89
"3432","La Paz","Nuestra Señora de La Paz","Esc. Alto Tembladerani",54,0,2,1,118,1,0,0,1,177,1,5,183,223,0.667,0.821
"3433","La Paz","Nuestra Señora de La Paz","Esc. Alto Tembladerani",44,0,3,0,122,4,18,0,1,192,2,6,200,226,0.635,0.885
"3434","La Paz","Nuestra Señora de La Paz","Esc. Alto Tembladerani",34,1,9,1,131,4,23,1,1,205,0,5,210,229,0.639,0.917
"3435","La Paz","Nuestra Señora de La Paz","Colegio Ignacio Calderon",111,0,1,1,69,2,15,0,4,203,1,3,207,221,0.34,0.937
"3436","La Paz","Nuestra Señora de La Paz","Colegio Ignacio Calderon",110,0,3,0,71,3,11,2,2,202,3,3,208,226,0.351,0.92
"3437","La Paz","Nuestra Señora de La Paz","Colegio Ignacio Calderon",111,1,1,1,69,2,13,0,1,199,1,3,203,227,0.347,0.894
"3438","La Paz","Nuestra Señora de La Paz","Colegio Ignacio Calderon",113,0,2,0,68,4,15,2,0,204,0,4,208,221,0.333,0.941
"3439","La Paz","Nuestra Señora de La Paz","Colegio Ignacio Calderon",110,0,5,0,69,3,8,1,2,198,1,4,203,226,0.348,0.898
"3440","La Paz","Nuestra Señora de La Paz","Colegio Ignacio Calderon",90,0,4,2,82,2,14,1,2,197,0,9,206,223,0.416,0.924
"3441","La Paz","Nuestra Señora de La Paz","Colegio Ignacio Calderon",98,0,1,1,78,2,18,0,2,200,0,5,205,225,0.39,0.911
"3442","La Paz","Nuestra Señora de La Paz","Colegio Ignacio Calderon",130,0,0,0,60,1,12,0,0,203,1,7,211,233,0.296,0.906
"3443","La Paz","Nuestra Señora de La Paz","Colegio Ignacio Calderon",99,1,5,4,70,3,14,0,2,198,1,6,205,227,0.354,0.903
"3444","La Paz","Nuestra Señora de La Paz","Colegio Ignacio Calderon",134,0,1,0,55,1,9,0,0,200,1,7,208,231,0.275,0.9
"3445","La Paz","Nuestra Señora de La Paz","Colegio Ignacio Calderon",101,0,1,3,78,1,17,2,2,205,0,4,209,226,0.38,0.925
"3446","La Paz","Nuestra Señora de La Paz","Colegio Ignacio Calderon",105,2,3,0,73,5,10,0,0,198,1,8,207,227,0.369,0.912
"3447","La Paz","Nuestra Señora de La Paz","Colegio Ignacio Calderon",83,1,4,0,99,3,12,0,2,204,0,3,207,224,0.485,0.924
"3448","La Paz","Nuestra Señora de La Paz","Colegio Ignacio Calderon",118,1,2,1,71,1,12,1,2,209,0,5,214,230,0.34,0.93
"3449","La Paz","Nuestra Señora de La Paz","Colegio Ignacio Calderon",129,0,0,0,58,2,13,1,1,204,1,2,207,233,0.284,0.888
"3450","La Paz","Nuestra Señora de La Paz","Colegio Ignacio Calderon",100,0,3,1,86,4,16,1,1,212,0,2,214,232,0.406,0.922
"3451","La Paz","Nuestra Señora de La Paz","Colegio Ignacio Calderon",128,0,4,0,53,1,14,2,0,202,0,1,203,224,0.262,0.906
"3452","La Paz","Nuestra Señora de La Paz","Colegio Ignacio Calderon",88,0,3,0,91,3,16,0,2,203,2,6,211,224,0.448,0.942
"3453","La Paz","Nuestra Señora de La Paz","Colegio Ignacio Calderon",116,0,0,0,64,2,8,1,3,194,1,10,205,225,0.33,0.911
"3454","La Paz","Nuestra Señora de La Paz","Colegio Ignacio Calderon",118,2,2,0,54,1,17,1,2,197,0,9,206,226,0.274,0.912
"3455","La Paz","Nuestra Señora de La Paz","Colegio Ignacio Calderon",107,0,0,0,73,6,15,0,1,202,3,4,209,233,0.361,0.897
"3456","La Paz","Nuestra Señora de La Paz","Colegio Ignacio Calderon",113,0,0,0,65,3,14,0,2,197,4,6,207,224,0.33,0.924
"3457","La Paz","Nuestra Señora de La Paz","Colegio Ignacio Calderon",122,0,3,1,64,2,9,0,2,203,0,6,209,227,0.315,0.921
"3458","La Paz","Nuestra Señora de La Paz","Unidad Educativa Puerto Rico",101,0,4,2,69,2,11,0,1,190,1,5,196,219,0.363,0.895
"3459","La Paz","Nuestra Señora de La Paz","Unidad Educativa Puerto Rico",94,1,2,0,82,1,17,1,1,199,1,3,203,219,0.412,0.927
"3460","La Paz","Nuestra Señora de La Paz","Unidad Educativa Puerto Rico",100,0,2,0,82,2,11,0,1,198,0,3,201,222,0.414,0.905
"3461","La Paz","Nuestra Señora de La Paz","Unidad Educativa Puerto Rico",110,0,3,1,68,2,15,0,1,200,0,4,204,221,0.34,0.923
"3462","La Paz","Nuestra Señora de La Paz","Unidad Educativa Puerto Rico",88,1,1,0,95,3,16,3,3,210,0,6,216,226,0.452,0.956
"3463","La Paz","Nuestra Señora de La Paz","Unidad Educativa Puerto Rico",93,0,1,0,81,1,10,0,1,187,2,5,194,217,0.433,0.894
"3464","La Paz","Nuestra Señora de La Paz","Unidad Educativa Puerto Rico",91,0,3,1,92,3,13,1,0,204,1,1,206,222,0.451,0.928
"3465","La Paz","Nuestra Señora de La Paz","Unidad Educativa Puerto Rico",90,0,2,2,86,1,13,1,1,196,1,4,201,223,0.439,0.901
"3466","La Paz","Nuestra Señora de La Paz","Unidad Educativa Puerto Rico",111,0,2,0,75,1,15,0,0,204,0,4,208,225,0.368,0.924
"3467","La Paz","Nuestra Señora de La Paz","Unidad Educativa Puerto Rico",80,2,4,0,91,1,19,0,4,201,0,6,207,228,0.453,0.908
"3468","La Paz","Nuestra Señora de La Paz","Unidad Educativa Puerto Rico",87,1,5,0,87,4,8,1,0,193,2,1,196,214,0.451,0.916
"3469","La Paz","Nuestra Señora de La Paz","Unidad Educativa Puerto Rico",103,0,1,0,90,1,9,2,2,208,0,2,210,222,0.433,0.946
"3470","La Paz","Nuestra Señora de La Paz","Unidad Educativa Puerto Rico",94,1,2,1,74,0,12,1,3,188,0,4,192,217,0.394,0.885
"3471","La Paz","Nuestra Señora de La Paz","Unidad Educativa Puerto Rico",80,0,3,0,102,5,15,1,1,207,1,5,213,224,0.493,0.951
"3472","La Paz","Nuestra Señora de La Paz","Unidad Educativa Puerto Rico",109,0,0,1,80,0,13,0,0,203,1,4,208,227,0.394,0.916
"3473","La Paz","Nuestra Señora de La Paz","Unidad Educativa Puerto Rico",100,2,0,1,89,3,8,1,0,204,0,4,208,226,0.436,0.92
"3474","La Paz","Nuestra Señora de La Paz","Unidad Educativa Puerto Rico",90,2,0,0,94,1,13,0,8,208,0,9,217,227,0.452,0.956
"3475","La Paz","Nuestra Señora de La Paz","Unidad Educativa Puerto Rico",90,1,3,0,78,3,6,1,0,182,2,8,192,208,0.429,0.923
"3476","La Paz","Nuestra Señora de La Paz","Unid. Educ. Raul Salmon De La Barra",69,1,5,0,100,2,21,2,1,201,1,2,204,226,0.498,0.903
"3477","La Paz","Nuestra Señora de La Paz","Unid. Educ. Raul Salmon De La Barra",53,1,2,0,123,5,15,0,1,200,0,5,205,228,0.615,0.899
"3478","La Paz","Nuestra Señora de La Paz","Unid. Educ. Raul Salmon De La Barra",52,0,5,1,101,3,26,0,0,188,2,8,198,218,0.537,0.908
"3479","La Paz","Nuestra Señora de La Paz","Unid. Educ. Raul Salmon De La Barra",37,2,5,1,132,2,25,1,2,207,1,6,214,230,0.638,0.93
"3480","La Paz","Nuestra Señora de La Paz","Unid. Educ. Raul Salmon De La Barra",58,1,7,1,119,3,19,0,2,210,1,5,216,226,0.567,0.956
"3481","La Paz","Nuestra Señora de La Paz","Unid. Educ. Raul Salmon De La Barra",49,0,4,3,121,2,21,1,4,205,3,3,211,225,0.59,0.938
"3482","La Paz","Nuestra Señora de La Paz","Unid. Educ. Raul Salmon De La Barra",68,2,0,0,102,5,21,0,1,199,0,9,208,225,0.513,0.924
"3483","La Paz","Nuestra Señora de La Paz","Unid. Educ. Raul Salmon De La Barra",60,1,1,2,112,0,30,1,0,207,0,0,207,224,0.541,0.924
"3484","La Paz","Nuestra Señora de La Paz","Unid. Educ. Raul Salmon De La Barra",52,1,1,0,114,0,33,0,1,202,1,12,215,232,0.564,0.927
"3485","La Paz","Nuestra Señora de La Paz","Unid. Educ. Raul Salmon De La Barra",45,1,4,0,119,1,19,0,0,189,1,15,205,225,0.63,0.911
"3486","La Paz","Nuestra Señora de La Paz","Unid. Educ. Raul Salmon De La Barra",55,1,3,0,110,4,25,0,3,201,0,6,207,224,0.547,0.924
"3487","La Paz","Nuestra Señora de La Paz","Unid. Educ. Raul Salmon De La Barra",56,0,3,0,114,2,26,1,3,205,0,6,211,225,0.556,0.938
"3488","La Paz","Nuestra Señora de La Paz","Unid. Educ. Raul Salmon De La Barra",49,2,5,0,120,2,15,0,2,195,2,7,204,222,0.615,0.919
"3489","La Paz","Nuestra Señora de La Paz","Unid. Educ. Raul Salmon De La Barra",54,0,2,0,109,2,16,0,6,189,2,6,197,217,0.577,0.908
"3490","La Paz","Nuestra Señora de La Paz","Unid. Educ. Raul Salmon De La Barra",62,1,2,0,115,4,22,0,1,207,0,6,213,230,0.556,0.926
"3491","La Paz","Nuestra Señora de La Paz","Unid. Educ. Raul Salmon De La Barra",55,1,8,1,125,1,11,1,1,204,2,6,212,233,0.613,0.91
"3492","La Paz","Nuestra Señora de La Paz","U. E. Pantaleon Dalence",108,0,0,1,60,5,13,2,2,191,1,3,195,214,0.314,0.911
"3493","La Paz","Nuestra Señora de La Paz","U. E. Pantaleon Dalence",110,4,2,3,58,3,11,1,1,193,1,4,198,215,0.301,0.921
"3494","La Paz","Nuestra Señora de La Paz","U. E. Pantaleon Dalence",115,0,0,0,64,7,12,0,1,199,2,8,209,227,0.322,0.921
"3495","La Paz","Nuestra Señora de La Paz","U. E. Pantaleon Dalence",123,0,3,0,61,3,5,1,2,198,1,1,200,217,0.308,0.922
"3496","La Paz","Nuestra Señora de La Paz","U. E. Pantaleon Dalence",98,0,1,1,73,8,9,1,0,191,1,4,196,215,0.382,0.912
"3497","La Paz","Nuestra Señora de La Paz","U. E. Pantaleon Dalence",140,0,2,1,50,1,11,1,0,206,0,3,209,222,0.243,0.941
"3498","La Paz","Nuestra Señora de La Paz","U. E. Pantaleon Dalence",131,0,0,1,61,0,11,0,1,205,0,3,208,228,0.298,0.912
"3499","La Paz","Nuestra Señora de La Paz","U. E. Pantaleon Dalence",124,2,1,1,58,6,8,1,2,203,0,6,209,222,0.286,0.941
"3500","La Paz","Nuestra Señora de La Paz","U. E. Pantaleon Dalence",114,1,2,0,72,2,7,2,0,200,1,5,206,225,0.36,0.916
"3501","La Paz","Nuestra Señora de La Paz","Unid. Educ. Hugo Banzer Suarez",105,1,2,0,70,3,8,0,2,191,3,6,200,220,0.366,0.909
"3502","La Paz","Nuestra Señora de La Paz","Unid. Educ. Hugo Banzer Suarez",101,0,1,1,79,4,12,1,1,200,4,4,208,224,0.395,0.929
"3503","La Paz","Nuestra Señora de La Paz","Unid. Educ. Hugo Banzer Suarez",80,0,0,0,86,4,22,2,3,197,1,7,205,218,0.437,0.94
"3504","La Paz","Nuestra Señora de La Paz","Unid. Educ. Hugo Banzer Suarez",106,2,1,3,70,1,14,0,2,199,0,4,203,221,0.352,0.919
"3505","La Paz","Nuestra Señora de La Paz","Unid. Educ. Hugo Banzer Suarez",86,1,5,1,87,2,8,2,1,193,1,3,197,216,0.451,0.912
"3506","La Paz","Nuestra Señora de La Paz","Unid. Educ. Hugo Banzer Suarez",86,2,3,0,78,2,0,0,3,174,0,7,181,211,0.448,0.858
"3507","La Paz","Nuestra Señora de La Paz","Unid. Educ. Hugo Banzer Suarez",100,0,3,0,76,3,12,0,0,194,1,6,201,220,0.392,0.914
"3508","La Paz","Nuestra Señora de La Paz","Unidad Educativa Carlos Medinacelli",115,0,0,0,63,2,7,0,0,187,1,7,195,219,0.337,0.89
"3509","La Paz","Nuestra Señora de La Paz","Unidad Educativa Carlos Medinacelli",90,0,7,2,79,1,11,1,0,191,2,6,199,216,0.414,0.921
"3510","La Paz","Nuestra Señora de La Paz","Unidad Educativa Carlos Medinacelli",107,0,1,0,63,4,12,2,1,190,1,8,199,218,0.332,0.913
"3511","La Paz","Nuestra Señora de La Paz","Unidad Educativa Carlos Medinacelli",93,0,3,2,76,3,11,0,2,190,0,6,196,219,0.4,0.895
"3512","La Paz","Nuestra Señora de La Paz","Unidad Educativa Carlos Medinacelli",87,0,6,0,88,4,13,0,0,198,1,3,202,225,0.444,0.898
"3513","La Paz","Nuestra Señora de La Paz","Unidad Educativa Carlos Medinacelli",94,2,3,0,87,1,10,0,2,199,9,0,208,223,0.437,0.933
"3514","La Paz","Nuestra Señora de La Paz","Unidad Educativa Carlos Medinacelli",117,0,3,0,63,2,10,1,2,198,2,8,208,224,0.318,0.929
"3515","La Paz","Nuestra Señora de La Paz","Unidad Educativa Carlos Medinacelli",103,0,1,0,76,2,6,1,0,189,2,4,195,217,0.402,0.899
"3516","La Paz","Nuestra Señora de La Paz","Unidad Educativa Carlos Medinacelli",116,1,0,1,73,1,7,1,0,200,1,3,204,226,0.365,0.903
"3517","La Paz","Nuestra Señora de La Paz","Unidad Educativa Carlos Medinacelli",100,0,2,0,75,2,14,0,2,195,0,8,203,219,0.385,0.927
"3518","La Paz","Nuestra Señora de La Paz","Unidad Educativa Carlos Medinacelli",98,0,0,1,78,2,13,1,2,195,0,8,203,217,0.4,0.935
"3519","La Paz","Nuestra Señora de La Paz","Unidad Educativa Carlos Medinacelli",98,0,1,2,75,1,13,0,0,190,0,8,198,221,0.395,0.896
"3520","La Paz","Nuestra Señora de La Paz","Unidad Educativa Carlos Medinacelli",87,2,1,0,95,2,10,0,1,198,0,3,201,221,0.48,0.91
"3521","La Paz","Nuestra Señora de La Paz","Unidad Educativa Carlos Medinacelli",103,1,2,0,64,2,12,2,1,187,2,3,192,217,0.342,0.885
"3522","La Paz","Nuestra Señora de La Paz","Unidad Educativa Carlos Medinacelli",101,0,2,0,64,0,10,1,2,180,2,4,186,207,0.356,0.899
"3523","La Paz","Nuestra Señora de La Paz","Unidad Educativa Carlos Medinacelli",102,0,4,1,74,2,7,2,2,194,1,8,203,219,0.381,0.927
"3524","La Paz","Nuestra Señora de La Paz","Unidad Educativa Carlos Medinacelli",83,0,3,2,86,0,20,2,3,199,1,6,206,219,0.432,0.941
"3525","La Paz","Nuestra Señora de La Paz","Unidad Educativa Carlos Medinacelli",103,1,1,0,77,3,12,3,3,203,0,4,207,220,0.379,0.941
"3526","La Paz","Nuestra Señora de La Paz","Unidad Educativa Carlos Medinacelli",103,1,3,1,64,1,12,1,2,188,1,4,193,216,0.34,0.894
"3527","La Paz","Nuestra Señora de La Paz","Unidad Educativa Carlos Medinacelli",105,0,6,1,69,4,9,1,1,196,2,10,208,226,0.352,0.92
"3528","La Paz","Nuestra Señora de La Paz","Unidad Educativa Carlos Medinacelli",121,0,1,1,60,0,9,0,0,192,3,6,201,222,0.312,0.905
"3529","La Paz","Nuestra Señora de La Paz","Unidad Educativa Carlos Medinacelli",88,0,2,0,73,0,6,0,0,169,0,3,172,188,0.432,0.915
"3530","La Paz","Nuestra Señora de La Paz","Liceo Bolivia",130,0,1,1,36,3,7,0,1,179,0,3,182,213,0.201,0.854
"3531","La Paz","Nuestra Señora de La Paz","Liceo Bolivia",143,1,0,0,37,2,5,2,0,190,1,2,193,219,0.195,0.881
"3532","La Paz","Nuestra Señora de La Paz","Liceo Bolivia",137,0,1,0,31,1,5,0,1,176,1,6,183,214,0.176,0.855
"3533","La Paz","Nuestra Señora de La Paz","Liceo Bolivia",129,0,1,1,43,4,7,2,0,187,1,3,191,221,0.23,0.864
"3534","La Paz","Nuestra Señora de La Paz","Liceo Bolivia",125,0,2,4,40,3,8,1,0,183,1,3,187,211,0.219,0.886
"3535","La Paz","Nuestra Señora de La Paz","Liceo Bolivia",135,0,0,0,28,2,9,1,3,178,0,2,180,213,0.157,0.845
"3536","La Paz","Nuestra Señora de La Paz","Colegio San Luis",115,1,2,0,71,1,5,4,0,199,1,6,206,225,0.357,0.916
"3537","La Paz","Nuestra Señora de La Paz","Colegio San Luis",131,0,3,5,70,2,3,0,1,215,0,2,217,227,0.326,0.956
"3538","La Paz","Nuestra Señora de La Paz","Colegio San Luis",114,0,1,0,59,4,11,1,0,190,1,6,197,215,0.311,0.916
"3539","La Paz","Nuestra Señora de La Paz","Colegio San Luis",122,0,1,1,66,0,7,0,1,198,0,2,200,223,0.333,0.897
"3540","La Paz","Nuestra Señora de La Paz","Colegio San Luis",103,1,1,0,84,2,13,1,1,206,0,4,210,224,0.408,0.938
"3541","La Paz","Nuestra Señora de La Paz","Colegio San Luis",112,0,1,3,61,2,11,2,0,192,2,8,202,223,0.318,0.906
"3542","La Paz","Nuestra Señora de La Paz","Colegio San Luis",94,1,0,0,95,4,15,0,2,211,0,2,213,231,0.45,0.922
"3543","La Paz","Nuestra Señora de La Paz","Colegio San Luis",90,0,3,0,80,1,18,0,3,195,0,8,203,222,0.41,0.914
"3544","La Paz","Nuestra Señora de La Paz","Colegio San Luis",113,0,1,1,72,1,7,2,1,198,0,6,204,224,0.364,0.911
"3545","La Paz","Nuestra Señora de La Paz","Colegio San Luis",122,0,2,0,57,1,7,2,1,192,1,5,198,218,0.297,0.908
"3546","La Paz","Nuestra Señora de La Paz","Colegio San Luis",118,0,0,1,64,2,15,0,1,201,2,2,205,223,0.318,0.919
"3547","La Paz","Nuestra Señora de La Paz","Colegio San Luis",129,0,1,0,55,4,11,2,1,203,0,4,207,226,0.271,0.916
"3548","La Paz","Nuestra Señora de La Paz","Colegio San Luis",103,1,2,1,74,4,13,0,13,211,2,2,215,222,0.351,0.968
"3549","La Paz","Nuestra Señora de La Paz","Colegio San Luis",104,1,3,1,68,5,9,1,0,192,2,6,200,218,0.354,0.917
"3550","La Paz","Nuestra Señora de La Paz","Colegio San Luis",117,1,1,2,68,2,7,0,2,200,0,3,203,221,0.34,0.919
"3551","La Paz","Nuestra Señora de La Paz","Colegio San Luis",103,0,0,1,72,2,8,3,0,189,0,8,197,215,0.381,0.916
"3552","La Paz","Nuestra Señora de La Paz","Colegio San Luis",122,0,1,1,69,0,8,1,4,206,1,4,211,223,0.335,0.946
"3553","La Paz","Nuestra Señora de La Paz","Colegio San Luis",132,2,2,0,49,2,11,1,2,201,1,5,207,225,0.244,0.92
"3554","La Paz","Nuestra Señora de La Paz","Colegio San Luis",146,0,0,1,37,1,5,1,2,193,1,4,198,223,0.192,0.888
"3555","La Paz","Nuestra Señora de La Paz","Colegio San Luis",123,0,3,0,52,3,12,1,0,194,0,8,202,219,0.268,0.922
"3556","La Paz","Nuestra Señora de La Paz","Colegio San Luis",113,2,0,3,53,3,11,1,0,186,2,8,196,215,0.285,0.912
"3557","La Paz","Nuestra Señora de La Paz","Colegio San Luis",110,0,1,0,70,4,13,1,2,201,2,2,205,224,0.348,0.915
"3558","La Paz","Nuestra Señora de La Paz","Colegio San Luis",89,0,7,3,82,2,11,1,1,196,1,4,201,220,0.418,0.914
"3559","La Paz","Nuestra Señora de La Paz","Colegio San Luis",136,0,0,0,56,1,7,0,0,200,3,7,210,221,0.28,0.95
"3560","La Paz","Nuestra Señora de La Paz","Colegio San Luis",127,0,7,0,50,4,3,1,0,192,0,2,194,217,0.26,0.894
"3561","La Paz","Nuestra Señora de La Paz","Colegio San Luis",126,0,2,0,54,2,11,0,0,195,0,4,199,226,0.277,0.881
"3562","La Paz","Nuestra Señora de La Paz","Colegio San Luis",108,0,6,0,82,0,13,1,1,211,0,1,212,221,0.389,0.959
"3563","La Paz","Nuestra Señora de La Paz","Colegio San Luis",108,0,2,1,44,5,0,4,2,166,32,4,202,219,0.265,0.922
"3564","La Paz","Nuestra Señora de La Paz","Colegio San Luis",135,1,0,1,54,0,7,1,0,199,1,1,201,222,0.271,0.905
"3565","La Paz","Nuestra Señora de La Paz","Colegio San Luis",145,0,0,1,54,1,11,0,2,214,0,9,223,232,0.252,0.961
"3566","La Paz","Nuestra Señora de La Paz","Instituto Mendez Arcos",124,2,0,1,46,3,12,1,0,189,0,11,200,223,0.243,0.897
"3567","La Paz","Nuestra Señora de La Paz","Instituto Mendez Arcos",148,0,0,1,42,0,5,2,0,198,2,7,207,223,0.212,0.928
"3568","La Paz","Nuestra Señora de La Paz","Instituto Mendez Arcos",130,1,3,2,38,0,4,3,0,181,0,4,185,215,0.21,0.86
"3569","La Paz","Nuestra Señora de La Paz","Instituto Mendez Arcos",108,1,0,4,60,3,4,0,2,182,1,4,187,213,0.33,0.878
"3570","La Paz","Nuestra Señora de La Paz","Instituto Mendez Arcos",116,1,5,2,51,0,11,2,1,189,0,5,194,217,0.27,0.894
"3571","La Paz","Nuestra Señora de La Paz","Instituto Mendez Arcos",146,0,0,1,42,2,4,1,0,196,1,6,203,225,0.214,0.902
"3572","La Paz","Nuestra Señora de La Paz","Instituto Mendez Arcos",140,1,0,1,45,4,8,1,0,200,0,6,206,226,0.225,0.912
"3573","La Paz","Nuestra Señora de La Paz","Instituto Mendez Arcos",144,0,1,2,39,0,8,3,0,197,1,3,201,214,0.198,0.939
"3574","La Paz","Nuestra Señora de La Paz","Instituto Mendez Arcos",133,0,3,1,46,3,6,0,1,193,0,3,196,216,0.238,0.907
"3575","La Paz","Nuestra Señora de La Paz","Instituto Mendez Arcos",119,0,4,2,59,1,7,3,0,195,0,5,200,217,0.303,0.922
"3576","La Paz","Nuestra Señora de La Paz","Instituto Mendez Arcos",153,0,1,0,38,1,4,0,1,198,0,3,201,226,0.192,0.889
"3577","La Paz","Nuestra Señora de La Paz","Instituto Mendez Arcos",140,1,2,0,49,2,6,1,0,201,0,2,203,217,0.244,0.935
"3578","La Paz","Nuestra Señora de La Paz","Instituto Mendez Arcos",136,0,2,2,35,1,6,2,1,185,0,4,189,217,0.189,0.871
"3579","La Paz","Nuestra Señora de La Paz","Instituto Mendez Arcos",135,0,4,1,46,2,4,2,0,194,0,3,197,218,0.237,0.904
"3580","La Paz","Nuestra Señora de La Paz","Instituto Mendez Arcos",142,1,1,1,30,4,10,0,1,190,1,6,197,224,0.158,0.879
"3581","La Paz","Nuestra Señora de La Paz","Instituto Mendez Arcos",133,2,1,3,47,3,8,0,1,198,0,8,206,225,0.237,0.916
"3582","La Paz","Nuestra Señora de La Paz","Instituto Mendez Arcos",133,0,1,3,42,0,4,3,0,186,0,6,192,216,0.226,0.889
"3583","La Paz","Nuestra Señora de La Paz","Instituto Mendez Arcos",140,0,2,0,45,2,8,0,3,200,0,7,207,224,0.225,0.924
"3584","La Paz","Nuestra Señora de La Paz","Esc. Alcides Arguedas",111,2,2,4,64,2,7,0,2,194,2,5,201,223,0.33,0.901
"3585","La Paz","Nuestra Señora de La Paz","Esc. Alcides Arguedas",111,0,1,4,59,4,12,0,0,191,0,5,196,222,0.309,0.883
"3586","La Paz","Nuestra Señora de La Paz","Esc. Alcides Arguedas",117,1,2,1,68,1,10,0,0,200,1,13,214,224,0.34,0.955
"3587","La Paz","Nuestra Señora de La Paz","Esc. Alcides Arguedas",115,1,1,1,45,2,18,1,1,185,2,8,195,219,0.243,0.89
"3588","La Paz","Nuestra Señora de La Paz","Esc. Alcides Arguedas",123,0,4,1,61,0,9,1,0,199,0,5,204,225,0.307,0.907
"3589","La Paz","Nuestra Señora de La Paz","Esc. Alcides Arguedas",94,0,3,2,75,2,10,0,0,186,0,3,189,208,0.403,0.909
"3590","La Paz","Nuestra Señora de La Paz","C. E. Adventista Bello Horizonte",114,1,3,0,55,2,17,0,2,194,2,5,201,232,0.284,0.866
"3591","La Paz","Nuestra Señora de La Paz","Instituto Americano - 2105",140,1,0,2,37,1,10,6,2,199,1,6,206,231,0.186,0.892
"3592","La Paz","Nuestra Señora de La Paz","Instituto Americano - 2105",144,1,0,0,47,3,6,1,1,203,0,8,211,232,0.232,0.909
"3593","La Paz","Nuestra Señora de La Paz","Instituto Americano - 2105",141,0,1,0,45,1,8,0,1,197,0,11,208,229,0.228,0.908
"3594","La Paz","Nuestra Señora de La Paz","Instituto Americano - 2105",147,0,2,0,36,3,10,0,0,198,0,5,203,224,0.182,0.906
"3595","La Paz","Nuestra Señora de La Paz","Instituto Americano - 2105",159,1,0,2,38,3,11,1,1,216,1,3,220,234,0.176,0.94
"3596","La Paz","Nuestra Señora de La Paz","Instituto Americano - 2105",151,1,0,0,50,2,7,2,1,214,0,7,221,233,0.234,0.948
"3597","La Paz","Nuestra Señora de La Paz","Instituto Americano - 2105",145,0,1,0,44,4,4,2,1,201,0,7,208,229,0.219,0.908
"3598","La Paz","Nuestra Señora de La Paz","Instituto Americano - 2105",146,0,0,0,51,1,13,0,0,211,2,7,220,237,0.242,0.928
"3599","La Paz","Nuestra Señora de La Paz","Instituto Americano - 2105",159,0,0,2,36,0,17,0,0,214,0,4,218,233,0.168,0.936
"3600","La Paz","Nuestra Señora de La Paz","Instituto Americano - 2105",153,0,0,1,42,7,9,2,1,215,0,6,221,243,0.195,0.909
"3601","La Paz","Nuestra Señora de La Paz","Liceo La Paz",136,0,1,0,41,1,7,1,1,188,0,2,190,221,0.218,0.86
"3602","La Paz","Nuestra Señora de La Paz","Liceo La Paz",110,0,0,3,62,3,8,2,2,190,1,5,196,222,0.326,0.883
"3603","La Paz","Nuestra Señora de La Paz","Liceo La Paz",114,0,1,1,56,6,11,0,0,189,1,4,194,229,0.296,0.847
"3604","La Paz","Nuestra Señora de La Paz","Liceo La Paz",116,0,0,0,56,1,9,2,0,184,1,8,193,226,0.304,0.854
"3605","La Paz","Nuestra Señora de La Paz","Liceo La Paz",104,0,1,0,59,4,9,2,2,181,1,4,186,217,0.326,0.857
"3606","La Paz","Nuestra Señora de La Paz","Liceo La Paz",126,0,0,0,43,3,8,0,3,183,1,2,186,224,0.235,0.83
"3607","La Paz","Nuestra Señora de La Paz","Colegio Saint Peters",143,0,0,1,41,3,5,2,0,195,1,5,201,222,0.21,0.905
"3608","La Paz","Nuestra Señora de La Paz","Colegio Saint Peters",142,0,0,1,35,1,9,1,1,190,0,7,197,216,0.184,0.912
"3609","La Paz","Nuestra Señora de La Paz","Colegio Saint Peters",127,0,3,2,46,0,5,2,0,185,0,3,188,210,0.249,0.895
"3610","La Paz","Nuestra Señora de La Paz","Colegio Saint Peters",148,0,2,1,34,1,12,1,0,199,0,4,203,223,0.171,0.91
"3611","La Paz","Nuestra Señora de La Paz","Colegio Saint Peters",137,0,0,0,40,1,9,3,0,190,1,4,195,214,0.211,0.911
"3612","La Paz","Nuestra Señora de La Paz","Colegio Saint Peters",149,1,2,0,37,1,5,1,0,196,1,1,198,222,0.189,0.892
"3613","La Paz","Nuestra Señora de La Paz","Colegio Saint Peters",135,1,2,0,41,0,13,1,0,193,0,2,195,214,0.212,0.911
"3614","La Paz","Nuestra Señora de La Paz","Colegio Saint Peters",143,0,0,0,46,2,4,1,2,198,0,3,201,220,0.232,0.914
"3615","La Paz","Nuestra Señora de La Paz","Colegio Canadiense",133,0,0,0,48,2,9,1,2,195,0,7,202,222,0.246,0.91
"3616","La Paz","Nuestra Señora de La Paz","Colegio Canadiense",132,0,4,1,42,5,9,3,1,197,0,4,201,230,0.213,0.874
"3617","La Paz","Nuestra Señora de La Paz","Colegio Canadiense",135,0,0,1,48,0,6,1,2,193,1,1,195,221,0.249,0.882
"3618","La Paz","Nuestra Señora de La Paz","Colegio Canadiense",144,0,3,1,38,6,6,0,1,199,0,5,204,224,0.191,0.911
"3619","La Paz","Nuestra Señora de La Paz","Colegio Canadiense",132,0,0,1,46,4,11,1,0,195,1,5,201,229,0.236,0.878
"3620","La Paz","Nuestra Señora de La Paz","Colegio Canadiense",130,0,1,1,49,3,4,0,0,188,1,2,191,221,0.261,0.864
"3621","La Paz","Nuestra Señora de La Paz","Colegio Bolivar",117,1,0,2,52,1,17,2,1,193,1,3,197,223,0.269,0.883
"3622","La Paz","Nuestra Señora de La Paz","Colegio Bolivar",113,1,3,0,45,6,13,3,0,184,0,7,191,221,0.245,0.864
"3623","La Paz","Nuestra Señora de La Paz","Colegio Bolivar",121,0,5,1,38,2,5,0,1,173,2,8,183,218,0.22,0.839
"3624","La Paz","Nuestra Señora de La Paz","Colegio Bolivar",116,0,0,1,47,0,11,1,2,178,2,10,190,212,0.264,0.896
"3625","La Paz","Nuestra Señora de La Paz","Colegio Bolivar",134,0,1,0,44,1,10,0,1,191,0,5,196,214,0.23,0.916
"3626","La Paz","Nuestra Señora de La Paz","Colegio Bolivar",141,0,1,1,33,3,3,4,0,186,1,3,190,213,0.177,0.892
"3627","La Paz","Nuestra Señora de La Paz","Colegio Bolivar",113,0,2,0,47,2,13,0,2,179,0,7,186,218,0.263,0.853
"3628","La Paz","Nuestra Señora de La Paz","Colegio Bolivar",119,1,2,0,53,0,7,2,2,186,1,9,196,222,0.285,0.883
"3629","La Paz","Nuestra Señora de La Paz","Colegio Bolivar",127,1,2,0,49,3,5,0,0,187,0,4,191,220,0.262,0.868
"3630","La Paz","Nuestra Señora de La Paz","Unidad Educativa Republica de Cuba",124,1,4,0,38,1,11,2,2,183,0,3,186,209,0.208,0.89
"3631","La Paz","Nuestra Señora de La Paz","Unidad Educativa Republica de Cuba",128,1,1,3,42,2,8,2,1,188,1,4,193,219,0.223,0.881
"3632","La Paz","Nuestra Señora de La Paz","Unidad Educativa Republica de Cuba",120,1,4,5,52,2,13,2,0,199,0,4,203,224,0.261,0.906
"3633","La Paz","Nuestra Señora de La Paz","Unidad Educativa Republica de Cuba",118,0,2,0,46,4,14,1,4,189,2,4,195,217,0.243,0.899
"3634","La Paz","Nuestra Señora de La Paz","Unidad Educativa Republica de Cuba",121,0,1,2,50,3,6,2,2,187,2,3,192,219,0.267,0.877
"3635","La Paz","Nuestra Señora de La Paz","Unidad Educativa Republica de Cuba",123,1,1,0,55,2,10,2,1,195,1,0,196,228,0.282,0.86
"3636","La Paz","Nuestra Señora de La Paz","Unidad Educativa Republica de Cuba",128,1,0,2,46,3,11,1,3,195,1,2,198,224,0.236,0.884
"3637","La Paz","Nuestra Señora de La Paz","Unidad Educativa Republica de Cuba",134,0,0,0,43,1,3,2,0,183,2,6,191,221,0.235,0.864
"3638","La Paz","Nuestra Señora de La Paz","Unidad Educativa Republica de Cuba",132,0,2,0,46,1,4,2,3,190,0,5,195,217,0.242,0.899
"3639","La Paz","Nuestra Señora de La Paz","Unidad Educativa Republica de Cuba",109,2,4,1,58,2,13,1,1,191,1,4,196,222,0.304,0.883
"3640","La Paz","Nuestra Señora de La Paz","Unidad Educativa Republica de Cuba",137,0,2,1,41,2,6,1,2,192,0,3,195,217,0.214,0.899
"3641","La Paz","Nuestra Señora de La Paz","Unidad Educativa Republica de Cuba",116,2,2,1,42,3,12,1,0,179,3,11,193,218,0.235,0.885
"3642","La Paz","Nuestra Señora de La Paz","Unidad Educativa Republica de Cuba",125,0,3,2,52,2,11,0,0,195,2,5,202,221,0.267,0.914
"3643","La Paz","Nuestra Señora de La Paz","Complejo Deportivo San Luis",138,1,0,3,45,2,9,2,1,201,0,6,207,219,0.224,0.945
"3644","La Paz","Nuestra Señora de La Paz","Complejo Deportivo San Luis",152,1,1,3,46,1,1,2,1,208,1,3,212,225,0.221,0.942
"3645","La Paz","Nuestra Señora de La Paz","Complejo Deportivo San Luis",133,1,2,0,50,1,11,3,0,201,0,6,207,229,0.249,0.904
"3646","La Paz","Nuestra Señora de La Paz","Complejo Deportivo San Luis",141,0,0,0,45,3,8,2,0,199,0,6,205,215,0.226,0.953
"3647","La Paz","Nuestra Señora de La Paz","Complejo Deportivo San Luis",151,0,0,1,40,2,9,0,1,204,0,2,206,225,0.196,0.916
"3648","La Paz","Nuestra Señora de La Paz","Colegio Villarroel - 2201",107,1,2,1,67,1,16,1,2,198,2,6,206,225,0.338,0.916
"3649","La Paz","Nuestra Señora de La Paz","Colegio Villarroel - 2201",104,1,1,0,67,5,24,0,2,204,1,3,208,232,0.328,0.897
"3650","La Paz","Nuestra Señora de La Paz","Colegio Villarroel - 2201",122,0,2,1,57,1,16,1,0,200,2,2,204,230,0.285,0.887
"3651","La Paz","Nuestra Señora de La Paz","Colegio Villarroel - 2201",94,0,4,1,75,2,16,0,4,196,1,6,203,229,0.383,0.886
"3652","La Paz","Nuestra Señora de La Paz","Colegio Villarroel - 2201",120,1,0,0,70,3,18,0,0,212,0,3,215,230,0.33,0.935
"3653","La Paz","Nuestra Señora de La Paz","Colegio Villarroel - 2201",122,0,2,0,58,3,15,2,2,204,2,3,209,230,0.284,0.909
"3654","La Paz","Nuestra Señora de La Paz","Unidad Educativa Arabe De Egipto",123,0,1,2,57,2,12,0,0,197,0,3,200,222,0.289,0.901
"3655","La Paz","Nuestra Señora de La Paz","Unidad Educativa Arabe De Egipto",99,1,4,1,72,4,12,3,1,197,2,3,202,216,0.365,0.935
"3656","La Paz","Nuestra Señora de La Paz","Unidad Educativa Arabe De Egipto",112,0,0,1,67,2,11,0,3,196,2,6,204,224,0.342,0.911
"3657","La Paz","Nuestra Señora de La Paz","Unidad Educativa Arabe De Egipto",117,0,2,1,56,2,12,1,0,191,3,2,196,215,0.293,0.912
"3658","La Paz","Nuestra Señora de La Paz","Unidad Educativa Arabe De Egipto",108,1,0,0,64,3,16,1,1,194,3,4,201,218,0.33,0.922
"3659","La Paz","Nuestra Señora de La Paz","Unidad Educativa Arabe De Egipto",104,3,2,1,67,3,20,1,2,203,2,3,208,222,0.33,0.937
"3660","La Paz","Nuestra Señora de La Paz","Unidad Educativa Arabe De Egipto",117,0,0,0,55,3,17,0,1,193,1,4,198,215,0.285,0.921
"3661","La Paz","Nuestra Señora de La Paz","Unidad Educativa Arabe De Egipto",86,1,0,3,56,1,8,0,1,156,1,4,161,175,0.359,0.92
"3662","La Paz","Nuestra Señora de La Paz","Colegio Villarroel - 2204",110,1,1,1,53,1,10,1,1,179,0,9,188,214,0.296,0.879
"3663","La Paz","Nuestra Señora de La Paz","Colegio Villarroel - 2204",101,1,2,1,61,1,14,0,3,184,1,4,189,214,0.332,0.883
"3664","La Paz","Nuestra Señora de La Paz","Colegio Villarroel - 2204",111,1,2,1,57,5,20,0,1,198,0,3,201,219,0.288,0.918
"3665","La Paz","Nuestra Señora de La Paz","Colegio Villarroel - 2204",118,1,1,2,50,2,13,1,1,189,0,7,196,218,0.265,0.899
"3666","La Paz","Nuestra Señora de La Paz","Colegio Villarroel - 2204",101,0,1,2,70,2,17,2,1,196,0,7,203,220,0.357,0.923
"3667","La Paz","Nuestra Señora de La Paz","Colegio Villarroel - 2204",115,0,4,0,53,2,19,2,0,195,1,5,201,220,0.272,0.914
"3668","La Paz","Nuestra Señora de La Paz","Colegio Villarroel - 2204",103,0,1,0,66,4,17,1,1,193,2,7,202,226,0.342,0.894
"3669","La Paz","Nuestra Señora de La Paz","Colegio Villarroel - 2204",113,2,1,2,50,2,12,0,3,185,2,5,192,213,0.27,0.901
"3670","La Paz","Nuestra Señora de La Paz","Colegio Villarroel - 2204",124,0,1,1,67,6,10,1,1,211,0,5,216,230,0.318,0.939
"3671","La Paz","Nuestra Señora de La Paz","Esc. Mcal Santa Cruz",110,0,0,2,64,1,11,1,0,189,1,7,197,220,0.339,0.895
"3672","La Paz","Nuestra Señora de La Paz","Esc. Mcal Santa Cruz",103,0,3,0,63,1,9,2,1,182,1,6,189,220,0.346,0.859
"3673","La Paz","Nuestra Señora de La Paz","Esc. Mcal Santa Cruz",122,0,2,3,56,2,9,2,0,196,2,5,203,224,0.286,0.906
"3674","La Paz","Nuestra Señora de La Paz","Col. San Francisco",138,0,0,2,40,0,12,1,2,195,0,2,197,223,0.205,0.883
"3675","La Paz","Nuestra Señora de La Paz","Col. San Francisco",125,0,3,1,53,2,13,3,0,200,2,1,203,225,0.265,0.902
"3676","La Paz","Nuestra Señora de La Paz","Col. San Francisco",130,0,2,2,41,4,16,2,1,198,1,5,204,222,0.207,0.919
"3677","La Paz","Nuestra Señora de La Paz","Col. San Francisco",119,0,2,0,37,2,13,0,0,173,0,2,175,215,0.214,0.814
"3678","La Paz","Nuestra Señora de La Paz","Col. San Francisco",108,0,1,0,56,3,15,3,3,189,1,5,195,224,0.296,0.871
"3679","La Paz","Nuestra Señora de La Paz","Col. San Francisco",121,0,2,0,45,2,8,3,1,182,0,5,187,211,0.247,0.886
"3680","La Paz","Nuestra Señora de La Paz","Col. San Francisco",115,0,3,5,44,21,16,1,3,208,1,4,213,220,0.212,0.968
"3681","La Paz","Nuestra Señora de La Paz","Col. San Francisco",118,0,1,1,62,1,16,1,1,201,1,2,204,223,0.308,0.915
"3682","La Paz","Nuestra Señora de La Paz","Col. San Martin",110,2,1,0,50,3,12,0,4,182,1,4,187,211,0.275,0.886
"3683","La Paz","Nuestra Señora de La Paz","Col. San Martin",107,0,5,1,58,10,12,2,1,196,2,0,198,212,0.296,0.934
"3684","La Paz","Nuestra Señora de La Paz","Col. San Martin",91,0,0,1,76,4,8,0,2,182,2,10,194,219,0.418,0.886
"3685","La Paz","Nuestra Señora de La Paz","Col. San Martin",106,0,2,1,58,3,17,1,1,189,1,5,195,218,0.307,0.894
"3686","La Paz","Nuestra Señora de La Paz","Col. San Martin",128,2,1,0,56,1,13,1,0,202,0,4,206,222,0.277,0.928
"3687","La Paz","Nuestra Señora de La Paz","Col. San Martin",84,1,6,1,58,7,15,0,0,172,1,3,176,204,0.337,0.863
"3688","La Paz","Nuestra Señora de La Paz","Col. San Martin",103,0,1,1,61,1,10,4,1,182,3,3,188,217,0.335,0.866
"3689","La Paz","Nuestra Señora de La Paz","Col. San Martin",89,0,2,1,77,1,18,1,0,189,2,4,195,224,0.407,0.871
"3690","La Paz","Nuestra Señora de La Paz","Col. San Martin",111,1,3,1,61,3,13,0,1,194,0,3,197,213,0.314,0.925
"3691","La Paz","Nuestra Señora de La Paz","Col. San Martin",100,1,1,0,64,1,20,3,1,191,3,3,197,216,0.335,0.912
"3692","La Paz","Nuestra Señora de La Paz","Col. Maria Auxiliadora",142,0,4,0,45,0,9,1,1,202,1,4,207,227,0.223,0.912
"3693","La Paz","Nuestra Señora de La Paz","Col. Maria Auxiliadora",120,0,1,1,45,2,13,0,0,182,3,8,193,219,0.247,0.881
"3694","La Paz","Nuestra Señora de La Paz","Col. Maria Auxiliadora",126,0,4,0,51,2,16,2,1,202,1,4,207,220,0.252,0.941
"3695","La Paz","Nuestra Señora de La Paz","Col. Maria Auxiliadora",128,0,1,3,52,0,12,1,0,197,1,8,206,228,0.264,0.904
"3696","La Paz","Nuestra Señora de La Paz","Col. Maria Auxiliadora",139,1,1,0,41,5,9,1,0,197,0,4,201,225,0.208,0.893
"3697","La Paz","Nuestra Señora de La Paz","Col. Maria Auxiliadora",137,0,4,0,49,2,13,0,0,205,1,4,210,227,0.239,0.925
"3698","La Paz","Nuestra Señora de La Paz","Col. Maria Auxiliadora",120,0,4,2,59,1,6,0,1,193,2,1,196,221,0.306,0.887
"3699","La Paz","Nuestra Señora de La Paz","Col. Maria Auxiliadora",144,3,0,2,47,3,4,0,1,204,0,5,209,225,0.23,0.929
"3700","La Paz","Nuestra Señora de La Paz","Col. Maria Auxiliadora",124,1,3,3,47,2,12,0,0,192,2,6,200,220,0.245,0.909
"3701","La Paz","Nuestra Señora de La Paz","Col. Maria Auxiliadora",138,2,0,0,37,0,14,1,1,193,0,2,195,220,0.192,0.886
"3702","La Paz","Nuestra Señora de La Paz","Col. Maria Auxiliadora",136,0,0,2,37,3,9,1,1,189,0,11,200,226,0.196,0.885
"3703","La Paz","Nuestra Señora de La Paz","Esc. Eduardo Avaroa",106,0,1,2,68,1,8,1,3,190,0,10,200,221,0.358,0.905
"3704","La Paz","Nuestra Señora de La Paz","Esc. Eduardo Avaroa",87,0,3,0,67,2,22,2,5,188,4,8,200,220,0.356,0.909
"3705","La Paz","Nuestra Señora de La Paz","Esc. Eduardo Avaroa",112,1,1,1,71,2,15,0,0,203,0,5,208,224,0.35,0.929
"3706","La Paz","Nuestra Señora de La Paz","Esc. Eduardo Avaroa",110,0,1,2,70,3,8,1,2,197,0,2,199,223,0.355,0.892
"3707","La Paz","Nuestra Señora de La Paz","Esc. Eduardo Avaroa",99,0,5,1,75,2,16,1,0,199,1,3,203,221,0.377,0.919
"3708","La Paz","Nuestra Señora de La Paz","Esc. Eduardo Avaroa",91,1,1,1,70,4,24,0,3,195,1,6,202,223,0.359,0.906
"3709","La Paz","Nuestra Señora de La Paz","Esc. Eduardo Avaroa",82,1,3,0,75,2,21,1,4,189,3,4,196,221,0.397,0.887
"3710","La Paz","Nuestra Señora de La Paz","Esc. Eduardo Avaroa",88,0,4,1,81,0,20,0,3,197,1,2,200,219,0.411,0.913
"3711","La Paz","Nuestra Señora de La Paz","Esc. Eduardo Avaroa",113,3,4,0,59,1,16,0,0,196,0,3,199,217,0.301,0.917
"3712","La Paz","Nuestra Señora de La Paz","Esc. Eduardo Avaroa",85,0,4,1,74,2,25,0,3,194,3,4,201,222,0.381,0.905
"3713","La Paz","Nuestra Señora de La Paz","Esc. Eduardo Avaroa",106,2,0,3,72,5,10,1,1,200,0,0,200,218,0.36,0.917
"3714","La Paz","Nuestra Señora de La Paz","Esc. Eduardo Avaroa",89,1,1,1,77,3,22,1,2,197,3,1,201,213,0.391,0.944
"3715","La Paz","Nuestra Señora de La Paz","Esc. Eduardo Avaroa",93,0,1,1,81,5,16,0,3,200,1,6,207,226,0.405,0.916
"3716","La Paz","Nuestra Señora de La Paz","Esc. Eduardo Avaroa",109,2,2,2,60,1,19,3,1,199,0,5,204,222,0.302,0.919
"3717","La Paz","Nuestra Señora de La Paz","Esc. Eduardo Avaroa",69,0,4,0,85,3,21,2,1,185,1,6,192,221,0.459,0.869
"3718","La Paz","Nuestra Señora de La Paz","Esc. Eduardo Avaroa",104,0,2,1,73,0,17,1,1,199,0,2,201,220,0.367,0.914
"3719","La Paz","Nuestra Señora de La Paz","Esc. Eduardo Avaroa",119,1,2,0,66,2,9,0,0,199,0,2,201,224,0.332,0.897
"3720","La Paz","Nuestra Señora de La Paz","Esc. Eduardo Avaroa",93,2,5,1,74,4,16,2,1,198,1,4,203,222,0.374,0.914
"3721","La Paz","Nuestra Señora de La Paz","Esc. Eduardo Avaroa",118,1,1,1,68,1,12,0,1,203,1,4,208,227,0.335,0.916
"3722","La Paz","Nuestra Señora de La Paz","Esc. Eduardo Avaroa",104,1,6,2,58,1,24,0,3,199,1,6,206,219,0.291,0.941
"3723","La Paz","Nuestra Señora de La Paz","Esc. Eduardo Avaroa",102,1,5,2,62,2,18,0,1,193,1,7,201,223,0.321,0.901
"3724","La Paz","Nuestra Señora de La Paz","Esc. Eduardo Avaroa",102,0,3,2,66,4,13,0,1,191,2,3,196,219,0.346,0.895
"3725","La Paz","Nuestra Señora de La Paz","Esc. Eduardo Avaroa",92,0,4,0,68,5,15,0,3,187,2,4,193,215,0.364,0.898
"3726","La Paz","Nuestra Señora de La Paz","Esc. Eduardo Avaroa",93,0,3,1,71,0,15,1,0,184,0,10,194,214,0.386,0.907
"3727","La Paz","Nuestra Señora de La Paz","Esc. Eduardo Avaroa",112,1,2,2,63,3,16,0,2,201,2,0,203,225,0.313,0.902
"3728","La Paz","Nuestra Señora de La Paz","Esc. Eduardo Avaroa",101,2,2,0,76,6,8,0,1,196,0,4,200,216,0.388,0.926
"3729","La Paz","Nuestra Señora de La Paz","Unidad Educativa Privada La Paz",81,0,2,1,80,7,16,1,4,192,0,6,198,216,0.417,0.917
"3730","La Paz","Nuestra Señora de La Paz","Unidad Educativa Privada La Paz",98,0,4,2,76,2,14,0,3,199,0,5,204,219,0.382,0.932
"3731","La Paz","Nuestra Señora de La Paz","Unidad Educativa Privada La Paz",93,1,2,0,82,0,12,0,2,192,2,1,195,215,0.427,0.907
"3732","La Paz","Nuestra Señora de La Paz","Unidad Educativa Privada La Paz",103,2,3,1,72,2,14,0,0,197,0,6,203,219,0.365,0.927
"3733","La Paz","Nuestra Señora de La Paz","Unidad Educativa Privada La Paz",100,0,1,1,63,0,11,2,1,179,1,7,187,207,0.352,0.903
"3734","La Paz","Nuestra Señora de La Paz","Unidad Educativa Privada La Paz",103,0,1,0,67,2,13,2,4,192,1,5,198,216,0.349,0.917
"3735","La Paz","Nuestra Señora de La Paz","Esc. Gral. Jose Manuel Pando",90,1,4,2,85,2,21,0,2,207,1,6,214,226,0.411,0.947
"3736","La Paz","Nuestra Señora de La Paz","Esc. Gral. Jose Manuel Pando",85,1,5,2,75,0,25,0,1,194,1,5,200,220,0.387,0.909
"3737","La Paz","Nuestra Señora de La Paz","Esc. Gral. Jose Manuel Pando",78,0,3,1,82,0,26,2,1,193,1,2,196,219,0.425,0.895
"3738","La Paz","Nuestra Señora de La Paz","Esc. Gral. Jose Manuel Pando",84,1,2,3,76,2,22,0,1,191,5,8,204,218,0.398,0.936
"3739","La Paz","Nuestra Señora de La Paz","Esc. Gral. Jose Manuel Pando",84,0,3,1,96,2,20,0,1,207,0,3,210,224,0.464,0.938
"3740","La Paz","Nuestra Señora de La Paz","Esc. Gral. Jose Manuel Pando",84,0,2,1,87,2,19,0,4,199,0,8,207,216,0.437,0.958
"3741","La Paz","Nuestra Señora de La Paz","Esc. Gral. Jose Manuel Pando",82,0,3,1,80,7,17,1,2,193,5,4,202,224,0.415,0.902
"3742","La Paz","Nuestra Señora de La Paz","Esc. Gral. Jose Manuel Pando",72,2,3,1,96,3,22,0,3,202,0,4,206,216,0.475,0.954
"3743","La Paz","Nuestra Señora de La Paz","Esc. Gral. Jose Manuel Pando",86,1,3,0,86,4,17,0,1,198,0,9,207,219,0.434,0.945
"3744","La Paz","Nuestra Señora de La Paz","Esc. Gral. Jose Manuel Pando",81,0,4,2,88,2,16,0,1,194,3,3,200,215,0.454,0.93
"3745","La Paz","Nuestra Señora de La Paz","Esc. Ladislao Cabrera",83,0,3,0,96,2,7,2,1,194,1,2,197,218,0.495,0.904
"3746","La Paz","Nuestra Señora de La Paz","Esc. Ladislao Cabrera",80,1,4,2,85,3,18,0,2,195,2,3,200,211,0.436,0.948
"3747","La Paz","Nuestra Señora de La Paz","Esc. Ladislao Cabrera",88,0,2,1,89,2,13,1,2,198,1,4,203,222,0.449,0.914
"3748","La Paz","Nuestra Señora de La Paz","Esc. Ladislao Cabrera",75,1,3,0,92,3,26,0,0,200,0,3,203,218,0.46,0.931
"3749","La Paz","Nuestra Señora de La Paz","Esc. Ladislao Cabrera",81,0,4,0,82,2,22,1,1,193,1,7,201,218,0.425,0.922
"3750","La Paz","Nuestra Señora de La Paz","Esc. Ladislao Cabrera",71,0,6,0,95,1,18,0,0,191,1,3,195,215,0.497,0.907
"3751","La Paz","Nuestra Señora de La Paz","Esc. Ladislao Cabrera",83,0,4,0,90,2,19,1,0,199,3,2,204,223,0.452,0.915
"3752","La Paz","Nuestra Señora de La Paz","Esc. Ladislao Cabrera",87,0,4,0,90,2,11,1,4,199,1,3,203,221,0.452,0.919
"3753","La Paz","Nuestra Señora de La Paz","Esc. Ladislao Cabrera",91,2,1,0,82,4,19,1,1,201,1,3,205,222,0.408,0.923
"3754","La Paz","Nuestra Señora de La Paz","Esc. Ladislao Cabrera",82,0,6,0,94,2,17,1,1,203,0,4,207,221,0.463,0.937
"3755","La Paz","Nuestra Señora de La Paz","Esc. Ladislao Cabrera",74,2,2,3,86,3,22,1,1,194,1,6,201,217,0.443,0.926
"3756","La Paz","Nuestra Señora de La Paz","Esc. Ladislao Cabrera",71,0,1,2,98,3,21,0,1,197,1,6,204,224,0.497,0.911
"3757","La Paz","Nuestra Señora de La Paz","Esc. Ladislao Cabrera",73,0,1,1,92,1,20,0,0,188,0,11,199,211,0.489,0.943
"3758","La Paz","Nuestra Señora de La Paz","Esc. Ladislao Cabrera",54,2,6,2,97,2,12,0,3,178,1,6,185,212,0.545,0.873
"3759","La Paz","Nuestra Señora de La Paz","Esc. Ladislao Cabrera",84,2,1,1,88,3,13,1,1,194,0,12,206,218,0.454,0.945
"3760","La Paz","Nuestra Señora de La Paz","Esc. Ladislao Cabrera",77,1,2,0,84,2,19,0,2,187,1,7,195,215,0.449,0.907
"3761","La Paz","Nuestra Señora de La Paz","Esc. Ladislao Cabrera",94,2,2,0,76,4,14,1,2,195,1,5,201,218,0.39,0.922
"3762","La Paz","Nuestra Señora de La Paz","Esc. Ladislao Cabrera",84,1,3,1,85,2,16,2,1,195,1,10,206,219,0.436,0.941
"3763","La Paz","Nuestra Señora de La Paz","Esc. Ladislao Cabrera",74,2,2,1,98,2,11,4,1,195,1,2,198,216,0.503,0.917
"3764","La Paz","Nuestra Señora de La Paz","Esc. Ladislao Cabrera",61,0,3,0,110,3,22,1,1,201,2,3,206,221,0.547,0.932
"3765","La Paz","Nuestra Señora de La Paz","Esc. Ladislao Cabrera",91,0,2,1,84,3,13,0,1,195,0,7,202,217,0.431,0.931
"3766","La Paz","Nuestra Señora de La Paz","Esc. Ladislao Cabrera",92,1,3,2,75,1,22,0,3,199,0,7,206,220,0.377,0.936
"3767","La Paz","Nuestra Señora de La Paz","Esc. Ladislao Cabrera",79,0,3,0,92,2,17,0,2,195,2,2,199,213,0.472,0.934
"3768","La Paz","Nuestra Señora de La Paz","Esc. Ladislao Cabrera",85,2,4,0,86,1,12,0,2,192,3,5,200,221,0.448,0.905
"3769","La Paz","Nuestra Señora de La Paz","Esc. Ladislao Cabrera",90,1,1,0,75,3,22,0,3,195,1,4,200,225,0.385,0.889
"3770","La Paz","Nuestra Señora de La Paz","Esc. Sagrado Corazon De Jesus",65,0,4,0,102,2,21,1,4,199,2,5,206,219,0.513,0.941
"3771","La Paz","Nuestra Señora de La Paz","Esc. Sagrado Corazon De Jesus",61,1,6,1,107,0,19,2,1,198,2,2,202,218,0.54,0.927
"3772","La Paz","Nuestra Señora de La Paz","Esc. Sagrado Corazon De Jesus",45,2,2,0,123,8,24,0,1,205,0,6,211,226,0.6,0.934
"3773","La Paz","Nuestra Señora de La Paz","Esc. Sagrado Corazon De Jesus",48,0,2,0,104,3,32,0,4,193,2,3,198,216,0.539,0.917
"3774","La Paz","Nuestra Señora de La Paz","Esc. Sagrado Corazon De Jesus",57,0,5,0,113,1,26,0,3,205,0,8,213,224,0.551,0.951
"3775","La Paz","Nuestra Señora de La Paz","Esc. Sagrado Corazon De Jesus",56,1,3,3,109,3,16,1,4,196,1,6,203,221,0.556,0.919
"3776","La Paz","Nuestra Señora de La Paz","Esc. Sagrado Corazon De Jesus",66,2,6,0,103,2,29,0,1,209,1,3,213,225,0.493,0.947
"3777","La Paz","Nuestra Señora de La Paz","Esc. Sagrado Corazon De Jesus",66,3,7,1,95,3,22,0,1,198,1,2,201,222,0.48,0.905
"3778","La Paz","Nuestra Señora de La Paz","Esc. Sagrado Corazon De Jesus",50,2,1,1,107,2,26,0,5,194,0,9,203,224,0.552,0.906
"3779","La Paz","Nuestra Señora de La Paz","Esc. Sagrado Corazon De Jesus",62,0,2,0,103,0,19,2,4,192,1,3,196,219,0.536,0.895
"3780","La Paz","Nuestra Señora de La Paz","Esc. Sagrado Corazon De Jesus",50,2,5,0,120,3,21,0,0,201,2,7,210,229,0.597,0.917
"3781","La Paz","Nuestra Señora de La Paz","Esc. Sagrado Corazon De Jesus",69,1,5,0,102,1,13,1,1,193,2,8,203,225,0.528,0.902
"3782","La Paz","Nuestra Señora de La Paz","Esc. Sagrado Corazon De Jesus",61,1,1,0,117,2,15,2,5,204,0,5,209,225,0.574,0.929
"3783","La Paz","Nuestra Señora de La Paz","Esc. Sagrado Corazon De Jesus",48,1,8,0,112,3,22,0,1,195,0,5,200,223,0.574,0.897
"3784","La Paz","Nuestra Señora de La Paz","Esc. Sagrado Corazon De Jesus",40,1,5,0,122,0,24,1,1,194,3,12,209,222,0.629,0.941
"3785","La Paz","Nuestra Señora de La Paz","Esc. Sagrado Corazon De Jesus",50,0,4,0,122,3,15,1,3,198,1,9,208,225,0.616,0.924
"3786","La Paz","Nuestra Señora de La Paz","Esc. Sagrado Corazon De Jesus",69,2,3,2,100,6,20,0,4,206,1,1,208,223,0.485,0.933
"3787","La Paz","Nuestra Señora de La Paz","Esc. Sagrado Corazon De Jesus",57,2,7,0,121,5,9,0,2,203,1,3,207,221,0.596,0.937
"3788","La Paz","Nuestra Señora de La Paz","Esc. Sagrado Corazon De Jesus",29,2,6,0,128,1,31,0,4,201,2,3,206,228,0.637,0.904
"3789","La Paz","Nuestra Señora de La Paz","Esc. Sagrado Corazon De Jesus",42,1,3,1,116,0,22,2,4,191,1,4,196,230,0.607,0.852
"3790","La Paz","Nuestra Señora de La Paz","Esc. Sagrado Corazon De Jesus",50,1,6,0,113,0,18,0,1,189,3,10,202,225,0.598,0.898
"3791","La Paz","Nuestra Señora de La Paz","Esc. Sagrado Corazon De Jesus",59,0,4,1,122,0,23,0,3,212,1,7,220,232,0.575,0.948
"3792","La Paz","Nuestra Señora de La Paz","Esc. Sagrado Corazon De Jesus",49,0,5,0,105,3,25,1,6,194,0,7,201,220,0.541,0.914
"3793","La Paz","Nuestra Señora de La Paz","Esc. Sagrado Corazon De Jesus",65,2,2,1,89,3,32,0,2,196,2,6,204,222,0.454,0.919
"3794","La Paz","Nuestra Señora de La Paz","Esc. Sagrado Corazon De Jesus",68,1,9,0,112,1,19,0,2,212,1,2,215,231,0.528,0.931
"3795","La Paz","Nuestra Señora de La Paz","Esc. Sagrado Corazon De Jesus",60,1,1,2,122,3,22,0,1,212,0,8,220,229,0.575,0.961
"3796","La Paz","Nuestra Señora de La Paz","Esc. Sagrado Corazon De Jesus",35,1,6,0,130,0,25,0,1,198,1,8,207,223,0.657,0.928
"3797","La Paz","Nuestra Señora de La Paz","Esc. Sagrado Corazon De Jesus",28,0,4,2,129,3,20,1,6,193,0,11,204,216,0.668,0.944
"3798","La Paz","Nuestra Señora de La Paz","Esc. Sagrado Corazon De Jesus",42,1,4,1,124,2,19,0,1,194,1,6,201,222,0.639,0.905
"3799","La Paz","Nuestra Señora de La Paz","Esc. Sagrado Corazon De Jesus",61,2,3,1,95,2,31,1,4,200,0,10,210,228,0.475,0.921
"3800","La Paz","Nuestra Señora de La Paz","Esc. Sagrado Corazon De Jesus",67,0,1,1,98,0,21,1,1,190,5,3,198,221,0.516,0.896
"3801","La Paz","Nuestra Señora de La Paz","Esc. Sagrado Corazon De Jesus",64,0,7,0,110,1,15,1,3,201,2,1,204,219,0.547,0.932
"3802","La Paz","Nuestra Señora de La Paz","Esc. Sagrado Corazon De Jesus",57,0,6,0,108,4,22,0,3,200,0,9,209,226,0.54,0.925
"3803","La Paz","Nuestra Señora de La Paz","Esc. Sagrado Corazon De Jesus",66,0,1,0,94,2,26,1,1,191,2,6,199,221,0.492,0.9
"3804","La Paz","Nuestra Señora de La Paz","Esc. Sagrado Corazon De Jesus",51,1,6,0,84,4,21,0,4,171,0,6,177,194,0.491,0.912
"3805","La Paz","Nuestra Señora de La Paz","Col. Daniel Sanchez Bustamante - Alto Chijini - 25050",72,0,7,0,90,3,22,0,2,196,0,6,202,225,0.459,0.898
"3806","La Paz","Nuestra Señora de La Paz","Col. Daniel Sanchez Bustamante - Alto Chijini - 25050",83,0,6,0,81,3,15,2,0,190,0,6,196,227,0.426,0.863
"3807","La Paz","Nuestra Señora de La Paz","Col. Daniel Sanchez Bustamante - Alto Chijini - 25050",65,0,2,0,103,2,21,1,4,198,1,5,204,229,0.52,0.891
"3808","La Paz","Nuestra Señora de La Paz","Col. Daniel Sanchez Bustamante - Alto Chijini - 25050",69,0,9,2,75,8,0,1,3,167,39,3,209,232,0.449,0.901
"3809","La Paz","Nuestra Señora de La Paz","Col. Daniel Sanchez Bustamante - Alto Chijini - 25050",87,2,1,0,87,2,21,1,3,204,2,6,212,229,0.426,0.926
"3810","La Paz","Nuestra Señora de La Paz","Col. Daniel Sanchez Bustamante - Alto Chijini - 25050",80,0,5,0,98,1,15,0,2,201,3,2,206,237,0.488,0.869
"3811","La Paz","Nuestra Señora de La Paz","Col. Canada",95,0,2,1,93,1,9,0,0,201,1,2,204,227,0.463,0.899
"3812","La Paz","Nuestra Señora de La Paz","Col. Canada",113,1,2,0,56,2,12,4,1,191,0,5,196,222,0.293,0.883
"3813","La Paz","Nuestra Señora de La Paz","Col. Canada",98,5,3,2,71,0,17,0,3,199,0,2,201,221,0.357,0.91
"3814","La Paz","Nuestra Señora de La Paz","Col. Canada",80,0,3,2,94,0,10,0,5,194,2,5,201,223,0.485,0.901
"3815","La Paz","Nuestra Señora de La Paz","Col. Canada",91,0,4,1,87,0,21,0,0,204,1,1,206,225,0.426,0.916
"3816","La Paz","Nuestra Señora de La Paz","Col. Canada",100,1,1,1,72,7,16,1,1,200,2,3,205,219,0.36,0.936
"3817","La Paz","Nuestra Señora de La Paz","Col. Canada",75,2,4,2,94,5,17,0,1,200,1,3,204,224,0.47,0.911
"3818","La Paz","Nuestra Señora de La Paz","Col. Canada",88,1,2,2,71,3,18,1,2,188,1,6,195,216,0.378,0.903
"3819","La Paz","Nuestra Señora de La Paz","Col. Canada",84,0,4,2,74,2,12,0,1,179,1,6,186,212,0.413,0.877
"3820","La Paz","Nuestra Señora de La Paz","Col. Canada",100,0,1,3,67,2,8,1,2,184,1,2,187,217,0.364,0.862
"3821","La Paz","Nuestra Señora de La Paz","Col. Canada",84,0,3,2,79,0,25,0,2,195,1,6,202,220,0.405,0.918
"3822","La Paz","Nuestra Señora de La Paz","Col. Canada",82,2,2,1,87,1,12,1,0,188,0,12,200,217,0.463,0.922
"3823","La Paz","Nuestra Señora de La Paz","Col. Canada",92,0,2,1,86,2,9,1,1,194,1,1,196,218,0.443,0.899
"3824","La Paz","Nuestra Señora de La Paz","Col. Canada",120,0,1,1,62,2,12,0,2,200,0,7,207,224,0.31,0.924
"3825","La Paz","Nuestra Señora de La Paz","Col. Canada",87,0,2,1,70,2,18,1,3,184,2,7,193,219,0.38,0.881
"3826","La Paz","Nuestra Señora de La Paz","Col. Daniel Sanchez Bustamante - Villa Nuevo Potosí - 2405",99,1,2,0,73,1,19,0,5,200,1,10,211,224,0.365,0.942
"3827","La Paz","Nuestra Señora de La Paz","Col. Daniel Sanchez Bustamante - Villa Nuevo Potosí - 2405",83,0,4,1,81,2,21,2,5,199,3,3,205,226,0.407,0.907
"3828","La Paz","Nuestra Señora de La Paz","Col. Daniel Sanchez Bustamante - Villa Nuevo Potosí - 2405",76,1,3,0,81,2,26,1,0,190,1,7,198,223,0.426,0.888
"3829","La Paz","Nuestra Señora de La Paz","Col. Daniel Sanchez Bustamante - Villa Nuevo Potosí - 2405",86,0,6,0,82,2,21,1,3,201,1,3,205,223,0.408,0.919
"3830","La Paz","Nuestra Señora de La Paz","Col. Daniel Sanchez Bustamante - Villa Nuevo Potosí - 2405",77,0,6,1,86,3,16,1,2,192,1,3,196,222,0.448,0.883
"3831","La Paz","Nuestra Señora de La Paz","Col. Daniel Sanchez Bustamante - Villa Nuevo Potosí - 2405",79,1,2,2,78,3,16,0,2,183,4,7,194,224,0.426,0.866
"3832","La Paz","Nuestra Señora de La Paz","Col. Daniel Sanchez Bustamante - Villa Nuevo Potosí - 2405",57,0,0,2,109,1,25,1,0,195,0,8,203,223,0.559,0.91
"3833","La Paz","Nuestra Señora de La Paz","Col. Daniel Sanchez Bustamante - Villa Nuevo Potosí - 2405",80,1,6,2,89,2,16,2,0,198,0,6,204,223,0.449,0.915
"3834","La Paz","Nuestra Señora de La Paz","Col. Daniel Sanchez Bustamante - Villa Nuevo Potosí - 2405",67,0,2,0,104,4,23,0,4,204,0,3,207,226,0.51,0.916
"3835","La Paz","Nuestra Señora de La Paz","Col. Daniel Sanchez Bustamante - Villa Nuevo Potosí - 2405",70,3,5,2,96,0,20,1,5,202,1,4,207,227,0.475,0.912
"3836","La Paz","Nuestra Señora de La Paz","Col. Daniel Sanchez Bustamante - Villa Nuevo Potosí - 2405",92,1,3,3,74,5,15,1,2,196,1,3,200,224,0.378,0.893
"3837","La Paz","Nuestra Señora de La Paz","Col. Daniel Sanchez Bustamante - Villa Nuevo Potosí - 2405",87,0,1,0,94,2,13,1,5,203,1,3,207,228,0.463,0.908
"3838","La Paz","Nuestra Señora de La Paz","Col. Daniel Sanchez Bustamante - Villa Nuevo Potosí - 2405",83,1,2,1,82,2,24,2,1,198,3,3,204,229,0.414,0.891
"3839","La Paz","Nuestra Señora de La Paz","Col. Daniel Sanchez Bustamante - Villa Nuevo Potosí - 2405",90,0,3,0,77,0,26,0,1,197,0,4,201,227,0.391,0.885
"3840","La Paz","Nuestra Señora de La Paz","Col. Daniel Sanchez Bustamante - Villa Nuevo Potosí - 2405",68,0,2,1,101,0,16,1,1,190,1,6,197,219,0.532,0.9
"3841","La Paz","Nuestra Señora de La Paz","Col. Daniel Sanchez Bustamante - Villa Nuevo Potosí - 2405",75,0,2,0,92,1,24,2,0,196,1,3,200,224,0.469,0.893
"3842","La Paz","Nuestra Señora de La Paz","Col. Daniel Sanchez Bustamante - Villa Nuevo Potosí - 2405",93,0,1,1,87,2,15,0,3,202,1,3,206,227,0.431,0.907
"3843","La Paz","Nuestra Señora de La Paz","Col. Daniel Sanchez Bustamante - Villa Nuevo Potosí - 2405",67,1,2,0,92,0,25,2,1,190,3,8,201,219,0.484,0.918
"3844","La Paz","Nuestra Señora de La Paz","Col. Daniel Sanchez Bustamante - Villa Nuevo Potosí - 2405",53,0,3,2,102,4,25,1,4,194,4,8,206,224,0.526,0.92
"3845","La Paz","Nuestra Señora de La Paz","Col. Daniel Sanchez Bustamante - Villa Nuevo Potosí - 2405",95,1,5,1,92,0,14,0,0,208,0,4,212,225,0.442,0.942
"3846","La Paz","Nuestra Señora de La Paz","Col. Daniel Sanchez Bustamante - Villa Nuevo Potosí - 2405",84,1,0,1,79,1,20,0,4,190,1,10,201,220,0.416,0.914
"3847","La Paz","Nuestra Señora de La Paz","Col. Daniel Sanchez Bustamante - Villa Nuevo Potosí - 2405",77,0,3,0,93,2,22,0,3,200,3,5,208,227,0.465,0.916
"3848","La Paz","Nuestra Señora de La Paz","Col. Daniel Sanchez Bustamante - Villa Nuevo Potosí - 2405",91,0,2,0,76,1,28,0,0,198,2,4,204,224,0.384,0.911
"3849","La Paz","Nuestra Señora de La Paz","Col. Daniel Sanchez Bustamante - Villa Nuevo Potosí - 2405",94,0,4,0,87,3,19,0,1,208,0,4,212,226,0.418,0.938
"3850","La Paz","Nuestra Señora de La Paz","Col. Daniel Sanchez Bustamante - Villa Nuevo Potosí - 2405",79,0,2,1,96,0,19,1,1,199,2,3,204,221,0.482,0.923
"3851","La Paz","Nuestra Señora de La Paz","Col. Daniel Sanchez Bustamante - Villa Nuevo Potosí - 2405",67,1,1,1,98,1,22,0,4,195,2,7,204,228,0.503,0.895
"3852","La Paz","Nuestra Señora de La Paz","Col. Daniel Sanchez Bustamante - Villa Nuevo Potosí - 2405",99,2,5,0,81,5,16,0,1,209,3,2,214,227,0.388,0.943
"3853","La Paz","Nuestra Señora de La Paz","Col. Daniel Sanchez Bustamante - Villa Nuevo Potosí - 2405",73,1,3,0,106,4,9,0,2,198,1,6,205,228,0.535,0.899
"3854","La Paz","Nuestra Señora de La Paz","Col. Daniel Sanchez Bustamante - Villa Nuevo Potosí - 2405",82,1,4,0,83,2,24,0,0,196,0,6,202,222,0.423,0.91
"3855","La Paz","Nuestra Señora de La Paz","Col. Daniel Sanchez Bustamante - Villa Nuevo Potosí - 2405",62,0,1,0,110,2,15,0,1,191,1,6,198,219,0.576,0.904
"3856","La Paz","Nuestra Señora de La Paz","Col. Daniel Sanchez Bustamante - Villa Nuevo Potosí - 2405",84,1,3,0,89,1,21,1,3,203,1,4,208,223,0.438,0.933
"3857","La Paz","Nuestra Señora de La Paz","Col. Daniel Sanchez Bustamante - Villa Nuevo Potosí - 2405",100,1,3,0,79,0,14,1,1,199,1,4,204,221,0.397,0.923
"3858","La Paz","Nuestra Señora de La Paz","Col. Daniel Sanchez Bustamante - Villa Nuevo Potosí - 2405",81,0,2,1,95,4,19,1,3,206,0,5,211,229,0.461,0.921
"3859","La Paz","Nuestra Señora de La Paz","Esc. Remberto Tapia",75,0,7,0,87,2,21,1,2,195,2,3,200,215,0.446,0.93
"3860","La Paz","Nuestra Señora de La Paz","Esc. Remberto Tapia",73,1,5,1,89,0,25,1,1,196,3,7,206,219,0.454,0.941
"3861","La Paz","Nuestra Señora de La Paz","Esc. Remberto Tapia",87,0,5,0,95,3,10,0,1,201,2,5,208,224,0.473,0.929
"3862","La Paz","Nuestra Señora de La Paz","Esc. Remberto Tapia",79,2,1,0,97,3,13,0,1,196,1,4,201,222,0.495,0.905
"3863","La Paz","Nuestra Señora de La Paz","Esc. Remberto Tapia",75,0,3,1,100,3,16,0,1,199,1,5,205,218,0.503,0.94
"3864","La Paz","Nuestra Señora de La Paz","Esc. Remberto Tapia",65,0,3,0,93,5,26,0,1,193,0,2,195,214,0.482,0.911
"3865","La Paz","Nuestra Señora de La Paz","Esc. Remberto Tapia",76,1,3,0,95,4,20,1,2,202,1,3,206,221,0.47,0.932
"3866","La Paz","Nuestra Señora de La Paz","Esc. Remberto Tapia",82,3,2,1,94,5,11,2,1,201,2,4,207,215,0.468,0.963
"3867","La Paz","Nuestra Señora de La Paz","Esc. Remberto Tapia",78,0,1,1,98,2,21,0,2,203,0,4,207,224,0.483,0.924
"3868","La Paz","Nuestra Señora de La Paz","Esc. Remberto Tapia",74,0,2,1,89,2,17,2,3,190,5,7,202,222,0.468,0.91
"3869","La Paz","Nuestra Señora de La Paz","Esc. Remberto Tapia",74,1,5,0,98,5,16,0,3,202,0,4,206,222,0.485,0.928
"3870","La Paz","Nuestra Señora de La Paz","Esc. Remberto Tapia",72,1,2,1,89,4,21,0,1,191,2,6,199,217,0.466,0.917
"3871","La Paz","Nuestra Señora de La Paz","Esc. Remberto Tapia",53,1,5,0,115,1,27,1,1,204,2,1,207,222,0.564,0.932
"3872","La Paz","Nuestra Señora de La Paz","Esc. Remberto Tapia",67,0,6,0,103,2,12,1,3,194,0,11,205,221,0.531,0.928
"3873","La Paz","Nuestra Señora de La Paz","Esc. Remberto Tapia",81,0,1,1,89,1,21,0,4,198,2,6,206,217,0.449,0.949
"3874","La Paz","Nuestra Señora de La Paz","Esc. Remberto Tapia",68,0,2,0,88,3,13,0,4,178,4,8,190,215,0.494,0.884
"3875","La Paz","Nuestra Señora de La Paz","Esc. Remberto Tapia",84,0,3,1,84,3,15,2,4,196,0,6,202,218,0.429,0.927
"3876","La Paz","Nuestra Señora de La Paz","Esc. Remberto Tapia",79,1,0,3,102,3,17,0,4,209,0,3,212,225,0.488,0.942
"3877","La Paz","Nuestra Señora de La Paz","Esc. Remberto Tapia",82,1,8,1,82,1,21,0,3,199,0,11,210,227,0.412,0.925
"3878","La Paz","Nuestra Señora de La Paz","Esc. Remberto Tapia",86,1,2,0,102,1,14,0,3,209,1,1,211,223,0.488,0.946
"3879","La Paz","Nuestra Señora de La Paz","Esc. Remberto Tapia",67,1,2,0,119,0,19,0,1,209,4,3,216,223,0.569,0.969
"3880","La Paz","Nuestra Señora de La Paz","Esc. Remberto Tapia",78,0,6,2,98,3,17,0,3,207,1,3,211,223,0.473,0.946
"3881","La Paz","Nuestra Señora de La Paz","Colegio Italia - 2501",72,0,4,0,96,2,25,0,0,199,0,4,203,219,0.482,0.927
"3882","La Paz","Nuestra Señora de La Paz","Colegio Italia - 2501",85,0,2,0,84,1,24,1,4,201,1,4,206,224,0.418,0.92
"3883","La Paz","Nuestra Señora de La Paz","Colegio Italia - 2501",56,1,9,0,98,5,30,0,1,200,0,6,206,220,0.49,0.936
"3884","La Paz","Nuestra Señora de La Paz","Colegio Italia - 2501",75,1,4,0,101,3,17,0,3,204,1,3,208,218,0.495,0.954
"3885","La Paz","Nuestra Señora de La Paz","Colegio Italia - 2501",62,0,4,1,104,1,21,1,2,196,1,6,203,223,0.531,0.91
"3886","La Paz","Nuestra Señora de La Paz","Colegio Italia - 2501",64,2,5,1,105,2,26,0,2,207,1,2,210,230,0.507,0.913
"3887","La Paz","Nuestra Señora de La Paz","Colegio Italia - 2501",68,0,0,1,98,4,22,0,3,196,1,7,204,219,0.5,0.932
"3888","La Paz","Nuestra Señora de La Paz","Colegio Italia - 2501",91,1,8,0,87,5,5,2,0,199,4,5,208,223,0.437,0.933
"3889","La Paz","Nuestra Señora de La Paz","Colegio Italia - 2501",54,0,5,0,113,4,20,1,2,199,2,3,204,218,0.568,0.936
"3890","La Paz","Nuestra Señora de La Paz","Colegio Italia - 2501",42,4,2,1,104,0,22,0,5,180,3,7,190,213,0.578,0.892
"3891","La Paz","Nuestra Señora de La Paz","Colegio Italia - 2501",72,1,5,0,89,3,27,0,1,198,1,6,205,222,0.449,0.923
"3892","La Paz","Nuestra Señora de La Paz","Colegio Italia - 2501",66,0,6,1,96,3,25,0,3,200,0,6,206,225,0.48,0.916
"3893","La Paz","Nuestra Señora de La Paz","Colegio Italia - 2501",78,1,2,0,95,0,25,2,0,203,2,5,210,232,0.468,0.905
"3894","La Paz","Nuestra Señora de La Paz","Colegio Italia - 2501",55,0,5,0,103,4,22,0,1,190,2,1,193,216,0.542,0.894
"3895","La Paz","Nuestra Señora de La Paz","Colegio Italia - 2501",84,0,5,1,81,1,22,0,2,196,2,6,204,222,0.413,0.919
"3896","La Paz","Nuestra Señora de La Paz","Colegio Italia - 2501",90,0,2,0,88,1,16,0,2,199,2,6,207,217,0.442,0.954
"3897","La Paz","Nuestra Señora de La Paz","Colegio Italia - 2501",85,0,2,1,83,1,24,0,3,199,3,2,204,222,0.417,0.919
"3898","La Paz","Nuestra Señora de La Paz","Esc. Club De Leones - 2502",100,1,2,2,80,4,18,2,1,210,2,5,217,229,0.381,0.948
"3899","La Paz","Nuestra Señora de La Paz","Esc. Club De Leones - 2502",74,1,3,1,101,2,17,0,2,201,0,11,212,222,0.502,0.955
"3900","La Paz","Nuestra Señora de La Paz","Esc. Club De Leones - 2502",82,1,1,0,82,2,28,2,2,200,0,5,205,227,0.41,0.903
"3901","La Paz","Nuestra Señora de La Paz","Esc. Club De Leones - 2502",98,1,4,0,76,0,15,0,0,194,1,7,202,225,0.392,0.898
"3902","La Paz","Nuestra Señora de La Paz","Esc. Club De Leones - 2502",82,2,1,1,89,3,23,3,1,205,0,5,210,224,0.434,0.938
"3903","La Paz","Nuestra Señora de La Paz","Esc. Club De Leones - 2502",83,2,4,3,73,6,23,1,1,196,0,6,202,217,0.372,0.931
"3904","La Paz","Nuestra Señora de La Paz","Esc. Club De Leones - 2502",63,1,4,0,103,4,26,2,1,204,1,6,211,227,0.505,0.93
"3905","La Paz","Nuestra Señora de La Paz","Esc. Club De Leones - 2502",64,2,4,1,98,6,17,1,3,196,2,12,210,222,0.5,0.946
"3906","La Paz","Nuestra Señora de La Paz","Esc. Club De Leones - 2502",65,1,3,0,97,4,16,2,1,189,2,11,202,222,0.513,0.91
"3907","La Paz","Nuestra Señora de La Paz","Esc. Club De Leones - 2502",60,0,5,2,102,2,21,0,0,192,0,8,200,221,0.531,0.905
"3908","La Paz","Nuestra Señora de La Paz","Esc. Club De Leones - 2502",83,0,6,1,86,5,16,1,1,199,1,4,204,219,0.432,0.932
"3909","La Paz","Nuestra Señora de La Paz","Esc. Club De Leones - 2502",80,0,1,1,99,0,20,0,0,201,2,4,207,225,0.493,0.92
"3910","La Paz","Nuestra Señora de La Paz","Esc. Club De Leones - 2502",71,0,3,0,99,6,17,0,2,198,1,4,203,214,0.5,0.949
"3911","La Paz","Nuestra Señora de La Paz","Esc. Club De Leones - 2502",93,1,2,0,76,4,22,1,1,200,0,4,204,223,0.38,0.915
"3912","La Paz","Nuestra Señora de La Paz","Esc. Club De Leones - 2502",70,2,4,4,96,2,26,1,1,206,0,7,213,225,0.466,0.947
"3913","La Paz","Nuestra Señora de La Paz","Esc. Club De Leones - 2502",81,0,7,0,92,1,22,1,2,206,0,3,209,223,0.447,0.937
"3914","La Paz","Nuestra Señora de La Paz","Esc. Club De Leones - 2502",53,0,2,1,99,3,20,1,4,183,5,8,196,212,0.541,0.925
"3915","La Paz","Nuestra Señora de La Paz","Esc. Club De Leones - 2502",54,1,6,0,117,0,16,1,4,199,2,7,208,226,0.588,0.92
"3916","La Paz","Nuestra Señora de La Paz","Esc. Club De Leones - 2502",64,1,0,3,99,2,27,0,1,197,0,4,201,226,0.503,0.889
"3917","La Paz","Nuestra Señora de La Paz","Esc. Club De Leones - 2502",81,1,6,1,75,3,19,0,3,189,0,6,195,215,0.397,0.907
"3918","La Paz","Nuestra Señora de La Paz","Esc. Club De Leones - 2502",72,1,6,1,90,5,20,0,1,196,1,12,209,228,0.459,0.917
"3919","La Paz","Nuestra Señora de La Paz","Esc. Club De Leones - 2502",66,0,4,0,100,0,26,1,0,197,1,5,203,222,0.508,0.914
"3920","La Paz","Nuestra Señora de La Paz","Esc. Club De Leones - 2502",81,0,3,0,96,1,12,1,3,197,4,4,205,220,0.487,0.932
"3921","La Paz","Nuestra Señora de La Paz","Esc. Club De Leones - 2502",59,2,7,1,119,1,22,0,0,211,2,10,223,230,0.564,0.97
"3922","La Paz","Nuestra Señora de La Paz","Esc. Club De Leones - 2502",75,0,3,0,89,2,20,0,3,192,2,12,206,225,0.464,0.916
"3923","La Paz","Nuestra Señora de La Paz","Esc. Club De Leones - 2502",78,1,5,0,96,2,19,0,0,201,1,4,206,226,0.478,0.912
"3924","La Paz","Nuestra Señora de La Paz","Esc. Club De Leones - 2502",82,1,2,0,85,7,21,0,0,198,1,8,207,214,0.429,0.967
"3925","La Paz","Nuestra Señora de La Paz","Esc. Club De Leones - 2502",50,0,7,1,109,0,16,1,0,184,1,7,192,212,0.592,0.906
"3926","La Paz","Nuestra Señora de La Paz","Esc. Club De Leones - 2502",86,0,5,1,88,1,16,0,1,198,1,6,205,223,0.444,0.919
"3927","La Paz","Nuestra Señora de La Paz","Esc. Club De Leones - 2502",82,2,4,0,90,1,21,2,2,204,1,5,210,222,0.441,0.946
"3928","La Paz","Nuestra Señora de La Paz","Esc. Club De Leones - 2502",73,0,4,0,71,4,29,2,0,183,3,9,195,212,0.388,0.92
"3929","La Paz","Nuestra Señora de La Paz","Colegio Holanda - 2505",96,1,2,0,68,3,16,0,2,188,2,7,197,227,0.362,0.868
"3930","La Paz","Nuestra Señora de La Paz","Colegio Holanda - 2505",71,0,5,1,93,1,24,0,3,198,1,2,201,224,0.47,0.897
"3931","La Paz","Nuestra Señora de La Paz","Colegio Holanda - 2505",79,0,2,0,84,0,29,0,0,194,0,6,200,229,0.433,0.873
"3932","La Paz","Nuestra Señora de La Paz","Colegio Holanda - 2505",75,0,1,0,98,1,21,2,2,200,1,4,205,226,0.49,0.907
"3933","La Paz","Nuestra Señora de La Paz","Colegio Holanda - 2505",98,1,1,1,72,0,25,0,1,199,2,7,208,228,0.362,0.912
"3934","La Paz","Nuestra Señora de La Paz","Colegio Holanda - 2505",79,0,3,1,78,4,25,2,4,196,1,5,202,225,0.398,0.898
"3935","La Paz","Nuestra Señora de La Paz","Colegio Holanda - 2505",67,2,1,0,101,2,19,1,1,194,0,6,200,226,0.521,0.885
"3936","La Paz","Nuestra Señora de La Paz","Colegio Holanda - 2505",89,2,2,0,85,5,15,1,4,203,0,1,204,229,0.419,0.891
"3937","La Paz","Nuestra Señora de La Paz","Colegio Holanda - 2505",82,0,0,0,86,3,19,0,3,193,1,10,204,226,0.446,0.903
"3938","La Paz","Nuestra Señora de La Paz","Colegio Holanda - 2505",59,0,6,3,99,4,26,0,1,198,1,3,202,222,0.5,0.91
"3939","La Paz","Nuestra Señora de La Paz","Colegio Holanda - 2505",84,1,4,2,79,1,16,2,4,193,2,3,198,221,0.409,0.896
"3940","La Paz","Nuestra Señora de La Paz","Colegio Holanda - 2505",62,0,4,1,100,4,23,1,1,196,2,12,210,226,0.51,0.929
"3941","La Paz","Nuestra Señora de La Paz","Colegio Holanda - 2505",58,1,3,3,102,4,21,1,0,193,0,4,197,227,0.528,0.868
"3942","La Paz","Nuestra Señora de La Paz","Colegio Holanda - 2505",95,1,4,0,86,2,12,0,2,202,1,3,206,222,0.426,0.928
"3943","La Paz","Nuestra Señora de La Paz","Colegio Holanda - 2505",80,1,5,3,87,3,17,2,2,200,0,5,205,226,0.435,0.907
"3944","La Paz","Nuestra Señora de La Paz","Colegio Holanda - 2505",90,0,2,1,82,5,19,2,0,201,1,4,206,225,0.408,0.916
"3945","La Paz","Nuestra Señora de La Paz","Colegio Holanda - 2505",68,0,6,1,95,2,27,0,0,199,1,6,206,218,0.477,0.945
"3946","La Paz","Nuestra Señora de La Paz","Colegio Holanda - 2505",49,1,2,0,115,1,26,0,1,195,2,9,206,227,0.59,0.907
"3947","La Paz","Nuestra Señora de La Paz","Colegio Holanda - 2505",86,1,2,0,85,2,28,0,3,207,0,4,211,228,0.411,0.925
"3948","La Paz","Nuestra Señora de La Paz","Colegio Holanda - 2505",87,0,0,0,86,4,24,0,0,201,0,1,202,230,0.428,0.878
"3949","La Paz","Nuestra Señora de La Paz","Colegio Holanda - 2505",80,0,2,3,89,4,23,0,1,202,0,6,208,231,0.441,0.9
"3950","La Paz","Nuestra Señora de La Paz","Colegio Holanda - 2505",108,0,0,0,79,5,18,1,0,211,1,5,217,235,0.374,0.923
"3951","La Paz","Nuestra Señora de La Paz","U.E. Filadelfia",39,0,8,0,124,3,35,2,3,214,1,7,222,237,0.579,0.937
"3952","La Paz","Nuestra Señora de La Paz","U.E. Filadelfia",28,1,8,4,124,2,28,2,3,200,3,12,215,235,0.62,0.915
"3953","La Paz","Nuestra Señora de La Paz","U.E. Filadelfia",23,1,5,0,136,1,40,0,3,209,1,9,219,234,0.651,0.936
"3954","La Paz","Nuestra Señora de La Paz","U.E. Filadelfia",33,1,7,0,140,0,25,0,2,208,0,13,221,233,0.673,0.948
"3955","La Paz","Nuestra Señora de La Paz","Colegio Holanda - 2504",77,0,4,0,85,4,21,5,1,197,0,8,205,228,0.431,0.899
"3956","La Paz","Nuestra Señora de La Paz","Colegio Holanda - 2504",69,0,5,1,94,0,24,1,2,196,2,4,202,221,0.48,0.914
"3957","La Paz","Nuestra Señora de La Paz","Colegio Holanda - 2504",61,2,2,1,96,4,24,1,1,192,1,6,199,226,0.5,0.881
"3958","La Paz","Nuestra Señora de La Paz","Colegio Holanda - 2504",66,1,2,0,96,6,26,0,4,201,0,4,205,226,0.478,0.907
"3959","La Paz","Nuestra Señora de La Paz","Colegio Holanda - 2504",73,0,2,1,97,2,25,0,1,201,1,7,209,229,0.483,0.913
"3960","La Paz","Nuestra Señora de La Paz","Colegio Holanda - 2504",74,1,2,1,87,2,27,0,1,195,0,8,203,232,0.446,0.875
"3961","La Paz","Nuestra Señora de La Paz","Colegio Holanda - 2504",88,1,3,0,78,6,20,0,1,197,3,12,212,229,0.396,0.926
"3962","La Paz","Nuestra Señora de La Paz","Colegio Holanda - 2504",72,1,4,0,107,3,22,0,2,211,0,6,217,233,0.507,0.931
"3963","La Paz","Nuestra Señora de La Paz","Colegio Holanda - 2504",69,0,5,0,95,5,17,1,3,195,1,7,203,223,0.487,0.91
"3964","La Paz","Nuestra Señora de La Paz","Colegio Holanda - 2504",50,0,7,3,106,4,22,0,1,193,3,4,200,232,0.549,0.862
"3965","La Paz","Nuestra Señora de La Paz","Colegio Holanda - 2504",65,0,0,1,119,1,21,0,1,208,0,6,214,230,0.572,0.93
"3966","La Paz","Nuestra Señora de La Paz","Colegio Holanda - 2504",87,0,6,0,81,1,29,0,1,205,3,5,213,232,0.395,0.918
"3967","La Paz","Nuestra Señora de La Paz","Colegio Holanda - 2504",76,1,3,0,92,2,16,1,1,192,3,10,205,232,0.479,0.884
"3968","La Paz","Nuestra Señora de La Paz","Colegio Holanda - 2504",85,1,4,0,88,0,10,1,5,194,1,6,201,221,0.454,0.91
"3969","La Paz","Nuestra Señora de La Paz","Colegio Holanda - 2504",69,0,3,0,90,1,24,0,1,188,2,6,196,229,0.479,0.856
"3970","La Paz","Nuestra Señora de La Paz","Colegio Holanda - 2504",96,2,5,0,79,3,26,1,2,214,0,6,220,230,0.369,0.957
"3971","La Paz","Nuestra Señora de La Paz","Colegio Holanda - 2504",65,0,3,2,108,4,18,1,0,201,1,5,207,225,0.537,0.92
"3972","La Paz","Nuestra Señora de La Paz","Colegio Holanda - 2504",80,1,1,0,97,2,20,1,1,203,0,5,208,224,0.478,0.929
"3973","La Paz","Nuestra Señora de La Paz","Colegio Holanda - 2504",57,0,4,0,108,4,26,0,1,200,3,7,210,227,0.54,0.925
"3974","La Paz","Nuestra Señora de La Paz","Colegio Holanda - 2504",45,0,7,0,130,3,16,0,1,202,4,9,215,235,0.644,0.915
"3975","La Paz","Nuestra Señora de La Paz","Colegio Holanda - 2504",75,0,4,1,95,1,29,1,4,210,2,5,217,232,0.452,0.935
"3976","La Paz","Nuestra Señora de La Paz","Colegio Holanda - 2504",69,0,4,0,106,1,18,1,4,203,0,3,206,231,0.522,0.892
"3977","La Paz","Nuestra Señora de La Paz","Colegio Holanda - 2504",85,0,2,1,95,4,14,1,0,202,1,6,209,229,0.47,0.913
"3978","La Paz","Nuestra Señora de La Paz","Colegio Holanda - 2504",81,0,2,0,79,7,28,0,1,198,1,9,208,225,0.399,0.924
"3979","La Paz","Nuestra Señora de La Paz","Colegio Holanda - 2504",63,0,4,0,106,1,24,0,0,198,3,6,207,229,0.535,0.904
"3980","La Paz","Nuestra Señora de La Paz","Colegio Holanda - 2504",91,1,2,0,86,1,31,0,0,212,0,5,217,227,0.406,0.956
"3981","La Paz","Nuestra Señora de La Paz","Colegio Holanda - 2504",60,0,3,1,102,4,19,0,1,190,0,15,205,222,0.537,0.923
"3982","La Paz","Nuestra Señora de La Paz","Colegio Holanda - 2504",59,1,6,1,110,4,21,0,1,203,2,5,210,229,0.542,0.917
"3983","La Paz","Nuestra Señora de La Paz","Colegio Holanda - 2504",73,1,2,0,94,3,11,1,1,186,2,3,191,219,0.505,0.872
"3984","La Paz","Nuestra Señora de La Paz","Colegio Holanda - 2504",77,0,4,0,102,0,19,1,1,204,0,7,211,229,0.5,0.921
"3985","La Paz","Nuestra Señora de La Paz","Colegio Holanda - 2504",71,0,1,0,100,5,19,1,6,203,1,3,207,227,0.493,0.912
"3986","La Paz","Nuestra Señora de La Paz","Colegio Holanda - 2504",54,0,3,0,107,6,28,1,2,201,1,2,204,224,0.532,0.911
"3987","La Paz","Nuestra Señora de La Paz","Colegio Holanda - 2504",76,1,0,1,88,4,25,1,0,196,2,4,202,226,0.449,0.894
"3988","La Paz","Nuestra Señora de La Paz","Colegio Holanda - 2504",81,0,0,0,91,2,23,0,3,200,1,9,210,228,0.455,0.921
"3989","La Paz","Nuestra Señora de La Paz","Colegio Max Toledo - 2601",90,1,4,1,80,5,18,0,0,199,1,3,203,221,0.402,0.919
"3990","La Paz","Nuestra Señora de La Paz","Colegio Max Toledo - 2601",81,1,5,0,89,3,9,1,2,191,1,3,195,208,0.466,0.938
"3991","La Paz","Nuestra Señora de La Paz","Colegio Max Toledo - 2601",106,0,3,0,71,2,16,0,1,199,1,6,206,219,0.357,0.941
"3992","La Paz","Nuestra Señora de La Paz","Colegio Max Toledo - 2601",87,1,2,0,85,2,24,1,2,204,1,2,207,224,0.417,0.924
"3993","La Paz","Nuestra Señora de La Paz","Colegio Max Toledo - 2601",83,0,2,1,91,3,15,0,4,199,0,5,204,215,0.457,0.949
"3994","La Paz","Nuestra Señora de La Paz","Colegio Max Toledo - 2601",92,0,3,2,79,2,15,2,1,196,2,4,202,220,0.403,0.918
"3995","La Paz","Nuestra Señora de La Paz","Colegio Max Toledo - 2601",81,0,4,1,92,5,12,1,1,197,0,5,202,218,0.467,0.927
"3996","La Paz","Nuestra Señora de La Paz","Colegio Max Toledo - 2601",83,1,4,0,81,2,22,2,0,195,2,7,204,222,0.415,0.919
"3997","La Paz","Nuestra Señora de La Paz","Colegio Max Toledo - 2601",97,0,3,1,75,3,17,0,0,196,1,4,201,217,0.383,0.926
"3998","La Paz","Nuestra Señora de La Paz","Colegio Max Toledo - 2601",100,0,4,0,76,3,16,0,0,199,1,3,203,217,0.382,0.935
"3999","La Paz","Nuestra Señora de La Paz","Colegio Max Toledo - 2601",84,0,1,0,90,1,13,0,0,189,0,7,196,212,0.476,0.925
"4000","La Paz","Nuestra Señora de La Paz","Colegio Max Toledo - 2601",80,0,5,0,91,1,20,0,0,197,2,0,199,222,0.462,0.896
"4001","La Paz","Nuestra Señora de La Paz","Colegio Max Toledo - 2601",92,0,4,0,79,4,27,0,1,207,3,3,213,224,0.382,0.951
"4002","La Paz","Nuestra Señora de La Paz","Colegio Max Toledo - 2601",91,0,3,0,79,5,11,0,2,191,2,7,200,216,0.414,0.926
"4003","La Paz","Nuestra Señora de La Paz","Colegio Max Toledo - 2601",93,0,2,0,80,2,21,1,0,199,1,6,206,225,0.402,0.916
"4004","La Paz","Nuestra Señora de La Paz","Colegio Max Toledo - 2601",70,1,5,1,90,4,20,0,0,191,1,7,199,216,0.471,0.921
"4005","La Paz","Nuestra Señora de La Paz","Colegio Max Toledo - 2601",108,0,3,0,71,10,11,0,5,208,1,4,213,229,0.341,0.93
"4006","La Paz","Nuestra Señora de La Paz","Colegio Max Toledo - 2601",109,2,1,0,65,2,14,0,3,196,0,4,200,219,0.332,0.913
"4007","La Paz","Nuestra Señora de La Paz","Colegio Max Toledo - 2601",104,0,1,0,72,2,24,0,2,205,1,3,209,222,0.351,0.941
"4008","La Paz","Nuestra Señora de La Paz","Colegio Max Toledo - 2601",102,0,2,4,62,2,21,0,1,194,0,6,200,219,0.32,0.913
"4009","La Paz","Nuestra Señora de La Paz","Colegio Max Toledo - 2601",97,0,2,0,73,0,7,2,2,183,0,3,186,203,0.399,0.916
"4010","La Paz","Nuestra Señora de La Paz","Unidad Educativa Fabril 18 de Mayo - Callampaya - 2602",106,1,1,1,65,4,16,1,0,195,0,2,197,222,0.333,0.887
"4011","La Paz","Nuestra Señora de La Paz","Unidad Educativa Fabril 18 de Mayo - Callampaya - 2602",109,0,4,0,63,1,16,1,0,194,1,6,201,221,0.325,0.91
"4012","La Paz","Nuestra Señora de La Paz","Unidad Educativa Fabril 18 de Mayo - Callampaya - 2602",94,0,2,2,83,2,17,1,0,201,0,6,207,223,0.413,0.928
"4013","La Paz","Nuestra Señora de La Paz","Unidad Educativa Fabril 18 de Mayo - Callampaya - 2602",123,1,2,1,51,5,15,0,1,199,5,3,207,223,0.256,0.928
"4014","La Paz","Nuestra Señora de La Paz","Unidad Educativa Fabril 18 de Mayo - Callampaya - 2602",103,0,2,1,65,0,20,4,3,198,2,3,203,219,0.328,0.927
"4015","La Paz","Nuestra Señora de La Paz","Unidad Educativa Fabril 18 de Mayo - Callampaya - 2602",115,1,2,0,67,2,13,0,1,201,1,6,208,221,0.333,0.941
"4016","La Paz","Nuestra Señora de La Paz","Colegio Max Toledo - 2603",95,0,3,0,68,0,19,1,1,187,0,9,196,211,0.364,0.929
"4017","La Paz","Nuestra Señora de La Paz","Colegio Max Toledo - 2603",95,0,3,1,62,2,24,0,1,188,3,6,197,217,0.33,0.908
"4018","La Paz","Nuestra Señora de La Paz","Colegio Max Toledo - 2603",68,1,2,3,75,4,21,2,1,177,0,6,183,205,0.424,0.893
"4019","La Paz","Nuestra Señora de La Paz","Colegio Max Toledo - 2603",77,3,4,0,63,6,24,3,4,184,2,2,188,209,0.342,0.9
"4020","La Paz","Nuestra Señora de La Paz","Colegio Max Toledo - 2603",85,0,5,1,80,4,12,0,1,188,1,5,194,220,0.426,0.882
"4021","La Paz","Nuestra Señora de La Paz","Colegio Max Toledo - 2603",98,1,7,0,69,3,17,0,2,197,1,3,201,219,0.35,0.918
"4022","La Paz","Nuestra Señora de La Paz","Colegio Max Toledo - 2603",73,0,5,2,76,0,22,0,1,179,1,6,186,212,0.425,0.877
"4023","La Paz","Nuestra Señora de La Paz","Colegio Max Toledo - 2603",87,1,3,2,69,7,21,1,1,192,3,4,199,214,0.359,0.93
"4024","La Paz","Nuestra Señora de La Paz","Colegio Max Toledo - 2603",85,0,3,3,72,1,20,1,1,186,5,3,194,215,0.387,0.902
"4025","La Paz","Nuestra Señora de La Paz","Colegio Max Toledo - 2603",80,0,2,0,82,3,19,0,1,187,2,8,197,215,0.439,0.916
"4026","La Paz","Nuestra Señora de La Paz","Colegio Max Toledo - 2603",89,2,2,1,78,7,10,2,0,191,0,2,193,218,0.408,0.885
"4027","La Paz","Nuestra Señora de La Paz","Esc. Club De Leones - 2604",94,1,4,1,81,0,18,2,0,201,0,6,207,218,0.403,0.95
"4028","La Paz","Nuestra Señora de La Paz","Esc. Club De Leones - 2604",96,0,2,2,69,1,31,0,2,203,1,2,206,226,0.34,0.912
"4029","La Paz","Nuestra Señora de La Paz","Esc. Club De Leones - 2604",61,1,2,0,108,2,22,0,1,197,0,9,206,217,0.548,0.949
"4030","La Paz","Nuestra Señora de La Paz","Esc. Club De Leones - 2604",90,2,4,2,80,2,20,1,0,201,3,7,211,224,0.398,0.942
"4031","La Paz","Nuestra Señora de La Paz","Esc. Club De Leones - 2604",83,1,2,0,94,3,18,1,2,204,0,6,210,218,0.461,0.963
"4032","La Paz","Nuestra Señora de La Paz","Esc. Club De Leones - 2604",87,1,3,1,88,2,16,0,2,200,2,2,204,213,0.44,0.958
"4033","La Paz","Nuestra Señora de La Paz","Esc. Club De Leones - 2604",100,0,1,1,75,4,19,0,2,202,2,3,207,224,0.371,0.924
"4034","La Paz","Nuestra Señora de La Paz","Esc. Club De Leones - 2604",80,0,4,1,95,4,18,0,2,204,1,4,209,222,0.466,0.941
"4035","La Paz","Nuestra Señora de La Paz","Esc. Club De Leones - 2604",92,0,7,1,80,4,10,2,2,198,0,7,205,219,0.404,0.936
"4036","La Paz","Nuestra Señora de La Paz","Esc. Club De Leones - 2604",81,0,0,1,84,1,24,0,2,193,4,11,208,225,0.435,0.924
"4037","La Paz","Nuestra Señora de La Paz","Colegio Italia - 2605",76,1,1,0,95,4,22,1,1,201,0,1,202,226,0.473,0.894
"4038","La Paz","Nuestra Señora de La Paz","Colegio Italia - 2605",66,2,3,0,101,2,29,0,3,206,1,4,211,230,0.49,0.917
"4039","La Paz","Nuestra Señora de La Paz","Colegio Italia - 2605",82,0,5,0,80,4,30,0,1,202,2,1,205,220,0.396,0.932
"4040","La Paz","Nuestra Señora de La Paz","Colegio Italia - 2605",84,1,3,2,90,1,24,0,1,206,2,9,217,232,0.437,0.935
"4041","La Paz","Nuestra Señora de La Paz","Colegio Italia - 2605",86,0,2,0,90,1,25,0,4,208,2,5,215,233,0.433,0.923
"4042","La Paz","Nuestra Señora de La Paz","Colegio Italia - 2605",83,1,6,0,73,2,31,0,1,197,0,8,205,224,0.371,0.915
"4043","La Paz","Nuestra Señora de La Paz","U.E. Copacabana (Fe y Alegria)",69,1,3,0,98,2,24,3,3,203,4,8,215,229,0.483,0.939
"4044","La Paz","Nuestra Señora de La Paz","U.E. Copacabana (Fe y Alegria)",70,1,6,0,101,4,18,0,2,202,0,4,206,227,0.5,0.907
"4045","La Paz","Nuestra Señora de La Paz","U.E. Copacabana (Fe y Alegria)",73,0,7,1,91,8,18,0,1,199,1,5,205,221,0.457,0.928
"4046","La Paz","Nuestra Señora de La Paz","U.E. Copacabana (Fe y Alegria)",74,0,3,2,101,3,19,0,0,202,0,2,204,224,0.5,0.911
"4047","La Paz","Nuestra Señora de La Paz","U.E. Copacabana (Fe y Alegria)",58,0,9,0,118,4,20,0,0,209,1,2,212,225,0.565,0.942
"4048","La Paz","Nuestra Señora de La Paz","U.E. Copacabana (Fe y Alegria)",64,1,5,1,108,4,22,1,1,207,0,7,214,227,0.522,0.943
"4049","La Paz","Nuestra Señora de La Paz","U.E. Copacabana (Fe y Alegria)",59,0,0,0,111,5,18,0,2,195,2,4,201,217,0.569,0.926
"4050","La Paz","Nuestra Señora de La Paz","U.E. Copacabana (Fe y Alegria)",63,1,1,1,103,2,26,1,1,199,1,4,204,228,0.518,0.895
"4051","La Paz","Nuestra Señora de La Paz","U.E. Copacabana (Fe y Alegria)",68,0,2,2,96,3,27,1,3,202,0,10,212,228,0.475,0.93
"4052","La Paz","Nuestra Señora de La Paz","U.E. Copacabana (Fe y Alegria)",74,1,1,0,99,3,21,0,1,200,2,3,205,223,0.495,0.919
"4053","La Paz","Nuestra Señora de La Paz","U.E. Copacabana (Fe y Alegria)",74,2,4,1,100,3,18,0,5,207,2,2,211,227,0.483,0.93
"4054","La Paz","Nuestra Señora de La Paz","U.E. Copacabana (Fe y Alegria)",69,3,6,0,96,0,18,1,1,194,0,13,207,225,0.495,0.92
"4055","La Paz","Nuestra Señora de La Paz","U.E. Copacabana (Fe y Alegria)",65,0,2,0,102,3,21,0,3,196,2,8,206,227,0.52,0.907
"4056","La Paz","Nuestra Señora de La Paz","U.E. Copacabana (Fe y Alegria)",68,0,5,1,100,1,26,0,1,202,3,4,209,222,0.495,0.941
"4057","La Paz","Nuestra Señora de La Paz","U.E. Copacabana (Fe y Alegria)",54,1,4,1,100,7,28,1,2,198,3,11,212,228,0.505,0.93
"4058","La Paz","Nuestra Señora de La Paz","U.E. Copacabana (Fe y Alegria)",50,3,9,0,116,2,15,1,2,198,0,14,212,224,0.586,0.946
"4059","La Paz","Nuestra Señora de La Paz","U.E. Copacabana (Fe y Alegria)",69,1,6,3,105,1,23,0,1,209,1,8,218,232,0.502,0.94
"4060","La Paz","Nuestra Señora de La Paz","U.E. Copacabana (Fe y Alegria)",67,0,5,1,106,3,22,0,3,207,3,10,220,231,0.512,0.952
"4061","La Paz","Nuestra Señora de La Paz","U.E. Copacabana (Fe y Alegria)",66,0,5,0,108,2,19,0,3,203,1,7,211,224,0.532,0.942
"4062","La Paz","Nuestra Señora de La Paz","U.E. Copacabana (Fe y Alegria)",71,1,6,0,100,0,28,0,0,206,2,4,212,226,0.485,0.938
"4063","La Paz","Nuestra Señora de La Paz","U.E. Copacabana (Fe y Alegria)",58,1,5,2,108,3,18,1,0,196,2,6,204,225,0.551,0.907
"4064","La Paz","Nuestra Señora de La Paz","U.E. Copacabana (Fe y Alegria)",49,2,7,0,110,1,26,1,1,197,3,7,207,224,0.558,0.924
"4065","La Paz","Nuestra Señora de La Paz","U.E. Copacabana (Fe y Alegria)",63,0,6,0,109,2,14,0,3,197,2,4,203,223,0.553,0.91
"4066","La Paz","Nuestra Señora de La Paz","U.E. Copacabana (Fe y Alegria)",76,1,5,0,101,1,23,0,2,209,1,4,214,227,0.483,0.943
"4067","La Paz","Nuestra Señora de La Paz","U.E. Copacabana (Fe y Alegria)",72,0,5,2,94,0,20,2,4,199,1,9,209,223,0.472,0.937
"4068","La Paz","Nuestra Señora de La Paz","U.E. Copacabana (Fe y Alegria)",69,0,4,0,113,0,18,1,3,208,1,1,210,227,0.543,0.925
"4069","La Paz","Nuestra Señora de La Paz","U.E. Copacabana (Fe y Alegria)",66,0,7,0,105,4,22,0,5,209,0,10,219,229,0.502,0.956
"4070","La Paz","Nuestra Señora de La Paz","U.E. Abraham Reyes (Fe y Alegria)",57,0,6,0,112,2,22,0,2,201,2,7,210,229,0.557,0.917
"4071","La Paz","Nuestra Señora de La Paz","U.E. Abraham Reyes (Fe y Alegria)",63,0,2,1,97,2,28,0,5,198,2,4,204,221,0.49,0.923
"4072","La Paz","Nuestra Señora de La Paz","U.E. Abraham Reyes (Fe y Alegria)",68,1,3,0,103,3,29,0,3,210,1,3,214,229,0.49,0.934
"4073","La Paz","Nuestra Señora de La Paz","U.E. Abraham Reyes (Fe y Alegria)",59,0,6,0,105,2,29,1,1,203,0,3,206,224,0.517,0.92
"4074","La Paz","Nuestra Señora de La Paz","U.E. Abraham Reyes (Fe y Alegria)",60,0,10,0,105,4,29,0,4,212,0,3,215,228,0.495,0.943
"4075","La Paz","Nuestra Señora de La Paz","U.E. Abraham Reyes (Fe y Alegria)",55,1,6,2,113,2,26,0,4,209,1,3,213,227,0.541,0.938
"4076","La Paz","Nuestra Señora de La Paz","U.E. Abraham Reyes (Fe y Alegria)",67,0,4,0,113,3,22,0,5,214,2,6,222,230,0.528,0.965
"4077","La Paz","Nuestra Señora de La Paz","U.E. Abraham Reyes (Fe y Alegria)",56,1,3,0,114,3,21,0,3,201,0,7,208,231,0.567,0.9
"4078","La Paz","Nuestra Señora de La Paz","U.E. Abraham Reyes (Fe y Alegria)",75,0,2,0,103,3,14,1,4,202,2,7,211,222,0.51,0.95
"4079","La Paz","Nuestra Señora de La Paz","Sede Social de Cusicancha",59,3,7,2,116,2,22,0,0,211,0,4,215,230,0.55,0.935
"4080","La Paz","Nuestra Señora de La Paz","Sede Social de Cusicancha",45,2,7,1,115,3,20,1,2,196,4,5,205,223,0.587,0.919
"4081","La Paz","Nuestra Señora de La Paz","Sede Social de Cusicancha",47,1,14,1,99,2,39,1,2,206,3,6,215,219,0.481,0.982
"4082","La Paz","Nuestra Señora de La Paz","Sede Social de Cusicancha",40,1,8,0,137,5,20,1,3,215,4,4,223,227,0.637,0.982
"4083","La Paz","Nuestra Señora de La Paz","Sede Social de Cusicancha",51,1,12,0,112,5,22,0,1,204,1,5,210,223,0.549,0.942
"4084","La Paz","Nuestra Señora de La Paz","Sede Social de Cusicancha",36,1,7,1,114,6,42,0,4,211,2,6,219,229,0.54,0.956
"4085","La Paz","Nuestra Señora de La Paz","Unidad Educativa San Jose (U. E. Manuel B. Mariaca)",107,1,2,0,73,0,11,2,1,197,0,7,204,221,0.371,0.923
"4086","La Paz","Nuestra Señora de La Paz","Unidad Educativa San Jose (U. E. Manuel B. Mariaca)",110,1,0,1,69,4,8,0,1,194,1,4,199,216,0.356,0.921
"4087","La Paz","Nuestra Señora de La Paz","Unidad Educativa San Jose (U. E. Manuel B. Mariaca)",115,0,1,0,69,1,12,2,1,201,1,5,207,223,0.343,0.928
"4088","La Paz","Nuestra Señora de La Paz","Unidad Educativa San Jose (U. E. Manuel B. Mariaca)",90,0,3,0,75,4,19,1,1,193,0,5,198,212,0.389,0.934
"4089","La Paz","Nuestra Señora de La Paz","Unidad Educativa San Jose (U. E. Manuel B. Mariaca)",105,2,3,0,89,1,10,2,1,213,0,1,214,224,0.418,0.955
"4090","La Paz","Nuestra Señora de La Paz","Unidad Educativa San Jose (U. E. Manuel B. Mariaca)",109,1,1,1,65,2,13,0,1,193,1,3,197,216,0.337,0.912
"4091","La Paz","Nuestra Señora de La Paz","Unidad Educativa San Jose (U. E. Manuel B. Mariaca)",95,0,0,1,77,2,13,1,1,190,3,9,202,221,0.405,0.914
"4092","La Paz","Nuestra Señora de La Paz","Unidad Educativa San Jose (U. E. Manuel B. Mariaca)",103,1,5,0,71,5,13,0,2,200,2,5,207,226,0.355,0.916
"4093","La Paz","Nuestra Señora de La Paz","Unidad Educativa San Jose (U. E. Manuel B. Mariaca)",91,0,3,1,77,5,15,0,0,192,1,4,197,214,0.401,0.921
"4094","La Paz","Nuestra Señora de La Paz","Unidad Educativa San Jose (U. E. Manuel B. Mariaca)",108,0,2,4,68,3,8,1,2,196,1,10,207,224,0.347,0.924
"4095","La Paz","Nuestra Señora de La Paz","Unidad Educativa San Jose (U. E. Manuel B. Mariaca)",110,1,5,0,73,4,9,1,0,203,2,2,207,224,0.36,0.924
"4096","La Paz","Nuestra Señora de La Paz","Unidad Educativa San Jose (U. E. Manuel B. Mariaca)",104,1,1,0,77,2,18,0,0,203,1,2,206,220,0.379,0.936
"4097","La Paz","Nuestra Señora de La Paz","Unidad Educativa San Jose (U. E. Manuel B. Mariaca)",88,1,1,0,82,6,24,0,1,203,1,7,211,221,0.404,0.955
"4098","La Paz","Nuestra Señora de La Paz","Unidad Educativa San Jose (U. E. Manuel B. Mariaca)",106,0,3,1,69,2,14,1,2,198,3,2,203,217,0.348,0.935
"4099","La Paz","Nuestra Señora de La Paz","Unidad Educativa San Jose (U. E. Manuel B. Mariaca)",93,0,3,2,81,2,9,0,1,191,1,2,194,210,0.424,0.924
"4100","La Paz","Nuestra Señora de La Paz","Unidad Educativa San Jose (U. E. Manuel B. Mariaca)",114,1,6,1,71,3,13,0,3,212,2,3,217,229,0.335,0.948
"4101","La Paz","Nuestra Señora de La Paz","Col. Franz Tamayo",91,0,3,1,92,1,14,0,2,204,0,3,207,225,0.451,0.92
"4102","La Paz","Nuestra Señora de La Paz","Col. Franz Tamayo",104,1,1,1,70,0,16,0,0,193,5,5,203,229,0.363,0.886
"4103","La Paz","Nuestra Señora de La Paz","Col. Franz Tamayo",105,0,2,0,70,2,25,1,2,207,0,3,210,228,0.338,0.921
"4104","La Paz","Nuestra Señora de La Paz","Col. Franz Tamayo",115,1,3,0,68,1,17,0,0,205,1,5,211,228,0.332,0.925
"4105","La Paz","Nuestra Señora de La Paz","Col. Franz Tamayo",84,1,3,2,92,1,21,0,1,205,2,3,210,223,0.449,0.942
"4106","La Paz","Nuestra Señora de La Paz","Col. Franz Tamayo",116,0,1,0,63,2,12,0,2,196,0,6,202,226,0.321,0.894
"4107","La Paz","Nuestra Señora de La Paz","Col. Franz Tamayo",89,1,2,0,88,4,18,0,4,206,1,1,208,227,0.427,0.916
"4108","La Paz","Nuestra Señora de La Paz","Col. Franz Tamayo",85,0,5,0,84,1,22,2,3,202,2,4,208,222,0.416,0.937
"4109","La Paz","Nuestra Señora de La Paz","Col. Franz Tamayo",112,1,0,0,65,3,17,1,0,199,1,7,207,224,0.327,0.924
"4110","La Paz","Nuestra Señora de La Paz","Col. Franz Tamayo",124,2,2,0,57,3,10,0,1,199,2,3,204,224,0.286,0.911
"4111","La Paz","Nuestra Señora de La Paz","Col. Franz Tamayo",106,0,5,0,64,0,21,2,1,199,3,7,209,227,0.322,0.921
"4112","La Paz","Nuestra Señora de La Paz","Col. Franz Tamayo",98,0,2,0,65,2,21,1,0,189,1,7,197,225,0.344,0.876
"4113","La Paz","Nuestra Señora de La Paz","Col. Franz Tamayo",98,0,3,1,75,3,11,2,0,193,0,3,196,221,0.389,0.887
"4114","La Paz","Nuestra Señora de La Paz","Col. Franz Tamayo",105,0,2,1,65,2,20,4,0,199,1,4,204,215,0.327,0.949
"4115","La Paz","Nuestra Señora de La Paz","Col. Franz Tamayo",101,1,6,1,64,2,21,2,4,202,0,4,206,223,0.317,0.924
"4116","La Paz","Nuestra Señora de La Paz","Col. Franz Tamayo",100,0,3,0,68,6,20,1,2,200,1,4,205,223,0.34,0.919
"4117","La Paz","Nuestra Señora de La Paz","Col. Franz Tamayo",70,4,4,1,100,2,21,0,1,203,2,4,209,225,0.493,0.929
"4118","La Paz","Nuestra Señora de La Paz","Col. Franz Tamayo",94,0,3,0,76,3,21,3,1,201,1,6,208,226,0.378,0.92
"4119","La Paz","Nuestra Señora de La Paz","Col. Franz Tamayo",108,2,1,1,66,2,14,0,4,198,0,8,206,219,0.333,0.941
"4120","La Paz","Nuestra Señora de La Paz","Col. Franz Tamayo",111,1,1,0,70,4,16,2,3,208,5,7,220,233,0.337,0.944
"4121","La Paz","Nuestra Señora de La Paz","Col. Franz Tamayo",113,1,2,0,66,3,12,1,0,198,0,6,204,220,0.333,0.927
"4122","La Paz","Nuestra Señora de La Paz","Col. Franz Tamayo",97,0,2,0,81,0,19,0,0,199,1,4,204,226,0.407,0.903
"4123","La Paz","Nuestra Señora de La Paz","Col. Franz Tamayo",103,1,3,0,74,2,14,0,2,199,0,4,203,224,0.372,0.906
"4124","La Paz","Nuestra Señora de La Paz","Col. Franz Tamayo",64,1,1,2,109,1,16,1,1,196,3,0,199,219,0.556,0.909
"4125","La Paz","Nuestra Señora de La Paz","Col. Franz Tamayo",115,0,2,1,62,2,10,0,1,193,0,14,207,227,0.321,0.912
"4126","La Paz","Nuestra Señora de La Paz","Col. Franz Tamayo",90,0,2,0,74,2,16,2,2,188,1,4,193,220,0.394,0.877
"4127","La Paz","Nuestra Señora de La Paz","Col. Franz Tamayo",107,1,2,0,71,2,15,0,1,199,0,5,204,226,0.357,0.903
"4128","La Paz","Nuestra Señora de La Paz","Col. Franz Tamayo",95,1,1,0,68,0,25,0,1,191,0,7,198,224,0.356,0.884
"4129","La Paz","Nuestra Señora de La Paz","Col. Franz Tamayo",91,0,7,1,87,5,9,0,2,202,3,5,210,227,0.431,0.925
"4130","La Paz","Nuestra Señora de La Paz","Col. Franz Tamayo",94,0,1,0,72,6,9,4,0,186,1,6,193,218,0.387,0.885
"4131","La Paz","Nuestra Señora de La Paz","Col. Franz Tamayo",97,0,1,0,95,2,14,2,1,212,1,6,219,228,0.448,0.961
"4132","La Paz","Nuestra Señora de La Paz","Col. Franz Tamayo",74,0,1,2,67,2,13,0,3,162,0,2,164,173,0.414,0.948
"4133","La Paz","Nuestra Señora de La Paz","Col. Marien Garten",73,1,1,1,107,3,17,0,3,206,1,7,214,231,0.519,0.926
"4134","La Paz","Nuestra Señora de La Paz","Col. Marien Garten",82,0,3,1,96,2,18,1,1,204,1,2,207,225,0.471,0.92
"4135","La Paz","Nuestra Señora de La Paz","Col. Marien Garten",82,0,0,1,97,0,15,0,2,197,0,7,204,221,0.492,0.923
"4136","La Paz","Nuestra Señora de La Paz","Col. Marien Garten",75,2,2,0,94,2,22,2,0,199,1,1,201,222,0.472,0.905
"4137","La Paz","Nuestra Señora de La Paz","Col. Marien Garten",89,0,2,1,78,2,26,1,1,200,5,2,207,226,0.39,0.916
"4138","La Paz","Nuestra Señora de La Paz","Col. Marien Garten",81,0,3,0,91,1,31,0,3,210,0,2,212,230,0.433,0.922
"4139","La Paz","Nuestra Señora de La Paz","Col. Marien Garten",61,0,9,0,101,4,25,0,2,202,2,5,209,226,0.5,0.925
"4140","La Paz","Nuestra Señora de La Paz","Col. Marien Garten",84,0,1,0,92,3,24,0,1,205,0,9,214,226,0.449,0.947
"4141","La Paz","Nuestra Señora de La Paz","Col. Marien Garten",88,0,4,0,91,2,14,1,0,200,1,9,210,228,0.455,0.921
"4142","La Paz","Nuestra Señora de La Paz","Col. Marien Garten",83,0,4,0,86,2,23,0,1,199,1,9,209,228,0.432,0.917
"4143","La Paz","Nuestra Señora de La Paz","Col. Marien Garten",75,0,1,0,94,2,22,1,0,195,1,9,205,228,0.482,0.899
"4144","La Paz","Nuestra Señora de La Paz","Col. Marien Garten",94,1,4,1,84,2,21,2,0,209,0,3,212,226,0.402,0.938
"4145","La Paz","Nuestra Señora de La Paz","Col. Marien Garten",78,1,5,0,99,4,16,0,1,204,2,6,212,223,0.485,0.951
"4146","La Paz","Nuestra Señora de La Paz","Col. Marien Garten",67,0,6,1,112,4,19,0,0,209,0,6,215,227,0.536,0.947
"4147","La Paz","Nuestra Señora de La Paz","Col. Marien Garten",78,3,4,2,85,7,22,0,2,203,1,6,210,225,0.419,0.933
"4148","La Paz","Nuestra Señora de La Paz","Col. Marien Garten",80,1,4,0,96,1,21,0,2,205,2,4,211,223,0.468,0.946
"4149","La Paz","Nuestra Señora de La Paz","Col. Marien Garten",74,0,4,0,94,5,25,0,2,204,0,7,211,226,0.461,0.934
"4150","La Paz","Nuestra Señora de La Paz","Col. Marien Garten",70,0,3,1,103,4,13,0,0,194,0,4,198,226,0.531,0.876
"4151","La Paz","Nuestra Señora de La Paz","Col. Marien Garten",62,1,2,0,124,2,20,2,2,215,1,2,218,227,0.577,0.96
"4152","La Paz","Nuestra Señora de La Paz","Col. Marien Garten",68,2,4,0,89,2,29,1,1,196,3,7,206,228,0.454,0.904
"4153","La Paz","Nuestra Señora de La Paz","Col. Marien Garten",89,1,1,2,75,1,29,0,1,199,0,9,208,226,0.377,0.92
"4154","La Paz","Nuestra Señora de La Paz","Col. Marien Garten",83,1,3,2,95,3,25,1,2,215,2,5,222,229,0.442,0.969
"4155","La Paz","Nuestra Señora de La Paz","Col. Marien Garten",88,1,2,3,82,5,27,0,4,212,0,1,213,229,0.387,0.93
"4156","La Paz","Nuestra Señora de La Paz","Col. Marien Garten",94,2,9,1,68,4,25,1,2,206,0,3,209,224,0.33,0.933
"4157","La Paz","Nuestra Señora de La Paz","Col. Guillen Pinto",79,0,2,0,103,5,18,0,1,208,0,8,216,225,0.495,0.96
"4158","La Paz","Nuestra Señora de La Paz","Col. Guillen Pinto",72,1,5,0,96,2,16,2,0,194,0,3,197,217,0.495,0.908
"4159","La Paz","Nuestra Señora de La Paz","Col. Guillen Pinto",70,0,2,0,109,4,16,2,4,207,2,6,215,228,0.527,0.943
"4160","La Paz","Nuestra Señora de La Paz","Col. Guillen Pinto",80,1,4,1,106,3,8,0,2,205,4,3,212,223,0.517,0.951
"4161","La Paz","Nuestra Señora de La Paz","Col. Guillen Pinto",64,1,3,0,111,4,15,0,1,199,1,4,204,217,0.558,0.94
"4162","La Paz","Nuestra Señora de La Paz","Col. Guillen Pinto",51,0,5,1,103,3,17,1,3,184,1,8,193,208,0.56,0.928
"4163","La Paz","Nuestra Señora de La Paz","Col. Guillen Pinto",59,1,7,1,114,1,19,1,2,205,2,5,212,224,0.556,0.946
"4164","La Paz","Nuestra Señora de La Paz","Col. Guillen Pinto",84,1,4,1,79,1,18,0,5,193,1,4,198,212,0.409,0.934
"4165","La Paz","Nuestra Señora de La Paz","Col. Guillen Pinto",71,2,2,0,90,2,24,1,2,194,1,4,199,223,0.464,0.892
"4166","La Paz","Nuestra Señora de La Paz","Col. Guillen Pinto",67,1,2,0,118,0,7,0,4,199,0,7,206,226,0.593,0.912
"4167","La Paz","Nuestra Señora de La Paz","Col. Guillen Pinto",59,0,6,1,121,0,20,0,5,212,0,3,215,227,0.571,0.947
"4168","La Paz","Nuestra Señora de La Paz","Col. Guillen Pinto",75,1,2,0,85,4,30,2,1,200,2,5,207,221,0.425,0.937
"4169","La Paz","Nuestra Señora de La Paz","Col. Guillen Pinto",88,0,3,2,82,1,15,1,1,193,4,4,201,225,0.425,0.893
"4170","La Paz","Nuestra Señora de La Paz","Col. Guillen Pinto",56,0,7,0,109,3,26,0,2,203,1,5,209,217,0.537,0.963
"4171","La Paz","Nuestra Señora de La Paz","Col. Guillen Pinto",83,0,7,0,85,7,15,0,0,197,0,8,205,221,0.431,0.928
"4172","La Paz","Nuestra Señora de La Paz","Col. Guillen Pinto",92,1,2,0,91,2,10,4,3,205,0,4,209,220,0.444,0.95
"4173","La Paz","Nuestra Señora de La Paz","Col. Guillen Pinto",85,2,4,2,93,1,20,1,2,210,1,5,216,228,0.443,0.947
"4174","La Paz","Nuestra Señora de La Paz","Col. Guillen Pinto",72,0,2,0,103,5,12,1,3,198,0,7,205,215,0.52,0.953
"4175","La Paz","Nuestra Señora de La Paz","Col. Guillen Pinto",49,1,2,2,109,4,24,0,1,192,3,8,203,219,0.568,0.927
"4176","La Paz","Nuestra Señora de La Paz","Col. Guillen Pinto",65,2,5,0,104,1,22,0,0,199,0,8,207,225,0.523,0.92
"4177","La Paz","Nuestra Señora de La Paz","Col. Guillen Pinto",73,1,2,0,94,4,22,0,0,196,1,4,201,221,0.48,0.91
"4178","La Paz","Nuestra Señora de La Paz","Col. Guillen Pinto",69,2,5,0,98,0,21,2,1,198,2,1,201,223,0.495,0.901
"4179","La Paz","Nuestra Señora de La Paz","Col. Guillen Pinto",67,0,2,2,101,3,26,2,3,206,0,7,213,223,0.49,0.955
"4180","La Paz","Nuestra Señora de La Paz","Col. Guillen Pinto",80,1,1,1,92,3,18,0,4,200,0,2,202,213,0.46,0.948
"4181","La Paz","Nuestra Señora de La Paz","Colegio German Busch",121,0,0,1,58,3,11,1,1,196,1,2,199,222,0.296,0.896
"4182","La Paz","Nuestra Señora de La Paz","Colegio German Busch",117,1,1,0,53,4,15,1,0,192,1,3,196,216,0.276,0.907
"4183","La Paz","Nuestra Señora de La Paz","Colegio German Busch",102,0,8,2,71,1,12,1,0,197,1,6,204,224,0.36,0.911
"4184","La Paz","Nuestra Señora de La Paz","Colegio German Busch",124,0,2,2,40,3,12,1,1,185,1,2,188,218,0.216,0.862
"4185","La Paz","Nuestra Señora de La Paz","Colegio German Busch",134,1,0,1,49,2,8,1,0,196,1,2,199,223,0.25,0.892
"4186","La Paz","Nuestra Señora de La Paz","Colegio German Busch",125,1,1,3,42,6,11,0,1,190,1,4,195,218,0.221,0.894
"4187","La Paz","Nuestra Señora de La Paz","Colegio German Busch",95,0,2,0,67,1,20,0,1,186,0,4,190,219,0.36,0.868
"4188","La Paz","Nuestra Señora de La Paz","Colegio German Busch",126,0,2,2,47,5,13,0,0,195,0,3,198,218,0.241,0.908
"4189","La Paz","Nuestra Señora de La Paz","Colegio German Busch",127,0,3,0,44,4,9,0,1,188,0,8,196,223,0.234,0.879
"4190","La Paz","Nuestra Señora de La Paz","Colegio German Busch",99,0,4,0,59,3,14,2,0,181,1,9,191,221,0.326,0.864
"4191","La Paz","Nuestra Señora de La Paz","Colegio German Busch",126,0,3,2,49,1,8,0,0,189,2,2,193,214,0.259,0.902
"4192","La Paz","Nuestra Señora de La Paz","Colegio German Busch",116,0,2,1,55,1,12,0,1,188,0,2,190,216,0.293,0.88
"4193","La Paz","Nuestra Señora de La Paz","Colegio German Busch",150,0,0,0,31,0,9,1,0,191,2,6,199,218,0.162,0.913
"4194","La Paz","Nuestra Señora de La Paz","Colegio Francia",96,2,4,0,77,1,17,1,4,202,0,4,206,222,0.381,0.928
"4195","La Paz","Nuestra Señora de La Paz","Colegio Francia",116,0,1,1,68,2,14,2,2,206,2,6,214,224,0.33,0.955
"4196","La Paz","Nuestra Señora de La Paz","Colegio Francia",116,0,1,0,71,3,14,0,1,206,0,2,208,224,0.345,0.929
"4197","La Paz","Nuestra Señora de La Paz","Colegio Francia",112,1,2,1,75,1,11,0,3,206,3,6,215,227,0.364,0.947
"4198","La Paz","Nuestra Señora de La Paz","Colegio Francia",96,0,0,2,83,1,12,2,2,198,0,1,199,218,0.419,0.913
"4199","La Paz","Nuestra Señora de La Paz","Colegio Francia",120,0,4,0,66,2,11,1,1,205,0,5,210,226,0.322,0.929
"4200","La Paz","Nuestra Señora de La Paz","Colegio Francia",114,0,1,2,67,3,9,1,1,198,1,8,207,227,0.338,0.912
"4201","La Paz","Nuestra Señora de La Paz","Colegio Francia",116,1,1,0,67,4,8,0,1,198,1,6,205,222,0.338,0.923
"4202","La Paz","Nuestra Señora de La Paz","Escuela Republica del Brasil",113,0,2,0,66,4,3,0,1,189,0,4,193,218,0.349,0.885
"4203","La Paz","Nuestra Señora de La Paz","Escuela Republica del Brasil",121,2,0,0,55,0,13,0,0,191,0,6,197,220,0.288,0.895
"4204","La Paz","Nuestra Señora de La Paz","Escuela Republica del Brasil",112,0,1,2,61,1,15,2,2,196,0,2,198,224,0.311,0.884
"4205","La Paz","Nuestra Señora de La Paz","Escuela Republica del Brasil",113,0,1,3,56,2,15,1,1,192,1,4,197,218,0.292,0.904
"4206","La Paz","Nuestra Señora de La Paz","Escuela Republica del Brasil",126,0,2,1,46,1,9,0,0,185,2,3,190,222,0.249,0.856
"4207","La Paz","Nuestra Señora de La Paz","Escuela Republica del Brasil",111,0,1,3,67,2,14,1,2,201,0,2,203,222,0.333,0.914
"4208","La Paz","Nuestra Señora de La Paz","Escuela Republica del Brasil",123,0,2,1,61,4,14,1,0,206,0,7,213,227,0.296,0.938
"4209","La Paz","Nuestra Señora de La Paz","Escuela Republica del Brasil",114,2,1,0,65,2,6,1,0,191,0,5,196,223,0.34,0.879
"4210","La Paz","Nuestra Señora de La Paz","Escuela Republica del Brasil",114,1,1,1,59,0,15,0,0,191,0,9,200,223,0.309,0.897
"4211","La Paz","Nuestra Señora de La Paz","Escuela Republica del Brasil",116,1,0,4,56,1,8,0,0,186,0,4,190,214,0.301,0.888
"4212","La Paz","Nuestra Señora de La Paz","Escuela Republica del Brasil",121,0,2,0,51,4,12,0,1,191,1,2,194,215,0.267,0.902
"4213","La Paz","Nuestra Señora de La Paz","Escuela Republica del Brasil",91,1,0,1,45,5,11,1,2,157,0,5,162,187,0.287,0.866
"4214","La Paz","Nuestra Señora de La Paz","Col. San Javier",107,2,2,0,66,2,13,0,1,193,1,10,204,218,0.342,0.936
"4215","La Paz","Nuestra Señora de La Paz","Col. San Javier",111,0,1,1,66,1,8,1,1,190,1,10,201,219,0.347,0.918
"4216","La Paz","Nuestra Señora de La Paz","Col. San Javier",112,0,2,1,68,1,9,1,1,195,3,3,201,222,0.349,0.905
"4217","La Paz","Nuestra Señora de La Paz","Col. San Javier",145,0,1,1,38,3,9,0,1,198,0,3,201,220,0.192,0.914
"4218","La Paz","Nuestra Señora de La Paz","Col. San Javier",101,1,1,1,64,4,17,0,1,190,0,5,195,217,0.337,0.899
"4219","La Paz","Nuestra Señora de La Paz","Col. San Javier",112,0,0,1,67,2,15,0,2,199,0,5,204,218,0.337,0.936
"4220","La Paz","Nuestra Señora de La Paz","Col. San Javier",130,0,1,0,60,2,6,1,0,200,2,6,208,221,0.3,0.941
"4221","La Paz","Nuestra Señora de La Paz","Col. San Javier",133,0,1,0,57,0,7,0,0,198,1,6,205,220,0.288,0.932
"4222","La Paz","Nuestra Señora de La Paz","Col. San Javier",113,0,6,3,46,6,0,6,0,180,24,7,211,225,0.256,0.938
"4223","La Paz","Nuestra Señora de La Paz","Col. San Javier",122,1,4,0,57,3,11,1,1,200,1,4,205,225,0.285,0.911
"4224","La Paz","Nuestra Señora de La Paz","Unidad Educativa Fabril 18 de Mayo - Pura Pura - 2905",130,0,1,0,56,4,12,1,2,206,3,3,212,226,0.272,0.938
"4225","La Paz","Nuestra Señora de La Paz","Unidad Educativa Fabril 18 de Mayo - Pura Pura - 2905",121,0,0,2,62,3,9,0,2,199,1,5,205,226,0.312,0.907
"4226","La Paz","Nuestra Señora de La Paz","Unidad Educativa Fabril 18 de Mayo - Pura Pura - 2905",125,0,2,0,58,1,4,3,1,194,0,3,197,225,0.299,0.876
"4227","La Paz","Nuestra Señora de La Paz","Unidad Educativa Fabril 18 de Mayo - Pura Pura - 2905",119,0,4,2,51,4,8,0,1,189,1,4,194,215,0.27,0.902
"4228","La Paz","Nuestra Señora de La Paz","Unidad Educativa Fabril 18 de Mayo - Pura Pura - 2905",123,1,3,0,57,4,11,0,0,199,0,12,211,223,0.286,0.946
"4229","La Paz","Nuestra Señora de La Paz","Unidad Educativa Fabril 18 de Mayo - Pura Pura - 2905",118,0,2,3,62,0,6,0,1,192,1,7,200,214,0.323,0.935
"4230","La Paz","Nuestra Señora de La Paz","Unidad Educativa Fabril 18 de Mayo - Pura Pura - 2905",124,0,0,0,60,2,11,0,1,198,1,4,203,219,0.303,0.927
"4231","La Paz","Nuestra Señora de La Paz","Unidad Educativa Fabril 18 de Mayo - Pura Pura - 2905",92,0,2,0,49,1,9,0,0,153,0,4,157,166,0.32,0.946
"4232","La Paz","Nuestra Señora de La Paz","Sede Social Pura Pura",99,1,4,0,84,2,15,0,1,206,0,10,216,229,0.408,0.943
"4233","La Paz","Nuestra Señora de La Paz","Sede Social Pura Pura",88,1,3,1,83,1,15,1,1,194,0,6,200,223,0.428,0.897
"4234","La Paz","Nuestra Señora de La Paz","Sede Social Pura Pura",94,0,1,0,95,4,13,0,1,208,0,5,213,227,0.457,0.938
"4235","La Paz","Nuestra Señora de La Paz","Sede Social Pura Pura",92,1,2,0,85,1,14,1,1,197,4,4,205,224,0.431,0.915
"4236","La Paz","Nuestra Señora de La Paz","Sede Social Pura Pura",94,1,2,0,82,2,8,2,1,192,0,1,193,213,0.427,0.906
"4237","La Paz","Nuestra Señora de La Paz","Sede Social Pura Pura",62,0,3,0,108,3,23,0,2,201,0,6,207,226,0.537,0.916
"4238","La Paz","Nuestra Señora de La Paz","Sede Social Pura Pura",87,0,0,1,100,2,13,0,1,204,0,5,209,222,0.49,0.941
"4239","La Paz","Nuestra Señora de La Paz","Sede Social Pura Pura",82,1,2,0,89,2,18,0,2,196,2,3,201,216,0.454,0.931
"4240","La Paz","Nuestra Señora de La Paz","Sede Social Pura Pura",87,2,2,0,82,3,12,0,1,189,2,8,199,215,0.434,0.926
"4241","La Paz","Nuestra Señora de La Paz","Sede Social Pura Pura",117,0,1,2,70,0,11,2,1,204,1,4,209,229,0.343,0.913
"4242","La Paz","Nuestra Señora de La Paz","Escuela Eloy Alvarez Plata",128,0,1,0,63,2,3,0,2,199,2,2,203,220,0.317,0.923
"4243","La Paz","Nuestra Señora de La Paz","Escuela Eloy Alvarez Plata",120,0,1,1,65,1,10,0,1,199,0,8,207,218,0.327,0.95
"4244","La Paz","Nuestra Señora de La Paz","Escuela Eloy Alvarez Plata",137,1,1,1,54,2,5,1,3,205,1,3,209,225,0.263,0.929
"4245","La Paz","Nuestra Señora de La Paz","Escuela Eloy Alvarez Plata",129,0,3,1,47,1,9,1,1,192,2,2,196,213,0.245,0.92
"4246","La Paz","Nuestra Señora de La Paz","Escuela Eloy Alvarez Plata",133,0,0,2,59,4,2,0,0,200,1,4,205,222,0.295,0.923
"4247","La Paz","Nuestra Señora de La Paz","Escuela Eloy Alvarez Plata",127,0,0,0,53,1,8,0,1,190,0,5,195,215,0.279,0.907
"4248","La Paz","Nuestra Señora de La Paz","Escuela Eloy Alvarez Plata",128,3,2,1,46,2,11,1,4,198,1,4,203,224,0.232,0.906
"4249","La Paz","Nuestra Señora de La Paz","Esc. Gil Tapia Rada",78,2,6,1,104,0,11,1,1,204,0,5,209,230,0.51,0.909
"4250","La Paz","Nuestra Señora de La Paz","Esc. Gil Tapia Rada",60,0,2,1,104,2,28,1,1,199,2,14,215,227,0.523,0.947
"4251","La Paz","Nuestra Señora de La Paz","Esc. Gil Tapia Rada",88,0,4,0,80,4,23,1,2,202,1,11,214,225,0.396,0.951
"4252","La Paz","Nuestra Señora de La Paz","Esc. Gil Tapia Rada",77,0,4,0,109,0,20,0,2,212,1,6,219,233,0.514,0.94
"4253","La Paz","Nuestra Señora de La Paz","Esc. Gil Tapia Rada",66,0,5,3,110,3,18,0,1,206,3,10,219,228,0.534,0.961
"4254","La Paz","Nuestra Señora de La Paz","Esc. Gil Tapia Rada",49,1,3,2,120,2,26,1,3,207,0,9,216,231,0.58,0.935
"4255","La Paz","Nuestra Señora de La Paz","Esc. Gil Tapia Rada",68,1,4,0,95,2,29,0,3,202,1,5,208,228,0.47,0.912
"4256","La Paz","Nuestra Señora de La Paz","Esc. Gil Tapia Rada",69,0,5,1,102,4,21,1,2,205,2,4,211,228,0.498,0.925
"4257","La Paz","Nuestra Señora de La Paz","Esc. Gil Tapia Rada",80,2,6,0,99,1,11,0,0,199,1,4,204,219,0.497,0.932
"4258","La Paz","Nuestra Señora de La Paz","Esc. Gil Tapia Rada",59,1,1,2,114,6,28,1,2,214,2,7,223,231,0.533,0.965
"4259","La Paz","Nuestra Señora de La Paz","Esc. Gil Tapia Rada",63,1,4,1,105,2,19,0,3,198,2,6,206,225,0.53,0.916
"4260","La Paz","Nuestra Señora de La Paz","Esc. Gil Tapia Rada",56,0,2,1,115,3,23,0,1,201,2,7,210,225,0.572,0.933
"4261","La Paz","Nuestra Señora de La Paz","Esc. Gil Tapia Rada",43,1,4,0,133,6,23,0,3,213,5,8,226,236,0.624,0.958
"4262","La Paz","Nuestra Señora de La Paz","Esc. Gil Tapia Rada",95,0,0,0,94,2,15,2,1,209,5,7,221,230,0.45,0.961
"4263","La Paz","Nuestra Señora de La Paz","Esc. Gil Tapia Rada",100,1,1,1,84,2,9,0,1,199,1,7,207,220,0.422,0.941
"4264","La Paz","Nuestra Señora de La Paz","Esc. Gil Tapia Rada",66,1,6,1,101,3,16,2,3,199,3,5,207,226,0.508,0.916
"4265","La Paz","Nuestra Señora de La Paz","Esc. Gil Tapia Rada",66,2,4,0,106,0,23,0,6,207,1,8,216,232,0.512,0.931
"4266","La Paz","Nuestra Señora de La Paz","Esc. Gil Tapia Rada",49,0,5,1,130,8,21,0,1,215,1,3,219,233,0.605,0.94
"4267","La Paz","Nuestra Señora de La Paz","Esc. Gil Tapia Rada",97,0,4,0,88,4,14,1,3,211,1,5,217,226,0.417,0.96
"4268","La Paz","Nuestra Señora de La Paz","Esc. Gil Tapia Rada",100,1,1,0,85,0,17,0,0,204,2,3,209,225,0.417,0.929
"4269","La Paz","Nuestra Señora de La Paz","Esc. Gil Tapia Rada",75,1,7,2,101,1,25,0,1,213,0,5,218,231,0.474,0.944
"4270","La Paz","Nuestra Señora de La Paz","Esc. Gil Tapia Rada",61,1,3,0,118,4,18,0,0,205,4,3,212,227,0.576,0.934
"4271","La Paz","Nuestra Señora de La Paz","Kinder Bolivia",68,1,3,0,113,2,24,0,0,211,1,12,224,233,0.536,0.961
"4272","La Paz","Nuestra Señora de La Paz","Kinder Bolivia",75,0,6,0,103,2,14,0,0,200,1,7,208,230,0.515,0.904
"4273","La Paz","Nuestra Señora de La Paz","Kinder Bolivia",46,2,1,0,129,3,20,0,1,202,4,9,215,233,0.639,0.923
"4274","La Paz","Nuestra Señora de La Paz","Kinder Bolivia",75,1,2,0,95,1,19,0,5,198,1,6,205,229,0.48,0.895
"4275","La Paz","Nuestra Señora de La Paz","Kinder Bolivia",48,2,9,2,115,4,26,2,5,213,1,11,225,237,0.54,0.949
"4276","La Paz","Nuestra Señora de La Paz","Kinder Bolivia",86,2,5,1,94,5,17,0,2,212,0,10,222,226,0.443,0.982
"4277","La Paz","Nuestra Señora de La Paz","Kinder Bolivia",51,0,6,2,114,3,26,1,5,208,3,2,213,225,0.548,0.947
"4278","La Paz","Nuestra Señora de La Paz","Kinder Bolivia",68,0,2,1,118,2,16,0,1,208,2,5,215,227,0.567,0.947
"4279","La Paz","Nuestra Señora de La Paz","Kinder Bolivia",45,2,5,2,124,1,27,0,5,211,0,3,214,231,0.588,0.926
"4280","La Paz","Nuestra Señora de La Paz","Kinder Bolivia",67,0,2,0,121,2,22,0,1,215,1,2,218,230,0.563,0.948
"4281","La Paz","Nuestra Señora de La Paz","Kinder Bolivia",68,0,2,2,109,4,22,0,1,208,2,10,220,229,0.524,0.961
"4282","La Paz","Nuestra Señora de La Paz","Kinder Bolivia",31,1,4,0,96,5,22,0,2,161,0,4,165,176,0.596,0.938
"4283","La Paz","Nuestra Señora de La Paz","Unid. Educ. 20 De Octubre N° 1",34,1,13,0,129,7,19,0,1,204,3,2,209,226,0.632,0.925
"4284","La Paz","Nuestra Señora de La Paz","Unid. Educ. 20 De Octubre N° 1",24,0,8,1,155,2,19,0,0,209,1,7,217,229,0.742,0.948
"4285","La Paz","Nuestra Señora de La Paz","Unid. Educ. 20 De Octubre N° 1",34,1,5,1,150,2,19,0,1,213,2,6,221,230,0.704,0.961
"4286","La Paz","Nuestra Señora de La Paz","Unid. Educ. 20 De Octubre N° 1",26,3,5,1,152,1,19,1,1,209,3,9,221,230,0.727,0.961
"4287","La Paz","Nuestra Señora de La Paz","Unid. Educ. 20 De Octubre N° 1",39,1,3,2,138,3,20,1,0,207,1,11,219,227,0.667,0.965
"4288","La Paz","Nuestra Señora de La Paz","Unid. Educ. 20 De Octubre N° 1",29,0,9,1,149,0,18,0,2,208,0,9,217,231,0.716,0.939
"4289","La Paz","Nuestra Señora de La Paz","Unid. Educ. 20 De Octubre N° 1",27,0,4,0,153,2,21,1,0,208,3,6,217,230,0.736,0.943
"4290","La Paz","Nuestra Señora de La Paz","Col. Luis Velasco Flores",26,1,5,1,155,4,17,1,2,212,1,3,216,228,0.731,0.947
"4291","La Paz","Nuestra Señora de La Paz","Col. Luis Velasco Flores",37,0,5,0,141,5,23,1,3,215,2,7,224,234,0.656,0.957
"4292","La Paz","Nuestra Señora de La Paz","Col. Luis Velasco Flores",39,1,14,0,124,4,25,0,1,208,2,7,217,227,0.596,0.956
"4293","La Paz","Nuestra Señora de La Paz","Col. Luis Velasco Flores",44,3,5,1,137,5,16,0,0,211,1,6,218,231,0.649,0.944
"4294","La Paz","Nuestra Señora de La Paz","Col. Luis Velasco Flores",36,3,7,2,145,1,14,1,2,211,1,8,220,234,0.687,0.94
"4295","La Paz","Nuestra Señora de La Paz","Col. Luis Velasco Flores",47,0,13,3,110,4,21,2,3,203,0,7,210,227,0.542,0.925
"4296","La Paz","Nuestra Señora de La Paz","Col. Luis Velasco Flores",22,2,6,1,141,5,27,2,3,209,4,9,222,234,0.675,0.949
"4297","La Paz","Nuestra Señora de La Paz","Sede Social Caja Ferroviaria",46,2,3,0,130,4,25,0,3,213,0,8,221,229,0.61,0.965
"4298","La Paz","Nuestra Señora de La Paz","Sede Social Caja Ferroviaria",36,1,3,4,139,3,24,0,2,212,0,6,218,228,0.656,0.956
"4299","La Paz","Nuestra Señora de La Paz","Sede Social Caja Ferroviaria",35,1,9,0,124,2,27,0,3,201,0,4,205,227,0.617,0.903
"4300","La Paz","Nuestra Señora de La Paz","Sede Social Caja Ferroviaria",35,0,5,0,147,0,18,1,2,208,2,6,216,228,0.707,0.947
"4301","La Paz","Nuestra Señora de La Paz","Sede Social Caja Ferroviaria",36,1,7,2,136,4,21,0,3,210,2,1,213,226,0.648,0.942
"4302","La Paz","Nuestra Señora de La Paz","Sede Social Caja Ferroviaria",30,1,5,3,129,3,20,2,2,195,4,9,208,224,0.662,0.929
"4303","La Paz","Nuestra Señora de La Paz","Sede Social Carpani",4,0,6,0,178,1,7,0,1,197,2,10,209,219,0.904,0.954
"4304","La Paz","Nuestra Señora de La Paz","Sede Social Carpani",5,1,4,1,180,1,2,0,0,194,5,7,206,224,0.928,0.92
"4305","La Paz","Nuestra Señora de La Paz","Sede Social Carpani",10,0,4,0,174,1,1,1,0,191,1,2,194,204,0.911,0.951
"4306","La Paz","Nuestra Señora de La Paz","Unidad Educativa Villa Harca",30,3,1,3,107,4,19,0,3,170,8,15,193,219,0.629,0.881
"4307","La Paz","Nuestra Señora de La Paz","Esc. Rural Canaviri",15,5,6,4,137,4,21,0,2,194,9,4,207,218,0.706,0.95
"4308","La Paz","Nuestra Señora de La Paz","Esc. Mscal Andres De Santa Cruz",10,0,1,1,123,2,23,3,0,163,3,2,168,189,0.755,0.889
"4309","La Paz","Palca","Col. Pedro Domingo Murillo",11,0,5,2,162,1,9,1,0,191,8,11,210,223,0.848,0.942
"4310","La Paz","Palca","Col. Pedro Domingo Murillo",9,1,6,1,158,0,6,0,1,182,5,4,191,209,0.868,0.914
"4311","La Paz","Palca","Col. Pedro Domingo Murillo",2,1,16,1,154,2,9,2,0,187,5,11,203,224,0.824,0.906
"4312","La Paz","Palca","Col. Pedro Domingo Murillo",7,2,7,0,167,1,6,1,0,191,7,9,207,219,0.874,0.945
"4313","La Paz","Palca","Col. Pedro Domingo Murillo",6,1,8,1,152,1,6,0,1,176,9,18,203,219,0.864,0.927
"4314","La Paz","Palca","Col. Pedro Domingo Murillo",3,0,9,0,175,1,2,0,0,190,6,6,202,219,0.921,0.922
"4315","La Paz","Palca","Col. Pedro Domingo Murillo",7,0,6,2,158,0,6,0,0,179,6,9,194,219,0.883,0.886
"4316","La Paz","Palca","Col. Pedro Domingo Murillo",3,1,7,0,161,2,12,0,0,186,5,8,199,220,0.866,0.905
"4317","La Paz","Palca","Col. Pedro Domingo Murillo",8,1,5,2,165,1,5,0,1,188,4,6,198,225,0.878,0.88
"4318","La Paz","Palca","Col. Pedro Domingo Murillo",10,1,6,0,167,1,5,1,1,192,6,9,207,223,0.87,0.928
"4319","La Paz","Palca","Unidad Educativa Uni",4,0,3,1,190,0,6,1,0,205,8,8,221,232,0.927,0.953
"4320","La Paz","Palca","Unidad Educativa Uni",5,0,1,1,171,2,9,0,0,189,5,12,206,219,0.905,0.941
"4321","La Paz","Palca","Unidad Educativa Uni",6,2,2,0,174,1,6,1,0,192,2,18,212,228,0.906,0.93
"4322","La Paz","Palca","Unidad Educativa Uni",19,0,1,2,182,2,5,0,1,212,7,7,226,234,0.858,0.966
"4323","La Paz","Palca","Escuela Cohoni",2,0,5,0,169,1,13,0,1,191,11,5,207,224,0.885,0.924
"4324","La Paz","Palca","Escuela Cohoni",2,0,5,0,156,0,5,0,0,168,13,13,194,213,0.929,0.911
"4325","La Paz","Palca","Escuela Cohoni",0,1,5,1,164,3,7,1,0,182,7,9,198,218,0.901,0.908
"4326","La Paz","Palca","Escuela Cohoni",3,1,3,0,168,0,8,0,0,183,3,7,193,211,0.918,0.915
"4327","La Paz","Palca","Escuela Cohoni",3,0,4,0,166,1,7,0,0,181,9,6,196,224,0.917,0.875
"4328","La Paz","Palca","Escuela Cohoni",1,1,6,0,141,2,19,1,2,173,12,15,200,218,0.815,0.917
"4329","La Paz","Palca","Escuela Quillihuaya",5,0,5,0,180,1,12,0,0,203,3,4,210,222,0.887,0.946
"4330","La Paz","Palca","Escuela Quillihuaya",7,1,3,0,171,0,12,0,2,196,5,4,205,219,0.872,0.936
"4331","La Paz","Palca","Escuela Quillihuaya",6,3,11,1,164,0,9,1,0,195,6,5,206,224,0.841,0.92
"4332","La Paz","Palca","Escuela Quillihuaya",1,0,4,0,179,1,0,0,0,185,3,6,194,222,0.968,0.874
"4333","La Paz","Palca","Escuela Quillihuaya",2,2,6,1,168,1,13,0,0,193,4,6,203,221,0.87,0.919
"4334","La Paz","Palca","Escuela Cayimbaya",6,3,14,0,132,3,23,0,1,182,6,21,209,222,0.725,0.941
"4335","La Paz","Palca","Escuela Cayimbaya",8,1,12,1,153,2,10,1,0,188,15,11,214,228,0.814,0.939
"4336","La Paz","Palca","Escuela Cayimbaya",3,1,11,1,155,4,7,1,1,184,11,6,201,224,0.842,0.897
"4337","La Paz","Palca","Escuela Cotaña",9,3,6,1,161,1,18,0,0,199,4,8,211,223,0.809,0.946
"4338","La Paz","Palca","Escuela Cotaña",2,3,3,0,171,2,22,1,0,204,4,9,217,230,0.838,0.943
"4339","La Paz","Palca","Escuela Cotaña",3,1,5,0,181,1,19,0,0,210,6,6,222,234,0.862,0.949
"4340","La Paz","Palca","Escuela Tahuapalca",7,0,4,0,175,1,8,0,1,196,3,6,205,218,0.893,0.94
"4341","La Paz","Palca","Escuela Tahuapalca",4,0,1,0,190,1,7,1,0,204,4,4,212,224,0.931,0.946
"4342","La Paz","Palca","Escuela Tirata",7,0,5,0,175,0,14,0,0,201,2,2,205,220,0.871,0.932
"4343","La Paz","Mecapaca","Escuela Santiago de Collana",4,0,11,0,188,1,3,0,0,207,4,1,212,221,0.908,0.959
"4344","La Paz","Mecapaca","Escuela Santiago de Collana",4,0,15,1,172,0,5,0,0,197,2,4,203,215,0.873,0.944
"4345","La Paz","Mecapaca","Escuela Santiago de Collana",3,0,8,0,185,0,6,0,0,202,2,0,204,216,0.916,0.944
"4346","La Paz","Mecapaca","Escuela Simona Manzaneda",37,2,3,0,134,2,17,2,0,197,0,10,207,226,0.68,0.916
"4347","La Paz","Mecapaca","Escuela Simona Manzaneda",31,0,6,1,138,0,16,0,0,192,4,4,200,222,0.719,0.901
"4348","La Paz","Mecapaca","Escuela Simona Manzaneda",27,0,6,0,162,0,6,0,0,201,2,8,211,229,0.806,0.921
"4349","La Paz","Mecapaca","Escuela Simona Manzaneda",43,0,6,0,124,1,19,0,0,193,2,5,200,223,0.642,0.897
"4350","La Paz","Mecapaca","Escuela Simona Manzaneda",32,0,5,0,146,4,13,0,1,201,4,3,208,225,0.726,0.924
"4351","La Paz","Mecapaca","Escuela Simona Manzaneda",30,1,6,0,160,1,11,0,2,211,1,4,216,230,0.758,0.939
"4352","La Paz","Mecapaca","Escuela Simona Manzaneda",64,0,10,0,114,3,16,1,0,208,0,3,211,229,0.548,0.921
"4353","La Paz","Mecapaca","Escuela Simona Manzaneda",28,0,5,0,153,0,15,1,3,205,1,2,208,224,0.746,0.929
"4354","La Paz","Mecapaca","Escuela Simona Manzaneda",24,0,3,2,150,4,26,0,0,209,0,5,214,230,0.718,0.93
"4355","La Paz","Mecapaca","Escuela Simona Manzaneda",33,0,7,1,148,3,15,1,0,208,2,4,214,227,0.712,0.943
"4356","La Paz","Mecapaca","U.E. Sagrada Familia",65,0,6,2,109,1,17,0,4,204,4,3,211,231,0.534,0.913
"4357","La Paz","Mecapaca","U.E. Sagrada Familia",46,2,8,1,130,1,22,0,0,210,1,3,214,231,0.619,0.926
"4358","La Paz","Mecapaca","U.E. Sagrada Familia",57,1,3,1,128,0,5,2,3,200,1,6,207,228,0.64,0.908
"4359","La Paz","Mecapaca","U.E. Sagrada Familia",47,0,3,0,133,0,18,0,0,201,3,6,210,226,0.662,0.929
"4360","La Paz","Mecapaca","U.E. Sagrada Familia",38,1,1,0,154,2,9,0,2,207,2,4,213,229,0.744,0.93
"4361","La Paz","Mecapaca","U.E. Sagrada Familia",59,2,4,0,128,2,7,3,1,206,1,5,212,232,0.621,0.914
"4362","La Paz","Mecapaca","U.E. Sagrada Familia",54,0,6,0,126,0,15,0,4,205,2,3,210,227,0.615,0.925
"4363","La Paz","Mecapaca","U.E. Sagrada Familia",52,0,8,0,126,0,9,2,0,197,0,1,198,225,0.64,0.88
"4364","La Paz","Mecapaca","U.E. Sagrada Familia",45,0,2,0,129,0,18,0,2,196,0,8,204,222,0.658,0.919
"4365","La Paz","Mecapaca","Escuela El Palomar",11,0,4,1,174,3,11,0,0,204,4,6,214,224,0.853,0.955
"4366","La Paz","Mecapaca","Escuela El Palomar",14,0,8,1,165,2,17,0,1,208,3,3,214,219,0.793,0.977
"4367","La Paz","Mecapaca","Escuela El Palomar",15,0,2,0,168,1,16,0,2,204,2,5,211,222,0.824,0.95
"4368","La Paz","Mecapaca","Escuela El Palomar",15,0,7,0,160,3,11,1,0,197,5,6,208,221,0.812,0.941
"4369","La Paz","Mecapaca","Escuela El Palomar",6,0,9,0,176,5,14,0,0,210,0,6,216,227,0.838,0.952
"4370","La Paz","Mecapaca","Escuela El Palomar",24,0,5,0,115,1,9,1,1,156,0,3,159,169,0.737,0.941
"4371","La Paz","Mecapaca","Escuela Huaricana Alto",12,2,2,0,183,0,13,0,2,214,2,4,220,226,0.855,0.973
"4372","La Paz","Mecapaca","Escuela Huaricana Alto",5,1,2,0,184,0,14,0,0,206,0,4,210,219,0.893,0.959
"4373","La Paz","Mecapaca","Escuela Huaricana Alto",8,3,2,0,183,0,16,0,0,212,1,4,217,225,0.863,0.964
"4374","La Paz","Mecapaca","Escuela Huaricana Alto",13,1,1,0,169,3,8,0,1,196,4,4,204,213,0.862,0.958
"4375","La Paz","Mecapaca","Col. San Simon De Ayacucho",1,1,4,0,156,1,13,0,0,176,5,17,198,221,0.886,0.896
"4376","La Paz","Mecapaca","Col. San Simon De Ayacucho",8,1,5,2,142,3,18,0,1,180,4,9,193,212,0.789,0.91
"4377","La Paz","Mecapaca","Escuela Jankosuni",4,0,5,0,179,0,11,0,0,199,1,0,200,212,0.899,0.943
"4378","La Paz","Mecapaca","Colegio 6 de Junio",4,1,4,2,169,2,7,1,0,190,5,3,198,220,0.889,0.9
"4379","La Paz","Mecapaca","Unidad Educativa Lluto",3,2,5,1,173,0,5,0,0,189,5,10,204,224,0.915,0.911
"4380","La Paz","Mecapaca","Unidad Educativa Millocato",5,0,7,1,191,0,8,0,2,214,5,5,224,227,0.893,0.987
"4381","La Paz","Mecapaca","Unid. Educ. Condor De Los Andes",10,0,12,0,164,3,17,1,0,207,5,9,221,228,0.792,0.969
"4382","La Paz","Mecapaca","Unid. Educ. Condor De Los Andes",3,2,8,2,135,0,13,1,0,164,4,0,168,174,0.823,0.966
"4383","La Paz","Achocalla","U. E. Rene Barrientos Ortuño",37,0,3,2,132,0,20,2,1,197,4,7,208,224,0.67,0.929
"4384","La Paz","Achocalla","U. E. Rene Barrientos Ortuño",36,4,8,0,116,5,27,0,0,196,5,10,211,225,0.592,0.938
"4385","La Paz","Achocalla","U. E. Rene Barrientos Ortuño",39,0,2,1,135,2,19,1,0,199,4,8,211,226,0.678,0.934
"4386","La Paz","Achocalla","U. E. Rene Barrientos Ortuño",29,0,10,0,141,2,15,0,0,197,3,9,209,222,0.716,0.941
"4387","La Paz","Achocalla","U. E. Rene Barrientos Ortuño",34,2,3,1,128,1,34,0,1,204,2,5,211,230,0.627,0.917
"4388","La Paz","Achocalla","U. E. Rene Barrientos Ortuño",20,0,6,1,120,0,14,1,1,163,5,41,209,224,0.736,0.933
"4389","La Paz","Achocalla","U. E. Rene Barrientos Ortuño",38,1,7,1,137,1,19,0,2,206,2,8,216,231,0.665,0.935
"4390","La Paz","Achocalla","U. E. Antonio Diaz Villamil",27,0,6,1,140,2,24,0,0,200,5,5,210,222,0.7,0.946
"4391","La Paz","Achocalla","U. E. Antonio Diaz Villamil",20,1,4,1,145,2,22,0,0,195,6,7,208,221,0.744,0.941
"4392","La Paz","Achocalla","U. E. Antonio Diaz Villamil",35,0,7,2,137,3,18,0,0,202,7,4,213,227,0.678,0.938
"4393","La Paz","Achocalla","U. E. Antonio Diaz Villamil",33,1,7,2,126,3,29,0,0,201,2,7,210,224,0.627,0.938
"4394","La Paz","Achocalla","U. E. Antonio Diaz Villamil",26,0,6,0,148,2,12,0,3,197,8,10,215,226,0.751,0.951
"4395","La Paz","Achocalla","U. E. Antonio Diaz Villamil",25,0,5,1,148,3,25,0,2,209,2,8,219,231,0.708,0.948
"4396","La Paz","Achocalla","U. E. Antonio Diaz Villamil",27,1,10,1,128,1,21,0,2,191,1,3,195,211,0.67,0.924
"4397","La Paz","Achocalla","U. E. Antonio Diaz Villamil",16,2,8,1,155,3,20,1,2,208,2,4,214,225,0.745,0.951
"4398","La Paz","Achocalla","U. E. Antonio Diaz Villamil",28,1,4,2,131,4,27,0,5,202,0,7,209,224,0.649,0.933
"4399","La Paz","Achocalla","U. E. Uypaca",23,0,3,1,152,5,19,0,0,203,2,5,210,227,0.749,0.925
"4400","La Paz","Achocalla","U. E. Uypaca",17,1,8,0,160,1,0,0,3,190,3,5,198,220,0.842,0.9
"4401","La Paz","Achocalla","U. E. Uypaca",12,0,8,2,131,0,20,0,2,175,3,2,180,186,0.749,0.968
"4402","La Paz","Achocalla","U. E. Mcal. Sucre",9,1,17,0,122,0,30,1,0,180,11,10,201,216,0.678,0.931
"4403","La Paz","Achocalla","U. E. Mcal. Sucre",10,2,32,1,136,0,13,0,0,194,7,10,211,221,0.701,0.955
"4404","La Paz","Achocalla","U. E. Mcal. Sucre",9,0,15,1,140,2,15,1,1,184,7,14,205,219,0.761,0.936
"4405","La Paz","Achocalla","U. E. Mcal. Sucre",6,4,16,1,153,1,20,0,0,201,1,11,213,227,0.761,0.938
"4406","La Paz","Achocalla","U. E. Mcal. Sucre",4,3,22,2,152,1,9,0,1,194,5,7,206,215,0.784,0.958
"4407","La Paz","Achocalla","U. E. Chañocahua",22,1,7,1,148,0,24,0,2,205,6,4,215,230,0.722,0.935
"4408","La Paz","Achocalla","U. E. Chañocahua",20,0,6,0,132,3,28,0,2,191,5,7,203,230,0.691,0.883
"4409","La Paz","Achocalla","U. E. Chañocahua",24,1,4,0,145,3,23,0,2,202,1,11,214,230,0.718,0.93
"4410","La Paz","Achocalla","U. E. Chañocahua",14,0,11,0,153,0,25,0,1,204,3,10,217,234,0.75,0.927
"4411","La Paz","Achocalla","U. E. Chañocahua",13,1,9,0,161,1,24,0,3,212,1,6,219,235,0.759,0.932
"4412","La Paz","Achocalla","U. E. Chañocahua",12,4,9,0,144,1,39,1,1,211,2,8,221,232,0.682,0.953
"4413","La Paz","Achocalla","U. E. Chañocahua",11,1,11,0,159,0,21,0,2,205,2,10,217,233,0.776,0.931
"4414","La Paz","Achocalla","U. E. Chañocahua",18,3,8,0,151,1,20,2,2,205,2,9,216,233,0.737,0.927
"4415","La Paz","Achocalla","U. E. Chañocahua",18,0,14,0,144,1,22,0,0,199,4,12,215,234,0.724,0.919
"4416","La Paz","Achocalla","U. E. Chañocahua",21,0,7,1,154,4,13,0,1,201,0,11,212,232,0.766,0.914
"4417","La Paz","Achocalla","U. E. Chañocahua",23,0,16,0,128,3,23,0,1,194,1,6,201,226,0.66,0.889
"4418","La Paz","Achocalla","U. E. Chañocahua",17,3,6,2,156,3,20,1,3,211,3,6,220,235,0.739,0.936
"4419","La Paz","Achocalla","U. E. Chañocahua",26,1,7,2,140,2,27,0,3,208,3,6,217,235,0.673,0.923
"4420","La Paz","Achocalla","U. E. Chañocahua",24,0,6,0,145,2,29,0,2,208,4,10,222,234,0.697,0.949
"4421","La Paz","Achocalla","U. E. Chañocahua",10,0,14,0,156,2,18,0,0,200,3,7,210,227,0.78,0.925
"4422","La Paz","Achocalla","U. E. Chañocahua",24,1,11,0,148,2,34,0,1,221,4,5,230,236,0.67,0.975
"4423","La Paz","Achocalla","U. E. Chañocahua",30,1,9,0,139,3,26,0,0,208,3,7,218,232,0.668,0.94
"4424","La Paz","Achocalla","U. E. Chañocahua",15,0,9,1,161,2,13,1,2,204,2,10,216,232,0.789,0.931
"4425","La Paz","Achocalla","U. E. Chañocahua",18,2,8,0,152,2,23,0,3,208,3,7,218,235,0.731,0.928
"4426","La Paz","Achocalla","U. E. Chañocahua",21,1,9,0,150,2,32,0,0,215,1,6,222,232,0.698,0.957
"4427","La Paz","Achocalla","U. E. Chañocahua",8,2,9,1,153,2,34,2,1,212,2,5,219,231,0.722,0.948
"4428","La Paz","Achocalla","U. E. Chañocahua",18,1,7,1,154,2,22,0,2,207,3,4,214,231,0.744,0.926
"4429","La Paz","Achocalla","U. E. Chañocahua",21,1,6,0,141,1,27,0,1,198,2,9,209,229,0.712,0.913
"4430","La Paz","Achocalla","U. E. Chañocahua",19,1,5,1,151,3,21,1,2,204,5,8,217,230,0.74,0.943
"4431","La Paz","Achocalla","U. E. Chañocahua",18,0,6,0,146,4,16,0,1,191,8,13,212,231,0.764,0.918
"4432","La Paz","Achocalla","U. E. Marquirivi",49,0,2,0,128,3,20,0,2,204,2,4,210,221,0.627,0.95
"4433","La Paz","Achocalla","U. E. Marquirivi",35,1,2,0,151,0,14,0,0,203,2,7,212,226,0.744,0.938
"4434","La Paz","Achocalla","U. E. Marquirivi",33,0,5,2,128,1,19,0,2,190,3,5,198,219,0.674,0.904
"4435","La Paz","Achocalla","U. E. Marquirivi",30,0,6,1,140,2,26,0,1,206,1,9,216,227,0.68,0.952
"4436","La Paz","Achocalla","U. E. Marquirivi",21,1,8,2,147,1,20,0,1,201,1,12,214,223,0.731,0.96
"4437","La Paz","Achocalla","U. E. Marquirivi",30,0,4,0,150,1,13,0,1,199,2,4,205,226,0.754,0.907
"4438","La Paz","Achocalla","U. E. Marquirivi",33,0,3,1,137,5,19,0,1,199,3,7,209,225,0.688,0.929
"4439","La Paz","Achocalla","U. E. Marquirivi",20,1,3,0,154,1,21,1,1,202,7,4,213,225,0.762,0.947
"4440","La Paz","Achocalla","U. E. Marquirivi",15,1,7,0,162,0,21,0,0,206,3,7,216,228,0.786,0.947
"4441","La Paz","Achocalla","U. E. Marquirivi",47,2,7,0,134,1,22,0,0,213,2,4,219,229,0.629,0.956
"4442","La Paz","Achocalla","U. E. Marquirivi",20,2,5,0,162,2,15,0,3,209,1,6,216,229,0.775,0.943
"4443","La Paz","Achocalla","U. E. Marquirivi",28,1,2,0,152,2,20,0,0,205,1,5,211,225,0.741,0.938
"4444","La Paz","Achocalla","U. E. 16 de Agosto",25,1,3,0,153,1,27,1,3,214,4,2,220,228,0.715,0.965
"4445","La Paz","Achocalla","U. E. 16 de Agosto",35,3,12,0,123,3,12,0,3,191,3,7,201,227,0.644,0.885
"4446","La Paz","Achocalla","U. E. 16 de Agosto",26,0,5,0,144,1,16,0,0,192,3,7,202,229,0.75,0.882
"4447","La Paz","Achocalla","U. E. 16 de Agosto",23,2,12,1,143,2,22,0,1,206,5,7,218,232,0.694,0.94
"4448","La Paz","Achocalla","U. E. 16 de Agosto",30,1,7,0,136,5,22,0,1,202,3,5,210,229,0.673,0.917
"4449","La Paz","Achocalla","U. E. 16 de Agosto",15,1,11,1,158,1,21,1,1,210,1,9,220,233,0.752,0.944
"4450","La Paz","Achocalla","U. E. 16 de Agosto",31,0,10,0,134,1,21,0,1,198,1,6,205,224,0.677,0.915
"4451","La Paz","Achocalla","U. E. Tuni",21,1,18,0,129,1,24,0,0,194,2,5,201,214,0.665,0.939
"4452","La Paz","Achocalla","U. E. Tuni",4,0,19,0,134,0,18,0,1,176,0,7,183,195,0.761,0.938
"4453","La Paz","El Alto","Col. Tunari",42,1,7,0,112,0,34,0,1,197,0,4,201,221,0.569,0.91
"4454","La Paz","El Alto","Col. Tunari",47,1,4,0,100,2,43,0,5,202,2,8,212,233,0.495,0.91
"4455","La Paz","El Alto","Col. Tunari",35,1,8,2,105,4,30,2,2,189,2,13,204,220,0.556,0.927
"4456","La Paz","El Alto","Col. Tunari",42,0,12,0,114,1,29,0,2,200,2,10,212,231,0.57,0.918
"4457","La Paz","El Alto","Col. Tunari",52,0,7,0,96,2,35,1,5,198,1,9,208,226,0.485,0.92
"4458","La Paz","El Alto","Col. Tunari",55,2,8,1,89,7,35,0,3,200,1,3,204,227,0.445,0.899
"4459","La Paz","El Alto","Col. Tunari",54,2,5,0,83,2,45,0,2,193,1,13,207,226,0.43,0.916
"4460","La Paz","El Alto","Col. Tunari",64,0,11,0,89,3,33,0,0,200,1,9,210,224,0.445,0.938
"4461","La Paz","El Alto","Col. Tunari",51,0,10,0,113,1,34,0,4,213,0,6,219,233,0.531,0.94
"4462","La Paz","El Alto","Col. Tunari",52,0,10,1,91,5,33,0,2,194,2,9,205,225,0.469,0.911
"4463","La Paz","El Alto","Col. Tunari",63,1,9,1,86,2,36,1,1,200,0,4,204,224,0.43,0.911
"4464","La Paz","El Alto","Col. Tunari",50,1,10,1,95,0,38,1,4,200,0,7,207,228,0.475,0.908
"4465","La Paz","El Alto","Col. Tunari",35,0,8,2,114,3,36,0,3,201,1,11,213,226,0.567,0.942
"4466","La Paz","El Alto","Col. Tunari",61,1,8,1,90,0,45,0,3,209,2,3,214,225,0.431,0.951
"4467","La Paz","El Alto","Col. Tunari",45,0,7,0,115,6,32,0,3,208,0,6,214,231,0.553,0.926
"4468","La Paz","El Alto","Col. Tunari",51,3,12,1,95,2,33,1,3,201,4,5,210,225,0.473,0.933
"4469","La Paz","El Alto","Col. Tunari",46,1,8,2,101,4,32,0,1,195,0,7,202,224,0.518,0.902
"4470","La Paz","El Alto","Col. Tunari",34,0,9,1,110,1,46,0,2,203,1,5,209,227,0.542,0.921
"4471","La Paz","El Alto","Col. Tunari",44,1,8,2,102,1,35,2,3,198,4,11,213,230,0.515,0.926
"4472","La Paz","El Alto","Col. Tunari",56,0,7,0,107,4,26,1,3,204,0,6,210,225,0.525,0.933
"4473","La Paz","El Alto","Col. Tunari",42,1,8,0,116,0,34,0,2,203,3,19,225,225,0.571,1
"4474","La Paz","El Alto","Col. Tunari",58,1,9,1,81,3,37,1,3,194,1,12,207,224,0.418,0.924
"4475","La Paz","El Alto","Col. Tunari",50,0,12,0,99,4,39,1,3,208,0,9,217,229,0.476,0.948
"4476","La Paz","El Alto","Col. Tunari",53,1,9,0,90,3,36,1,2,195,2,6,203,219,0.462,0.927
"4477","La Paz","El Alto","Col. Tunari",61,0,7,2,104,2,25,1,2,204,1,7,212,230,0.51,0.922
"4478","La Paz","El Alto","Col. Tunari",39,0,12,2,102,1,38,0,2,196,0,8,204,226,0.52,0.903
"4479","La Paz","El Alto","Col. Tunari",44,0,4,0,94,3,50,0,2,197,2,9,208,230,0.477,0.904
"4480","La Paz","El Alto","Col. Tunari",55,0,8,0,84,3,41,0,2,193,1,12,206,226,0.435,0.912
"4481","La Paz","El Alto","Col. Tunari",55,2,7,0,115,4,21,0,1,205,0,5,210,232,0.561,0.905
"4482","La Paz","El Alto","Col. Tunari",54,1,10,0,92,2,35,2,3,199,0,8,207,226,0.462,0.916
"4483","La Paz","El Alto","Col. Tunari",50,0,8,0,111,1,30,0,2,202,2,6,210,228,0.55,0.921
"4484","La Paz","El Alto","Col. Tunari",62,1,8,0,84,3,41,0,6,205,0,2,207,225,0.41,0.92
"4485","La Paz","El Alto","Col. Tunari",46,1,5,0,104,4,36,0,2,198,1,11,210,227,0.525,0.925
"4486","La Paz","El Alto","Col. Tunari",25,2,9,2,115,3,37,0,4,197,4,5,206,224,0.584,0.92
"4487","La Paz","El Alto","Col. Tunari",51,0,6,0,107,2,39,0,1,206,2,5,213,230,0.519,0.926
"4488","La Paz","El Alto","Col. Tunari",51,0,10,0,107,2,32,0,3,205,0,5,210,227,0.522,0.925
"4489","La Paz","El Alto","Col. Tunari",50,0,6,0,115,2,36,0,5,214,1,6,221,234,0.537,0.944
"4490","La Paz","El Alto","Col. Tunari",38,0,13,0,106,0,33,0,6,196,0,5,201,225,0.541,0.893
"4491","La Paz","El Alto","Col. Tunari",37,1,8,0,111,6,33,0,2,198,1,15,214,232,0.561,0.922
"4492","La Paz","El Alto","Col. Tunari",59,2,7,1,93,2,28,0,2,194,2,7,203,225,0.479,0.902
"4493","La Paz","El Alto","Col. Tunari",52,1,10,3,111,2,24,0,2,205,2,8,215,228,0.541,0.943
"4494","La Paz","El Alto","Col. Tunari",55,1,6,1,90,3,32,0,3,191,1,8,200,228,0.471,0.877
"4495","La Paz","El Alto","Col. Tunari",41,2,6,0,105,3,34,2,1,194,4,11,209,222,0.541,0.941
"4496","La Paz","El Alto","Col. Tunari",53,2,2,0,96,2,36,0,2,193,0,9,202,224,0.497,0.902
"4497","La Paz","El Alto","Col. Tunari",58,1,11,0,95,2,41,0,1,209,0,5,214,229,0.455,0.934
"4498","La Paz","El Alto","Col. Tunari",48,1,3,0,122,0,18,1,5,198,0,14,212,226,0.616,0.938
"4499","La Paz","El Alto","Col. Tunari",47,0,4,1,107,1,42,0,0,202,3,10,215,232,0.53,0.927
"4500","La Paz","El Alto","Col. Tunari",56,0,12,1,83,0,26,1,2,181,3,7,191,213,0.459,0.897
"4501","La Paz","El Alto","Col. Tunari",41,0,8,1,102,5,42,0,3,202,2,5,209,218,0.505,0.959
"4502","La Paz","El Alto","Col. Tunari",47,2,12,0,87,3,43,0,4,198,1,15,214,228,0.439,0.939
"4503","La Paz","El Alto","Col. Tunari",42,3,8,1,117,2,25,0,5,203,1,9,213,228,0.576,0.934
"4504","La Paz","El Alto","Col. Tunari",50,0,9,0,110,7,30,1,3,210,0,13,223,235,0.524,0.949
"4505","La Paz","El Alto","Col. Tunari",37,1,11,2,109,6,38,1,1,206,0,6,212,231,0.529,0.918
"4506","La Paz","El Alto","Col. Tunari",66,2,3,0,93,5,33,1,4,207,1,2,210,228,0.449,0.921
"4507","La Paz","El Alto","Col. Tunari",39,0,8,0,110,2,38,2,1,200,2,9,211,225,0.55,0.938
"4508","La Paz","El Alto","Col. Tunari",49,1,7,0,104,3,40,0,2,206,1,3,210,228,0.505,0.921
"4509","La Paz","El Alto","Col. Tunari",62,3,7,0,94,3,35,1,2,207,0,6,213,226,0.454,0.942
"4510","La Paz","El Alto","Col. Tunari",65,0,7,2,81,0,38,0,3,196,2,7,205,214,0.413,0.958
"4511","La Paz","El Alto","Col. Tunari",57,0,4,0,93,1,46,1,5,207,0,10,217,226,0.449,0.96
"4512","La Paz","El Alto","Col. Tunari",43,1,12,1,114,3,31,1,3,209,0,8,217,231,0.545,0.939
"4513","La Paz","El Alto","Col. Tunari",48,1,5,1,120,6,29,0,1,211,3,5,219,233,0.569,0.94
"4514","La Paz","El Alto","Col. Tunari",58,0,8,1,103,2,19,0,5,196,4,11,211,228,0.526,0.925
"4515","La Paz","El Alto","Col. Tunari",62,1,14,1,95,2,27,0,2,204,2,4,210,223,0.466,0.942
"4516","La Paz","El Alto","Col. Tunari",66,1,10,0,85,4,40,1,3,210,3,6,219,229,0.405,0.956
"4517","La Paz","El Alto","U.E. Mariscal de Zepita",27,1,2,0,139,1,48,1,2,221,3,2,226,240,0.629,0.942
"4518","La Paz","El Alto","U.E. Mariscal de Zepita",36,0,3,0,130,2,45,0,1,217,2,3,222,239,0.599,0.929
"4519","La Paz","El Alto","U.E. Mariscal de Zepita",47,1,3,0,105,4,46,1,2,209,4,11,224,239,0.502,0.937
"4520","La Paz","El Alto","U.E. Mariscal de Zepita",43,0,3,0,91,1,33,0,1,172,1,11,184,196,0.529,0.939
"4521","La Paz","El Alto","Colegio Huayna Potosi",40,0,7,0,116,2,31,0,3,199,3,8,210,225,0.583,0.933
"4522","La Paz","El Alto","Colegio Huayna Potosi",35,2,6,1,116,3,30,0,4,197,2,8,207,223,0.589,0.928
"4523","La Paz","El Alto","Colegio Huayna Potosi",44,1,2,0,111,0,38,1,0,197,5,7,209,227,0.563,0.921
"4524","La Paz","El Alto","Colegio Huayna Potosi",28,0,11,0,110,5,38,0,1,193,4,5,202,221,0.57,0.914
"4525","La Paz","El Alto","Colegio Huayna Potosi",59,3,3,1,97,1,46,0,3,213,2,5,220,227,0.455,0.969
"4526","La Paz","El Alto","Colegio Huayna Potosi",41,1,6,1,114,4,33,0,1,201,3,10,214,232,0.567,0.922
"4527","La Paz","El Alto","Colegio Huayna Potosi",38,0,3,0,119,6,35,0,1,202,1,9,212,225,0.589,0.942
"4528","La Paz","El Alto","Colegio Huayna Potosi",29,0,6,0,125,3,42,0,0,205,3,4,212,226,0.61,0.938
"4529","La Paz","El Alto","Colegio Huayna Potosi",29,2,7,1,126,2,30,0,2,199,2,9,210,226,0.633,0.929
"4530","La Paz","El Alto","Colegio Huayna Potosi",44,1,6,0,115,2,31,0,1,200,3,4,207,225,0.575,0.92
"4531","La Paz","El Alto","Colegio Huayna Potosi",37,3,5,1,116,2,37,2,1,204,4,10,218,233,0.569,0.936
"4532","La Paz","El Alto","Colegio Huayna Potosi",41,0,6,1,111,3,34,1,5,202,1,8,211,228,0.55,0.925
"4533","La Paz","El Alto","Colegio Huayna Potosi",32,0,6,0,86,1,33,0,1,159,6,41,206,222,0.541,0.928
"4534","La Paz","El Alto","Colegio Huayna Potosi",38,0,7,1,126,0,30,1,4,207,1,4,212,229,0.609,0.926
"4535","La Paz","El Alto","Colegio Huayna Potosi",37,1,7,2,129,2,29,0,1,208,4,11,223,229,0.62,0.974
"4536","La Paz","El Alto","Colegio Huayna Potosi",41,1,10,0,123,4,25,0,0,204,2,8,214,226,0.603,0.947
"4537","La Paz","El Alto","Colegio Huayna Potosi",26,0,6,1,121,1,39,0,4,198,0,11,209,227,0.611,0.921
"4538","La Paz","El Alto","Colegio Huayna Potosi",31,0,7,2,123,0,25,0,1,189,1,10,200,223,0.651,0.897
"4539","La Paz","El Alto","Colegio Huayna Potosi",55,1,10,1,100,1,24,0,7,199,1,4,204,220,0.503,0.927
"4540","La Paz","El Alto","Colegio Huayna Potosi",33,1,8,1,114,1,36,0,3,197,5,7,209,221,0.579,0.946
"4541","La Paz","El Alto","Colegio Huayna Potosi",22,1,8,2,128,5,24,1,1,192,2,9,203,223,0.667,0.91
"4542","La Paz","El Alto","Colegio Huayna Potosi",29,2,5,3,131,0,29,1,1,201,2,9,212,230,0.652,0.922
"4543","La Paz","El Alto","Colegio Huayna Potosi",29,0,6,1,117,2,42,0,6,203,1,5,209,222,0.576,0.941
"4544","La Paz","El Alto","Colegio Huayna Potosi",37,0,8,0,123,1,30,1,0,200,5,5,210,230,0.615,0.913
"4545","La Paz","El Alto","Colegio Huayna Potosi",43,2,7,0,117,2,34,0,4,209,2,5,216,227,0.56,0.952
"4546","La Paz","El Alto","Colegio Huayna Potosi",35,0,7,1,130,1,23,0,1,198,3,6,207,229,0.657,0.904
"4547","La Paz","El Alto","Colegio Huayna Potosi",42,5,0,0,116,0,45,0,3,211,0,9,220,231,0.55,0.952
"4548","La Paz","El Alto","Colegio Huayna Potosi",29,0,8,2,130,3,31,1,2,206,1,5,212,226,0.631,0.938
"4549","La Paz","El Alto","Colegio Huayna Potosi",34,1,9,2,110,3,46,1,6,212,1,2,215,231,0.519,0.931
"4550","La Paz","El Alto","Colegio Huayna Potosi",28,0,6,1,128,0,29,3,3,198,2,6,206,223,0.646,0.924
"4551","La Paz","El Alto","Colegio Huayna Potosi",25,0,10,0,121,2,40,0,5,203,1,8,212,228,0.596,0.93
"4552","La Paz","El Alto","Colegio Huayna Potosi",25,1,15,0,116,0,33,0,3,193,3,8,204,223,0.601,0.915
"4553","La Paz","El Alto","Colegio Huayna Potosi",30,0,7,0,132,1,37,0,2,209,2,5,216,232,0.632,0.931
"4554","La Paz","El Alto","Colegio Huayna Potosi",39,1,4,0,110,2,40,0,5,201,2,5,208,227,0.547,0.916
"4555","La Paz","El Alto","Colegio Huayna Potosi",35,2,7,2,125,1,31,1,3,207,1,5,213,227,0.604,0.938
"4556","La Paz","El Alto","Colegio Huayna Potosi",33,0,5,0,106,3,40,0,0,187,6,7,200,222,0.567,0.901
"4557","La Paz","El Alto","Colegio Huayna Potosi",41,1,6,0,109,0,49,0,3,209,1,3,213,228,0.522,0.934
"4558","La Paz","El Alto","Colegio Huayna Potosi",18,0,8,1,137,3,32,0,3,202,0,9,211,230,0.678,0.917
"4559","La Paz","El Alto","Colegio Huayna Potosi",43,2,2,0,113,2,36,0,5,203,0,7,210,224,0.557,0.938
"4560","La Paz","El Alto","Colegio Huayna Potosi",33,1,5,2,117,5,31,0,3,197,2,7,206,226,0.594,0.912
"4561","La Paz","El Alto","Unidad Educativa Noruega",47,0,6,0,95,1,49,0,2,200,3,5,208,220,0.475,0.945
"4562","La Paz","El Alto","Unidad Educativa Noruega",40,1,14,0,111,2,34,0,2,204,1,7,212,226,0.544,0.938
"4563","La Paz","El Alto","Unidad Educativa Noruega",44,0,8,2,106,6,38,0,4,208,2,7,217,229,0.51,0.948
"4564","La Paz","El Alto","Unidad Educativa Noruega",42,1,7,0,106,6,41,0,2,205,1,9,215,228,0.517,0.943
"4565","La Paz","El Alto","Unidad Educativa Noruega",59,0,3,0,109,0,33,0,5,209,3,8,220,233,0.522,0.944
"4566","La Paz","El Alto","Unidad Educativa Noruega",34,1,6,0,116,0,49,0,0,206,0,11,217,229,0.563,0.948
"4567","La Paz","El Alto","Unidad Educativa Noruega",53,0,8,0,97,4,40,0,1,203,4,7,214,225,0.478,0.951
"4568","La Paz","El Alto","Unidad Educativa Noruega",32,1,5,0,110,1,45,0,2,196,3,9,208,228,0.561,0.912
"4569","La Paz","El Alto","Unidad Educativa Noruega",34,0,10,0,119,0,30,0,3,196,3,7,206,228,0.607,0.904
"4570","La Paz","El Alto","Unidad Educativa Noruega",41,1,4,1,117,2,37,1,5,209,2,6,217,232,0.56,0.935
"4571","La Paz","El Alto","Unidad Educativa Noruega",31,0,4,0,133,2,34,0,5,209,0,5,214,230,0.636,0.93
"4572","La Paz","El Alto","Unidad Educativa Noruega",39,0,6,1,112,1,36,1,0,196,7,7,210,228,0.571,0.921
"4573","La Paz","El Alto","Unidad Educativa Noruega",36,1,11,0,115,4,35,0,6,208,4,12,224,234,0.553,0.957
"4574","La Paz","El Alto","Unidad Educativa Noruega",35,2,6,0,107,0,45,0,7,202,2,9,213,228,0.53,0.934
"4575","La Paz","El Alto","Unidad Educativa Noruega",38,0,8,0,123,0,37,0,0,206,1,2,209,230,0.597,0.909
"4576","La Paz","El Alto","Unidad Educativa Noruega",44,1,6,0,114,2,29,0,6,202,0,7,209,226,0.564,0.925
"4577","La Paz","El Alto","Unidad Educativa Noruega",36,0,5,0,115,1,37,0,2,196,2,7,205,225,0.587,0.911
"4578","La Paz","El Alto","Unidad Educativa Noruega",31,1,9,0,121,1,34,1,7,205,2,9,216,224,0.59,0.964
"4579","La Paz","El Alto","Unidad Educativa Noruega",38,0,5,0,125,4,29,0,2,203,3,6,212,231,0.616,0.918
"4580","La Paz","El Alto","Unidad Educativa Noruega",35,1,9,0,120,4,39,0,1,209,1,9,219,231,0.574,0.948
"4581","La Paz","El Alto","Unidad Educativa Noruega",40,0,9,2,107,2,44,0,4,208,4,5,217,229,0.514,0.948
"4582","La Paz","El Alto","Unidad Educativa Noruega",46,0,5,0,87,4,45,2,5,194,3,5,202,219,0.448,0.922
"4583","La Paz","El Alto","Unidad Educativa Noruega",50,1,10,1,100,0,49,2,3,216,0,8,224,233,0.463,0.961
"4584","La Paz","El Alto","Unidad Educativa Noruega",32,0,9,0,121,3,28,0,6,199,4,3,206,219,0.608,0.941
"4585","La Paz","El Alto","Unidad Educativa Noruega",36,1,4,0,122,0,47,0,4,214,3,2,219,232,0.57,0.944
"4586","La Paz","El Alto","Unidad Educativa Noruega",24,0,4,2,136,1,33,0,5,205,1,8,214,226,0.663,0.947
"4587","La Paz","El Alto","Unidad Educativa Noruega",36,0,10,1,118,2,37,0,1,205,2,9,216,233,0.576,0.927
"4588","La Paz","El Alto","Unidad Educativa Noruega",30,0,4,0,111,8,42,1,2,198,2,5,205,225,0.561,0.911
"4589","La Paz","El Alto","Unidad Educativa Noruega",45,1,7,0,115,3,30,0,3,204,2,8,214,232,0.564,0.922
"4590","La Paz","El Alto","Unidad Educativa Noruega",25,1,4,0,128,1,33,0,4,196,1,10,207,223,0.653,0.928
"4591","La Paz","El Alto","Unidad Educativa Noruega",48,1,9,1,98,1,41,0,3,202,4,7,213,227,0.485,0.938
"4592","La Paz","El Alto","Unidad Educativa Noruega",36,3,12,0,111,0,29,0,5,196,1,11,208,225,0.566,0.924
"4593","La Paz","El Alto","Unidad Educativa Pablo Zarate Villca",21,2,9,0,147,3,34,0,4,220,4,5,229,240,0.668,0.954
"4594","La Paz","El Alto","Unidad Educativa Pablo Zarate Villca",27,1,16,0,125,1,41,2,3,216,2,2,220,235,0.579,0.936
"4595","La Paz","El Alto","Unidad Educativa Pablo Zarate Villca",24,0,11,0,138,2,34,0,1,210,3,6,219,234,0.657,0.936
"4596","La Paz","El Alto","Unidad Educativa Pablo Zarate Villca",28,0,7,0,133,3,31,0,9,211,1,5,217,235,0.63,0.923
"4597","La Paz","El Alto","Escuela Tupac Katari",52,0,7,1,102,2,29,0,4,197,0,9,206,223,0.518,0.924
"4598","La Paz","El Alto","Escuela Tupac Katari",45,3,8,3,110,1,29,1,1,201,2,7,210,223,0.547,0.942
"4599","La Paz","El Alto","Escuela Tupac Katari",58,1,6,2,89,1,40,0,2,199,3,7,209,226,0.447,0.925
"4600","La Paz","El Alto","Escuela Tupac Katari",30,2,6,0,117,1,37,3,2,198,4,8,210,227,0.591,0.925
"4601","La Paz","El Alto","Escuela Tupac Katari",46,0,2,1,111,2,32,0,2,196,0,8,204,223,0.566,0.915
"4602","La Paz","El Alto","Escuela Tupac Katari",57,1,13,1,102,3,24,1,0,202,3,10,215,228,0.505,0.943
"4603","La Paz","El Alto","Escuela Tupac Katari",54,0,7,1,98,1,34,0,3,198,0,7,205,225,0.495,0.911
"4604","La Paz","El Alto","Escuela Tupac Katari",52,0,5,1,98,5,31,1,2,195,2,9,206,225,0.503,0.916
"4605","La Paz","El Alto","Escuela Tupac Katari",41,0,8,0,105,4,34,1,4,197,3,5,205,227,0.533,0.903
"4606","La Paz","El Alto","Escuela Tupac Katari",50,2,6,0,89,1,37,0,5,190,3,11,204,219,0.468,0.932
"4607","La Paz","El Alto","Escuela Tupac Katari",48,0,10,2,108,1,27,0,2,198,4,10,212,225,0.545,0.942
"4608","La Paz","El Alto","Escuela Tupac Katari",47,0,6,0,113,1,37,0,4,208,2,9,219,228,0.543,0.961
"4609","La Paz","El Alto","Escuela Tupac Katari",42,1,7,1,114,1,40,1,1,208,0,8,216,227,0.548,0.952
"4610","La Paz","El Alto","Escuela Tupac Katari",61,2,4,1,86,1,38,2,2,197,0,8,205,222,0.437,0.923
"4611","La Paz","El Alto","Escuela Tupac Katari",54,0,8,1,102,2,40,1,3,211,1,5,217,232,0.483,0.935
"4612","La Paz","El Alto","Escuela Tupac Katari",48,0,7,1,105,3,41,1,1,207,1,3,211,227,0.507,0.93
"4613","La Paz","El Alto","Escuela Tupac Katari",59,3,3,0,94,3,33,0,1,196,0,4,200,220,0.48,0.909
"4614","La Paz","El Alto","Escuela Tupac Katari",52,1,4,0,92,2,38,0,6,195,4,8,207,222,0.472,0.932
"4615","La Paz","El Alto","Col. Rafael Mendoza",59,0,13,1,95,5,26,1,2,202,1,8,211,232,0.47,0.909
"4616","La Paz","El Alto","Col. Rafael Mendoza",56,0,5,0,103,2,37,1,3,207,0,9,216,229,0.498,0.943
"4617","La Paz","El Alto","Col. Rafael Mendoza",65,0,5,1,96,3,30,0,2,202,0,10,212,224,0.475,0.946
"4618","La Paz","El Alto","Col. Rafael Mendoza",53,4,8,0,85,1,35,1,4,191,3,18,212,226,0.445,0.938
"4619","La Paz","El Alto","Col. Rafael Mendoza",59,0,7,2,117,3,23,0,1,212,0,5,217,227,0.552,0.956
"4620","La Paz","El Alto","Col. Rafael Mendoza",66,1,7,0,91,0,34,1,5,205,0,9,214,227,0.444,0.943
"4621","La Paz","El Alto","Col. Rafael Mendoza",54,0,8,0,103,1,38,0,4,208,1,6,215,227,0.495,0.947
"4622","La Paz","El Alto","Col. Rafael Mendoza",61,1,7,0,96,6,29,2,6,208,1,3,212,230,0.462,0.922
"4623","La Paz","El Alto","Col. Rafael Mendoza",76,0,11,0,86,2,24,0,3,202,0,6,208,228,0.426,0.912
"4624","La Paz","El Alto","Col. Rafael Mendoza",74,0,11,2,95,2,28,1,1,214,0,6,220,230,0.444,0.957
"4625","La Paz","El Alto","Col. Rafael Mendoza",48,1,10,0,87,3,41,2,5,197,3,7,207,225,0.442,0.92
"4626","La Paz","El Alto","Col. Rafael Mendoza",48,3,3,0,111,3,43,1,4,216,0,6,222,235,0.514,0.945
"4627","La Paz","El Alto","Col. Rafael Mendoza",69,0,11,2,84,1,35,1,4,207,2,7,216,231,0.406,0.935
"4628","La Paz","El Alto","Col. Rafael Mendoza",49,2,9,2,94,2,39,1,6,204,0,7,211,227,0.461,0.93
"4629","La Paz","El Alto","Col. Rafael Mendoza",49,0,5,0,112,0,39,0,3,208,1,5,214,231,0.538,0.926
"4630","La Paz","El Alto","Col. Rafael Mendoza",60,1,7,2,105,5,30,0,3,213,1,3,217,230,0.493,0.943
"4631","La Paz","El Alto","Col. Rafael Mendoza",45,0,11,1,101,3,44,0,4,209,2,7,218,232,0.483,0.94
"4632","La Paz","El Alto","Col. Rafael Mendoza",56,1,10,1,93,2,38,1,3,205,2,4,211,226,0.454,0.934
"4633","La Paz","El Alto","Col. Rafael Mendoza",56,3,9,0,96,7,29,0,4,204,4,5,213,222,0.471,0.959
"4634","La Paz","El Alto","Col. Rafael Mendoza",74,2,10,1,93,1,30,1,1,213,0,7,220,231,0.437,0.952
"4635","La Paz","El Alto","Col. Rafael Mendoza",44,0,4,0,111,1,41,1,3,205,0,10,215,230,0.541,0.935
"4636","La Paz","El Alto","Col. Rafael Mendoza",66,3,7,1,96,2,36,0,0,211,1,4,216,226,0.455,0.956
"4637","La Paz","El Alto","Col. Rafael Mendoza",61,1,6,0,81,2,42,1,2,196,0,12,208,227,0.413,0.916
"4638","La Paz","El Alto","Col. Rafael Mendoza",67,1,9,1,100,1,22,0,3,204,1,5,210,232,0.49,0.905
"4639","La Paz","El Alto","Col. Rafael Mendoza",40,0,11,1,100,2,39,0,3,196,0,8,204,228,0.51,0.895
"4640","La Paz","El Alto","Unidad Educativa Ingavi",39,1,5,1,120,2,18,0,6,192,7,9,208,224,0.625,0.929
"4641","La Paz","El Alto","Unidad Educativa Ingavi",31,0,6,2,124,3,37,1,2,206,3,5,214,228,0.602,0.939
"4642","La Paz","El Alto","Unidad Educativa Ingavi",35,0,10,3,133,4,16,1,4,206,3,8,217,232,0.646,0.935
"4643","La Paz","El Alto","Unidad Educativa Ingavi",37,1,9,0,117,5,34,1,2,206,4,4,214,231,0.568,0.926
"4644","La Paz","El Alto","Unidad Educativa Ingavi",20,1,8,0,139,0,27,0,4,199,3,8,210,220,0.698,0.955
"4645","La Paz","El Alto","Unidad Educativa Ingavi",25,1,9,0,129,3,32,0,2,201,4,5,210,227,0.642,0.925
"4646","La Paz","El Alto","Unidad Educativa Ingavi",26,1,13,0,126,3,45,0,0,214,2,2,218,231,0.589,0.944
"4647","La Paz","El Alto","Unidad Educativa Ingavi",12,3,13,0,136,2,27,0,3,196,3,6,205,224,0.694,0.915
"4648","La Paz","El Alto","Unidad Educativa Ingavi",34,0,4,0,122,2,34,0,0,196,1,7,204,224,0.622,0.911
"4649","La Paz","El Alto","Unidad Educativa Ingavi",32,1,6,1,123,5,34,0,1,203,2,8,213,228,0.606,0.934
"4650","La Paz","El Alto","Unidad Educativa Ingavi",47,0,8,1,108,4,28,1,6,203,3,9,215,234,0.532,0.919
"4651","La Paz","El Alto","Unidad Educativa Ingavi",18,1,6,0,149,1,36,1,0,212,4,6,222,233,0.703,0.953
"4652","La Paz","El Alto","Unidad Educativa Ingavi",46,1,4,0,122,6,32,1,2,214,0,9,223,231,0.57,0.965
"4653","La Paz","El Alto","Unidad Educativa Ingavi",18,0,6,0,145,2,20,1,3,195,4,6,205,220,0.744,0.932
"4654","La Paz","El Alto","Unidad Educativa Ingavi",31,0,13,0,121,2,31,0,5,203,0,8,211,228,0.596,0.925
"4655","La Paz","El Alto","Unidad Educativa Ingavi",34,1,5,0,126,3,25,1,2,197,3,12,212,225,0.64,0.942
"4656","La Paz","El Alto","Unidad Educativa Ingavi",30,3,5,1,124,6,34,1,3,207,2,9,218,232,0.599,0.94
"4657","La Paz","El Alto","Unidad Educativa Ingavi",20,3,5,1,142,5,25,0,2,203,1,5,209,220,0.7,0.95
"4658","La Paz","El Alto","Unidad Educativa Ingavi",36,1,6,0,120,1,35,2,2,203,3,7,213,223,0.591,0.955
"4659","La Paz","El Alto","Unidad Educativa Ingavi",34,3,10,0,120,2,35,1,3,208,1,8,217,229,0.577,0.948
"4660","La Paz","El Alto","Unidad Educativa Ingavi",28,0,6,0,139,4,27,2,3,209,4,10,223,238,0.665,0.937
"4661","La Paz","El Alto","Unidad Educativa Ingavi",30,1,11,0,136,2,34,0,4,218,1,5,224,237,0.624,0.945
"4662","La Paz","El Alto","Unidad Educativa Ingavi",24,0,7,1,129,1,42,0,3,207,1,9,217,237,0.623,0.916
"4663","La Paz","El Alto","Unidad Educativa Ingavi",37,0,8,2,124,1,40,0,3,215,3,5,223,238,0.577,0.937
"4664","La Paz","El Alto","Unidad Educativa Ingavi",36,2,7,0,138,5,24,1,3,216,4,3,223,238,0.639,0.937
"4665","La Paz","El Alto","U.E. Tokio",39,0,11,1,110,3,30,1,3,198,3,10,211,230,0.556,0.917
"4666","La Paz","El Alto","U.E. Tokio",37,1,10,1,143,4,22,0,1,219,0,9,228,236,0.653,0.966
"4667","La Paz","El Alto","U.E. Tokio",36,3,13,1,122,5,22,0,4,206,2,5,213,226,0.592,0.942
"4668","La Paz","El Alto","U.E. Tokio",33,2,10,0,132,3,23,0,2,205,2,9,216,225,0.644,0.96
"4669","La Paz","El Alto","U.E. Tokio",42,0,10,1,110,0,24,0,5,192,1,9,202,218,0.573,0.927
"4670","La Paz","El Alto","U.E. Tokio",49,1,10,1,110,2,31,2,0,206,1,8,215,225,0.534,0.956
"4671","La Paz","El Alto","U.E. Tokio",18,2,12,1,140,2,26,0,2,203,0,5,208,228,0.69,0.912
"4672","La Paz","El Alto","U.E. Tokio",28,0,9,0,120,1,0,28,2,188,2,4,194,217,0.638,0.894
"4673","La Paz","El Alto","U.E. Tokio",27,1,4,1,118,1,30,2,1,185,4,14,203,224,0.638,0.906
"4674","La Paz","El Alto","U.E. Tokio",38,1,5,1,116,4,39,3,4,211,1,7,219,227,0.55,0.965
"4675","La Paz","El Alto","U.E. Tokio",33,3,11,2,114,3,31,0,1,198,0,7,205,224,0.576,0.915
"4676","La Paz","El Alto","U.E. Tokio",24,1,8,0,129,2,33,0,0,197,2,9,208,218,0.655,0.954
"4677","La Paz","El Alto","U.E. Tokio",29,1,3,2,117,4,26,0,1,183,3,12,198,215,0.639,0.921
"4678","La Paz","El Alto","U.E. Tokio",34,2,10,0,110,2,28,2,1,189,0,3,192,216,0.582,0.889
"4679","La Paz","El Alto","Unidad Educativa Illimani",38,1,4,0,115,2,25,0,0,185,3,10,198,223,0.622,0.888
"4680","La Paz","El Alto","Unidad Educativa Illimani",23,1,8,1,138,2,41,0,3,217,3,4,224,235,0.636,0.953
"4681","La Paz","El Alto","Unidad Educativa Illimani",42,2,7,1,123,6,34,0,2,217,2,4,223,231,0.567,0.965
"4682","La Paz","El Alto","Unidad Educativa Illimani",42,2,4,0,131,1,25,1,2,208,1,6,215,229,0.63,0.939
"4683","La Paz","El Alto","Unidad Educativa Illimani",28,0,0,2,141,1,29,2,2,205,1,10,216,232,0.688,0.931
"4684","La Paz","El Alto","Unidad Educativa Illimani",38,0,5,0,120,2,46,0,2,213,0,10,223,230,0.563,0.97
"4685","La Paz","El Alto","Unidad Educativa Illimani",38,0,8,0,134,1,28,0,1,210,3,2,215,233,0.638,0.923
"4686","La Paz","El Alto","Unidad Educativa Illimani",30,1,4,1,127,6,32,0,1,202,3,7,212,232,0.629,0.914
"4687","La Paz","El Alto","Unidad Educativa Illimani",26,0,5,2,143,0,24,1,2,203,1,12,216,226,0.704,0.956
"4688","La Paz","El Alto","Unidad Educativa Illimani",41,1,8,0,121,0,26,0,4,201,3,10,214,231,0.602,0.926
"4689","La Paz","El Alto","Unidad Educativa Illimani",31,1,2,0,137,0,31,1,3,206,3,9,218,233,0.665,0.936
"4690","La Paz","El Alto","Unidad Educativa Illimani",22,2,8,0,145,2,32,0,0,211,0,4,215,232,0.687,0.927
"4691","La Paz","El Alto","Unidad Educativa Illimani",32,0,12,2,129,1,31,1,2,210,2,7,219,230,0.614,0.952
"4692","La Paz","El Alto","Unidad Educativa Illimani",38,1,7,0,115,2,31,0,0,194,3,9,206,227,0.593,0.907
"4693","La Paz","El Alto","Unidad Educativa Illimani",22,0,8,0,138,2,37,0,4,211,2,7,220,229,0.654,0.961
"4694","La Paz","El Alto","Unidad Educativa Illimani",34,2,12,1,126,1,26,1,2,205,3,8,216,235,0.615,0.919
"4695","La Paz","El Alto","Unidad Educativa Illimani",36,0,10,1,117,0,40,1,3,208,2,6,216,235,0.562,0.919
"4696","La Paz","El Alto","Unidad Educativa Illimani",42,2,7,4,127,3,25,1,0,211,1,7,219,232,0.602,0.944
"4697","La Paz","El Alto","Unidad Educativa Illimani",38,3,9,1,107,1,49,1,4,213,1,3,217,230,0.502,0.943
"4698","La Paz","El Alto","Unidad Educativa Illimani",40,1,7,1,130,1,27,0,0,207,0,6,213,228,0.628,0.934
"4699","La Paz","El Alto","Unidad Educativa Illimani",28,0,7,0,132,1,40,0,3,211,0,8,219,234,0.626,0.936
"4700","La Paz","El Alto","Unidad Educativa Illimani",25,1,12,1,129,1,47,0,1,217,0,1,218,230,0.594,0.948
"4701","La Paz","El Alto","Unidad Educativa Illimani",46,0,7,0,129,3,17,0,0,202,1,13,216,231,0.639,0.935
"4702","La Paz","El Alto","Unidad Educativa Illimani",51,1,5,0,112,2,23,0,2,196,5,7,208,228,0.571,0.912
"4703","La Paz","El Alto","Unidad Educativa Illimani",40,2,7,0,117,6,29,1,0,202,2,8,212,231,0.579,0.918
"4704","La Paz","El Alto","Unidad Educativa Illimani",46,0,5,1,123,2,27,0,1,205,3,3,211,230,0.6,0.917
"4705","La Paz","El Alto","Unidad Educativa Illimani",27,1,6,0,135,2,41,0,1,213,3,8,224,231,0.634,0.97
"4706","La Paz","El Alto","Escuela Rafael Pabon",21,0,5,2,160,2,21,0,1,212,3,4,219,231,0.755,0.948
"4707","La Paz","El Alto","Escuela Rafael Pabon",28,1,8,0,137,1,26,0,0,201,2,5,208,227,0.682,0.916
"4708","La Paz","El Alto","Escuela Rafael Pabon",21,0,6,0,139,0,41,0,1,208,3,12,223,228,0.668,0.978
"4709","La Paz","El Alto","Escuela Rafael Pabon",20,3,9,0,135,0,35,0,2,204,1,7,212,229,0.662,0.926
"4710","La Paz","El Alto","Escuela Rafael Pabon",42,1,11,0,111,1,32,0,3,201,2,15,218,230,0.552,0.948
"4711","La Paz","El Alto","Escuela Rafael Pabon",18,1,9,0,125,4,28,0,4,189,2,12,203,225,0.661,0.902
"4712","La Paz","El Alto","Escuela Rafael Pabon",21,0,13,1,136,1,31,0,1,204,1,8,213,228,0.667,0.934
"4713","La Paz","El Alto","Escuela Rafael Pabon",34,2,9,0,126,0,38,0,1,210,1,10,221,231,0.6,0.957
"4714","La Paz","El Alto","Escuela Rafael Pabon",28,2,12,1,123,2,26,0,2,196,3,9,208,224,0.628,0.929
"4715","La Paz","El Alto","Escuela Rafael Pabon",14,2,7,1,144,1,31,1,3,204,5,9,218,230,0.706,0.948
"4716","La Paz","El Alto","Escuela Rafael Pabon",27,0,11,0,126,4,26,0,5,199,2,9,210,229,0.633,0.917
"4717","La Paz","El Alto","Escuela Rafael Pabon",17,0,4,1,135,4,31,1,0,193,6,7,206,227,0.699,0.907
"4718","La Paz","El Alto","Escuela Rafael Pabon",21,1,6,1,150,2,27,0,1,209,2,7,218,231,0.718,0.944
"4719","La Paz","El Alto","Escuela Rafael Pabon",24,1,9,0,136,1,39,0,2,212,2,6,220,236,0.642,0.932
"4720","La Paz","El Alto","Escuela Rafael Pabon",29,2,12,0,118,3,34,1,2,201,4,5,210,230,0.587,0.913
"4721","La Paz","El Alto","Escuela Rafael Pabon",13,0,10,0,138,1,37,1,4,204,2,10,216,228,0.676,0.947
"4722","La Paz","El Alto","Escuela Rafael Pabon",35,1,11,2,130,2,22,0,1,204,2,9,215,230,0.637,0.935
"4723","La Paz","El Alto","Escuela Rafael Pabon",16,1,8,1,148,2,26,1,3,206,2,11,219,229,0.718,0.956
"4724","La Paz","El Alto","Escuela Rafael Pabon",20,2,7,0,136,0,40,0,4,209,1,8,218,233,0.651,0.936
"4725","La Paz","El Alto","Escuela Rafael Pabon",32,0,13,1,121,2,32,1,3,205,2,13,220,232,0.59,0.948
"4726","La Paz","El Alto","Escuela Rafael Pabon",23,1,2,0,140,1,37,2,1,207,2,11,220,228,0.676,0.965
"4727","La Paz","El Alto","Escuela Rafael Pabon",19,0,2,1,148,0,38,0,1,209,0,8,217,230,0.708,0.943
"4728","La Paz","El Alto","Escuela Rafael Pabon",17,1,8,1,116,1,30,0,2,176,2,5,183,194,0.659,0.943
"4729","La Paz","El Alto","Unidad Educativa Santa Rosa de Lima",24,0,7,2,135,5,33,0,1,207,5,6,218,228,0.652,0.956
"4730","La Paz","El Alto","Unidad Educativa Santa Rosa de Lima",18,0,9,1,147,1,16,1,1,194,6,11,211,232,0.758,0.909
"4731","La Paz","El Alto","Unidad Educativa Santa Rosa de Lima",22,1,11,1,151,1,28,0,2,217,2,4,223,233,0.696,0.957
"4732","La Paz","El Alto","Unidad Educativa Santa Rosa de Lima",20,0,7,0,141,1,28,0,0,197,5,8,210,230,0.716,0.913
"4733","La Paz","El Alto","Unidad Educativa Santa Rosa de Lima",26,1,10,0,138,3,26,1,3,208,2,18,228,231,0.663,0.987
"4734","La Paz","El Alto","Unidad Educativa Santa Rosa de Lima",24,0,5,1,135,2,35,0,1,203,6,8,217,229,0.665,0.948
"4735","La Paz","El Alto","Unidad Educativa Santa Rosa de Lima",36,0,8,0,137,2,30,0,1,214,0,7,221,231,0.64,0.957
"4736","La Paz","El Alto","Unidad Educativa Santa Rosa de Lima",28,1,9,0,139,2,24,0,0,203,3,14,220,233,0.685,0.944
"4737","La Paz","El Alto","Unidad Educativa Santa Rosa de Lima",31,2,24,0,98,6,0,3,1,165,53,4,222,235,0.594,0.945
"4738","La Paz","El Alto","Unidad Educativa Santa Rosa de Lima",22,0,6,0,146,1,28,0,2,205,1,7,213,229,0.712,0.93
"4739","La Paz","El Alto","Unidad Educativa Santa Rosa de Lima",28,2,12,0,134,0,24,0,1,201,3,11,215,229,0.667,0.939
"4740","La Paz","El Alto","Escuela Guaqui",32,1,3,0,128,3,28,0,4,199,2,4,205,223,0.643,0.919
"4741","La Paz","El Alto","Escuela Guaqui",41,1,4,1,116,7,27,0,2,199,1,9,209,224,0.583,0.933
"4742","La Paz","El Alto","Escuela Guaqui",50,0,5,1,102,1,31,1,3,194,2,6,202,220,0.526,0.918
"4743","La Paz","El Alto","Escuela Guaqui",45,1,6,0,114,4,26,0,2,198,1,2,201,221,0.576,0.91
"4744","La Paz","El Alto","Escuela Guaqui",48,0,5,1,115,1,35,0,1,206,1,9,216,234,0.558,0.923
"4745","La Paz","El Alto","Escuela Guaqui",32,1,6,1,118,2,34,0,3,197,3,6,206,226,0.599,0.912
"4746","La Paz","El Alto","Escuela Guaqui",50,2,5,0,116,3,26,0,0,202,2,6,210,225,0.574,0.933
"4747","La Paz","El Alto","Escuela Guaqui",43,0,11,1,118,3,19,1,2,198,3,5,206,228,0.596,0.904
"4748","La Paz","El Alto","Escuela Guaqui",43,0,1,5,128,4,17,0,1,199,2,10,211,221,0.643,0.955
"4749","La Paz","El Alto","Escuela Guaqui",34,3,10,3,126,2,29,0,1,208,1,10,219,232,0.606,0.944
"4750","La Paz","El Alto","Escuela Guaqui",51,1,7,0,96,3,35,0,1,194,1,11,206,225,0.495,0.916
"4751","La Paz","El Alto","Escuela Guaqui",48,0,5,1,118,4,24,1,4,205,1,6,212,225,0.576,0.942
"4752","La Paz","El Alto","Escuela Guaqui",47,0,5,0,113,1,31,0,1,198,2,6,206,224,0.571,0.92
"4753","La Paz","El Alto","Escuela Guaqui",36,2,6,0,124,5,27,0,2,202,4,3,209,225,0.614,0.929
"4754","La Paz","El Alto","Escuela Guaqui",54,0,6,0,104,1,27,2,1,195,1,7,203,226,0.533,0.898
"4755","La Paz","El Alto","Escuela Guaqui",44,2,3,0,114,2,26,1,3,195,1,8,204,219,0.585,0.932
"4756","La Paz","El Alto","Escuela Guaqui",61,1,3,0,115,3,13,0,0,196,1,6,203,220,0.587,0.923
"4757","La Paz","El Alto","Escuela Guaqui",44,1,3,0,120,4,35,0,7,214,1,5,220,232,0.561,0.948
"4758","La Paz","El Alto","Escuela Guaqui",35,2,3,0,122,5,30,0,2,199,1,13,213,225,0.613,0.947
"4759","La Paz","El Alto","Escuela Guaqui",31,2,6,0,126,1,35,0,1,202,2,10,214,226,0.624,0.947
"4760","La Paz","El Alto","Escuela Guaqui",45,2,5,2,115,2,29,1,0,201,2,6,209,228,0.572,0.917
"4761","La Paz","El Alto","Escuela Guaqui",41,0,5,1,128,0,26,1,0,202,3,4,209,223,0.634,0.937
"4762","La Paz","El Alto","Escuela Guaqui",41,1,5,0,131,0,18,0,3,199,1,12,212,227,0.658,0.934
"4763","La Paz","El Alto","Escuela Guaqui",42,0,6,2,120,5,18,0,3,196,0,13,209,218,0.612,0.959
"4764","La Paz","El Alto","Escuela Guaqui",41,0,5,1,110,7,34,1,1,200,1,7,208,226,0.55,0.92
"4765","La Paz","El Alto","Escuela Guaqui",37,1,9,0,118,1,35,0,2,203,1,7,211,225,0.581,0.938
"4766","La Paz","El Alto","Escuela Guaqui",30,0,2,0,124,4,34,0,5,199,1,2,202,224,0.623,0.902
"4767","La Paz","El Alto","Escuela Guaqui",39,1,2,3,129,3,23,0,3,203,2,6,211,222,0.635,0.95
"4768","La Paz","El Alto","Escuela Guaqui",48,0,6,0,116,2,41,1,1,215,0,2,217,225,0.54,0.964
"4769","La Paz","El Alto","Escuela Guaqui",35,1,6,0,122,2,32,2,2,202,1,8,211,227,0.604,0.93
"4770","La Paz","El Alto","Escuela Guaqui",38,0,2,3,121,1,22,0,6,193,2,11,206,221,0.627,0.932
"4771","La Paz","El Alto","Colegio San Jose",43,1,9,0,119,0,37,0,0,209,2,3,214,223,0.569,0.96
"4772","La Paz","El Alto","Colegio San Jose",60,1,8,1,93,1,31,0,3,198,0,8,206,216,0.47,0.954
"4773","La Paz","El Alto","Colegio San Jose",68,4,4,0,97,5,26,0,2,206,1,5,212,220,0.471,0.964
"4774","La Paz","El Alto","Colegio San Jose",62,1,2,2,98,2,32,2,1,202,2,10,214,224,0.485,0.955
"4775","La Paz","El Alto","Colegio San Jose",46,0,8,0,121,2,33,1,4,215,2,4,221,230,0.563,0.961
"4776","La Paz","El Alto","Colegio San Jose",54,1,5,0,99,2,36,1,2,200,2,8,210,221,0.495,0.95
"4777","La Paz","El Alto","Colegio San Jose",48,0,10,0,114,3,22,0,4,201,3,8,212,227,0.567,0.934
"4778","La Paz","El Alto","Colegio San Jose",64,0,4,1,91,3,33,0,2,198,4,4,206,226,0.46,0.912
"4779","La Paz","El Alto","Colegio San Jose",51,2,3,1,117,0,22,0,3,199,4,5,208,219,0.588,0.95
"4780","La Paz","El Alto","Colegio San Jose",61,1,5,0,97,4,22,1,4,195,2,8,205,222,0.497,0.923
"4781","La Paz","El Alto","Colegio San Jose",47,1,7,0,117,1,26,0,3,202,0,6,208,223,0.579,0.933
"4782","La Paz","El Alto","Colegio San Jose",57,1,9,0,106,2,24,2,1,202,1,5,208,220,0.525,0.945
"4783","La Paz","El Alto","Colegio San Jose",35,0,1,2,111,6,31,0,3,189,3,5,197,210,0.587,0.938
"4784","La Paz","El Alto","Colegio San Jose",62,4,3,0,104,4,28,0,4,209,2,7,218,231,0.498,0.944
"4785","La Paz","El Alto","Colegio San Jose",59,0,10,0,101,1,25,0,3,199,0,12,211,231,0.508,0.913
"4786","La Paz","El Alto","Colegio San Jose",45,4,6,0,124,4,18,0,5,206,1,5,212,220,0.602,0.964
"4787","La Paz","El Alto","Colegio San Jose",52,1,7,1,107,1,33,0,1,203,3,5,211,228,0.527,0.925
"4788","La Paz","El Alto","Colegio San Jose",68,1,4,0,116,1,23,0,0,213,0,5,218,225,0.545,0.969
"4789","La Paz","El Alto","Colegio San Jose",53,0,6,0,105,4,26,1,1,196,5,4,205,219,0.536,0.936
"4790","La Paz","El Alto","Colegio San Jose",55,0,5,1,105,0,29,0,2,197,2,7,206,224,0.533,0.92
"4791","La Paz","El Alto","Colegio San Jose",47,1,9,0,110,2,28,1,5,203,0,4,207,224,0.542,0.924
"4792","La Paz","El Alto","Colegio San Jose",59,1,9,0,112,3,29,0,4,217,0,4,221,228,0.516,0.969
"4793","La Paz","El Alto","Colegio San Jose",54,1,8,0,103,2,26,0,2,196,2,9,207,223,0.526,0.928
"4794","La Paz","El Alto","Colegio San Jose",65,2,2,0,100,2,29,0,3,203,0,5,208,223,0.493,0.933
"4795","La Paz","El Alto","Colegio San Jose",54,2,2,0,116,2,23,0,3,202,2,11,215,228,0.574,0.943
"4796","La Paz","El Alto","Colegio San Jose",60,0,2,0,105,0,27,0,2,196,5,5,206,227,0.536,0.907
"4797","La Paz","El Alto","Colegio San Jose",43,1,3,1,111,2,24,0,1,186,3,3,192,211,0.597,0.91
"4798","La Paz","El Alto","Colegio San Jose",47,1,9,0,103,3,32,2,6,203,3,9,215,230,0.507,0.935
"4799","La Paz","El Alto","Colegio San Jose",46,0,5,0,132,3,25,0,1,212,1,7,220,228,0.623,0.965
"4800","La Paz","El Alto","Colegio San Jose",42,2,10,1,119,1,21,0,2,198,1,4,203,225,0.601,0.902
"4801","La Paz","El Alto","Colegio San Jose",35,0,4,2,111,2,46,0,3,203,0,8,211,229,0.547,0.921
"4802","La Paz","El Alto","Colegio San Jose",53,3,9,1,105,4,36,0,2,213,1,3,217,229,0.493,0.948
"4803","La Paz","El Alto","Colegio San Jose",53,1,2,0,106,2,31,0,3,198,0,4,202,222,0.535,0.91
"4804","La Paz","El Alto","Colegio San Jose",67,0,6,0,110,1,23,1,2,210,2,7,219,227,0.524,0.965
"4805","La Paz","El Alto","Colegio San Jose",59,0,9,1,93,5,20,0,2,189,2,9,200,218,0.492,0.917
"4806","La Paz","El Alto","Colegio San Jose",47,3,9,2,99,0,32,1,1,194,2,6,202,224,0.51,0.902
"4807","La Paz","El Alto","Colegio San Jose",42,0,7,0,104,3,27,1,1,185,1,10,196,221,0.562,0.887
"4808","La Paz","El Alto","Colegio San Jose",45,0,6,1,102,1,22,0,3,180,5,11,196,210,0.567,0.933
"4809","La Paz","El Alto","Colegio San Jose",60,0,2,0,106,4,28,2,3,205,3,4,212,224,0.517,0.946
"4810","La Paz","El Alto","Colegio San Jose",38,2,5,0,125,2,31,1,2,206,0,7,213,226,0.607,0.942
"4811","La Paz","El Alto","Colegio San Jose",53,5,6,0,107,3,30,0,4,208,2,7,217,229,0.514,0.948
"4812","La Paz","El Alto","Colegio San Jose",57,0,7,0,107,3,21,0,0,195,0,17,212,229,0.549,0.926
"4813","La Paz","El Alto","Colegio San Jose",62,1,3,0,110,4,21,0,1,202,2,3,207,222,0.545,0.932
"4814","La Paz","El Alto","Colegio San Jose",56,2,3,0,123,2,18,0,3,207,1,2,210,224,0.594,0.938
"4815","La Paz","El Alto","Colegio San Jose",69,1,7,0,91,3,23,0,2,196,0,7,203,219,0.464,0.927
"4816","La Paz","El Alto","Colegio San Jose",44,4,4,0,108,3,35,0,2,200,3,6,209,224,0.54,0.933
"4817","La Paz","El Alto","Colegio San Jose",51,1,7,1,114,4,24,0,0,202,2,6,210,224,0.564,0.938
"4818","La Paz","El Alto","Colegio San Jose",65,1,2,3,102,2,24,0,2,201,2,5,208,226,0.507,0.92
"4819","La Paz","El Alto","Colegio San Jose",62,1,3,0,94,2,32,0,2,196,2,8,206,220,0.48,0.936
"4820","La Paz","El Alto","Colegio San Jose",48,0,7,1,98,3,34,1,0,192,2,9,203,223,0.51,0.91
"4821","La Paz","El Alto","Colegio San Jose",52,0,2,0,109,4,16,1,0,184,0,4,188,199,0.592,0.945
"4822","La Paz","El Alto","Colegio Adrian Castillo Nava",37,1,7,0,112,0,45,1,4,207,2,5,214,230,0.541,0.93
"4823","La Paz","El Alto","Colegio Adrian Castillo Nava",41,1,5,0,114,3,26,1,1,192,0,7,199,223,0.594,0.892
"4824","La Paz","El Alto","Colegio Adrian Castillo Nava",44,1,7,1,106,5,41,1,2,208,2,7,217,226,0.51,0.96
"4825","La Paz","El Alto","Colegio Adrian Castillo Nava",35,0,6,0,123,1,36,0,3,204,6,5,215,228,0.603,0.943
"4826","La Paz","El Alto","Colegio Adrian Castillo Nava",56,0,7,2,101,5,33,0,1,205,2,5,212,226,0.493,0.938
"4827","La Paz","El Alto","Colegio Adrian Castillo Nava",51,0,9,0,104,3,28,0,5,200,3,6,209,222,0.52,0.941
"4828","La Paz","El Alto","Colegio Adrian Castillo Nava",39,1,3,0,122,2,28,1,1,197,4,9,210,223,0.619,0.942
"4829","La Paz","El Alto","Colegio Adrian Castillo Nava",38,1,14,0,106,2,30,0,4,195,2,4,201,219,0.544,0.918
"4830","La Paz","El Alto","Colegio Adrian Castillo Nava",39,1,8,1,120,1,33,1,5,209,2,4,215,228,0.574,0.943
"4831","La Paz","El Alto","Colegio Adrian Castillo Nava",40,0,5,0,102,4,46,4,4,205,1,5,211,230,0.498,0.917
"4832","La Paz","El Alto","Colegio Adrian Castillo Nava",51,2,7,1,109,1,24,0,4,199,3,15,217,228,0.548,0.952
"4833","La Paz","El Alto","Colegio Adrian Castillo Nava",48,2,1,1,124,2,33,0,3,214,3,3,220,227,0.579,0.969
"4834","La Paz","El Alto","Colegio Adrian Castillo Nava",41,1,5,0,116,2,29,1,1,196,3,14,213,230,0.592,0.926
"4835","La Paz","El Alto","Colegio Adrian Castillo Nava",59,0,3,1,93,1,40,0,1,198,2,7,207,223,0.47,0.928
"4836","La Paz","El Alto","Colegio Adrian Castillo Nava",50,2,7,0,119,3,35,0,2,218,1,4,223,230,0.546,0.97
"4837","La Paz","El Alto","Colegio Adrian Castillo Nava",44,1,1,1,118,1,34,0,0,200,1,7,208,228,0.59,0.912
"4838","La Paz","El Alto","Colegio Adrian Castillo Nava",50,1,5,1,125,3,25,0,1,211,1,6,218,228,0.592,0.956
"4839","La Paz","El Alto","Colegio Adrian Castillo Nava",41,2,4,2,116,2,39,1,1,208,1,11,220,232,0.558,0.948
"4840","La Paz","El Alto","Colegio Adrian Castillo Nava",50,1,6,1,108,1,37,0,1,205,2,2,209,227,0.527,0.921
"4841","La Paz","El Alto","Colegio Adrian Castillo Nava",44,7,0,0,117,3,26,0,1,198,0,6,204,230,0.591,0.887
"4842","La Paz","El Alto","Colegio Adrian Castillo Nava",35,1,3,0,113,2,34,0,3,191,2,10,203,221,0.592,0.919
"4843","La Paz","El Alto","Colegio Adrian Castillo Nava",46,0,9,0,92,2,35,0,2,186,3,10,199,216,0.495,0.921
"4844","La Paz","El Alto","Colegio Adrian Castillo Nava",32,0,6,0,115,1,41,1,2,198,0,5,203,214,0.581,0.949
"4845","La Paz","El Alto","Colegio Adrian Castillo Nava",31,0,9,0,107,2,37,0,1,187,3,8,198,217,0.572,0.912
"4846","La Paz","El Alto","Colegio Adrian Castillo Nava",38,1,5,0,91,3,54,0,2,194,2,13,209,224,0.469,0.933
"4847","La Paz","El Alto","Colegio Adrian Castillo Nava",37,2,3,0,105,3,51,1,3,205,0,9,214,227,0.512,0.943
"4848","La Paz","El Alto","Colegio Adrian Castillo Nava",40,3,4,1,117,4,29,2,1,201,1,11,213,225,0.582,0.947
"4849","La Paz","El Alto","Colegio Adrian Castillo Nava",45,2,8,1,105,2,38,1,1,203,2,4,209,223,0.517,0.937
"4850","La Paz","El Alto","Colegio Adrian Castillo Nava",53,0,5,0,109,0,36,0,2,205,0,2,207,227,0.532,0.912
"4851","La Paz","El Alto","Colegio Adrian Castillo Nava",60,3,7,0,95,1,26,0,6,198,3,8,209,221,0.48,0.946
"4852","La Paz","El Alto","Colegio Adrian Castillo Nava",54,1,9,0,102,4,32,0,2,204,2,5,211,230,0.5,0.917
"4853","La Paz","El Alto","Colegio Adrian Castillo Nava",48,2,5,1,118,3,19,1,3,200,1,7,208,221,0.59,0.941
"4854","La Paz","El Alto","Colegio Adrian Castillo Nava",44,1,4,0,125,3,23,0,4,204,2,6,212,227,0.613,0.934
"4855","La Paz","El Alto","Colegio Adrian Castillo Nava",43,1,4,0,112,2,30,0,1,193,2,10,205,221,0.58,0.928
"4856","La Paz","El Alto","Colegio Adrian Castillo Nava",48,1,4,0,113,1,39,0,2,208,2,4,214,226,0.543,0.947
"4857","La Paz","El Alto","Colegio Adrian Castillo Nava",33,2,7,1,117,7,35,0,3,205,3,8,216,230,0.571,0.939
"4858","La Paz","El Alto","Colegio Adrian Castillo Nava",58,0,8,0,110,1,28,1,1,207,4,9,220,226,0.531,0.973
"4859","La Paz","El Alto","Colegio Adrian Castillo Nava",46,1,7,0,112,6,25,0,4,201,1,6,208,226,0.557,0.92
"4860","La Paz","El Alto","Colegio Adrian Castillo Nava",43,1,7,0,123,3,33,0,4,214,0,3,217,230,0.575,0.943
"4861","La Paz","El Alto","Colegio Adrian Castillo Nava",45,0,7,2,120,1,29,1,3,208,0,6,214,225,0.577,0.951
"4862","La Paz","El Alto","Colegio Adrian Castillo Nava",60,0,4,0,94,3,36,3,2,202,2,5,209,224,0.465,0.933
"4863","La Paz","El Alto","Colegio Adrian Castillo Nava",46,1,11,0,107,1,39,2,0,207,2,3,212,227,0.517,0.934
"4864","La Paz","El Alto","Colegio Adrian Castillo Nava",39,0,1,1,101,3,49,1,2,197,5,11,213,225,0.513,0.947
"4865","La Paz","El Alto","Colegio Adrian Castillo Nava",42,0,4,0,117,3,22,1,0,189,0,15,204,223,0.619,0.915
"4866","La Paz","El Alto","Colegio Adrian Castillo Nava",57,1,14,0,96,4,26,1,3,202,2,7,211,222,0.475,0.95
"4867","La Paz","El Alto","Escuela Juan Jose Torrez",46,1,9,0,111,2,35,1,2,207,2,8,217,224,0.536,0.969
"4868","La Paz","El Alto","Escuela Juan Jose Torrez",37,1,6,0,106,1,41,0,3,195,2,10,207,225,0.544,0.92
"4869","La Paz","El Alto","Escuela Juan Jose Torrez",37,1,5,2,120,7,30,1,4,207,2,4,213,225,0.58,0.947
"4870","La Paz","El Alto","Escuela Juan Jose Torrez",29,1,8,0,142,3,24,1,4,212,0,3,215,230,0.67,0.935
"4871","La Paz","El Alto","Escuela Juan Jose Torrez",32,1,3,2,113,3,34,0,4,192,1,6,199,225,0.589,0.884
"4872","La Paz","El Alto","Escuela Juan Jose Torrez",33,0,9,3,103,3,47,0,3,201,2,5,208,226,0.512,0.92
"4873","La Paz","El Alto","Escuela Juan Jose Torrez",29,1,4,1,121,9,35,0,1,201,5,7,213,222,0.602,0.959
"4874","La Paz","El Alto","Escuela Juan Jose Torrez",38,0,4,0,125,4,33,0,3,207,0,7,214,230,0.604,0.93
"4875","La Paz","El Alto","Escuela Juan Jose Torrez",45,0,5,0,104,3,40,2,1,200,1,6,207,229,0.52,0.904
"4876","La Paz","El Alto","Escuela Juan Jose Torrez",25,1,6,1,140,2,35,0,1,211,5,4,220,233,0.664,0.944
"4877","La Paz","El Alto","Escuela Juan Jose Torrez",36,1,6,1,120,2,27,0,2,195,2,7,204,225,0.615,0.907
"4878","La Paz","El Alto","Escuela Juan Jose Torrez",25,0,12,1,129,8,31,1,1,208,2,6,216,230,0.62,0.939
"4879","La Paz","El Alto","Escuela Juan Jose Torrez",28,0,8,0,138,1,32,0,2,209,1,3,213,227,0.66,0.938
"4880","La Paz","El Alto","Escuela Juan Jose Torrez",25,0,8,0,125,1,41,0,1,201,1,6,208,223,0.622,0.933
"4881","La Paz","El Alto","Escuela Juan Jose Torrez",40,0,4,1,120,4,27,2,1,199,2,6,207,226,0.603,0.916
"4882","La Paz","El Alto","Escuela Juan Jose Torrez",38,0,2,1,123,2,36,0,5,207,3,7,217,234,0.594,0.927
"4883","La Paz","El Alto","Escuela Juan Jose Torrez",43,1,4,0,138,2,19,0,2,209,0,4,213,227,0.66,0.938
"4884","La Paz","El Alto","Escuela Juan Jose Torrez",33,3,6,0,120,5,33,2,2,204,5,5,214,232,0.588,0.922
"4885","La Paz","El Alto","Escuela Juan Jose Torrez",34,0,5,0,119,2,41,0,4,205,2,8,215,228,0.58,0.943
"4886","La Paz","El Alto","Escuela Juan Jose Torrez",45,2,9,0,105,1,35,0,6,203,1,4,208,228,0.517,0.912
"4887","La Paz","El Alto","Escuela Juan Jose Torrez",35,1,5,0,130,5,23,0,2,201,4,11,216,229,0.647,0.943
"4888","La Paz","El Alto","Escuela Juan Jose Torrez",38,2,4,0,117,5,32,0,3,201,3,6,210,226,0.582,0.929
"4889","La Paz","El Alto","Esc. Luis Espinal Camps",60,0,5,0,108,4,26,1,1,205,1,4,210,225,0.527,0.933
"4890","La Paz","El Alto","Esc. Luis Espinal Camps",49,1,8,2,105,2,31,2,2,202,2,5,209,224,0.52,0.933
"4891","La Paz","El Alto","Esc. Luis Espinal Camps",58,2,5,0,103,5,28,1,0,202,3,7,212,229,0.51,0.926
"4892","La Paz","El Alto","Esc. Luis Espinal Camps",42,0,1,2,121,0,32,1,5,204,2,3,209,229,0.593,0.913
"4893","La Paz","El Alto","Esc. Luis Espinal Camps",43,1,3,0,130,4,20,1,2,204,1,2,207,226,0.637,0.916
"4894","La Paz","El Alto","Esc. Luis Espinal Camps",39,1,9,0,123,4,37,0,2,215,1,3,219,232,0.572,0.944
"4895","La Paz","El Alto","Esc. Luis Espinal Camps",47,0,9,0,113,5,33,0,2,209,0,7,216,226,0.541,0.956
"4896","La Paz","El Alto","Esc. Luis Espinal Camps",28,0,7,0,121,4,29,0,3,192,2,8,202,224,0.63,0.902
"4897","La Paz","El Alto","Esc. Luis Espinal Camps",41,0,7,2,109,4,34,0,2,199,3,11,213,225,0.548,0.947
"4898","La Paz","El Alto","Esc. Luis Espinal Camps",55,0,6,1,104,4,27,0,3,200,2,7,209,226,0.52,0.925
"4899","La Paz","El Alto","Esc. Luis Espinal Camps",44,1,5,0,116,4,36,0,2,208,2,7,217,233,0.558,0.931
"4900","La Paz","El Alto","Esc. Luis Espinal Camps",40,0,5,0,123,3,34,0,2,207,2,6,215,227,0.594,0.947
"4901","La Paz","El Alto","Esc. Luis Espinal Camps",39,3,4,3,131,0,18,1,1,200,3,3,206,223,0.655,0.924
"4902","La Paz","El Alto","Esc. Elizardo Perez",61,1,8,2,98,2,31,0,3,206,1,4,211,227,0.476,0.93
"4903","La Paz","El Alto","Esc. Elizardo Perez",53,2,9,1,94,1,47,0,3,210,1,4,215,231,0.448,0.931
"4904","La Paz","El Alto","Esc. Elizardo Perez",59,2,5,1,99,1,33,2,1,203,3,6,212,230,0.488,0.922
"4905","La Paz","El Alto","Esc. Elizardo Perez",51,2,4,1,95,1,46,3,1,204,1,8,213,228,0.466,0.934
"4906","La Paz","El Alto","Esc. Elizardo Perez",44,1,7,1,111,3,32,1,0,200,0,11,211,230,0.555,0.917
"4907","La Paz","El Alto","Esc. Elizardo Perez",40,1,5,1,113,4,32,1,3,200,1,8,209,223,0.565,0.937
"4908","La Paz","El Alto","Esc. Elizardo Perez",33,0,6,0,121,3,32,0,4,199,4,11,214,230,0.608,0.93
"4909","La Paz","El Alto","Esc. Elizardo Perez",62,0,3,1,100,2,37,1,0,206,0,6,212,228,0.485,0.93
"4910","La Paz","El Alto","Esc. Elizardo Perez",56,1,11,0,100,4,34,0,2,208,1,6,215,228,0.481,0.943
"4911","La Paz","El Alto","Esc. Elizardo Perez",71,1,7,0,100,6,19,0,2,206,0,6,212,230,0.485,0.922
"4912","La Paz","El Alto","Esc. Elizardo Perez",55,1,8,1,106,2,25,1,1,200,1,9,210,225,0.53,0.933
"4913","La Paz","El Alto","Esc. Elizardo Perez",46,3,9,1,101,1,46,4,0,211,0,7,218,231,0.479,0.944
"4914","La Paz","El Alto","Esc. Elizardo Perez",65,1,6,0,82,2,37,1,2,196,1,7,204,225,0.418,0.907
"4915","La Paz","El Alto","Esc. Elizardo Perez",41,0,10,1,101,2,33,0,1,189,2,14,205,227,0.534,0.903
"4916","La Paz","El Alto","Esc. Elizardo Perez",42,0,9,0,114,4,42,0,4,215,1,4,220,231,0.53,0.952
"4917","La Paz","El Alto","Esc. Elizardo Perez",64,1,8,1,86,2,39,0,4,205,1,10,216,221,0.42,0.977
"4918","La Paz","El Alto","Esc. Elizardo Perez",47,2,4,0,110,3,32,0,5,203,1,7,211,227,0.542,0.93
"4919","La Paz","El Alto","Esc. Elizardo Perez",54,0,10,1,96,4,28,1,3,197,1,7,205,219,0.487,0.936
"4920","La Paz","El Alto","Esc. Elizardo Perez",51,1,8,0,99,4,33,0,2,198,1,11,210,227,0.5,0.925
"4921","La Paz","El Alto","Esc. Elizardo Perez",58,0,7,1,105,1,30,0,3,205,3,4,212,235,0.512,0.902
"4922","La Paz","El Alto","Esc. Elizardo Perez",65,0,9,0,99,2,24,1,3,203,1,7,211,222,0.488,0.95
"4923","La Paz","El Alto","Esc. Elizardo Perez",65,0,1,1,108,2,29,0,1,207,2,3,212,228,0.522,0.93
"4924","La Paz","El Alto","Esc. Elizardo Perez",52,1,6,0,107,3,20,1,1,191,4,6,201,223,0.56,0.901
"4925","La Paz","El Alto","Esc. Elizardo Perez",49,2,3,0,100,3,47,0,1,205,2,8,215,234,0.488,0.919
"4926","La Paz","El Alto","Esc. Ballivian",62,0,2,1,112,1,20,0,3,201,1,3,205,223,0.557,0.919
"4927","La Paz","El Alto","Esc. Ballivian",64,0,3,1,106,0,26,0,1,201,1,7,209,223,0.527,0.937
"4928","La Paz","El Alto","Esc. Ballivian",59,1,3,0,106,4,27,0,2,202,1,6,209,222,0.525,0.941
"4929","La Paz","El Alto","Esc. Ballivian",61,1,7,1,91,0,23,0,1,185,1,17,203,221,0.492,0.919
"4930","La Paz","El Alto","Esc. Ballivian",44,4,6,0,112,3,23,1,2,195,2,10,207,221,0.574,0.937
"4931","La Paz","El Alto","Esc. Ballivian",52,3,5,0,105,3,32,0,4,204,1,5,210,217,0.515,0.968
"4932","La Paz","El Alto","Esc. Ballivian",46,0,9,0,105,4,28,2,2,196,6,1,203,221,0.536,0.919
"4933","La Paz","El Alto","Esc. Ballivian",49,1,11,1,101,4,30,1,0,198,1,8,207,215,0.51,0.963
"4934","La Paz","El Alto","Esc. Ballivian",53,1,7,1,106,2,30,0,4,204,1,7,212,229,0.52,0.926
"4935","La Paz","El Alto","Esc. Ballivian",70,2,5,1,88,2,29,0,3,200,2,12,214,226,0.44,0.947
"4936","La Paz","El Alto","Esc. Ballivian",54,0,5,0,102,2,26,1,2,192,0,10,202,221,0.531,0.914
"4937","La Paz","El Alto","Esc. Ballivian",72,1,10,0,79,6,24,2,2,196,3,2,201,223,0.403,0.901
"4938","La Paz","El Alto","Esc. Ballivian",56,1,4,1,101,1,29,1,2,196,3,8,207,220,0.515,0.941
"4939","La Paz","El Alto","Esc. Ballivian",56,0,6,0,108,0,25,0,6,201,1,3,205,216,0.537,0.949
"4940","La Paz","El Alto","Esc. Ballivian",60,1,6,0,102,0,28,0,1,198,2,12,212,224,0.515,0.946
"4941","La Paz","El Alto","Esc. Ballivian",48,1,6,2,106,4,19,2,2,190,2,11,203,219,0.558,0.927
"4942","La Paz","El Alto","Esc. Ballivian",55,0,16,0,103,0,32,0,4,210,0,5,215,227,0.49,0.947
"4943","La Paz","El Alto","Esc. Ballivian",50,1,5,2,105,5,35,3,2,208,1,7,216,229,0.505,0.943
"4944","La Paz","El Alto","Esc. Ballivian",57,0,3,0,105,5,28,0,2,200,1,15,216,237,0.525,0.911
"4945","La Paz","El Alto","Col. Basill Miller",69,1,7,1,98,3,28,0,2,209,1,4,214,231,0.469,0.926
"4946","La Paz","El Alto","Col. Basill Miller",70,1,2,1,92,2,27,0,1,196,1,9,206,224,0.469,0.92
"4947","La Paz","El Alto","Col. Basill Miller",63,1,3,0,97,2,35,1,1,203,0,5,208,222,0.478,0.937
"4948","La Paz","El Alto","Col. Basill Miller",62,0,2,0,116,2,35,0,0,217,0,6,223,229,0.535,0.974
"4949","La Paz","El Alto","Col. Basill Miller",73,2,10,0,98,3,25,0,1,212,1,5,218,227,0.462,0.96
"4950","La Paz","El Alto","Col. Basill Miller",93,1,2,0,86,2,33,2,0,219,0,6,225,236,0.393,0.953
"4951","La Paz","El Alto","Col. Basill Miller",67,1,12,1,85,1,32,0,3,202,3,6,211,225,0.421,0.938
"4952","La Paz","El Alto","Col. Basill Miller",77,0,7,1,83,2,28,1,3,202,0,11,213,230,0.411,0.926
"4953","La Paz","El Alto","Col. Basill Miller",53,0,5,0,107,0,37,1,2,205,1,5,211,234,0.522,0.902
"4954","La Paz","El Alto","Col. Basill Miller",75,1,7,0,86,0,37,1,5,212,2,4,218,234,0.406,0.932
"4955","La Paz","El Alto","Col. Basill Miller",73,3,2,1,86,2,23,1,3,194,1,8,203,221,0.443,0.919
"4956","La Paz","El Alto","Col. Basill Miller",76,3,6,0,78,0,48,0,0,211,1,4,216,228,0.37,0.947
"4957","La Paz","El Alto","Col. Basill Miller",72,0,3,1,103,2,25,0,1,207,0,2,209,228,0.498,0.917
"4958","La Paz","El Alto","Col. Basill Miller",72,0,3,0,88,4,38,1,3,209,0,6,215,229,0.421,0.939
"4959","La Paz","El Alto","Col. Basill Miller",66,0,2,0,63,1,27,0,1,160,1,2,163,172,0.394,0.948
"4960","La Paz","El Alto","Col. Tec. Humanistico Jose Ballivian",54,0,2,0,105,1,41,0,3,206,1,6,213,237,0.51,0.899
"4961","La Paz","El Alto","Col. Tec. Humanistico Jose Ballivian",40,3,8,0,107,4,36,0,5,203,2,12,217,235,0.527,0.923
"4962","La Paz","El Alto","Col. Tec. Humanistico Jose Ballivian",62,0,7,0,101,4,36,0,1,211,1,6,218,238,0.479,0.916
"4963","La Paz","El Alto","Col. Tec. Humanistico Jose Ballivian",45,0,5,0,113,1,38,1,2,205,2,6,213,232,0.551,0.918
"4964","La Paz","El Alto","Col. Tec. Humanistico Jose Ballivian",41,0,5,0,111,5,31,0,3,196,4,8,208,219,0.566,0.95
"4965","La Paz","El Alto","Col. Tec. Humanistico Jose Ballivian",54,0,2,1,110,5,35,1,2,210,0,8,218,231,0.524,0.944
"4966","La Paz","El Alto","Col. Tec. Humanistico Jose Ballivian",74,0,2,1,92,4,30,0,2,205,3,5,213,227,0.449,0.938
"4967","La Paz","El Alto","Col. Tec. Humanistico Jose Ballivian",65,0,4,1,106,0,26,0,2,204,2,7,213,226,0.52,0.942
"4968","La Paz","El Alto","Col. Tec. Humanistico Jose Ballivian",58,2,3,1,94,3,34,1,5,201,2,7,210,225,0.468,0.933
"4969","La Paz","El Alto","Col. Tec. Humanistico Jose Ballivian",45,1,3,1,100,2,32,0,1,185,1,8,194,220,0.541,0.882
"4970","La Paz","El Alto","Col. Tec. Humanistico Jose Ballivian",41,1,7,1,102,3,26,1,3,185,1,8,194,221,0.551,0.878
"4971","La Paz","El Alto","Col. Tec. Humanistico Jose Ballivian",61,1,2,0,97,3,30,0,8,202,2,7,211,226,0.48,0.934
"4972","La Paz","El Alto","Col. Tec. Humanistico Jose Ballivian",68,2,4,0,99,3,23,2,2,203,3,4,210,222,0.488,0.946
"4973","La Paz","El Alto","Col. Tec. Humanistico Jose Ballivian",62,2,2,0,106,0,19,0,2,193,5,8,206,219,0.549,0.941
"4974","La Paz","El Alto","Col. Tec. Humanistico Jose Ballivian",64,1,2,2,97,4,25,0,1,196,3,4,203,213,0.495,0.953
"4975","La Paz","El Alto","Col. Tec. Humanistico Jose Ballivian",49,2,3,0,101,1,32,2,6,196,4,11,211,229,0.515,0.921
"4976","La Paz","El Alto","Col. Tec. Humanistico Jose Ballivian",53,0,6,0,98,2,34,1,2,196,2,13,211,225,0.5,0.938
"4977","La Paz","El Alto","Col. Gran Bretaña",50,1,6,3,93,1,40,1,2,197,2,10,209,227,0.472,0.921
"4978","La Paz","El Alto","Col. Gran Bretaña",70,1,6,0,92,1,35,0,3,208,4,5,217,227,0.442,0.956
"4979","La Paz","El Alto","Col. Gran Bretaña",56,1,10,2,95,0,38,1,1,204,5,3,212,225,0.466,0.942
"4980","La Paz","El Alto","Col. Gran Bretaña",81,1,11,0,86,3,25,0,0,207,1,2,210,222,0.415,0.946
"4981","La Paz","El Alto","Col. Gran Bretaña",69,1,9,2,97,1,30,0,1,210,2,4,216,225,0.462,0.96
"4982","La Paz","El Alto","Col. Gran Bretaña",57,1,2,0,100,1,38,0,3,202,2,8,212,223,0.495,0.951
"4983","La Paz","El Alto","Col. Gran Bretaña",67,1,6,1,100,1,30,2,4,212,2,4,218,227,0.472,0.96
"4984","La Paz","El Alto","Col. Gran Bretaña",64,0,10,1,92,4,35,1,4,211,0,7,218,230,0.436,0.948
"4985","La Paz","El Alto","Col. Gran Bretaña",51,2,7,0,103,2,38,0,6,209,2,5,216,231,0.493,0.935
"4986","La Paz","El Alto","Col. Gran Bretaña",68,1,11,0,93,0,32,1,3,209,1,3,213,233,0.445,0.914
"4987","La Paz","El Alto","Col. Gran Bretaña",59,0,3,0,104,4,29,2,3,204,1,8,213,229,0.51,0.93
"4988","La Paz","El Alto","Col. Gran Bretaña",54,1,5,0,119,2,28,2,1,212,0,2,214,225,0.561,0.951
"4989","La Paz","El Alto","Col. Gran Bretaña",60,2,4,1,96,0,36,1,1,201,2,10,213,227,0.478,0.938
"4990","La Paz","El Alto","Col. Gran Bretaña",74,0,10,1,92,3,30,1,1,212,1,6,219,230,0.434,0.952
"4991","La Paz","El Alto","Col. Gran Bretaña",65,1,4,0,94,6,35,0,1,206,1,7,214,227,0.456,0.943
"4992","La Paz","El Alto","Col. Gran Bretaña",68,1,8,0,107,1,26,0,3,214,2,4,220,231,0.5,0.952
"4993","La Paz","El Alto","Col. Gran Bretaña",60,1,11,2,96,1,40,1,2,214,2,6,222,232,0.449,0.957
"4994","La Paz","El Alto","Col. Gran Bretaña",61,1,10,0,97,0,36,1,3,209,1,1,211,225,0.464,0.938
"4995","La Paz","El Alto","Col. Gran Bretaña",60,1,4,1,102,3,32,0,2,205,3,6,214,228,0.498,0.939
"4996","La Paz","El Alto","Col. Gran Bretaña",71,1,8,0,103,2,23,0,5,213,1,7,221,231,0.484,0.957
"4997","La Paz","El Alto","Col. Gran Bretaña",72,1,4,0,95,1,26,0,1,200,2,8,210,219,0.475,0.959
"4998","La Paz","El Alto","Col. Gran Bretaña",62,3,11,0,84,1,33,0,1,195,5,7,207,218,0.431,0.95
"4999","La Paz","El Alto","Col. Gran Bretaña",47,1,13,0,101,3,32,0,3,200,0,8,208,224,0.505,0.929
"5000","La Paz","El Alto","Col. Gran Bretaña",70,0,5,0,100,3,28,1,4,211,2,5,218,232,0.474,0.94
"5001","La Paz","El Alto","Col. Gran Bretaña",59,1,9,0,113,4,15,1,2,204,3,8,215,225,0.554,0.956
"5002","La Paz","El Alto","Col. Gran Bretaña",43,2,1,1,113,5,44,0,6,215,0,3,218,232,0.526,0.94
"5003","La Paz","El Alto","Col. Gran Bretaña",50,6,8,0,96,4,35,2,3,204,1,5,210,230,0.471,0.913
"5004","La Paz","El Alto","Col. Gran Bretaña",73,0,9,0,88,1,29,0,0,200,0,10,210,223,0.44,0.942
"5005","La Paz","El Alto","Esc. Los Andes",51,2,4,0,109,1,34,1,2,204,2,4,210,225,0.534,0.933
"5006","La Paz","El Alto","Esc. Los Andes",72,1,3,2,100,1,30,0,2,211,1,4,216,233,0.474,0.927
"5007","La Paz","El Alto","Esc. Los Andes",69,2,6,0,89,1,35,0,2,204,1,5,210,225,0.436,0.933
"5008","La Paz","El Alto","Esc. Los Andes",57,0,4,1,93,2,43,1,2,203,2,5,210,218,0.458,0.963
"5009","La Paz","El Alto","Esc. Los Andes",53,2,6,2,102,2,30,0,5,202,1,11,214,227,0.505,0.943
"5010","La Paz","El Alto","Esc. Los Andes",63,1,3,0,95,2,25,0,2,191,2,9,202,225,0.497,0.898
"5011","La Paz","El Alto","Esc. Los Andes",55,1,4,0,110,1,28,0,3,202,3,8,213,227,0.545,0.938
"5012","La Paz","El Alto","Esc. Los Andes",64,1,7,0,85,2,39,0,1,199,0,6,205,224,0.427,0.915
"5013","La Paz","El Alto","Esc. Los Andes",70,1,6,0,88,3,29,2,1,200,1,3,204,224,0.44,0.911
"5014","La Paz","El Alto","Esc. Los Andes",43,4,6,1,105,3,36,0,3,201,3,7,211,227,0.522,0.93
"5015","La Paz","El Alto","Esc. Los Andes",52,3,4,0,110,1,28,0,2,200,0,9,209,228,0.55,0.917
"5016","La Paz","El Alto","Esc. Los Andes",69,1,2,1,97,2,25,0,3,200,3,4,207,226,0.485,0.916
"5017","La Paz","El Alto","Esc. Los Andes",63,1,4,1,99,1,27,0,2,198,1,7,206,226,0.5,0.912
"5018","La Paz","El Alto","Esc. Los Andes",72,1,9,1,95,1,30,0,3,212,0,5,217,231,0.448,0.939
"5019","La Paz","El Alto","Esc. Los Andes",58,0,4,0,106,3,38,0,4,213,1,5,219,232,0.498,0.944
"5020","La Paz","El Alto","Esc. Los Andes",55,0,10,0,90,1,38,0,4,198,1,7,206,227,0.455,0.907
"5021","La Paz","El Alto","Esc. Los Andes",61,1,8,0,92,1,38,0,2,203,0,6,209,225,0.453,0.929
"5022","La Paz","El Alto","Col. Santa Maria De Los Angeles",68,0,7,0,96,2,22,0,4,199,3,6,208,224,0.482,0.929
"5023","La Paz","El Alto","Col. Santa Maria De Los Angeles",63,0,6,1,100,3,30,0,2,205,0,9,214,223,0.488,0.96
"5024","La Paz","El Alto","Col. Santa Maria De Los Angeles",77,0,6,0,100,3,19,0,3,208,0,4,212,225,0.481,0.942
"5025","La Paz","El Alto","Col. Santa Maria De Los Angeles",69,1,7,0,76,4,35,0,4,196,0,13,209,225,0.388,0.929
"5026","La Paz","El Alto","Col. Santa Maria De Los Angeles",65,0,4,0,91,4,36,1,3,204,0,6,210,223,0.446,0.942
"5027","La Paz","El Alto","Col. Santa Maria De Los Angeles",72,1,6,3,88,2,28,0,2,202,1,10,213,227,0.436,0.938
"5028","La Paz","El Alto","Col. Santa Maria De Los Angeles",63,2,4,1,108,3,21,0,1,203,1,4,208,224,0.532,0.929
"5029","La Paz","El Alto","Col. Santa Maria De Los Angeles",76,2,3,0,85,5,27,0,1,199,1,12,212,224,0.427,0.946
"5030","La Paz","El Alto","Col. Santa Maria De Los Angeles",68,0,1,0,98,1,30,1,1,200,1,5,206,225,0.49,0.916
"5031","La Paz","El Alto","Col. Santa Maria De Los Angeles",58,0,2,1,105,3,37,0,3,209,3,8,220,232,0.502,0.948
"5032","La Paz","El Alto","Col. Santa Maria De Los Angeles",76,0,6,0,86,5,28,1,3,205,3,5,213,227,0.42,0.938
"5033","La Paz","El Alto","Col. Santa Maria De Los Angeles",88,2,6,0,77,2,17,0,3,195,5,10,210,219,0.395,0.959
"5034","La Paz","El Alto","Col. Santa Maria De Los Angeles",81,0,2,2,80,2,29,1,1,198,1,5,204,222,0.404,0.919
"5035","La Paz","El Alto","Col. Santa Maria De Los Angeles",87,1,3,0,81,1,26,2,0,201,1,3,205,223,0.403,0.919
"5036","La Paz","El Alto","Col. Santa Maria De Los Angeles",53,0,5,2,110,3,25,1,3,202,2,5,209,225,0.545,0.929
"5037","La Paz","El Alto","Col. Santa Maria De Los Angeles",57,0,11,2,95,1,27,0,5,198,1,4,203,218,0.48,0.931
"5038","La Paz","El Alto","Col. Santa Maria De Los Angeles",80,0,2,1,109,2,21,0,4,219,1,1,221,228,0.498,0.969
"5039","La Paz","El Alto","Col. Santa Maria De Los Angeles",75,0,3,0,91,5,24,1,2,201,0,3,204,223,0.453,0.915
"5040","La Paz","El Alto","Col. Santa Maria De Los Angeles",46,1,4,0,114,2,25,0,2,194,0,9,203,215,0.588,0.944
"5041","La Paz","El Alto","Col. Santa Maria De Los Angeles",63,0,11,1,99,1,29,0,5,209,2,0,211,224,0.474,0.942
"5042","La Paz","El Alto","Col. Santa Maria De Los Angeles",59,0,3,1,123,0,17,0,0,203,5,5,213,229,0.606,0.93
"5043","La Paz","El Alto","Col. Santa Maria De Los Angeles",62,1,2,0,113,2,28,0,1,209,1,3,213,230,0.541,0.926
"5044","La Paz","El Alto","Col. Santa Maria De Los Angeles",79,0,5,1,87,3,24,1,3,203,1,6,210,225,0.429,0.933
"5045","La Paz","El Alto","Col. Santa Maria De Los Angeles",77,1,8,0,81,1,31,2,3,204,3,5,212,226,0.397,0.938
"5046","La Paz","El Alto","Col. Santa Maria De Los Angeles",72,0,6,0,90,4,23,0,3,198,0,6,204,225,0.455,0.907
"5047","La Paz","El Alto","Col. Santa Maria De Los Angeles",77,1,3,2,82,2,23,1,4,195,2,8,205,223,0.421,0.919
"5048","La Paz","El Alto","Col. Santa Maria De Los Angeles",73,1,8,0,87,0,30,1,9,209,2,5,216,230,0.416,0.939
"5049","La Paz","El Alto","Col. Santa Maria De Los Angeles",66,3,10,2,93,7,26,0,0,207,2,6,215,227,0.449,0.947
"5050","La Paz","El Alto","Col. Santa Maria De Los Angeles",81,1,2,1,79,4,31,1,4,204,3,11,218,233,0.387,0.936
"5051","La Paz","El Alto","Col. Santa Maria De Los Angeles",85,1,1,1,86,0,33,1,0,208,1,4,213,228,0.413,0.934
"5052","La Paz","El Alto","Col. Santa Maria De Los Angeles",67,0,2,0,92,4,35,0,0,200,1,7,208,221,0.46,0.941
"5053","La Paz","El Alto","Col. Santa Maria De Los Angeles",72,0,7,0,81,5,22,0,1,188,1,10,199,220,0.431,0.905
"5054","La Paz","El Alto","Col. Santa Maria De Los Angeles",75,1,6,1,85,1,29,1,3,202,1,9,212,229,0.421,0.926
"5055","La Paz","El Alto","Col. Santa Maria De Los Angeles",67,1,4,1,85,3,24,1,5,191,2,5,198,215,0.445,0.921
"5056","La Paz","El Alto","Esc. Juvenal Mariaca",94,0,3,1,79,1,30,0,1,209,0,5,214,229,0.378,0.934
"5057","La Paz","El Alto","Esc. Juvenal Mariaca",78,0,0,1,94,5,24,0,0,202,4,3,209,223,0.465,0.937
"5058","La Paz","El Alto","Esc. Juvenal Mariaca",88,0,3,1,84,1,22,2,0,201,0,8,209,227,0.418,0.921
"5059","La Paz","El Alto","Esc. Juvenal Mariaca",68,2,5,0,104,4,14,1,1,199,3,7,209,228,0.523,0.917
"5060","La Paz","El Alto","Esc. Juvenal Mariaca",73,4,4,0,84,2,25,1,3,196,2,11,209,228,0.429,0.917
"5061","La Paz","El Alto","Esc. Juvenal Mariaca",71,0,2,1,87,6,22,1,2,192,1,7,200,220,0.453,0.909
"5062","La Paz","El Alto","Esc. Juvenal Mariaca",81,4,2,1,74,2,35,0,5,204,0,6,210,226,0.363,0.929
"5063","La Paz","El Alto","Esc. Juvenal Mariaca",71,1,8,1,86,3,32,1,2,205,0,4,209,231,0.42,0.905
"5064","La Paz","El Alto","Esc. Juvenal Mariaca",74,1,5,0,80,4,32,0,3,199,0,7,206,220,0.402,0.936
"5065","La Paz","El Alto","Esc. Juvenal Mariaca",54,0,3,2,93,2,42,2,2,200,1,4,205,223,0.465,0.919
"5066","La Paz","El Alto","Esc. Juvenal Mariaca",76,1,5,0,96,1,22,0,0,201,2,4,207,226,0.478,0.916
"5067","La Paz","El Alto","Esc. Juvenal Mariaca",96,0,3,0,79,1,25,2,2,208,0,4,212,232,0.38,0.914
"5068","La Paz","El Alto","Esc. Juvenal Mariaca",95,0,1,2,70,7,27,2,1,205,1,0,206,223,0.341,0.924
"5069","La Paz","El Alto","Esc. Juvenal Mariaca",97,2,3,0,65,2,31,2,1,203,1,3,207,225,0.32,0.92
"5070","La Paz","El Alto","Esc. Juvenal Mariaca",87,1,1,0,79,4,29,0,2,203,3,7,213,224,0.389,0.951
"5071","La Paz","El Alto","Esc. Juvenal Mariaca",75,3,4,0,89,0,27,0,1,199,0,3,202,221,0.447,0.914
"5072","La Paz","El Alto","Esc. Juvenal Mariaca",90,1,6,2,73,2,24,1,3,202,0,3,205,227,0.361,0.903
"5073","La Paz","El Alto","Esc. Juvenal Mariaca",79,0,4,1,94,1,21,0,3,203,2,7,212,224,0.463,0.946
"5074","La Paz","El Alto","Esc. Juvenal Mariaca",58,3,4,2,96,1,18,0,1,183,1,8,192,214,0.525,0.897
"5075","La Paz","El Alto","Esc. Juvenal Mariaca",77,1,3,0,86,4,29,0,1,201,1,7,209,234,0.428,0.893
"5076","La Paz","El Alto","Esc. Juvenal Mariaca",57,1,5,0,113,4,29,0,0,209,0,8,217,231,0.541,0.939
"5077","La Paz","El Alto","Esc. Juvenal Mariaca",84,0,8,2,86,1,21,1,2,205,1,6,212,226,0.42,0.938
"5078","La Paz","El Alto","Esc. Juvenal Mariaca",75,3,2,2,90,1,33,0,2,208,0,3,211,222,0.433,0.95
"5079","La Paz","El Alto","Esc. Juvenal Mariaca",79,0,4,0,88,2,25,1,3,202,2,10,214,233,0.436,0.918
"5080","La Paz","El Alto","Esc. Juvenal Mariaca",59,1,5,1,103,3,18,2,2,194,1,5,200,227,0.531,0.881
"5081","La Paz","El Alto","Esc. Juvenal Mariaca",82,1,3,1,92,2,24,0,0,205,1,7,213,226,0.449,0.942
"5082","La Paz","El Alto","Esc. Juvenal Mariaca",93,1,4,1,76,2,24,0,3,204,2,6,212,222,0.373,0.955
"5083","La Paz","El Alto","Esc. Juvenal Mariaca",79,1,3,1,87,4,21,0,2,198,2,7,207,221,0.439,0.937
"5084","La Paz","El Alto","Esc. Juvenal Mariaca",78,1,1,0,79,0,40,1,2,202,1,7,210,230,0.391,0.913
"5085","La Paz","El Alto","Esc. Juvenal Mariaca",80,0,4,2,94,0,17,0,1,198,2,7,207,228,0.475,0.908
"5086","La Paz","El Alto","Esc. Juvenal Mariaca",88,1,2,1,94,1,14,0,3,204,1,7,212,228,0.461,0.93
"5087","La Paz","El Alto","Esc. Juvenal Mariaca",97,2,4,0,74,0,13,0,1,191,0,6,197,222,0.387,0.887
"5088","La Paz","El Alto","Esc. Juvenal Mariaca",73,0,4,0,85,1,21,0,3,187,2,3,192,219,0.455,0.877
"5089","La Paz","El Alto","Esc. Juvenal Mariaca",73,1,4,0,95,3,24,1,1,202,1,8,211,228,0.47,0.925
"5090","La Paz","El Alto","Esc. Juvenal Mariaca",105,1,4,1,68,3,15,2,0,199,3,10,212,228,0.342,0.93
"5091","La Paz","El Alto","Esc. Juvenal Mariaca",82,1,3,0,84,2,27,2,0,201,1,4,206,221,0.418,0.932
"5092","La Paz","El Alto","U.E. Particular Interandino Boliviano",83,0,3,1,68,1,38,0,2,196,0,4,200,231,0.347,0.866
"5093","La Paz","El Alto","Unidad Educativa Integracion",98,0,1,1,79,1,25,0,6,211,3,1,215,228,0.374,0.943
"5094","La Paz","El Alto","Unidad Educativa Integracion",91,1,3,1,87,5,20,0,1,209,1,3,213,225,0.416,0.947
"5095","La Paz","El Alto","Unidad Educativa Integracion",106,2,3,0,68,0,18,0,2,199,2,4,205,227,0.342,0.903
"5096","La Paz","El Alto","Unidad Educativa Integracion",87,0,6,0,77,1,25,1,2,199,1,6,206,226,0.387,0.912
"5097","La Paz","El Alto","Unidad Educativa Integracion",90,0,2,0,83,2,20,0,4,201,2,3,206,223,0.413,0.924
"5098","La Paz","El Alto","Unidad Educativa Integracion",82,0,3,1,76,6,19,2,2,191,1,7,199,220,0.398,0.905
"5099","La Paz","El Alto","Unidad Educativa Integracion",75,0,1,0,81,4,30,2,0,193,1,8,202,223,0.42,0.906
"5100","La Paz","El Alto","Unidad Educativa Integracion",97,0,2,0,61,2,27,0,2,191,1,5,197,222,0.319,0.887
"5101","La Paz","El Alto","Unidad Educativa Integracion",95,0,3,0,70,3,29,0,5,205,2,1,208,226,0.341,0.92
"5102","La Paz","El Alto","Unidad Educativa Integracion",69,3,5,0,84,5,26,0,3,195,2,10,207,221,0.431,0.937
"5103","La Paz","El Alto","Unidad Educativa Integracion",79,0,4,0,92,6,20,0,2,203,0,5,208,227,0.453,0.916
"5104","La Paz","El Alto","Unidad Educativa Integracion",90,1,6,2,82,7,20,0,1,209,1,5,215,225,0.392,0.956
"5105","La Paz","El Alto","Unidad Educativa 12 de Octubre",110,0,1,0,70,3,11,0,4,199,0,4,203,226,0.352,0.898
"5106","La Paz","El Alto","Unidad Educativa 12 de Octubre",76,0,3,0,97,1,20,1,2,200,0,4,204,226,0.485,0.903
"5107","La Paz","El Alto","Unidad Educativa 12 de Octubre",96,0,3,0,76,2,25,0,1,203,0,7,210,227,0.374,0.925
"5108","La Paz","El Alto","Unidad Educativa 12 de Octubre",82,0,9,0,82,3,19,0,2,197,2,5,204,224,0.416,0.911
"5109","La Paz","El Alto","Unidad Educativa 12 de Octubre",80,1,5,0,76,1,37,0,4,204,1,6,211,226,0.373,0.934
"5110","La Paz","El Alto","Unidad Educativa 12 de Octubre",76,1,4,0,70,1,42,2,2,198,1,12,211,230,0.354,0.917
"5111","La Paz","El Alto","Unidad Educativa 12 de Octubre",81,2,8,0,87,0,22,1,2,203,1,8,212,227,0.429,0.934
"5112","La Paz","El Alto","Unidad Educativa 12 de Octubre",105,0,3,1,66,2,25,1,3,206,1,6,213,231,0.32,0.922
"5113","La Paz","El Alto","Unidad Educativa 12 de Octubre",99,1,4,0,77,5,14,1,1,202,1,7,210,226,0.381,0.929
"5114","La Paz","El Alto","Unidad Educativa 12 de Octubre",81,0,4,0,92,5,24,2,1,209,3,1,213,230,0.44,0.926
"5115","La Paz","El Alto","Unidad Educativa 12 de Octubre",71,1,5,0,103,1,25,1,4,211,0,8,219,236,0.488,0.928
"5116","La Paz","El Alto","Unidad Educativa 12 de Octubre",88,0,4,0,69,6,24,0,4,195,1,15,211,228,0.354,0.925
"5117","La Paz","El Alto","Unidad Educativa 12 de Octubre",58,1,8,1,96,1,38,0,3,206,1,5,212,229,0.466,0.926
"5118","La Paz","El Alto","Unidad Educativa 12 de Octubre",76,0,4,0,87,1,33,1,1,203,2,5,210,230,0.429,0.913
"5119","La Paz","El Alto","Unidad Educativa 12 de Octubre",94,0,1,0,78,1,22,1,2,199,1,3,203,221,0.392,0.919
"5120","La Paz","El Alto","Unidad Educativa 12 de Octubre",101,0,2,0,70,4,20,1,4,202,0,8,210,222,0.347,0.946
"5121","La Paz","El Alto","Unidad Educativa 12 de Octubre",76,1,5,0,81,4,24,2,1,194,0,4,198,223,0.418,0.888
"5122","La Paz","El Alto","Unidad Educativa 12 de Octubre",90,2,3,3,74,3,20,0,1,196,0,4,200,228,0.378,0.877
"5123","La Paz","El Alto","Unidad Educativa 12 de Octubre",95,0,1,0,68,3,22,1,2,192,1,10,203,223,0.354,0.91
"5124","La Paz","El Alto","Unidad Educativa 12 de Octubre",79,0,7,1,69,6,33,5,3,203,0,1,204,224,0.34,0.911
"5125","La Paz","El Alto","Unidad Educativa 12 de Octubre",75,1,3,1,86,2,21,0,4,193,2,4,199,219,0.446,0.909
"5126","La Paz","El Alto","Unidad Educativa 12 de Octubre",98,0,3,2,61,4,24,1,3,196,1,6,203,222,0.311,0.914
"5127","La Paz","El Alto","Unidad Educativa 12 de Octubre",63,1,0,0,62,1,20,3,1,151,1,3,155,169,0.411,0.917
"5128","La Paz","El Alto","Unidad Educativa Santiago I",83,2,4,1,92,2,22,0,2,208,0,6,214,229,0.442,0.934
"5129","La Paz","El Alto","Unidad Educativa Santiago I",67,0,6,0,83,1,39,1,0,197,2,12,211,223,0.421,0.946
"5130","La Paz","El Alto","Unidad Educativa Santiago I",68,1,3,1,96,0,21,0,1,191,2,5,198,229,0.503,0.865
"5131","La Paz","El Alto","Unidad Educativa Santiago I",73,0,4,0,100,3,26,0,0,206,2,7,215,232,0.485,0.927
"5132","La Paz","El Alto","Unidad Educativa Santiago I",53,0,6,4,98,1,20,0,2,184,2,5,191,223,0.533,0.857
"5133","La Paz","El Alto","Unidad Educativa Santiago I",63,1,6,2,91,2,29,0,4,198,5,3,206,224,0.46,0.92
"5134","La Paz","El Alto","Unidad Educativa Santiago I",69,0,4,1,98,2,26,0,3,203,3,4,210,225,0.483,0.933
"5135","La Paz","El Alto","Unidad Educativa Santiago I",77,0,3,1,93,1,26,0,1,202,2,3,207,227,0.46,0.912
"5136","La Paz","El Alto","Unidad Educativa Santiago I",85,0,4,1,68,2,30,0,2,192,2,6,200,230,0.354,0.87
"5137","La Paz","El Alto","Unidad Educativa Santiago I",76,0,6,1,98,2,27,0,2,212,1,10,223,231,0.462,0.965
"5138","La Paz","El Alto","Unidad Educativa Santiago I",82,1,2,0,85,4,20,0,2,196,0,4,200,225,0.434,0.889
"5139","La Paz","El Alto","Unidad Educativa Santiago I",54,1,6,1,115,2,17,0,2,198,5,8,211,225,0.581,0.938
"5140","La Paz","El Alto","Unidad Educativa Santiago I",58,1,8,1,93,0,26,0,4,191,2,11,204,224,0.487,0.911
"5141","La Paz","El Alto","Unidad Educativa Santiago I",63,0,5,0,90,1,20,0,1,180,2,11,193,220,0.5,0.877
"5142","La Paz","El Alto","Unidad Educativa Santiago I",85,1,4,0,79,2,33,1,0,205,0,1,206,230,0.385,0.896
"5143","La Paz","El Alto","Unidad Educativa Santiago I",77,0,5,1,80,2,31,1,1,198,2,12,212,228,0.404,0.93
"5144","La Paz","El Alto","Unidad Educativa Santiago I",60,1,4,0,104,0,17,0,3,189,1,11,201,223,0.55,0.901
"5145","La Paz","El Alto","Unidad Educativa Santiago I",85,1,5,0,79,1,16,0,4,191,2,5,198,228,0.414,0.868
"5146","La Paz","El Alto","Unidad Educativa Santiago I",70,0,6,2,98,0,21,1,2,200,1,8,209,230,0.49,0.909
"5147","La Paz","El Alto","Unidad Educativa Santiago I",85,2,3,1,74,5,24,2,3,199,1,11,211,228,0.372,0.925
"5148","La Paz","El Alto","Unidad Educativa Santiago I",66,0,4,2,66,0,16,1,1,156,1,2,159,170,0.423,0.935
"5149","La Paz","El Alto","Unidad Educativa Andres Bello (U. E. 16 de Julio)",102,3,5,0,53,3,19,1,4,190,0,4,194,218,0.279,0.89
"5150","La Paz","El Alto","Unidad Educativa Andres Bello (U. E. 16 de Julio)",93,1,4,0,75,3,26,0,3,205,0,1,206,220,0.366,0.936
"5151","La Paz","El Alto","Unidad Educativa Andres Bello",102,1,4,1,73,1,22,1,2,207,2,0,209,230,0.353,0.909
"5152","La Paz","El Alto","Unidad Educativa Andres Bello",97,1,1,1,67,4,29,0,0,200,0,4,204,221,0.335,0.923
"5153","La Paz","El Alto","Unidad Educativa Andres Bello",82,0,10,0,79,3,24,1,3,202,1,6,209,229,0.391,0.913
"5154","La Paz","El Alto","Unidad Educativa Andres Bello",90,1,3,1,81,3,30,0,4,213,0,2,215,231,0.38,0.931
"5155","La Paz","El Alto","Unidad Educativa Andres Bello",89,1,2,1,68,4,25,0,2,192,1,3,196,211,0.354,0.929
"5156","La Paz","El Alto","Unidad Educativa Eva Peron",75,1,4,0,100,1,17,0,0,198,1,5,204,225,0.505,0.907
"5157","La Paz","El Alto","Unidad Educativa Eva Peron",82,2,6,0,86,2,25,0,3,206,0,2,208,232,0.417,0.897
"5158","La Paz","El Alto","Unidad Educativa Eva Peron",93,3,7,1,82,5,18,2,1,212,1,6,219,233,0.387,0.94
"5159","La Paz","El Alto","Unidad Educativa Eva Peron",67,0,6,0,92,3,25,1,3,197,3,7,207,225,0.467,0.92
"5160","La Paz","El Alto","Unidad Educativa Eva Peron",72,0,4,2,87,5,28,2,4,204,1,6,211,225,0.426,0.938
"5161","La Paz","El Alto","Unidad Educativa Eva Peron",67,0,2,1,95,1,29,0,3,198,0,6,204,221,0.48,0.923
"5162","La Paz","El Alto","Unidad Educativa Eva Peron",67,1,3,0,100,4,29,0,1,205,1,7,213,227,0.488,0.938
"5163","La Paz","El Alto","Unidad Educativa Eva Peron",96,3,5,1,64,2,18,0,6,195,2,7,204,221,0.328,0.923
"5164","La Paz","El Alto","Unidad Educativa Eva Peron",106,1,3,2,83,3,16,1,1,216,0,2,218,230,0.384,0.948
"5165","La Paz","El Alto","Unidad Educativa Eva Peron",81,3,4,0,76,3,17,1,2,187,1,7,195,223,0.406,0.874
"5166","La Paz","El Alto","Unidad Educativa Eva Peron",73,0,3,2,91,1,33,0,2,205,2,10,217,230,0.444,0.943
"5167","La Paz","El Alto","Unidad Educativa Eva Peron",68,2,4,0,87,2,27,1,1,192,3,7,202,224,0.453,0.902
"5168","La Paz","El Alto","Unidad Educativa Eva Peron",56,1,8,2,92,3,27,0,2,191,4,15,210,231,0.482,0.909
"5169","La Paz","El Alto","Unidad Educativa Eva Peron",79,0,2,1,78,4,21,1,3,189,3,15,207,220,0.413,0.941
"5170","La Paz","El Alto","Unidad Educativa Eva Peron",83,1,3,0,88,6,19,0,0,200,1,9,210,223,0.44,0.942
"5171","La Paz","El Alto","Unidad Educativa Eva Peron",75,1,6,0,88,4,24,1,3,202,2,6,210,224,0.436,0.938
"5172","La Paz","El Alto","Unidad Educativa Eva Peron",82,1,2,1,92,1,18,1,1,199,1,6,206,225,0.462,0.916
"5173","La Paz","El Alto","Unidad Educativa Eva Peron",65,4,8,2,91,2,27,1,3,203,0,5,208,228,0.448,0.912
"5174","La Paz","El Alto","Unidad Educativa Eva Peron",93,1,2,0,85,1,17,1,0,200,0,3,203,224,0.425,0.906
"5175","La Paz","El Alto","Unidad Educativa Eva Peron",88,0,3,0,84,4,20,0,0,199,2,5,206,224,0.422,0.92
"5176","La Paz","El Alto","Unidad Educativa Eva Peron",88,1,4,0,93,0,18,2,1,207,1,6,214,229,0.449,0.934
"5177","La Paz","El Alto","Unidad Educativa Eva Peron",80,1,4,0,88,4,28,0,1,206,0,10,216,229,0.427,0.943
"5178","La Paz","El Alto","Unidad Educativa Brasilia",92,0,1,1,75,3,18,0,1,191,2,6,199,218,0.393,0.913
"5179","La Paz","El Alto","Unidad Educativa Brasilia",69,2,4,1,94,4,27,0,1,202,0,7,209,222,0.465,0.941
"5180","La Paz","El Alto","Unidad Educativa Brasilia",104,3,3,0,65,3,20,0,1,199,0,5,204,222,0.327,0.919
"5181","La Paz","El Alto","Unidad Educativa Brasilia",69,0,5,0,101,1,30,1,1,208,1,3,212,229,0.486,0.926
"5182","La Paz","El Alto","Unidad Educativa Brasilia",62,1,9,1,91,2,35,0,2,203,3,3,209,227,0.448,0.921
"5183","La Paz","El Alto","Unidad Educativa Brasilia",62,0,1,2,93,2,34,1,2,197,2,3,202,220,0.472,0.918
"5184","La Paz","El Alto","Unidad Educativa Brasilia",69,1,1,1,93,3,31,2,2,203,0,2,205,230,0.458,0.891
"5185","La Paz","El Alto","Unidad Educativa Brasilia",82,3,5,1,77,4,23,2,1,198,2,7,207,225,0.389,0.92
"5186","La Paz","El Alto","Unidad Educativa Brasilia",79,0,6,1,79,0,29,1,1,196,1,5,202,223,0.403,0.906
"5187","La Paz","El Alto","Unidad Educativa Brasilia",78,1,3,0,83,5,21,0,2,193,2,8,203,221,0.43,0.919
"5188","La Paz","El Alto","Unidad Educativa Brasilia",71,0,3,0,99,3,21,3,1,201,0,11,212,226,0.493,0.938
"5189","La Paz","El Alto","Unidad Educativa Brasilia",46,0,3,1,106,1,32,0,0,189,1,14,204,218,0.561,0.936
"5190","La Paz","El Alto","Unidad Educativa Brasilia",82,0,2,2,80,3,29,1,3,202,1,8,211,226,0.396,0.934
"5191","La Paz","El Alto","Unidad Educativa Brasilia",100,2,4,0,82,2,21,1,0,212,0,4,216,226,0.387,0.956
"5192","La Paz","El Alto","Unidad Educativa Brasilia",77,2,3,0,96,1,15,0,1,195,3,4,202,219,0.492,0.922
"5193","La Paz","El Alto","Unidad Educativa Brasilia",69,1,6,2,84,4,20,0,3,189,0,9,198,216,0.444,0.917
"5194","La Paz","El Alto","Unidad Educativa Brasilia",64,1,6,0,95,2,27,0,2,197,1,6,204,220,0.482,0.927
"5195","La Paz","El Alto","Unidad Educativa Brasilia",95,0,3,0,76,1,18,2,0,195,1,5,201,219,0.39,0.918
"5196","La Paz","El Alto","Unidad Educativa Brasilia",82,2,8,1,79,3,13,0,2,190,1,7,198,213,0.416,0.93
"5197","La Paz","El Alto","Unidad Educativa Brasilia",71,1,5,0,87,3,23,0,1,191,1,5,197,218,0.455,0.904
"5198","La Paz","El Alto","Unidad Educativa Brasilia",75,2,4,0,79,2,26,1,0,189,1,3,193,205,0.418,0.941
"5199","La Paz","El Alto","Unidad Educativa Juan Capriles",68,1,4,2,91,3,26,4,0,199,0,8,207,227,0.457,0.912
"5200","La Paz","El Alto","Unidad Educativa Juan Capriles",71,1,4,1,90,1,28,2,3,201,0,11,212,226,0.448,0.938
"5201","La Paz","El Alto","Unidad Educativa Juan Capriles",60,1,5,1,98,3,28,1,4,201,3,4,208,225,0.488,0.924
"5202","La Paz","El Alto","Unidad Educativa Juan Capriles",61,1,5,2,106,3,21,1,3,203,1,4,208,226,0.522,0.92
"5203","La Paz","El Alto","Unidad Educativa Juan Capriles",61,1,3,0,114,2,21,0,3,205,4,3,212,227,0.556,0.934
"5204","La Paz","El Alto","Unidad Educativa Juan Capriles",75,1,6,0,83,2,22,0,2,191,2,8,201,224,0.435,0.897
"5205","La Paz","El Alto","Unidad Educativa Juan Capriles",69,1,4,1,91,2,26,0,4,198,3,3,204,218,0.46,0.936
"5206","La Paz","El Alto","Unidad Educativa Juan Capriles",55,2,5,2,101,3,26,1,7,202,2,9,213,223,0.5,0.955
"5207","La Paz","El Alto","Unidad Educativa Juan Capriles",63,1,8,2,95,1,21,1,1,193,4,2,199,221,0.492,0.9
"5208","La Paz","El Alto","Unidad Educativa Juan Capriles",43,3,8,0,99,2,31,2,2,190,2,7,199,222,0.521,0.896
"5209","La Paz","El Alto","Unidad Educativa Juan Capriles",74,0,5,0,93,2,26,1,3,204,1,6,211,228,0.456,0.925
"5210","La Paz","El Alto","Unidad Educativa Juan Capriles",66,0,4,1,100,0,22,2,0,195,2,8,205,227,0.513,0.903
"5211","La Paz","El Alto","Unidad Educativa Juan Capriles",56,1,6,1,104,0,31,0,2,201,2,9,212,230,0.517,0.922
"5212","La Paz","El Alto","Unidad Educativa Juan Capriles",64,2,10,1,92,2,23,1,0,195,1,10,206,229,0.472,0.9
"5213","La Paz","El Alto","Unidad Educativa Juan Capriles",57,2,8,0,108,5,18,2,0,200,2,9,211,228,0.54,0.925
"5214","La Paz","El Alto","Unidad Educativa Juan Capriles",77,0,3,0,90,5,27,0,2,204,0,11,215,228,0.441,0.943
"5215","La Paz","El Alto","Unidad Educativa Juan Capriles",56,3,4,1,108,3,25,0,1,201,2,4,207,228,0.537,0.908
"5216","La Paz","El Alto","Col. Vicente Tejada",72,2,7,1,92,1,22,1,1,199,2,6,207,226,0.462,0.916
"5217","La Paz","El Alto","Col. Vicente Tejada",81,0,1,1,82,5,23,1,3,197,2,6,205,222,0.416,0.923
"5218","La Paz","El Alto","Col. Vicente Tejada",79,0,4,0,91,1,21,0,2,198,0,7,205,221,0.46,0.928
"5219","La Paz","El Alto","Col. Vicente Tejada",66,2,8,0,110,0,23,0,2,211,0,3,214,222,0.521,0.964
"5220","La Paz","El Alto","Col. Vicente Tejada",66,1,3,1,101,2,20,1,3,198,2,6,206,227,0.51,0.907
"5221","La Paz","El Alto","Col. Vicente Tejada",72,0,4,1,89,8,22,0,1,197,1,7,205,224,0.452,0.915
"5222","La Paz","El Alto","Col. Vicente Tejada",85,0,5,3,83,0,34,1,0,211,1,7,219,231,0.393,0.948
"5223","La Paz","El Alto","Col. Vicente Tejada",72,1,3,2,89,3,30,1,0,201,2,2,205,222,0.443,0.923
"5224","La Paz","El Alto","Col. Vicente Tejada",82,1,5,3,73,3,26,0,2,195,0,10,205,224,0.374,0.915
"5225","La Paz","El Alto","Col. Vicente Tejada",84,1,2,1,80,1,22,0,1,192,0,5,197,221,0.417,0.891
"5226","La Paz","El Alto","Col. Vicente Tejada",90,1,2,1,88,6,17,2,1,208,0,1,209,227,0.423,0.921
"5227","La Paz","El Alto","Col. Vicente Tejada",73,1,2,1,107,2,21,1,1,209,2,8,219,230,0.512,0.952
"5228","La Paz","El Alto","Col. Vicente Tejada",75,1,4,0,112,3,12,0,0,207,1,4,212,226,0.541,0.938
"5229","La Paz","El Alto","Col. Vicente Tejada",84,1,3,0,87,2,16,0,0,193,2,13,208,227,0.451,0.916
"5230","La Paz","El Alto","Col. Vicente Tejada",56,1,5,2,106,1,30,0,2,203,0,11,214,219,0.522,0.977
"5231","La Paz","El Alto","Col. Vicente Tejada",47,1,9,0,104,2,25,0,4,192,1,8,201,220,0.542,0.914
"5232","La Paz","El Alto","Col. Vicente Tejada",80,1,5,0,78,2,33,0,0,199,1,12,212,230,0.392,0.922
"5233","La Paz","El Alto","Col. Vicente Tejada",75,2,3,0,84,3,29,0,0,196,1,13,210,229,0.429,0.917
"5234","La Paz","El Alto","Col. Vicente Tejada",94,2,3,0,68,5,24,2,0,198,1,7,206,224,0.343,0.92
"5235","La Paz","El Alto","Col. Vicente Tejada",87,1,3,1,78,1,18,1,0,190,1,4,195,213,0.411,0.915
"5236","La Paz","El Alto","Col. Vicente Tejada",75,3,5,2,85,2,20,0,1,193,1,9,203,224,0.44,0.906
"5237","La Paz","El Alto","Col. Vicente Tejada",59,0,4,0,101,5,23,0,4,196,2,3,201,226,0.515,0.889
"5238","La Paz","El Alto","Col. Vicente Tejada",70,0,3,0,105,2,20,0,2,202,0,4,206,224,0.52,0.92
"5239","La Paz","El Alto","Col. Vicente Tejada",76,3,2,0,95,5,19,0,4,204,0,5,209,219,0.466,0.954
"5240","La Paz","El Alto","Col. Vicente Tejada",97,1,2,0,84,4,18,0,0,206,2,2,210,229,0.408,0.917
"5241","La Paz","El Alto","Col. Vicente Tejada",68,0,6,1,95,3,23,1,3,200,1,5,206,223,0.475,0.924
"5242","La Paz","El Alto","Col. Vicente Tejada",83,3,6,0,86,4,18,0,1,201,2,11,214,227,0.428,0.943
"5243","La Paz","El Alto","Col. Vicente Tejada",90,0,3,2,99,0,15,0,1,210,1,3,214,235,0.471,0.911
"5244","La Paz","El Alto","Escuela Tejada Triangular",82,0,5,1,91,2,19,1,0,201,3,5,209,226,0.453,0.925
"5245","La Paz","El Alto","Escuela Tejada Triangular",74,3,2,1,96,2,29,0,0,207,0,3,210,229,0.464,0.917
"5246","La Paz","El Alto","Escuela Tejada Triangular",79,1,3,0,101,2,21,1,2,210,2,6,218,232,0.481,0.94
"5247","La Paz","El Alto","Escuela Tejada Triangular",60,2,6,1,90,2,31,1,3,196,1,3,200,223,0.459,0.897
"5248","La Paz","El Alto","Escuela Tejada Triangular",69,2,3,0,87,1,29,0,4,195,0,8,203,226,0.446,0.898
"5249","La Paz","El Alto","Escuela Tejada Triangular",75,2,3,1,96,0,23,2,1,203,1,2,206,224,0.473,0.92
"5250","La Paz","El Alto","Escuela Tejada Triangular",74,2,4,0,89,2,27,0,3,201,1,7,209,225,0.443,0.929
"5251","La Paz","El Alto","Escuela Tejada Triangular",60,0,5,0,111,1,24,1,3,205,1,3,209,222,0.541,0.941
"5252","La Paz","El Alto","Escuela Tejada Triangular",92,0,11,0,71,1,22,0,3,200,3,3,206,228,0.355,0.904
"5253","La Paz","El Alto","Escuela Tejada Triangular",85,0,9,0,67,0,29,2,2,194,0,8,202,220,0.345,0.918
"5254","La Paz","El Alto","Escuela Tejada Triangular",61,2,9,1,84,3,43,1,1,205,2,3,210,225,0.41,0.933
"5255","La Paz","El Alto","Escuela Tejada Triangular",80,0,4,1,79,1,27,1,1,194,3,10,207,224,0.407,0.924
"5256","La Paz","El Alto","Escuela Tejada Triangular",97,2,6,0,71,1,25,1,1,204,0,5,209,222,0.348,0.941
"5257","La Paz","El Alto","Escuela Tejada Triangular",88,2,2,0,101,5,20,1,1,220,0,5,225,246,0.459,0.915
"5258","La Paz","El Alto","Col. Puerto Mejillones",120,0,3,0,45,0,19,0,1,188,2,8,198,224,0.239,0.884
"5259","La Paz","El Alto","Col. Puerto Mejillones",128,1,0,0,64,0,12,0,1,206,0,10,216,229,0.311,0.943
"5260","La Paz","El Alto","Col. Puerto Mejillones",135,0,2,1,53,3,14,0,1,209,1,3,213,228,0.254,0.934
"5261","La Paz","El Alto","Col. Puerto Mejillones",130,1,2,1,49,0,12,2,0,197,1,2,200,220,0.249,0.909
"5262","La Paz","El Alto","Col. Puerto Mejillones",132,1,1,0,45,6,19,0,1,205,1,1,207,224,0.22,0.924
"5263","La Paz","El Alto","Col. Puerto Mejillones",99,1,3,0,76,2,14,0,2,197,1,7,205,219,0.386,0.936
"5264","La Paz","El Alto","Col. Puerto Mejillones",120,1,1,0,65,3,13,0,0,203,1,4,208,229,0.32,0.908
"5265","La Paz","El Alto","Col. Puerto Mejillones",116,0,3,1,54,4,16,1,1,196,1,8,205,219,0.276,0.936
"5266","La Paz","El Alto","Col. Puerto Mejillones",102,0,1,1,65,4,23,0,0,196,1,3,200,225,0.332,0.889
"5267","La Paz","El Alto","Col. Puerto Mejillones",95,0,6,0,83,0,19,0,1,204,0,2,206,227,0.407,0.907
"5268","La Paz","El Alto","Col. Puerto Mejillones",95,0,3,0,83,1,19,0,3,204,0,6,210,225,0.407,0.933
"5269","La Paz","El Alto","Col. Puerto Mejillones",121,0,2,1,45,3,21,1,1,195,0,4,199,220,0.231,0.905
"5270","La Paz","El Alto","Col. Puerto Mejillones",124,1,2,1,53,2,21,0,1,205,0,2,207,227,0.259,0.912
"5271","La Paz","El Alto","Col. Puerto Mejillones",117,0,0,0,65,3,13,1,1,200,0,5,205,223,0.325,0.919
"5272","La Paz","El Alto","Col. Puerto Mejillones",125,1,2,2,64,1,6,3,1,205,0,5,210,230,0.312,0.913
"5273","La Paz","El Alto","Col. Puerto Mejillones",129,0,0,1,57,2,15,0,1,205,0,7,212,227,0.278,0.934
"5274","La Paz","El Alto","Col. Puerto Mejillones",132,0,3,1,42,1,14,0,4,197,2,2,201,223,0.213,0.901
"5275","La Paz","El Alto","Col. Puerto Mejillones",107,2,3,0,73,2,18,0,0,205,2,4,211,229,0.356,0.921
"5276","La Paz","El Alto","Col. Puerto Mejillones",132,1,0,1,50,2,17,1,1,205,1,3,209,224,0.244,0.933
"5277","La Paz","El Alto","Col. Puerto Mejillones",119,0,1,0,73,2,14,1,0,210,0,4,214,227,0.348,0.943
"5278","La Paz","El Alto","Col. Puerto Mejillones",128,2,2,2,60,0,16,1,1,212,0,3,215,231,0.283,0.931
"5279","La Paz","El Alto","Col. Puerto Mejillones",88,0,4,1,73,2,27,2,2,199,1,4,204,227,0.367,0.899
"5280","La Paz","El Alto","Col. Puerto Mejillones",103,0,1,0,72,3,18,0,1,198,4,6,208,229,0.364,0.908
"5281","La Paz","El Alto","Col. Puerto Mejillones",118,1,2,0,67,3,14,1,0,206,0,4,210,228,0.325,0.921
"5282","La Paz","El Alto","Col. Puerto Mejillones",137,0,1,0,47,2,17,1,0,205,1,4,210,228,0.229,0.921
"5283","La Paz","El Alto","Col. Puerto Mejillones",129,2,1,1,64,2,9,1,2,211,2,2,215,229,0.303,0.939
"5284","La Paz","El Alto","Col. Puerto Mejillones",127,2,1,0,52,7,9,1,0,199,0,2,201,219,0.261,0.918
"5285","La Paz","El Alto","Col. Puerto Mejillones",127,0,4,1,55,3,9,1,0,200,0,5,205,228,0.275,0.899
"5286","La Paz","El Alto","Col. Puerto Mejillones",126,2,2,0,50,1,16,0,3,200,0,6,206,222,0.25,0.928
"5287","La Paz","El Alto","Col. Puerto Mejillones",111,0,2,2,63,0,21,0,1,200,0,6,206,226,0.315,0.912
"5288","La Paz","El Alto","Col. Puerto Mejillones",102,1,3,0,74,6,14,2,0,202,1,3,206,228,0.366,0.904
"5289","La Paz","El Alto","Col. Puerto Mejillones",141,0,2,0,42,0,12,1,1,199,0,5,204,228,0.211,0.895
"5290","La Paz","El Alto","Col. Puerto Mejillones",130,0,4,0,44,3,19,0,0,200,1,4,205,226,0.22,0.907
"5291","La Paz","El Alto","Col. Puerto Mejillones",134,0,0,0,48,3,10,1,0,196,0,4,200,225,0.245,0.889
"5292","La Paz","El Alto","Col. Puerto Mejillones",131,1,2,2,57,0,12,0,0,205,0,2,207,223,0.278,0.928
"5293","La Paz","El Alto","Col. Puerto Mejillones",122,2,0,0,60,1,20,0,3,208,0,5,213,229,0.288,0.93
"5294","La Paz","El Alto","Col. Puerto Mejillones",108,1,3,0,64,4,14,1,4,199,2,2,203,224,0.322,0.906
"5295","La Paz","El Alto","Col. Puerto Mejillones",126,1,0,1,51,2,16,1,2,200,0,2,202,230,0.255,0.878
"5296","La Paz","El Alto","Col. Puerto Mejillones",116,1,2,0,65,1,12,1,1,199,2,3,204,226,0.327,0.903
"5297","La Paz","El Alto","Col. Puerto Mejillones",125,2,2,1,57,4,14,0,1,206,0,6,212,230,0.277,0.922
"5298","La Paz","El Alto","Col. Puerto Mejillones",91,0,1,2,46,2,14,1,2,159,0,3,162,173,0.289,0.936
"5299","La Paz","El Alto","Unidad Educativa Donozo Torres",118,0,3,2,58,1,11,0,1,194,1,5,200,213,0.299,0.939
"5300","La Paz","El Alto","Unidad Educativa Donozo Torres",108,0,1,0,65,2,17,2,0,195,0,6,201,220,0.333,0.914
"5301","La Paz","El Alto","Unidad Educativa Donozo Torres",103,2,1,0,65,6,8,1,2,188,0,5,193,218,0.346,0.885
"5302","La Paz","El Alto","Unidad Educativa Donozo Torres",108,1,8,1,71,1,12,0,1,203,2,9,214,228,0.35,0.939
"5303","La Paz","El Alto","Unidad Educativa Donozo Torres",79,0,6,1,103,3,20,1,0,213,0,5,218,230,0.484,0.948
"5304","La Paz","El Alto","Unidad Educativa Donozo Torres",119,0,1,0,65,5,15,1,0,206,2,6,214,224,0.316,0.955
"5305","La Paz","El Alto","Unidad Educativa Donozo Torres",110,2,1,0,70,2,15,3,0,203,0,5,208,227,0.345,0.916
"5306","La Paz","El Alto","Unidad Educativa Donozo Torres",128,1,1,0,57,2,12,1,0,202,0,4,206,219,0.282,0.941
"5307","La Paz","El Alto","Unidad Educativa Donozo Torres",93,1,5,0,83,5,21,0,3,211,1,5,217,229,0.393,0.948
"5308","La Paz","El Alto","Unidad Educativa Donozo Torres",90,1,3,0,89,2,12,1,1,199,1,3,203,221,0.447,0.919
"5309","La Paz","El Alto","Unidad Educativa Donozo Torres",85,0,7,0,84,1,31,0,1,209,0,6,215,225,0.402,0.956
"5310","La Paz","El Alto","Unidad Educativa Donozo Torres",124,1,1,0,60,2,15,1,3,207,0,1,208,227,0.29,0.916
"5311","La Paz","El Alto","Unidad Educativa Donozo Torres",134,0,0,1,51,3,13,0,1,203,2,8,213,228,0.251,0.934
"5312","La Paz","El Alto","Unidad Educativa Donozo Torres",120,1,1,3,63,6,14,0,1,209,1,4,214,227,0.301,0.943
"5313","La Paz","El Alto","Unidad Educativa Donozo Torres",97,1,5,1,93,4,13,0,1,215,0,5,220,229,0.433,0.961
"5314","La Paz","El Alto","Unidad Educativa Donozo Torres",115,0,2,0,63,4,20,1,0,205,1,6,212,223,0.307,0.951
"5315","La Paz","El Alto","Unidad Educativa Donozo Torres",126,0,4,1,60,1,8,1,2,203,0,7,210,225,0.296,0.933
"5316","La Paz","El Alto","Unidad Educativa Donozo Torres",102,1,3,1,80,1,18,2,4,212,3,3,218,229,0.377,0.952
"5317","La Paz","El Alto","Unidad Educativa Donozo Torres",120,0,1,0,70,2,6,1,0,200,2,10,212,221,0.35,0.959
"5318","La Paz","El Alto","Col. Heroes del Pacifico",136,3,2,1,52,4,13,0,1,212,1,1,214,225,0.245,0.951
"5319","La Paz","El Alto","Col. Heroes del Pacifico",134,0,0,2,49,3,12,0,1,201,0,4,205,224,0.244,0.915
"5320","La Paz","El Alto","Col. Heroes del Pacifico",132,0,3,4,45,2,14,1,2,203,0,6,209,223,0.222,0.937
"5321","La Paz","El Alto","Col. Heroes del Pacifico",120,1,5,0,57,3,15,3,2,206,0,5,211,222,0.277,0.95
"5322","La Paz","El Alto","Col. Heroes del Pacifico",135,1,4,0,53,3,10,0,0,206,0,4,210,226,0.257,0.929
"5323","La Paz","El Alto","Col. Heroes del Pacifico",101,0,1,0,69,3,26,1,3,204,0,7,211,229,0.338,0.921
"5324","La Paz","El Alto","Col. Heroes del Pacifico",122,1,0,2,52,2,19,0,2,200,0,4,204,226,0.26,0.903
"5325","La Paz","El Alto","Col. Heroes del Pacifico",121,0,4,1,56,1,19,0,0,202,0,2,204,223,0.277,0.915
"5326","La Paz","El Alto","Col. Heroes del Pacifico",141,2,2,1,44,5,11,1,0,207,0,10,217,228,0.213,0.952
"5327","La Paz","El Alto","Col. Heroes del Pacifico",129,1,1,1,55,7,11,1,1,207,0,4,211,227,0.266,0.93
"5328","La Paz","El Alto","Col. Heroes del Pacifico",135,0,1,0,50,2,14,2,1,205,3,2,210,229,0.244,0.917
"5329","La Paz","El Alto","Col. Heroes del Pacifico",111,0,3,0,64,6,18,1,2,205,1,3,209,224,0.312,0.933
"5330","La Paz","El Alto","Col. Heroes del Pacifico",129,0,0,0,49,2,19,0,1,200,1,5,206,225,0.245,0.916
"5331","La Paz","El Alto","Col. Heroes del Pacifico",126,2,3,1,51,0,11,2,2,198,2,6,206,224,0.258,0.92
"5332","La Paz","El Alto","Col. Heroes del Pacifico",137,1,4,1,52,2,10,1,2,210,1,5,216,228,0.248,0.947
"5333","La Paz","El Alto","Col. Heroes del Pacifico",119,2,2,2,61,2,14,1,1,204,0,4,208,228,0.299,0.912
"5334","La Paz","El Alto","Col. Heroes del Pacifico",111,0,1,0,62,1,13,2,0,190,1,5,196,223,0.326,0.879
"5335","La Paz","El Alto","Col. Heroes del Pacifico",148,1,1,0,34,2,8,0,2,196,0,5,201,222,0.173,0.905
"5336","La Paz","El Alto","Col. Heroes del Pacifico",121,0,4,1,60,4,13,0,0,203,1,8,212,223,0.296,0.951
"5337","La Paz","El Alto","Col. Heroes del Pacifico",134,0,2,0,66,2,4,0,2,210,2,3,215,226,0.314,0.951
"5338","La Paz","El Alto","Col. Heroes del Pacifico",119,0,6,1,56,0,21,1,0,204,0,4,208,225,0.275,0.924
"5339","La Paz","El Alto","U.E. Gral. Armando Escobar Uria",125,1,4,2,60,3,12,1,0,208,1,3,212,224,0.288,0.946
"5340","La Paz","El Alto","U.E. Gral. Armando Escobar Uria",118,1,3,0,62,1,9,0,2,196,0,6,202,222,0.316,0.91
"5341","La Paz","El Alto","U.E. Gral. Armando Escobar Uria",119,1,4,1,56,5,8,1,0,195,1,5,201,222,0.287,0.905
"5342","La Paz","El Alto","U.E. Gral. Armando Escobar Uria",120,0,1,1,68,0,17,0,1,208,1,5,214,225,0.327,0.951
"5343","La Paz","El Alto","U.E. Gral. Armando Escobar Uria",101,1,2,2,64,3,12,2,1,188,3,2,193,214,0.34,0.902
"5344","La Paz","El Alto","U.E. Gral. Armando Escobar Uria",117,1,1,0,57,2,13,1,2,194,1,4,199,221,0.294,0.9
"5345","La Paz","El Alto","U.E. Gral. Armando Escobar Uria",128,0,0,0,55,1,14,0,1,199,1,8,208,225,0.276,0.924
"5346","La Paz","El Alto","U.E. Gral. Armando Escobar Uria",124,0,2,2,42,1,8,4,0,183,1,3,187,206,0.23,0.908
"5347","La Paz","El Alto","Colegio Mariscal Andres De Santa Cruz",94,2,1,1,83,3,17,0,0,201,2,7,210,223,0.413,0.942
"5348","La Paz","El Alto","Colegio Mariscal Andres De Santa Cruz",80,1,5,0,97,0,19,1,4,207,0,4,211,229,0.469,0.921
"5349","La Paz","El Alto","Colegio Mariscal Andres De Santa Cruz",95,0,2,1,76,1,19,0,2,196,3,8,207,223,0.388,0.928
"5350","La Paz","El Alto","Colegio Mariscal Andres De Santa Cruz",78,0,2,2,85,2,31,0,2,202,0,6,208,224,0.421,0.929
"5351","La Paz","El Alto","Colegio Mariscal Andres De Santa Cruz",97,1,2,0,69,7,18,2,1,197,2,9,208,219,0.35,0.95
"5352","La Paz","El Alto","Colegio Mariscal Andres De Santa Cruz",75,1,4,0,93,3,20,1,0,197,0,7,204,226,0.472,0.903
"5353","La Paz","El Alto","Colegio Mariscal Andres De Santa Cruz",82,2,0,0,93,2,22,0,1,202,1,8,211,226,0.46,0.934
"5354","La Paz","El Alto","Esc. Libertad en las Americas",50,0,9,0,116,2,29,1,0,207,3,4,214,224,0.56,0.955
"5355","La Paz","El Alto","Esc. Libertad en las Americas",71,0,4,0,100,4,26,0,1,206,0,7,213,228,0.485,0.934
"5356","La Paz","El Alto","Esc. Libertad en las Americas",61,0,5,0,103,1,28,0,2,200,1,14,215,230,0.515,0.935
"5357","La Paz","El Alto","Esc. Libertad en las Americas",46,0,3,0,113,3,31,1,0,197,0,6,203,228,0.574,0.89
"5358","La Paz","El Alto","Esc. Libertad en las Americas",74,0,1,1,89,0,27,0,3,195,0,8,203,229,0.456,0.886
"5359","La Paz","El Alto","Esc. Libertad en las Americas",54,0,5,1,111,2,30,0,0,203,2,2,207,224,0.547,0.924
"5360","La Paz","El Alto","Esc. Libertad en las Americas",52,2,3,0,108,1,26,0,0,192,3,10,205,225,0.562,0.911
"5361","La Paz","El Alto","Esc. Libertad en las Americas",62,0,8,3,94,5,29,0,4,205,0,11,216,232,0.459,0.931
"5362","La Paz","El Alto","Esc. Libertad en las Americas",66,0,5,1,95,3,26,0,3,199,1,7,207,227,0.477,0.912
"5363","La Paz","El Alto","Esc. Libertad en las Americas",64,0,5,2,101,5,25,0,1,203,1,6,210,229,0.498,0.917
"5364","La Paz","El Alto","Esc. Libertad en las Americas",57,1,8,0,106,0,25,0,3,200,3,7,210,225,0.53,0.933
"5365","La Paz","El Alto","Esc. Libertad en las Americas",59,1,4,0,113,0,14,1,1,193,0,11,204,227,0.585,0.899
"5366","La Paz","El Alto","Esc. Libertad en las Americas",64,0,5,0,107,2,17,0,1,196,3,7,206,223,0.546,0.924
"5367","La Paz","El Alto","Esc. Libertad en las Americas",68,1,9,2,105,1,18,0,0,204,0,2,206,226,0.515,0.912
"5368","La Paz","El Alto","Esc. Libertad en las Americas",56,1,9,1,105,2,9,0,1,184,1,7,192,221,0.571,0.869
"5369","La Paz","El Alto","Esc. Libertad en las Americas",61,1,3,0,110,4,22,0,0,201,2,9,212,228,0.547,0.93
"5370","La Paz","El Alto","Esc. Libertad en las Americas",65,1,3,1,104,2,19,0,0,195,23,6,224,224,0.533,1
"5371","La Paz","El Alto","Esc. Libertad en las Americas",79,1,1,1,81,1,25,0,3,192,2,11,205,226,0.422,0.907
"5372","La Paz","El Alto","Esc. Libertad en las Americas",44,0,9,0,115,5,26,1,1,201,1,3,205,225,0.572,0.911
"5373","La Paz","El Alto","Esc. Libertad en las Americas",56,0,6,1,103,1,25,1,2,195,1,5,201,222,0.528,0.905
"5374","La Paz","El Alto","Esc. Libertad en las Americas",62,1,3,1,104,3,26,0,3,203,3,7,213,227,0.512,0.938
"5375","La Paz","El Alto","Esc. Libertad en las Americas",63,1,7,2,98,4,27,0,1,203,2,6,211,226,0.483,0.934
"5376","La Paz","El Alto","Esc. Libertad en las Americas",64,1,5,1,94,4,15,3,1,188,1,7,196,211,0.5,0.929
"5377","La Paz","El Alto","Esc. Libertad en las Americas",45,3,5,0,114,1,23,0,1,192,5,7,204,224,0.594,0.911
"5378","La Paz","El Alto","Esc. Libertad en las Americas",34,1,7,0,137,4,17,0,1,201,4,4,209,225,0.682,0.929
"5379","La Paz","El Alto","Esc. Libertad en las Americas",61,1,6,1,99,0,28,0,3,199,4,4,207,224,0.497,0.924
"5380","La Paz","El Alto","Esc. Libertad en las Americas",68,0,3,0,107,3,24,0,1,206,0,7,213,230,0.519,0.926
"5381","La Paz","El Alto","Esc. Libertad en las Americas",72,0,2,1,95,2,20,0,1,193,1,16,210,221,0.492,0.95
"5382","La Paz","El Alto","Esc. Libertad en las Americas",52,2,2,1,113,0,18,0,1,189,0,8,197,217,0.598,0.908
"5383","La Paz","El Alto","Esc. Libertad en las Americas",70,0,7,1,102,4,30,0,0,214,0,5,219,233,0.477,0.94
"5384","La Paz","El Alto","Esc. Libertad en las Americas",65,1,7,1,94,2,34,0,2,206,1,2,209,223,0.456,0.937
"5385","La Paz","El Alto","Esc. Libertad en las Americas",43,1,7,1,124,4,23,0,1,204,1,5,210,222,0.608,0.946
"5386","La Paz","El Alto","Esc. Libertad en las Americas",54,2,1,0,117,2,29,0,5,210,1,5,216,228,0.557,0.947
"5387","La Paz","El Alto","Esc. Libertad en las Americas",60,0,5,1,105,4,37,2,0,214,1,4,219,236,0.491,0.928
"5388","La Paz","El Alto","Esc. Libertad en las Americas",77,0,4,0,97,0,19,1,2,200,2,10,212,231,0.485,0.918
"5389","La Paz","El Alto","Esc. Libertad en las Americas",73,3,6,2,93,1,35,1,2,216,2,4,222,238,0.431,0.933
"5390","La Paz","El Alto","Esc. Libertad en las Americas",42,0,4,0,77,1,21,3,4,152,0,0,152,161,0.507,0.944
"5391","La Paz","El Alto","U.E. San Andres",63,1,2,0,102,0,38,1,2,209,1,12,222,237,0.488,0.937
"5392","La Paz","El Alto","U.E. San Andres",44,1,7,3,103,1,35,0,3,197,2,5,204,216,0.523,0.944
"5393","La Paz","El Alto","U.E. San Andres",51,0,6,1,108,5,22,0,0,193,2,14,209,223,0.56,0.937
"5394","La Paz","El Alto","U.E. San Andres",65,0,4,0,106,1,21,0,1,198,1,9,208,224,0.535,0.929
"5395","La Paz","El Alto","U.E. San Andres",54,2,1,1,106,3,27,1,1,196,0,7,203,219,0.541,0.927
"5396","La Paz","El Alto","U.E. San Andres",55,1,2,1,103,3,17,0,5,187,1,5,193,217,0.551,0.889
"5397","La Paz","El Alto","U.E. San Andres",69,2,3,1,100,3,28,0,2,208,2,4,214,226,0.481,0.947
"5398","La Paz","El Alto","U.E. San Andres",47,1,5,2,108,2,23,0,2,190,1,6,197,217,0.568,0.908
"5399","La Paz","El Alto","Col. Rotary Chuquiago Marca",65,0,4,2,100,3,30,0,2,206,3,8,217,227,0.485,0.956
"5400","La Paz","El Alto","Col. Rotary Chuquiago Marca",71,1,8,0,94,2,26,1,3,206,1,4,211,230,0.456,0.917
"5401","La Paz","El Alto","Col. Rotary Chuquiago Marca",47,0,4,0,109,2,34,0,3,199,1,6,206,223,0.548,0.924
"5402","La Paz","El Alto","Col. Rotary Chuquiago Marca",51,0,4,2,90,2,41,1,5,196,3,6,205,228,0.459,0.899
"5403","La Paz","El Alto","Col. Rotary Chuquiago Marca",46,2,3,0,105,2,33,0,1,192,1,9,202,225,0.547,0.898
"5404","La Paz","El Alto","Col. Rotary Chuquiago Marca",45,2,1,2,113,3,33,0,2,201,3,7,211,227,0.562,0.93
"5405","La Paz","El Alto","Col. Rotary Chuquiago Marca",52,1,13,0,102,4,33,1,1,207,0,5,212,231,0.493,0.918
"5406","La Paz","El Alto","Col. Rotary Chuquiago Marca",59,2,1,0,113,3,19,0,4,201,1,8,210,227,0.562,0.925
"5407","La Paz","El Alto","Col. Rotary Chuquiago Marca",59,0,7,1,110,3,21,1,1,203,2,4,209,223,0.542,0.937
"5408","La Paz","El Alto","Col. Rotary Chuquiago Marca",57,1,5,0,112,4,31,0,0,210,1,8,219,230,0.533,0.952
"5409","La Paz","El Alto","Col. Rotary Chuquiago Marca",55,0,6,1,100,2,24,1,1,190,2,10,202,222,0.526,0.91
"5410","La Paz","El Alto","Col. Rotary Chuquiago Marca",49,1,5,1,112,2,31,0,2,203,2,8,213,227,0.552,0.938
"5411","La Paz","El Alto","Col. Rotary Chuquiago Marca",55,0,5,1,99,0,39,1,1,201,3,8,212,227,0.493,0.934
"5412","La Paz","El Alto","Col. Rotary Chuquiago Marca",57,1,5,2,107,4,21,0,5,202,1,6,209,229,0.53,0.913
"5413","La Paz","El Alto","Col. Rotary Chuquiago Marca",46,1,4,1,115,2,26,0,2,197,3,10,210,227,0.584,0.925
"5414","La Paz","El Alto","Col. Rotary Chuquiago Marca",40,1,8,0,93,2,45,2,3,194,2,4,200,223,0.479,0.897
"5415","La Paz","El Alto","Col. Rotary Chuquiago Marca",54,0,8,1,108,1,22,1,3,198,0,6,204,228,0.545,0.895
"5416","La Paz","El Alto","Col. Rotary Chuquiago Marca",69,0,6,0,92,3,23,1,1,195,1,5,201,224,0.472,0.897
"5417","La Paz","El Alto","Col. Rotary Chuquiago Marca",60,0,5,0,104,1,35,1,3,209,0,3,212,230,0.498,0.922
"5418","La Paz","El Alto","Col. Rotary Chuquiago Marca",44,0,5,0,91,1,27,0,3,171,2,30,203,232,0.532,0.875
"5419","La Paz","El Alto","Col. Rotary Chuquiago Marca",57,1,5,0,74,2,26,1,1,167,1,38,206,220,0.443,0.936
"5420","La Paz","El Alto","Col. Rotary Chuquiago Marca",59,1,5,1,94,2,31,0,3,196,2,3,201,220,0.48,0.914
"5421","La Paz","El Alto","Col. Rotary Chuquiago Marca",42,0,4,2,119,2,21,1,1,192,2,7,201,214,0.62,0.939
"5422","La Paz","El Alto","Col. Rotary Chuquiago Marca",45,0,6,1,108,3,30,1,1,195,2,7,204,232,0.554,0.879
"5423","La Paz","El Alto","Col. Rotary Chuquiago Marca",51,2,5,2,105,6,19,0,2,192,2,6,200,221,0.547,0.905
"5424","La Paz","El Alto","Col. Rotary Chuquiago Marca",69,1,9,0,100,0,26,0,2,207,1,6,214,224,0.483,0.955
"5425","La Paz","El Alto","Col. Rotary Chuquiago Marca",65,0,3,2,107,1,27,3,1,209,0,6,215,236,0.512,0.911
"5426","La Paz","El Alto","Col. Rotary Chuquiago Marca",58,2,6,0,92,1,23,0,3,185,1,11,197,215,0.497,0.916
"5427","La Paz","El Alto","Col. Rotary Chuquiago Marca",54,1,6,0,98,3,24,0,3,189,2,6,197,220,0.519,0.895
"5428","La Paz","El Alto","Col. Rotary Chuquiago Marca",69,0,5,1,87,2,26,0,2,192,1,11,204,221,0.453,0.923
"5429","La Paz","El Alto","Col. Rotary Chuquiago Marca",46,1,5,1,99,4,32,2,4,194,2,7,203,230,0.51,0.883
"5430","La Paz","El Alto","Col. Rotary Chuquiago Marca",60,1,4,0,105,0,21,0,1,192,2,6,200,223,0.547,0.897
"5431","La Paz","El Alto","Col. Rotary Chuquiago Marca",42,3,6,0,111,0,32,0,2,196,1,11,208,228,0.566,0.912
"5432","La Paz","El Alto","Col. Rotary Chuquiago Marca",38,0,4,0,136,1,31,0,0,210,1,7,218,232,0.648,0.94
"5433","La Paz","El Alto","Col. Rotary Chuquiago Marca",67,2,2,0,108,2,23,0,2,206,1,6,213,227,0.524,0.938
"5434","La Paz","El Alto","Col. Rotary Chuquiago Marca",43,4,1,1,109,1,32,2,2,195,1,11,207,225,0.559,0.92
"5435","La Paz","El Alto","Col. Rotary Chuquiago Marca",45,2,1,0,117,1,27,0,3,196,2,6,204,225,0.597,0.907
"5436","La Paz","El Alto","Col. Rotary Chuquiago Marca",64,2,5,1,96,3,24,0,4,199,0,11,210,230,0.482,0.913
"5437","La Paz","El Alto","Col. Rotary Chuquiago Marca",61,2,3,1,99,4,29,0,0,199,1,10,210,231,0.497,0.909
"5438","La Paz","El Alto","Col. Rotary Chuquiago Marca",63,1,2,2,101,6,21,0,1,197,3,5,205,226,0.513,0.907
"5439","La Paz","El Alto","Col. Rotary Chuquiago Marca",49,2,3,0,102,1,35,2,4,198,1,7,206,228,0.515,0.904
"5440","La Paz","El Alto","Col. Rotary Chuquiago Marca",63,1,7,1,97,1,27,1,1,199,2,4,205,224,0.487,0.915
"5441","La Paz","El Alto","Col. Rotary Chuquiago Marca",60,1,1,0,124,3,36,0,1,226,1,4,231,243,0.549,0.951
"5442","La Paz","El Alto","Col. Bolivia",39,0,6,1,120,1,24,1,0,192,0,18,210,229,0.625,0.917
"5443","La Paz","El Alto","Col. Bolivia",63,3,18,0,90,3,28,1,3,209,0,4,213,232,0.431,0.918
"5444","La Paz","El Alto","Col. Bolivia",48,1,5,1,104,0,31,1,4,195,1,13,209,230,0.533,0.909
"5445","La Paz","El Alto","Col. Bolivia",46,0,6,1,112,2,27,1,2,197,3,14,214,232,0.569,0.922
"5446","La Paz","El Alto","Col. Bolivia",52,0,13,0,109,0,35,1,0,210,3,1,214,236,0.519,0.907
"5447","La Paz","El Alto","Col. Bolivia",28,2,6,0,128,5,33,1,2,205,2,7,214,231,0.624,0.926
"5448","La Paz","El Alto","Col. Bolivia",36,6,16,1,115,2,29,0,3,208,3,2,213,227,0.553,0.938
"5449","La Paz","El Alto","Col. Bolivia",43,0,18,1,111,1,28,1,2,205,0,9,214,233,0.541,0.918
"5450","La Paz","El Alto","Col. Bolivia",32,0,7,2,126,1,25,0,3,196,3,10,209,227,0.643,0.921
"5451","La Paz","El Alto","Col. Bolivia",53,3,4,0,106,2,29,1,0,198,1,6,205,229,0.535,0.895
"5452","La Paz","El Alto","Col. Bolivia",46,2,7,0,116,2,30,0,3,206,2,4,212,227,0.563,0.934
"5453","La Paz","El Alto","Col. Bolivia",36,2,6,0,103,1,37,1,1,187,1,17,205,224,0.551,0.915
"5454","La Paz","El Alto","Col. Bolivia",40,0,9,0,108,3,43,0,0,203,1,6,210,223,0.532,0.942
"5455","La Paz","El Alto","Col. Bolivia",50,1,11,0,95,3,40,1,2,203,1,13,217,228,0.468,0.952
"5456","La Paz","El Alto","Col. Bolivia",38,0,11,1,111,2,27,0,3,193,4,12,209,228,0.575,0.917
"5457","La Paz","El Alto","Col. Bolivia",46,3,9,0,110,3,23,0,2,196,1,10,207,231,0.561,0.896
"5458","La Paz","El Alto","Col. Bolivia",41,0,11,2,121,6,21,0,0,202,0,12,214,228,0.599,0.939
"5459","La Paz","El Alto","Col. Bolivia",52,1,7,0,97,2,39,0,0,198,3,10,211,229,0.49,0.921
"5460","La Paz","El Alto","Col. Bolivia",52,1,9,1,109,3,27,1,2,205,2,8,215,229,0.532,0.939
"5461","La Paz","El Alto","Col. Bolivia",36,0,7,0,111,0,28,0,3,185,0,21,206,225,0.6,0.916
"5462","La Paz","El Alto","Col. 25 de Julio",32,0,7,0,145,6,24,0,1,215,1,4,220,233,0.674,0.944
"5463","La Paz","El Alto","Col. 25 de Julio",38,0,16,0,113,3,31,0,2,203,1,7,211,231,0.557,0.913
"5464","La Paz","El Alto","Col. 25 de Julio",34,0,12,0,124,4,31,0,2,207,0,5,212,233,0.599,0.91
"5465","La Paz","El Alto","Col. 25 de Julio",30,0,8,1,128,5,31,2,0,205,1,5,211,230,0.624,0.917
"5466","La Paz","El Alto","Col. 25 de Julio",30,0,10,0,126,1,25,0,0,192,3,8,203,231,0.656,0.879
"5467","La Paz","El Alto","Col. 25 de Julio",20,1,6,1,120,1,45,0,0,194,5,5,204,229,0.619,0.891
"5468","La Paz","El Alto","Col. 25 de Julio",28,3,8,0,115,2,28,0,2,186,5,9,200,229,0.618,0.873
"5469","La Paz","El Alto","Col. 25 de Julio",30,2,6,0,133,1,26,1,0,199,1,11,211,233,0.668,0.906
"5470","La Paz","El Alto","Col. 25 de Julio",40,0,8,0,107,4,41,1,1,202,0,11,213,230,0.53,0.926
"5471","La Paz","El Alto","Col. 25 de Julio",29,1,6,0,128,5,30,0,2,201,1,8,210,231,0.637,0.909
"5472","La Paz","El Alto","Col. 25 de Julio",26,2,8,0,128,2,35,0,2,203,0,12,215,231,0.631,0.931
"5473","La Paz","El Alto","Col. 25 de Julio",30,0,11,0,128,1,30,1,1,202,3,8,213,228,0.634,0.934
"5474","La Paz","El Alto","Col. 25 de Julio",36,3,13,0,111,5,31,0,0,199,1,13,213,229,0.558,0.93
"5475","La Paz","El Alto","Col. 25 de Julio",37,0,8,2,124,2,27,0,3,203,0,5,208,226,0.611,0.92
"5476","La Paz","El Alto","Col. 25 de Julio",44,1,10,1,125,1,24,1,2,209,1,3,213,228,0.598,0.934
"5477","La Paz","El Alto","Col. 25 de Julio",39,0,10,3,116,2,36,0,1,207,2,3,212,228,0.56,0.93
"5478","La Paz","El Alto","Col. 25 de Julio",29,3,7,0,123,4,34,0,2,202,0,7,209,224,0.609,0.933
"5479","La Paz","El Alto","Col. 25 de Julio",34,1,8,0,124,3,32,0,1,203,3,11,217,232,0.611,0.935
"5480","La Paz","El Alto","Col. 25 de Julio",35,1,8,0,124,3,36,1,0,208,2,8,218,230,0.596,0.948
"5481","La Paz","El Alto","Col. 25 de Julio",21,0,5,1,124,2,47,0,1,201,5,8,214,234,0.617,0.915
"5482","La Paz","El Alto","Col. 25 de Julio",30,1,6,1,128,1,21,0,1,189,0,12,201,219,0.677,0.918
"5483","La Paz","El Alto","Col. 25 de Julio",21,0,5,1,139,2,33,0,2,203,1,5,209,233,0.685,0.897
"5484","La Paz","El Alto","Col. 25 de Julio",31,2,8,0,123,1,36,0,2,203,1,9,213,232,0.606,0.918
"5485","La Paz","El Alto","Col. 25 de Julio",23,1,7,1,115,1,42,0,3,193,0,8,201,231,0.596,0.87
"5486","La Paz","El Alto","Col. 25 de Julio",37,0,7,0,116,1,33,1,0,195,3,10,208,234,0.595,0.889
"5487","La Paz","El Alto","Col. 25 de Julio",23,0,9,1,128,4,32,0,2,199,2,3,204,231,0.643,0.883
"5488","La Paz","El Alto","Col. 25 de Julio",40,0,5,0,130,0,20,0,4,199,0,7,206,224,0.653,0.92
"5489","La Paz","El Alto","Col. 25 de Julio",28,0,16,0,117,2,35,0,1,199,3,5,207,231,0.588,0.896
"5490","La Paz","El Alto","Col. 25 de Julio",33,2,8,0,117,3,31,0,1,195,4,10,209,232,0.6,0.901
"5491","La Paz","El Alto","Col. 25 de Julio",27,0,9,0,129,0,28,0,2,195,5,4,204,225,0.662,0.907
"5492","La Paz","El Alto","Col. 25 de Julio",31,0,7,0,129,2,32,1,2,204,1,5,210,228,0.632,0.921
"5493","La Paz","El Alto","Col. 25 de Julio",31,2,9,1,129,1,30,0,2,205,1,5,211,232,0.629,0.909
"5494","La Paz","El Alto","Col. 25 de Julio",35,0,5,0,119,7,39,0,4,209,3,4,216,228,0.569,0.947
"5495","La Paz","El Alto","Col. 25 de Julio",34,0,7,0,121,7,29,0,1,199,3,11,213,237,0.608,0.899
"5496","La Paz","El Alto","Col. 25 de Julio",32,3,6,1,126,4,39,0,2,213,1,3,217,230,0.592,0.943
"5497","La Paz","El Alto","Col. 25 de Julio",35,0,12,1,128,4,21,0,0,201,2,8,211,234,0.637,0.902
"5498","La Paz","El Alto","Col. 25 de Julio",31,2,11,3,124,2,30,0,3,206,2,10,218,232,0.602,0.94
"5499","La Paz","El Alto","Col. 25 de Julio",46,0,11,0,131,1,21,0,3,213,1,5,219,230,0.615,0.952
"5500","La Paz","El Alto","Col. 25 de Julio",42,0,8,0,125,1,27,2,6,211,0,8,219,229,0.592,0.956
"5501","La Paz","El Alto","Col. 25 de Julio",42,0,1,13,118,2,31,2,5,214,2,2,218,241,0.551,0.905
"5502","La Paz","El Alto","Col. España",28,1,7,0,131,2,30,2,1,202,1,9,212,224,0.649,0.946
"5503","La Paz","El Alto","Col. España",31,0,7,0,126,0,29,0,3,196,2,6,204,226,0.643,0.903
"5504","La Paz","El Alto","Col. España",27,0,14,0,126,1,22,0,0,190,3,12,205,228,0.663,0.899
"5505","La Paz","El Alto","Col. España",35,1,8,1,123,4,16,0,2,190,1,9,200,228,0.647,0.877
"5506","La Paz","El Alto","Col. España",34,0,11,0,130,0,31,0,0,206,2,5,213,232,0.631,0.918
"5507","La Paz","El Alto","Col. España",39,1,8,0,137,2,27,2,0,216,0,2,218,231,0.634,0.944
"5508","La Paz","El Alto","Col. España",30,2,7,0,136,4,22,0,3,204,3,10,217,226,0.667,0.96
"5509","La Paz","El Alto","Col. España",46,2,7,1,108,1,26,0,0,191,2,12,205,229,0.565,0.895
"5510","La Paz","El Alto","Col. España",24,0,9,2,126,1,36,0,2,200,3,4,207,225,0.63,0.92
"5511","La Paz","El Alto","Col. España",36,2,3,0,129,0,22,0,4,196,1,12,209,229,0.658,0.913
"5512","La Paz","El Alto","Col. España",26,2,16,0,122,2,24,1,3,196,5,12,213,231,0.622,0.922
"5513","La Paz","El Alto","Col. España",30,0,13,2,119,1,29,2,5,201,2,9,212,228,0.592,0.93
"5514","La Paz","El Alto","Col. España",26,0,5,0,122,5,33,0,3,194,0,9,203,227,0.629,0.894
"5515","La Paz","El Alto","Col. España",21,1,10,0,124,3,39,0,0,198,1,4,203,226,0.626,0.898
"5516","La Paz","El Alto","Col. España",27,0,5,3,132,4,25,0,2,198,0,6,204,225,0.667,0.907
"5517","La Paz","El Alto","Col. España",17,1,6,0,143,3,35,1,2,208,0,3,211,229,0.688,0.921
"5518","La Paz","El Alto","Col. España",33,1,14,1,120,0,24,0,1,194,1,8,203,223,0.619,0.91
"5519","La Paz","El Alto","Col. España",24,3,8,0,142,0,25,0,2,204,0,7,211,226,0.696,0.934
"5520","La Paz","El Alto","Col. España",33,0,8,0,129,4,27,0,1,202,1,5,208,225,0.639,0.924
"5521","La Paz","El Alto","Col. España",53,0,6,0,102,0,31,0,2,194,3,8,205,221,0.526,0.928
"5522","La Paz","El Alto","Col. España",35,2,9,0,125,2,23,0,3,199,1,10,210,220,0.628,0.955
"5523","La Paz","El Alto","Col. España",25,0,24,0,134,1,18,0,0,202,1,6,209,232,0.663,0.901
"5524","La Paz","El Alto","Col. España",31,1,13,0,132,3,26,1,0,207,2,5,214,230,0.638,0.93
"5525","La Paz","El Alto","Col. España",30,0,7,1,113,3,27,0,3,184,2,12,198,228,0.614,0.868
"5526","La Paz","El Alto","Col. España",30,1,1,1,130,5,26,1,1,196,4,9,209,228,0.663,0.917
"5527","La Paz","El Alto","Col. España",26,1,8,0,142,1,29,0,0,207,1,8,216,229,0.686,0.943
"5528","La Paz","El Alto","Col. España",28,2,7,2,134,3,17,0,3,196,1,12,209,232,0.684,0.901
"5529","La Paz","El Alto","Col. España",24,1,14,0,128,2,31,0,2,202,2,7,211,232,0.634,0.909
"5530","La Paz","El Alto","Col. España",31,1,9,0,136,1,20,0,1,199,4,7,210,228,0.683,0.921
"5531","La Paz","El Alto","Col. España",25,4,12,1,126,0,27,0,0,195,5,5,205,228,0.646,0.899
"5532","La Paz","El Alto","Col. España",25,1,14,0,131,0,33,0,1,205,0,6,211,234,0.639,0.902
"5533","La Paz","El Alto","Col. España",42,3,8,0,125,0,22,0,4,204,1,3,208,226,0.613,0.92
"5534","La Paz","El Alto","Col. España",31,1,4,1,126,1,33,0,1,198,2,8,208,231,0.636,0.9
"5535","La Paz","El Alto","Col. España",34,0,8,0,124,3,26,3,9,207,1,8,216,229,0.599,0.943
"5536","La Paz","El Alto","Col. España",34,0,13,0,132,1,27,3,1,211,2,4,217,233,0.626,0.931
"5537","La Paz","El Alto","Col. España",22,0,11,1,130,1,28,1,1,195,1,7,203,223,0.667,0.91
"5538","La Paz","El Alto","Col. España",26,0,5,0,128,1,45,2,2,209,1,5,215,230,0.612,0.935
"5539","La Paz","El Alto","Col. España",38,0,9,0,95,1,38,1,1,183,3,8,194,223,0.519,0.87
"5540","La Paz","El Alto","Col. España",28,1,7,0,144,1,25,1,0,207,4,3,214,233,0.696,0.918
"5541","La Paz","El Alto","Col. España",36,1,3,1,121,1,33,2,1,199,2,7,208,232,0.608,0.897
"5542","La Paz","El Alto","Col. España",40,1,6,1,125,0,29,0,1,203,1,7,211,231,0.616,0.913
"5543","La Paz","El Alto","Col. España",33,0,4,0,128,0,36,1,3,205,2,5,212,233,0.624,0.91
"5544","La Paz","El Alto","Col. España",27,0,6,0,124,2,40,2,3,204,2,7,213,234,0.608,0.91
"5545","La Paz","El Alto","Col. España",23,1,9,0,117,5,36,1,8,200,2,10,212,235,0.585,0.902
"5546","La Paz","El Alto","Col. Republica De Italia",32,3,8,0,131,2,35,0,2,213,2,8,223,239,0.615,0.933
"5547","La Paz","El Alto","Col. Republica De Italia",33,1,11,0,130,4,35,0,0,214,4,4,222,240,0.607,0.925
"5548","La Paz","El Alto","Col. Republica De Italia",27,0,8,0,127,2,48,1,1,214,3,4,221,234,0.593,0.944
"5549","La Paz","El Alto","Col. Republica De Italia",34,2,6,1,126,1,34,0,5,209,2,7,218,236,0.603,0.924
"5550","La Paz","El Alto","Col. Republica De Italia",32,3,10,0,128,1,40,0,2,216,2,7,225,238,0.593,0.945
"5551","La Paz","El Alto","Col. Republica De Italia",32,2,8,0,124,2,32,0,2,202,3,9,214,230,0.614,0.93
"5552","La Paz","El Alto","Col. Republica De Italia",36,2,8,0,123,1,29,0,4,203,2,8,213,223,0.606,0.955
"5553","La Paz","El Alto","Col. Republica De Italia",38,0,8,0,120,3,28,1,2,200,1,4,205,226,0.6,0.907
"5554","La Paz","El Alto","Col. Republica De Italia",33,0,16,1,123,1,27,0,3,204,3,4,211,220,0.603,0.959
"5555","La Paz","El Alto","Col. Republica De Italia",19,0,4,1,154,3,20,0,0,201,0,7,208,223,0.766,0.933
"5556","La Paz","El Alto","Col. Republica De Italia",23,0,11,0,130,2,32,0,1,199,0,6,205,231,0.653,0.887
"5557","La Paz","El Alto","Col. Republica De Italia",27,2,5,0,131,1,36,0,2,204,0,10,214,226,0.642,0.947
"5558","La Paz","El Alto","U.E. Cristal",30,0,8,0,147,1,24,0,1,211,2,8,221,234,0.697,0.944
"5559","La Paz","El Alto","U.E. Cristal",41,0,5,0,142,4,23,0,4,219,2,6,227,235,0.648,0.966
"5560","La Paz","El Alto","U.E. Cristal",30,1,4,1,143,6,25,0,0,210,4,8,222,238,0.681,0.933
"5561","La Paz","El Alto","U.E. Cristal",44,1,7,0,145,1,14,0,1,213,1,7,221,236,0.681,0.936
"5562","La Paz","El Alto","U.E. Cristal",33,0,5,0,144,3,24,0,1,210,2,4,216,236,0.686,0.915
"5563","La Paz","El Alto","U.E. Cristal",35,1,5,0,152,2,21,1,1,218,0,6,224,238,0.697,0.941
"5564","La Paz","El Alto","U.E. Cristal",44,0,3,0,151,0,16,1,3,218,0,7,225,238,0.693,0.945
"5565","La Paz","El Alto","U.E. Cristal",25,1,7,0,141,3,28,2,1,208,3,5,216,235,0.678,0.919
"5566","La Paz","El Alto","U.E. Cristal",37,0,6,0,141,3,23,0,2,212,1,10,223,233,0.665,0.957
"5567","La Paz","El Alto","U.E. Cristal",42,0,2,0,138,3,26,0,1,212,3,9,224,235,0.651,0.953
"5568","La Paz","El Alto","U.E. Cristal",31,0,6,0,147,2,26,1,5,218,4,4,226,240,0.674,0.942
"5569","La Paz","El Alto","U.E. Cristal",45,2,2,0,136,2,25,1,3,216,1,4,221,238,0.63,0.929
"5570","La Paz","El Alto","U.E. Cristal",38,1,3,0,135,2,32,1,1,213,1,5,219,232,0.634,0.944
"5571","La Paz","El Alto","Unidad Educativa Ecologico Los Pinos",29,0,10,1,129,4,32,1,1,207,3,5,215,230,0.623,0.935
"5572","La Paz","El Alto","Unidad Educativa Ecologico Los Pinos",16,0,9,1,148,1,32,0,0,207,3,4,214,237,0.715,0.903
"5573","La Paz","El Alto","Unidad Educativa Ecologico Los Pinos",29,1,10,1,137,3,22,1,1,205,1,6,212,230,0.668,0.922
"5574","La Paz","El Alto","Unidad Educativa Ecologico Los Pinos",33,1,6,1,136,3,21,1,1,203,3,8,214,227,0.67,0.943
"5575","La Paz","El Alto","Unidad Educativa Ecologico Los Pinos",15,1,8,0,155,4,20,0,0,203,1,9,213,234,0.764,0.91
"5576","La Paz","El Alto","Unidad Educativa Ecologico Los Pinos",22,0,8,0,148,4,18,0,2,202,3,6,211,228,0.733,0.925
"5577","La Paz","El Alto","Unidad Educativa Ecologico Los Pinos",25,1,20,1,131,1,26,0,1,206,3,6,215,228,0.636,0.943
"5578","La Paz","El Alto","Unidad Educativa Ecologico Los Pinos",20,0,5,3,135,2,34,1,0,200,2,9,211,227,0.675,0.93
"5579","La Paz","El Alto","Unidad Educativa Ecologico Los Pinos",24,0,10,1,141,6,24,0,2,208,1,3,212,231,0.678,0.918
"5580","La Paz","El Alto","Unidad Educativa Ecologico Los Pinos",16,0,14,0,159,1,14,0,1,205,2,9,216,233,0.776,0.927
"5581","La Paz","El Alto","Unidad Educativa Ecologico Los Pinos",20,0,3,0,149,4,26,1,1,204,5,5,214,232,0.73,0.922
"5582","La Paz","El Alto","Unidad Educativa Ecologico Los Pinos",13,1,13,1,149,2,24,1,0,204,1,11,216,235,0.73,0.919
"5583","La Paz","El Alto","Unidad Educativa Ecologico Los Pinos",23,0,5,1,148,1,25,0,0,203,0,8,211,230,0.729,0.917
"5584","La Paz","El Alto","Unidad Educativa Ecologico Los Pinos",17,0,10,0,144,0,29,3,0,203,2,5,210,232,0.709,0.905
"5585","La Paz","El Alto","Unidad Educativa Ecologico Los Pinos",47,0,5,0,147,2,12,1,1,215,2,4,221,229,0.684,0.965
"5586","La Paz","El Alto","Unidad Educativa Ecologico Los Pinos",24,1,10,0,151,1,14,0,0,201,5,6,212,230,0.751,0.922
"5587","La Paz","El Alto","Unidad Educativa Ecologico Los Pinos",15,2,17,0,161,1,21,2,1,220,1,3,224,237,0.732,0.945
"5588","La Paz","El Alto","Unidad Educativa Ecologico Los Pinos",15,0,5,1,151,2,25,0,2,201,4,6,211,230,0.751,0.917
"5589","La Paz","El Alto","Unidad Educativa Ecologico Los Pinos",36,1,9,0,135,1,34,0,0,216,3,4,223,238,0.625,0.937
"5590","La Paz","El Alto","Unidad Educativa Ecologico Los Pinos",24,1,6,0,144,3,30,0,0,208,1,9,218,233,0.692,0.936
"5591","La Paz","El Alto","Unidad Educativa Ecologico Los Pinos",32,1,11,0,140,1,22,0,2,209,2,7,218,234,0.67,0.932
"5592","La Paz","El Alto","Unidad Educativa Ecologico Los Pinos",27,1,5,0,139,3,25,0,0,200,2,12,214,228,0.695,0.939
"5593","La Paz","El Alto","Unidad Educativa Ecologico Los Pinos",25,2,9,0,138,1,29,0,3,207,1,4,212,231,0.667,0.918
"5594","La Paz","El Alto","Unidad Educativa Ecologico Los Pinos",18,0,6,0,156,0,30,0,0,210,0,13,223,234,0.743,0.953
"5595","La Paz","El Alto","Unidad Educativa Ecologico Los Pinos",22,2,13,2,139,3,24,0,1,206,3,8,217,232,0.675,0.935
"5596","La Paz","El Alto","Unidad Educativa Ecologico Los Pinos",17,2,5,3,134,1,34,0,2,198,3,10,211,226,0.677,0.934
"5597","La Paz","El Alto","Unidad Educativa Ecologico Los Pinos",23,0,5,1,138,5,25,2,0,199,2,7,208,231,0.693,0.9
"5598","La Paz","El Alto","Unidad Educativa Ecologico Los Pinos",29,3,7,0,144,2,22,1,2,210,2,5,217,233,0.686,0.931
"5599","La Paz","El Alto","Unidad Educativa Ecologico Los Pinos",23,0,7,0,145,0,27,0,2,204,3,14,221,245,0.711,0.902
"5600","La Paz","El Alto","Esc. Tarapaca",28,1,3,1,145,0,24,0,1,203,3,7,213,227,0.714,0.938
"5601","La Paz","El Alto","Esc. Tarapaca",19,0,4,0,146,2,26,0,2,199,7,4,210,231,0.734,0.909
"5602","La Paz","El Alto","Esc. Tarapaca",24,1,7,0,156,4,22,0,2,216,1,4,221,234,0.722,0.944
"5603","La Paz","El Alto","Esc. Tarapaca",25,1,4,1,148,4,17,0,3,203,2,10,215,229,0.729,0.939
"5604","La Paz","El Alto","Esc. Tarapaca",22,0,8,0,150,3,26,0,1,210,1,7,218,233,0.714,0.936
"5605","La Paz","El Alto","Esc. Tarapaca",29,0,5,0,138,2,26,0,1,201,2,14,217,231,0.687,0.939
"5606","La Paz","El Alto","Esc. Tarapaca",33,0,8,0,151,2,21,0,2,217,0,3,220,232,0.696,0.948
"5607","La Paz","El Alto","Esc. Tarapaca",24,0,13,0,148,2,23,0,2,212,4,1,217,235,0.698,0.923
"5608","La Paz","El Alto","Esc. Tarapaca",19,1,15,0,154,1,26,1,2,219,2,7,228,234,0.703,0.974
"5609","La Paz","El Alto","Esc. Tarapaca",20,0,9,0,154,3,22,2,0,210,3,3,216,227,0.733,0.952
"5610","La Paz","El Alto","Esc. Tarapaca",22,0,7,0,154,2,32,0,0,217,1,4,222,231,0.71,0.961
"5611","La Paz","El Alto","Esc. Tarapaca",27,0,12,0,128,1,33,0,2,203,2,8,213,229,0.631,0.93
"5612","La Paz","El Alto","Esc. Tarapaca",27,2,9,0,127,1,38,1,0,205,1,7,213,226,0.62,0.942
"5613","La Paz","El Alto","Esc. Tarapaca",20,0,15,0,138,0,34,0,0,207,1,2,210,233,0.667,0.901
"5614","La Paz","El Alto","Esc. Tarapaca",29,1,10,0,144,2,20,1,1,208,2,7,217,231,0.692,0.939
"5615","La Paz","El Alto","Esc. Tarapaca",23,0,8,0,147,3,21,0,5,207,0,6,213,229,0.71,0.93
"5616","La Paz","El Alto","Esc. Tarapaca",21,2,2,0,144,3,27,0,0,199,6,3,208,224,0.724,0.929
"5617","La Paz","El Alto","Esc. Tarapaca",25,1,6,1,143,1,34,0,0,211,1,6,218,229,0.678,0.952
"5618","La Paz","El Alto","Esc. Tarapaca",30,2,12,0,128,1,28,0,3,204,2,8,214,229,0.627,0.934
"5619","La Paz","El Alto","Esc. Tarapaca",16,2,12,0,143,1,29,1,3,207,3,6,216,229,0.691,0.943
"5620","La Paz","El Alto","Esc. Tarapaca",23,9,0,0,135,4,31,0,0,202,2,3,207,228,0.668,0.908
"5621","La Paz","El Alto","Esc. Tarapaca",18,0,6,0,157,1,18,1,2,203,4,5,212,230,0.773,0.922
"5622","La Paz","El Alto","Esc. Tarapaca",16,0,10,0,140,3,23,0,3,195,0,13,208,224,0.718,0.929
"5623","La Paz","El Alto","Esc. Tarapaca",23,1,6,0,150,1,24,0,0,205,4,7,216,230,0.732,0.939
"5624","La Paz","El Alto","Esc. Tarapaca",15,7,8,0,155,3,24,0,2,214,2,10,226,234,0.724,0.966
"5625","La Paz","El Alto","Esc. Tarapaca",24,0,17,1,121,2,24,0,1,190,0,10,200,224,0.637,0.893
"5626","La Paz","El Alto","Esc. Tarapaca",29,1,8,0,132,1,31,0,2,204,1,3,208,228,0.647,0.912
"5627","La Paz","El Alto","Esc. Tarapaca",19,1,7,1,152,0,29,0,3,212,2,5,219,230,0.717,0.952
"5628","La Paz","El Alto","Esc. Tarapaca",14,0,10,0,153,2,19,0,2,200,4,5,209,231,0.765,0.905
"5629","La Paz","El Alto","Esc. Tarapaca",26,0,6,0,143,5,23,1,2,206,3,9,218,230,0.694,0.948
"5630","La Paz","El Alto","Esc. Tarapaca",29,1,7,0,130,3,30,0,0,200,2,6,208,227,0.65,0.916
"5631","La Paz","El Alto","Esc. Tarapaca",21,0,10,0,154,2,28,0,1,216,1,4,221,234,0.713,0.944
"5632","La Paz","El Alto","Esc. Tarapaca",31,0,12,0,148,2,20,1,0,214,3,3,220,229,0.692,0.961
"5633","La Paz","El Alto","Esc. Tarapaca",17,0,3,0,159,3,33,0,1,216,1,3,220,233,0.736,0.944
"5634","La Paz","El Alto","Esc. Tarapaca",37,2,20,2,93,3,0,1,0,158,53,8,219,232,0.589,0.944
"5635","La Paz","El Alto","Esc. Tarapaca",38,1,4,0,123,3,28,0,1,198,2,11,211,229,0.621,0.921
"5636","La Paz","El Alto","Col. 18 de Diciembre",19,0,6,0,154,2,27,0,2,210,3,5,218,228,0.733,0.956
"5637","La Paz","El Alto","Col. 18 de Diciembre",35,1,11,0,120,2,30,2,3,204,0,6,210,229,0.588,0.917
"5638","La Paz","El Alto","Col. 18 de Diciembre",30,3,10,0,129,2,34,0,1,209,3,5,217,230,0.617,0.943
"5639","La Paz","El Alto","Col. 18 de Diciembre",37,1,10,1,127,2,22,0,1,201,2,9,212,229,0.632,0.926
"5640","La Paz","El Alto","Col. 18 de Diciembre",28,0,11,1,123,2,37,1,0,203,0,5,208,226,0.606,0.92
"5641","La Paz","El Alto","Col. 18 de Diciembre",34,1,12,0,135,3,23,0,1,209,1,8,218,231,0.646,0.944
"5642","La Paz","El Alto","Col. 18 de Diciembre",36,2,7,1,125,1,34,0,0,206,3,10,219,232,0.607,0.944
"5643","La Paz","El Alto","Col. 18 de Diciembre",29,0,14,1,121,0,31,1,3,200,2,7,209,231,0.605,0.905
"5644","La Paz","El Alto","Col. 18 de Diciembre",33,1,9,0,129,2,27,0,6,207,4,4,215,231,0.623,0.931
"5645","La Paz","El Alto","Col. 18 de Diciembre",19,0,7,1,132,2,32,0,3,196,4,5,205,225,0.673,0.911
"5646","La Paz","El Alto","Col. 18 de Diciembre",22,2,16,2,129,1,31,0,0,203,0,6,209,219,0.635,0.954
"5647","La Paz","El Alto","Col. 18 de Diciembre",22,0,8,1,140,2,35,0,0,208,1,6,215,229,0.673,0.939
"5648","La Paz","El Alto","Col. 18 de Diciembre",29,1,7,0,129,1,33,0,2,202,4,9,215,232,0.639,0.927
"5649","La Paz","El Alto","Col. 18 de Diciembre",23,2,9,0,121,5,38,0,2,200,2,7,209,228,0.605,0.917
"5650","La Paz","El Alto","Col. 18 de Diciembre",30,1,4,0,145,1,29,0,1,211,0,12,223,234,0.687,0.953
"5651","La Paz","El Alto","Col. 18 de Diciembre",28,0,10,0,135,0,30,0,3,206,0,7,213,229,0.655,0.93
"5652","La Paz","El Alto","Col. 18 de Diciembre",17,0,10,0,150,1,24,1,2,205,4,4,213,229,0.732,0.93
"5653","La Paz","El Alto","Col. 18 de Diciembre",33,0,13,0,115,4,24,0,1,190,2,8,200,221,0.605,0.905
"5654","La Paz","El Alto","Col. Atipiris",20,3,9,1,148,3,22,1,2,209,3,2,214,231,0.708,0.926
"5655","La Paz","El Alto","Col. Atipiris",30,1,14,0,117,2,37,0,1,202,6,8,216,230,0.579,0.939
"5656","La Paz","El Alto","Col. Atipiris",24,0,17,0,144,0,21,0,1,207,2,5,214,230,0.696,0.93
"5657","La Paz","El Alto","Col. Atipiris",30,1,9,1,130,4,24,2,1,202,1,4,207,228,0.644,0.908
"5658","La Paz","El Alto","Col. Atipiris",21,1,10,1,136,2,24,2,0,197,3,6,206,223,0.69,0.924
"5659","La Paz","El Alto","Col. Atipiris",39,1,12,0,111,4,26,0,0,193,3,13,209,228,0.575,0.917
"5660","La Paz","El Alto","Col. Atipiris",27,2,8,1,121,2,32,0,0,193,5,11,209,224,0.627,0.933
"5661","La Paz","El Alto","Col. Atipiris",23,0,12,0,140,1,32,0,2,210,2,5,217,235,0.667,0.923
"5662","La Paz","El Alto","Col. Atipiris",31,0,7,0,141,0,28,0,0,207,1,7,215,232,0.681,0.927
"5663","La Paz","El Alto","Col. Atipiris",28,0,5,0,150,0,17,1,1,202,4,9,215,233,0.743,0.923
"5664","La Paz","El Alto","Col. Atipiris",26,1,11,0,129,3,27,0,1,198,2,11,211,228,0.652,0.925
"5665","La Paz","El Alto","Col. Atipiris",35,0,11,2,122,5,25,0,0,200,0,16,216,234,0.61,0.923
"5666","La Paz","El Alto","Col. Atipiris",18,2,10,1,152,1,23,1,0,208,1,4,213,227,0.731,0.938
"5667","La Paz","El Alto","Col. Atipiris",23,2,11,0,137,1,27,0,0,201,3,5,209,232,0.682,0.901
"5668","La Paz","El Alto","Col. Atipiris",23,0,14,0,141,2,19,0,1,200,1,9,210,228,0.705,0.921
"5669","La Paz","El Alto","Col. Atipiris",26,0,9,1,136,4,16,0,2,194,2,20,216,231,0.701,0.935
"5670","La Paz","El Alto","Col. Atipiris",23,1,7,1,129,2,37,0,0,200,0,9,209,232,0.645,0.901
"5671","La Paz","El Alto","Colegio 23 de Marzo",26,2,7,0,147,3,32,0,1,218,1,7,226,236,0.674,0.958
"5672","La Paz","El Alto","Colegio 23 de Marzo",25,0,5,0,158,1,26,0,0,215,0,10,225,235,0.735,0.957
"5673","La Paz","El Alto","Colegio 23 de Marzo",28,0,8,1,146,4,25,0,2,214,1,5,220,234,0.682,0.94
"5674","La Paz","El Alto","Colegio 23 de Marzo",23,0,6,0,144,2,27,1,0,203,4,12,219,232,0.709,0.944
"5675","La Paz","El Alto","Colegio 23 de Marzo",32,0,11,0,120,0,39,0,1,203,2,3,208,228,0.591,0.912
"5676","La Paz","El Alto","Colegio 23 de Marzo",21,2,13,2,129,3,30,1,4,205,2,6,213,230,0.629,0.926
"5677","La Paz","El Alto","Colegio 23 de Marzo",24,1,7,0,144,2,23,0,0,201,2,10,213,233,0.716,0.914
"5678","La Paz","El Alto","Colegio 23 de Marzo",29,1,10,0,119,1,42,0,1,203,1,11,215,237,0.586,0.907
"5679","La Paz","El Alto","Colegio 23 de Marzo",24,1,7,0,152,2,29,0,1,216,2,8,226,235,0.704,0.962
"5680","La Paz","El Alto","Colegio 23 de Marzo",18,0,4,0,147,2,26,1,3,201,3,10,214,232,0.731,0.922
"5681","La Paz","El Alto","Colegio 23 de Marzo",18,0,8,1,143,5,34,0,0,209,1,4,214,227,0.684,0.943
"5682","La Paz","El Alto","Colegio 23 de Marzo",17,1,10,1,165,0,18,0,2,214,4,0,218,229,0.771,0.952
"5683","La Paz","El Alto","Colegio 23 de Marzo",22,2,4,0,139,1,34,0,2,204,2,4,210,233,0.681,0.901
"5684","La Paz","El Alto","Colegio 23 de Marzo",14,0,12,1,142,1,34,0,0,204,5,8,217,232,0.696,0.935
"5685","La Paz","El Alto","Colegio 23 de Marzo",29,0,7,0,144,0,21,0,6,207,1,9,217,234,0.696,0.927
"5686","La Paz","El Alto","Colegio 23 de Marzo",22,0,1,0,140,3,22,0,2,190,2,13,205,230,0.737,0.891
"5687","La Paz","El Alto","Colegio 23 de Marzo",25,0,3,0,134,6,31,0,3,202,1,9,212,232,0.663,0.914
"5688","La Paz","El Alto","Colegio 23 de Marzo",31,0,10,0,140,1,25,0,0,207,2,4,213,232,0.676,0.918
"5689","La Paz","El Alto","Colegio 23 de Marzo",24,2,11,1,143,1,23,2,1,208,3,6,217,229,0.688,0.948
"5690","La Paz","El Alto","Colegio 23 de Marzo",21,2,6,0,149,6,18,2,0,204,1,7,212,229,0.73,0.926
"5691","La Paz","El Alto","Colegio 23 de Marzo",36,0,5,2,132,3,29,1,1,209,2,3,214,228,0.632,0.939
"5692","La Paz","El Alto","Colegio 23 de Marzo",15,1,5,1,148,2,31,0,2,205,0,7,212,226,0.722,0.938
"5693","La Paz","El Alto","Colegio 23 de Marzo",22,1,11,3,143,1,26,0,1,208,5,9,222,231,0.688,0.961
"5694","La Paz","El Alto","Colegio 23 de Marzo",15,0,9,1,133,2,40,0,0,200,5,5,210,225,0.665,0.933
"5695","La Paz","El Alto","Colegio 23 de Marzo",20,1,9,0,136,4,22,2,2,196,4,10,210,229,0.694,0.917
"5696","La Paz","El Alto","Colegio 23 de Marzo",13,0,8,0,135,6,38,0,2,202,2,7,211,232,0.668,0.909
"5697","La Paz","El Alto","Colegio 23 de Marzo",33,2,8,0,128,2,33,0,1,207,3,5,215,231,0.618,0.931
"5698","La Paz","El Alto","Colegio 23 de Marzo",26,0,13,1,135,3,35,0,1,214,3,5,222,237,0.631,0.937
"5699","La Paz","El Alto","Colegio 23 de Marzo",28,0,9,0,135,1,29,1,2,205,3,2,210,229,0.659,0.917
"5700","La Paz","El Alto","Colegio 23 de Marzo",29,1,16,0,130,2,22,0,0,200,3,9,212,231,0.65,0.918
"5701","La Paz","El Alto","Colegio 23 de Marzo",25,0,2,1,140,1,31,0,1,201,2,7,210,225,0.697,0.933
"5702","La Paz","El Alto","Colegio 23 de Marzo",27,1,9,1,133,0,26,1,1,199,4,11,214,227,0.668,0.943
"5703","La Paz","El Alto","Colegio 23 de Marzo",21,2,10,1,127,1,14,0,0,176,3,30,209,225,0.722,0.929
"5704","La Paz","El Alto","Colegio 23 de Marzo",19,2,1,0,142,1,33,1,1,200,1,7,208,231,0.71,0.9
"5705","La Paz","El Alto","Colegio 23 de Marzo",22,1,11,1,133,2,21,0,0,191,6,9,206,233,0.696,0.884
"5706","La Paz","El Alto","Colegio 23 de Marzo",24,0,4,0,135,2,41,1,1,208,3,5,216,231,0.649,0.935
"5707","La Paz","El Alto","Colegio 23 de Marzo",16,0,8,2,147,1,23,1,1,199,2,3,204,227,0.739,0.899
"5708","La Paz","El Alto","Colegio 23 de Marzo",22,0,11,0,141,2,20,0,0,196,3,4,203,225,0.719,0.902
"5709","La Paz","El Alto","Colegio 23 de Marzo",33,0,9,3,128,2,29,0,2,206,0,6,212,231,0.621,0.918
"5710","La Paz","El Alto","Colegio 23 de Marzo",33,0,9,2,139,1,17,1,0,202,3,10,215,232,0.688,0.927
"5711","La Paz","El Alto","Colegio 23 de Marzo",24,1,6,0,134,3,32,2,2,204,0,6,210,227,0.657,0.925
"5712","La Paz","El Alto","Colegio Bolivia Mar",26,0,2,1,147,5,38,1,0,220,1,5,226,238,0.668,0.95
"5713","La Paz","El Alto","Colegio Bolivia Mar",28,1,6,4,132,4,26,0,2,203,1,9,213,230,0.65,0.926
"5714","La Paz","El Alto","Colegio Bolivia Mar",17,1,6,3,149,1,29,0,0,206,0,11,217,235,0.723,0.923
"5715","La Paz","El Alto","Colegio Bolivia Mar",29,1,13,2,129,2,26,0,3,205,1,6,212,234,0.629,0.906
"5716","La Paz","El Alto","Colegio Bolivia Mar",25,1,9,0,145,4,24,0,0,208,2,6,216,233,0.697,0.927
"5717","La Paz","El Alto","Colegio Bolivia Mar",18,0,10,0,135,7,31,0,0,201,2,9,212,228,0.672,0.93
"5718","La Paz","El Alto","Colegio Bolivia Mar",29,0,6,0,134,3,26,0,2,200,1,10,211,231,0.67,0.913
"5719","La Paz","El Alto","Colegio Bolivia Mar",26,3,9,0,121,4,30,0,5,198,0,10,208,230,0.611,0.904
"5720","La Paz","El Alto","Colegio Bolivia Mar",28,2,10,1,141,0,31,0,1,214,1,3,218,234,0.659,0.932
"5721","La Paz","El Alto","Colegio Bolivia Mar",16,0,5,0,160,0,26,0,4,211,1,10,222,237,0.758,0.937
"5722","La Paz","El Alto","Colegio Bolivia Mar",24,3,4,0,153,1,26,0,1,212,1,3,216,229,0.722,0.943
"5723","La Paz","El Alto","Colegio Bolivia Mar",14,0,10,0,146,1,32,0,6,209,2,7,218,231,0.699,0.944
"5724","La Paz","El Alto","Colegio Bolivia Mar",25,0,12,0,146,1,20,1,0,205,2,6,213,229,0.712,0.93
"5725","La Paz","El Alto","Colegio Bolivia Mar",16,1,10,0,137,2,33,0,2,201,1,15,217,237,0.682,0.916
"5726","La Paz","El Alto","Colegio Bolivia Mar",28,1,6,2,142,0,23,0,2,204,2,5,211,228,0.696,0.925
"5727","La Paz","El Alto","Colegio Bolivia Mar",21,1,5,1,136,3,26,0,2,195,3,5,203,220,0.697,0.923
"5728","La Paz","El Alto","Colegio 27 de Mayo",26,1,9,2,134,1,29,0,3,205,4,3,212,230,0.654,0.922
"5729","La Paz","El Alto","Colegio 27 de Mayo",26,2,6,0,134,2,28,0,1,199,3,6,208,229,0.673,0.908
"5730","La Paz","El Alto","Colegio 27 de Mayo",28,0,6,0,142,1,22,0,3,202,2,10,214,232,0.703,0.922
"5731","La Paz","El Alto","Colegio 27 de Mayo",32,0,10,0,129,1,35,0,1,208,2,2,212,233,0.62,0.91
"5732","La Paz","El Alto","Colegio 27 de Mayo",19,0,11,1,148,2,25,0,3,209,1,8,218,233,0.708,0.936
"5733","La Paz","El Alto","Colegio 27 de Mayo",30,0,5,0,131,3,32,0,1,202,3,5,210,232,0.649,0.905
"5734","La Paz","El Alto","Colegio 27 de Mayo",22,0,10,0,133,1,31,1,1,199,2,13,214,232,0.668,0.922
"5735","La Paz","El Alto","Colegio 27 de Mayo",19,0,22,0,136,2,30,0,2,211,3,3,217,231,0.645,0.939
"5736","La Paz","El Alto","Colegio 27 de Mayo",21,0,16,0,133,3,28,0,0,201,4,4,209,229,0.662,0.913
"5737","La Paz","El Alto","Colegio 27 de Mayo",17,1,15,0,146,1,27,0,0,207,1,6,214,233,0.705,0.918
"5738","La Paz","El Alto","Colegio 27 de Mayo",20,1,14,0,149,3,33,0,1,221,1,3,225,237,0.674,0.949
"5739","La Paz","El Alto","Colegio 27 de Mayo",21,1,8,0,146,1,26,0,1,204,1,10,215,232,0.716,0.927
"5740","La Paz","El Alto","Colegio 27 de Mayo",36,0,13,0,124,6,26,0,4,209,3,5,217,229,0.593,0.948
"5741","La Paz","El Alto","Colegio 27 de Mayo",18,2,9,1,141,3,27,0,0,201,2,10,213,231,0.701,0.922
"5742","La Paz","El Alto","Colegio 27 de Mayo",15,2,8,0,135,2,36,0,2,200,1,11,212,232,0.675,0.914
"5743","La Paz","El Alto","Colegio 27 de Mayo",20,1,14,2,142,0,27,0,4,210,2,6,218,237,0.676,0.92
"5744","La Paz","El Alto","Colegio 27 de Mayo",26,0,11,0,136,2,33,1,4,213,1,9,223,236,0.638,0.945
"5745","La Paz","El Alto","Colegio 27 de Mayo",30,0,6,0,133,3,34,0,1,207,1,14,222,233,0.643,0.953
"5746","La Paz","El Alto","Colegio 27 de Mayo",18,3,7,0,144,1,30,1,3,207,5,4,216,229,0.696,0.943
"5747","La Paz","El Alto","Colegio 27 de Mayo",34,0,11,0,133,3,26,1,2,210,0,5,215,235,0.633,0.915
"5748","La Paz","El Alto","Colegio 27 de Mayo",22,0,6,0,134,7,29,0,4,202,2,3,207,232,0.663,0.892
"5749","La Paz","El Alto","Colegio 27 de Mayo",11,2,11,2,142,1,37,0,0,206,3,4,213,233,0.689,0.914
"5750","La Paz","El Alto","Colegio 27 de Mayo",32,0,9,0,127,1,32,1,1,203,2,5,210,232,0.626,0.905
"5751","La Paz","El Alto","Colegio 27 de Mayo",17,0,9,0,147,0,31,1,2,207,3,7,217,235,0.71,0.923
"5752","La Paz","El Alto","Colegio 27 de Mayo",30,0,8,0,126,3,34,0,4,205,0,12,217,229,0.615,0.948
"5753","La Paz","El Alto","Colegio 27 de Mayo",17,0,16,2,146,1,31,0,1,214,2,7,223,233,0.682,0.957
"5754","La Paz","El Alto","Colegio 27 de Mayo",31,2,11,0,133,0,20,0,2,199,3,7,209,229,0.668,0.913
"5755","La Paz","El Alto","Colegio 27 de Mayo",27,2,10,0,135,3,28,0,1,206,0,3,209,230,0.655,0.909
"5756","La Paz","El Alto","Colegio 27 de Mayo",22,2,4,0,148,1,22,0,1,200,3,4,207,228,0.74,0.908
"5757","La Paz","El Alto","Colegio 27 de Mayo",21,0,8,0,148,2,33,2,2,216,2,7,225,236,0.685,0.953
"5758","La Paz","El Alto","Colegio 27 de Mayo",20,0,11,0,143,4,25,0,1,204,3,4,211,231,0.701,0.913
"5759","La Paz","El Alto","Colegio 27 de Mayo",25,2,4,0,145,2,28,0,3,209,0,5,214,225,0.694,0.951
"5760","La Paz","El Alto","Colegio 27 de Mayo",24,1,4,1,148,4,14,0,2,198,3,11,212,229,0.747,0.926
"5761","La Paz","El Alto","Colegio 27 de Mayo",25,1,6,2,127,3,20,0,1,185,4,22,211,231,0.686,0.913
"5762","La Paz","El Alto","Colegio 27 de Mayo",17,0,9,0,146,2,32,0,1,207,4,7,218,228,0.705,0.956
"5763","La Paz","El Alto","Colegio 27 de Mayo",40,0,5,1,120,3,42,1,2,214,2,5,221,235,0.561,0.94
"5764","La Paz","El Alto","Unidad Educativa Republica de Francia",40,1,7,0,105,1,39,1,4,198,0,10,208,229,0.53,0.908
"5765","La Paz","El Alto","Unidad Educativa Republica de Francia",42,0,6,1,133,2,23,2,3,212,0,6,218,232,0.627,0.94
"5766","La Paz","El Alto","Unidad Educativa Republica de Francia",53,3,4,2,114,1,32,0,1,210,1,5,216,232,0.543,0.931
"5767","La Paz","El Alto","Unidad Educativa Republica de Francia",40,0,9,1,114,2,36,1,1,204,1,7,212,233,0.559,0.91
"5768","La Paz","El Alto","Unidad Educativa Republica de Francia",39,0,2,1,137,3,23,0,1,206,1,5,212,226,0.665,0.938
"5769","La Paz","El Alto","Unidad Educativa Republica de Francia",41,0,4,0,134,1,31,2,3,216,0,5,221,232,0.62,0.953
"5770","La Paz","El Alto","Unidad Educativa Republica de Francia",33,0,5,0,125,3,33,1,3,203,0,9,212,225,0.616,0.942
"5771","La Paz","El Alto","Unidad Educativa Republica de Francia",33,1,5,0,132,1,23,2,2,199,2,7,208,231,0.663,0.9
"5772","La Paz","El Alto","Unidad Educativa Republica de Francia",41,0,7,0,131,1,31,0,1,212,4,5,221,229,0.618,0.965
"5773","La Paz","El Alto","Unidad Educativa Republica de Francia",42,0,2,0,130,3,25,0,1,203,14,14,231,231,0.64,1
"5774","La Paz","El Alto","Unidad Educativa Republica de Francia",35,0,4,0,125,1,40,0,1,206,3,6,215,231,0.607,0.931
"5775","La Paz","El Alto","Unidad Educativa Republica de Francia",52,0,4,0,124,1,29,1,2,213,0,3,216,226,0.582,0.956
"5776","La Paz","El Alto","Unidad Educativa Republica de Francia",47,1,7,0,120,1,30,0,1,207,2,5,214,231,0.58,0.926
"5777","La Paz","El Alto","Unidad Educativa Republica de Francia",43,0,8,0,121,7,27,0,2,208,0,5,213,232,0.582,0.918
"5778","La Paz","El Alto","Unidad Educativa Republica de Francia",43,2,4,0,116,0,29,0,0,194,2,13,209,224,0.598,0.933
"5779","La Paz","El Alto","Unidad Educativa Republica de Francia",37,0,4,1,127,1,31,0,0,201,1,4,206,224,0.632,0.92
"5780","La Paz","El Alto","Unidad Educativa Republica de Francia",45,0,8,1,117,0,30,0,0,201,0,7,208,224,0.582,0.929
"5781","La Paz","El Alto","Unidad Educativa Republica de Francia",40,0,10,0,120,1,33,0,3,207,0,2,209,227,0.58,0.921
"5782","La Paz","El Alto","Unidad Educativa Republica de Francia",38,0,12,1,114,1,31,1,3,201,2,6,209,231,0.567,0.905
"5783","La Paz","El Alto","Unidad Educativa Republica de Francia",47,1,5,1,129,0,22,0,0,205,2,4,211,228,0.629,0.925
"5784","La Paz","El Alto","Unidad Educativa Republica de Francia",50,0,3,2,103,5,42,0,2,207,1,4,212,224,0.498,0.946
"5785","La Paz","El Alto","Unidad Educativa Republica de Francia",35,2,6,0,126,3,33,1,0,206,0,6,212,223,0.612,0.951
"5786","La Paz","El Alto","Unidad Educativa Republica de Francia",62,3,12,1,103,2,17,2,0,202,4,4,210,227,0.51,0.925
"5787","La Paz","El Alto","Unidad Educativa Republica de Francia",50,1,2,2,116,1,32,0,2,206,2,14,222,238,0.563,0.933
"5788","La Paz","El Alto","Unidad Educativa Republica de Francia",36,1,6,1,117,1,26,0,3,191,2,7,200,223,0.613,0.897
"5789","La Paz","El Alto","Unidad Educativa Republica de Francia",33,1,8,0,133,0,28,1,1,205,2,7,214,225,0.649,0.951
"5790","La Paz","El Alto","Unidad Educativa Republica de Francia",30,1,4,3,131,1,36,0,1,207,0,5,212,224,0.633,0.946
"5791","La Paz","El Alto","Unidad Educativa Republica de Francia",46,0,4,1,112,5,29,0,1,198,0,8,206,225,0.566,0.916
"5792","La Paz","El Alto","Unidad Educativa Republica de Francia",29,1,8,0,110,6,47,0,3,204,3,6,213,227,0.539,0.938
"5793","La Paz","El Alto","Unidad Educativa Republica de Francia",52,2,3,0,122,2,30,1,2,214,1,1,216,227,0.57,0.952
"5794","La Paz","El Alto","Unidad Educativa Republica de Francia",34,1,5,1,129,1,33,0,3,207,3,4,214,229,0.623,0.934
"5795","La Paz","El Alto","Unidad Educativa Republica de Francia",38,0,8,0,115,1,35,4,3,204,0,2,206,227,0.564,0.907
"5796","La Paz","El Alto","Sede Social Junta Vecinal",45,0,6,0,122,3,27,1,1,205,2,4,211,226,0.595,0.934
"5797","La Paz","El Alto","Sede Social Junta Vecinal",43,2,4,1,119,0,22,1,4,196,2,6,204,225,0.607,0.907
"5798","La Paz","El Alto","Sede Social Junta Vecinal",44,0,10,1,129,2,15,2,3,206,2,2,210,225,0.626,0.933
"5799","La Paz","El Alto","Sede Social Junta Vecinal",41,0,2,1,120,1,35,1,1,202,1,6,209,223,0.594,0.937
"5800","La Paz","El Alto","Sede Social Junta Vecinal",42,6,5,1,121,2,26,0,0,203,3,8,214,232,0.596,0.922
"5801","La Paz","El Alto","Sede Social Junta Vecinal",40,2,9,1,106,3,29,1,2,193,0,5,198,218,0.549,0.908
"5802","La Paz","El Alto","Col. Mutual La Paz",74,0,4,0,91,1,34,1,0,205,3,1,209,224,0.444,0.933
"5803","La Paz","El Alto","Col. Mutual La Paz",57,0,7,0,99,2,37,0,1,203,3,4,210,228,0.488,0.921
"5804","La Paz","El Alto","Col. Mutual La Paz",89,0,4,0,84,1,27,0,2,207,2,3,212,228,0.406,0.93
"5805","La Paz","El Alto","Col. Mutual La Paz",61,2,5,1,103,3,31,0,1,207,2,8,217,233,0.498,0.931
"5806","La Paz","El Alto","Col. Mutual La Paz",50,1,4,0,103,1,30,2,3,194,2,9,205,222,0.531,0.923
"5807","La Paz","El Alto","Col. Mutual La Paz",55,1,5,0,105,2,23,1,2,194,2,6,202,221,0.541,0.914
"5808","La Paz","El Alto","Col. Mutual La Paz",56,2,1,0,100,3,31,1,8,202,3,5,210,223,0.495,0.942
"5809","La Paz","El Alto","Col. Mutual La Paz",79,2,4,0,95,0,22,0,1,203,4,3,210,230,0.468,0.913
"5810","La Paz","El Alto","Col. Mutual La Paz",69,0,5,0,95,2,29,1,4,205,1,5,211,226,0.463,0.934
"5811","La Paz","El Alto","Col. Mutual La Paz",71,1,3,2,103,1,30,1,2,214,1,3,218,230,0.481,0.948
"5812","La Paz","El Alto","Col. Mutual La Paz",86,0,5,0,90,0,15,0,4,200,0,6,206,224,0.45,0.92
"5813","La Paz","El Alto","Col. Mutual La Paz",56,3,6,0,111,0,17,0,2,195,3,3,201,220,0.569,0.914
"5814","La Paz","El Alto","Col. Mutual La Paz",50,0,9,0,113,0,27,3,2,204,3,3,210,228,0.554,0.921
"5815","La Paz","El Alto","Col. Mutual La Paz",92,3,1,1,76,4,25,1,0,203,1,8,212,224,0.374,0.946
"5816","La Paz","El Alto","Col. Mutual La Paz",67,1,5,0,81,3,23,0,5,185,2,22,209,222,0.438,0.941
"5817","La Paz","El Alto","Col. Mutual La Paz",61,0,3,0,111,1,25,0,1,202,0,9,211,232,0.55,0.909
"5818","La Paz","El Alto","Col. Mutual La Paz",73,2,6,0,97,3,27,0,1,209,2,3,214,227,0.464,0.943
"5819","La Paz","El Alto","Col. Mutual La Paz",77,0,5,1,107,1,21,0,1,213,2,1,216,228,0.502,0.947
"5820","La Paz","El Alto","Col. Mutual La Paz",76,2,3,3,81,4,27,0,0,196,0,5,201,229,0.413,0.878
"5821","La Paz","El Alto","Col. Mutual La Paz",73,2,3,1,98,0,21,0,2,200,1,10,211,229,0.49,0.921
"5822","La Paz","El Alto","Unidad Educativa Gran Poder",46,0,9,1,123,2,33,0,1,215,1,8,224,236,0.572,0.949
"5823","La Paz","El Alto","Unidad Educativa Gran Poder",39,0,2,0,122,1,43,1,4,212,0,5,217,231,0.575,0.939
"5824","La Paz","El Alto","Unidad Educativa Gran Poder",49,1,3,0,115,0,38,0,5,211,0,5,216,229,0.545,0.943
"5825","La Paz","El Alto","Unidad Educativa Gran Poder",47,0,7,0,110,2,28,1,2,197,2,10,209,232,0.558,0.901
"5826","La Paz","El Alto","Unidad Educativa Gran Poder",47,2,6,0,121,0,25,0,3,204,2,10,216,236,0.593,0.915
"5827","La Paz","El Alto","Unidad Educativa Gran Poder",44,1,6,1,107,0,41,1,3,204,0,6,210,231,0.525,0.909
"5828","La Paz","El Alto","Unidad Educativa Gran Poder",55,0,7,1,116,4,30,0,2,215,0,3,218,236,0.54,0.924
"5829","La Paz","El Alto","Unidad Educativa Gran Poder",41,2,5,0,129,2,29,1,3,212,1,3,216,234,0.608,0.923
"5830","La Paz","El Alto","Unidad Educativa Gran Poder",57,1,4,1,101,0,42,1,1,208,2,6,216,232,0.486,0.931
"5831","La Paz","El Alto","Unidad Educativa Gran Poder",59,1,5,0,106,4,28,0,3,206,3,4,213,227,0.515,0.938
"5832","La Paz","El Alto","Unidad Educativa Gran Poder",38,1,10,0,117,1,32,1,1,201,1,7,209,229,0.582,0.913
"5833","La Paz","El Alto","Unidad Educativa Gran Poder",35,1,4,1,123,3,34,0,3,204,1,5,210,231,0.603,0.909
"5834","La Paz","El Alto","Unidad Educativa Gran Poder",58,0,3,1,117,4,1,0,2,186,1,8,195,245,0.629,0.796
"5835","La Paz","El Alto","Unidad Educativa Aniceto Arce",61,4,4,1,96,1,40,1,4,212,3,6,221,231,0.453,0.957
"5836","La Paz","El Alto","Unidad Educativa Aniceto Arce",58,0,5,0,122,3,17,1,3,209,4,4,217,229,0.584,0.948
"5837","La Paz","El Alto","Unidad Educativa Aniceto Arce",47,1,3,3,117,0,29,1,1,202,2,3,207,226,0.579,0.916
"5838","La Paz","El Alto","Unidad Educativa Aniceto Arce",60,1,9,0,106,2,27,0,6,211,4,6,221,234,0.502,0.944
"5839","La Paz","El Alto","Unidad Educativa Aniceto Arce",70,1,6,0,97,1,29,1,1,206,2,4,212,224,0.471,0.946
"5840","La Paz","El Alto","Unidad Educativa Aniceto Arce",52,2,11,0,102,4,26,0,1,198,0,11,209,232,0.515,0.901
"5841","La Paz","El Alto","Unidad Educativa Aniceto Arce",68,1,11,1,98,3,22,2,0,206,0,10,216,228,0.476,0.947
"5842","La Paz","El Alto","Unidad Educativa Aniceto Arce",50,1,8,0,115,3,32,0,1,210,3,5,218,228,0.548,0.956
"5843","La Paz","El Alto","Unidad Educativa Aniceto Arce",53,2,7,1,109,3,25,1,1,202,0,11,213,224,0.54,0.951
"5844","La Paz","El Alto","Colegio 6 de Junio",36,0,5,3,112,4,30,0,4,194,3,8,205,224,0.577,0.915
"5845","La Paz","El Alto","Colegio 6 de Junio",42,0,9,0,119,2,25,2,4,203,2,7,212,230,0.586,0.922
"5846","La Paz","El Alto","Colegio 6 de Junio",44,2,9,0,106,1,32,0,3,197,3,6,206,231,0.538,0.892
"5847","La Paz","El Alto","Colegio 6 de Junio",23,1,7,0,131,3,38,0,5,208,1,4,213,231,0.63,0.922
"5848","La Paz","El Alto","Colegio 6 de Junio",25,1,5,2,138,5,27,0,1,204,5,6,215,228,0.676,0.943
"5849","La Paz","El Alto","Colegio 6 de Junio",37,0,7,1,121,2,34,0,0,202,2,7,211,231,0.599,0.913
"5850","La Paz","El Alto","Colegio 6 de Junio",40,1,8,0,116,5,32,1,7,210,0,12,222,233,0.552,0.953
"5851","La Paz","El Alto","Colegio 6 de Junio",52,1,5,0,118,2,29,0,3,210,0,1,211,231,0.562,0.913
"5852","La Paz","El Alto","Colegio 6 de Junio",46,0,5,0,122,1,29,1,2,206,1,6,213,232,0.592,0.918
"5853","La Paz","El Alto","Colegio 6 de Junio",39,2,4,0,124,1,35,1,5,211,0,6,217,233,0.588,0.931
"5854","La Paz","El Alto","Colegio 6 de Junio",37,1,11,2,114,2,27,1,2,197,6,2,205,226,0.579,0.907
"5855","La Paz","El Alto","Colegio 6 de Junio",33,0,11,0,122,2,26,0,2,196,1,4,201,222,0.622,0.905
"5856","La Paz","El Alto","Colegio 6 de Junio",31,0,10,0,123,6,32,0,1,203,2,5,210,227,0.606,0.925
"5857","La Paz","El Alto","Colegio 6 de Junio",24,1,1,0,137,1,31,1,0,196,1,5,202,231,0.699,0.874
"5858","La Paz","El Alto","Colegio 6 de Junio",37,0,4,0,128,0,32,1,1,203,0,5,208,227,0.631,0.916
"5859","La Paz","El Alto","Colegio 6 de Junio",53,0,7,1,104,3,30,1,1,200,1,11,212,227,0.52,0.934
"5860","La Paz","El Alto","Colegio 6 de Junio",39,0,6,0,129,2,29,0,0,205,2,8,215,233,0.629,0.923
"5861","La Paz","El Alto","Colegio 6 de Junio",38,1,10,0,116,0,39,0,4,208,3,6,217,229,0.558,0.948
"5862","La Paz","El Alto","Colegio 6 de Junio",37,1,4,0,126,1,2,1,1,173,0,4,177,231,0.728,0.766
"5863","La Paz","El Alto","Colegio 6 de Junio",45,2,7,2,101,1,38,1,6,203,0,9,212,230,0.498,0.922
"5864","La Paz","El Alto","Colegio 6 de Junio",44,3,5,2,124,3,2,0,2,185,1,7,193,233,0.67,0.828
"5865","La Paz","El Alto","Colegio 6 de Junio",24,0,6,0,131,1,33,1,1,197,2,9,208,227,0.665,0.916
"5866","La Paz","El Alto","Colegio 6 de Junio",46,2,8,0,113,3,32,1,4,209,1,2,212,232,0.541,0.914
"5867","La Paz","El Alto","Colegio 6 de Junio",47,2,11,1,98,3,34,4,1,201,0,6,207,228,0.488,0.908
"5868","La Paz","El Alto","Col. Topater",45,0,4,1,113,2,35,1,2,203,1,6,210,228,0.557,0.921
"5869","La Paz","El Alto","Col. Topater",47,0,5,0,129,3,30,0,1,215,1,5,221,231,0.6,0.957
"5870","La Paz","El Alto","Col. Topater",44,1,10,1,101,2,40,1,3,203,2,5,210,229,0.498,0.917
"5871","La Paz","El Alto","Col. Topater",49,1,8,0,99,2,37,0,2,198,0,10,208,226,0.5,0.92
"5872","La Paz","El Alto","Col. Topater",51,0,7,0,120,2,26,0,1,207,0,5,212,230,0.58,0.922
"5873","La Paz","El Alto","Col. Topater",40,3,12,1,102,2,37,2,0,199,2,10,211,224,0.513,0.942
"5874","La Paz","El Alto","Col. Topater",53,3,7,0,97,2,40,0,1,203,3,5,211,226,0.478,0.934
"5875","La Paz","El Alto","Col. Topater",38,0,11,1,117,4,28,0,1,200,0,8,208,229,0.585,0.908
"5876","La Paz","El Alto","Col. Topater",43,2,7,1,113,4,27,0,0,197,3,11,211,230,0.574,0.917
"5877","La Paz","El Alto","Col. Topater",55,0,9,0,115,5,22,1,1,208,0,6,214,230,0.553,0.93
"5878","La Paz","El Alto","Col. Topater",57,1,5,0,108,6,26,1,3,207,0,2,209,226,0.522,0.925
"5879","La Paz","El Alto","Col. Topater",35,1,5,1,119,4,36,0,1,202,3,8,213,230,0.589,0.926
"5880","La Paz","El Alto","Col. Topater",37,1,5,0,127,2,31,0,2,205,3,9,217,232,0.62,0.935
"5881","La Paz","El Alto","Col. Topater",43,2,5,1,135,2,29,1,1,219,0,0,219,232,0.616,0.944
"5882","La Paz","El Alto","Col. Topater",36,0,4,1,129,2,26,1,1,200,4,5,209,226,0.645,0.925
"5883","La Paz","El Alto","Col. Topater",32,0,4,0,127,1,34,0,1,199,3,8,210,231,0.638,0.909
"5884","La Paz","El Alto","Col. Topater",43,0,7,1,118,5,33,0,0,207,0,11,218,234,0.57,0.932
"5885","La Paz","El Alto","Col. Topater",54,0,8,2,102,8,25,0,3,202,5,9,216,234,0.505,0.923
"5886","La Paz","El Alto","Col. Topater",47,2,12,0,110,2,31,0,1,205,1,9,215,234,0.537,0.919
"5887","La Paz","El Alto","Col. Topater",55,1,9,0,120,2,24,0,4,215,1,1,217,230,0.558,0.943
"5888","La Paz","El Alto","Col. Topater",49,0,6,1,129,5,20,0,3,213,0,4,217,228,0.606,0.952
"5889","La Paz","El Alto","Col. Topater",26,0,7,0,144,0,28,0,4,209,0,7,216,231,0.689,0.935
"5890","La Paz","El Alto","Col. Topater",55,0,4,1,102,0,40,0,1,203,0,3,206,228,0.502,0.904
"5891","La Paz","El Alto","Col. Topater",44,2,5,0,121,2,25,0,0,199,3,10,212,232,0.608,0.914
"5892","La Paz","El Alto","Col. Topater",58,0,6,0,121,2,27,0,2,216,0,7,223,234,0.56,0.953
"5893","La Paz","El Alto","Col. Topater",48,0,10,1,122,3,25,1,1,211,3,3,217,231,0.578,0.939
"5894","La Paz","El Alto","Col. Topater",43,0,9,1,118,5,25,0,1,202,0,4,206,229,0.584,0.9
"5895","La Paz","El Alto","Col. Topater",52,1,6,2,96,3,26,0,0,186,0,1,187,203,0.516,0.921
"5896","La Paz","El Alto","Centro Educativo Catolico Mercedes",28,1,9,2,125,4,33,1,2,205,3,9,217,226,0.61,0.96
"5897","La Paz","El Alto","Centro Educativo Catolico Mercedes",44,0,8,1,119,0,22,0,1,195,5,14,214,230,0.61,0.93
"5898","La Paz","El Alto","Centro Educativo Catolico Mercedes",32,1,9,0,125,2,44,0,2,215,2,6,223,234,0.581,0.953
"5899","La Paz","El Alto","Centro Educativo Catolico Mercedes",39,2,6,1,120,3,44,0,0,215,1,5,221,228,0.558,0.969
"5900","La Paz","El Alto","Centro Educativo Catolico Mercedes",40,0,5,1,133,2,26,4,3,214,2,7,223,234,0.621,0.953
"5901","La Paz","El Alto","Centro Educativo Catolico Mercedes",34,2,6,1,110,2,23,0,1,179,1,37,217,228,0.615,0.952
"5902","La Paz","El Alto","Centro Educativo Catolico Mercedes",40,2,10,1,128,1,27,0,0,209,0,10,219,230,0.612,0.952
"5903","La Paz","El Alto","Centro Educativo Catolico Mercedes",35,1,13,0,117,4,29,0,1,200,5,4,209,230,0.585,0.909
"5904","La Paz","El Alto","Centro Educativo Catolico Mercedes",44,0,3,0,130,1,34,0,1,213,0,6,219,231,0.61,0.948
"5905","La Paz","El Alto","Centro Educativo Catolico Mercedes",41,0,7,2,120,3,37,1,0,211,3,7,221,229,0.569,0.965
"5906","La Paz","El Alto","Centro Educativo Catolico Mercedes",28,2,7,0,138,3,27,0,3,208,3,4,215,231,0.663,0.931
"5907","La Paz","El Alto","Centro Educativo Catolico Mercedes",33,1,5,0,139,1,39,0,0,218,3,5,226,235,0.638,0.962
"5908","La Paz","El Alto","Centro Educativo Catolico Mercedes",34,0,9,0,122,3,34,1,4,207,4,6,217,228,0.589,0.952
"5909","La Paz","El Alto","Centro Educativo Catolico Mercedes",37,1,9,1,107,2,36,0,2,195,1,4,200,215,0.549,0.93
"5910","La Paz","El Alto","Unidad Educativa Tupac Amaru",46,1,10,0,137,0,20,0,7,221,1,1,223,232,0.62,0.961
"5911","La Paz","El Alto","Unidad Educativa Tupac Amaru",31,3,5,1,131,0,33,0,1,205,3,4,212,228,0.639,0.93
"5912","La Paz","El Alto","Unidad Educativa Tupac Amaru",32,0,9,0,135,3,31,0,2,212,2,4,218,231,0.637,0.944
"5913","La Paz","El Alto","Unidad Educativa Tupac Amaru",27,0,11,1,129,2,33,0,4,207,5,4,216,230,0.623,0.939
"5914","La Paz","El Alto","Unidad Educativa Tupac Amaru",30,1,10,0,139,2,20,0,3,205,0,8,213,227,0.678,0.938
"5915","La Paz","El Alto","Unidad Educativa Tupac Amaru",32,2,8,0,126,0,33,0,7,208,3,3,214,231,0.606,0.926
"5916","La Paz","El Alto","Unidad Educativa Tupac Amaru",33,0,6,1,136,4,29,0,1,210,1,6,217,235,0.648,0.923
"5917","La Paz","El Alto","Unidad Educativa Tupac Amaru",22,1,10,0,141,0,31,2,2,209,1,6,216,230,0.675,0.939
"5918","La Paz","El Alto","Unidad Educativa Tupac Amaru",33,0,8,0,126,2,31,1,2,203,2,8,213,233,0.621,0.914
"5919","La Paz","El Alto","Unidad Educativa Tupac Amaru",38,0,12,1,133,1,22,0,4,211,2,8,221,234,0.63,0.944
"5920","La Paz","El Alto","Unidad Educativa Tupac Amaru",31,0,6,2,132,2,23,0,1,197,4,9,210,226,0.67,0.929
"5921","La Paz","El Alto","Unidad Educativa Tupac Amaru",39,0,2,2,123,1,23,0,4,194,2,5,201,221,0.634,0.91
"5922","La Paz","El Alto","U.E. Akapana Fuerza Andina",40,0,0,2,111,3,26,0,4,186,0,5,191,206,0.597,0.927
"5923","La Paz","El Alto","Esc. Bolivar Municipal",53,0,7,3,111,3,27,0,2,206,1,4,211,227,0.539,0.93
"5924","La Paz","El Alto","Esc. Bolivar Municipal",67,2,4,1,107,5,22,0,3,211,1,6,218,237,0.507,0.92
"5925","La Paz","El Alto","Esc. Bolivar Municipal",49,1,8,0,107,1,35,0,3,204,1,9,214,225,0.525,0.951
"5926","La Paz","El Alto","Esc. Bolivar Municipal",65,1,6,0,101,3,27,0,4,207,1,4,212,228,0.488,0.93
"5927","La Paz","El Alto","Esc. Bolivar Municipal",62,2,4,0,106,3,22,0,1,200,0,2,202,221,0.53,0.914
"5928","La Paz","El Alto","Esc. Bolivar Municipal",77,2,9,1,87,3,27,0,4,210,2,5,217,227,0.414,0.956
"5929","La Paz","El Alto","Esc. Bolivar Municipal",60,0,10,1,102,2,27,1,0,203,1,5,209,230,0.502,0.909
"5930","La Paz","El Alto","Esc. Bolivar Municipal",56,1,3,0,111,1,30,0,1,203,3,10,216,229,0.547,0.943
"5931","La Paz","El Alto","Esc. Bolivar Municipal",47,0,6,0,113,2,33,2,2,205,1,8,214,228,0.551,0.939
"5932","La Paz","El Alto","Esc. Bolivar Municipal",36,0,2,1,127,1,35,1,2,205,3,11,219,234,0.62,0.936
"5933","La Paz","El Alto","Esc. Bolivar Municipal",56,0,5,2,112,5,21,2,5,208,1,5,214,228,0.538,0.939
"5934","La Paz","El Alto","Esc. Bolivar Municipal",58,2,5,1,104,1,33,0,2,206,1,4,211,228,0.505,0.925
"5935","La Paz","El Alto","Esc. Bolivar Municipal",66,0,8,1,96,0,25,1,1,198,2,3,203,225,0.485,0.902
"5936","La Paz","El Alto","Esc. Bolivar Municipal",47,0,4,0,113,2,35,0,3,204,1,8,213,231,0.554,0.922
"5937","La Paz","El Alto","Esc. Bolivar Municipal",57,2,5,1,90,2,33,0,4,194,3,11,208,227,0.464,0.916
"5938","La Paz","El Alto","Esc. Bolivar Municipal",51,1,12,0,121,1,32,0,1,219,0,3,222,229,0.553,0.969
"5939","La Paz","El Alto","Esc. Bolivar Municipal",66,2,6,1,110,3,17,0,3,208,2,5,215,227,0.529,0.947
"5940","La Paz","El Alto","Colegio Puerto Del Rosario",66,3,6,1,102,2,31,1,2,214,0,3,217,233,0.477,0.931
"5941","La Paz","El Alto","Colegio Puerto Del Rosario",49,3,4,1,108,3,36,0,1,205,1,5,211,231,0.527,0.913
"5942","La Paz","El Alto","Colegio Puerto Del Rosario",67,1,2,0,100,0,38,0,2,210,0,15,225,237,0.476,0.949
"5943","La Paz","El Alto","Colegio Puerto Del Rosario",43,1,3,0,116,2,40,1,4,210,2,7,219,234,0.552,0.936
"5944","La Paz","El Alto","Colegio Puerto Del Rosario",65,2,2,0,111,3,33,0,2,218,1,6,225,237,0.509,0.949
"5945","La Paz","El Alto","Colegio Puerto Del Rosario",49,0,4,1,111,3,40,1,2,211,1,7,219,236,0.526,0.928
"5946","La Paz","El Alto","Colegio Puerto Del Rosario",65,1,3,0,107,2,34,1,1,214,3,9,226,239,0.5,0.946
"5947","La Paz","El Alto","Colegio Puerto Del Rosario - Recinto 1403",65,0,7,0,93,3,36,0,1,205,1,3,209,227,0.454,0.921
"5948","La Paz","El Alto","Colegio Puerto Del Rosario - Recinto 1403",72,1,3,0,94,1,33,1,2,207,1,4,212,229,0.454,0.926
"5949","La Paz","El Alto","Colegio Puerto Del Rosario - Recinto 1403",69,1,8,0,92,0,17,0,4,191,2,6,199,218,0.482,0.913
"5950","La Paz","El Alto","Colegio Puerto Del Rosario - Recinto 1403",53,1,1,0,118,2,36,0,1,212,1,5,218,235,0.557,0.928
"5951","La Paz","El Alto","Colegio Puerto Del Rosario - Recinto 1403",80,0,6,0,93,1,19,0,2,201,2,5,208,226,0.463,0.92
"5952","La Paz","El Alto","Colegio Puerto Del Rosario - Recinto 1403",60,3,6,0,95,5,25,0,3,197,1,4,202,226,0.482,0.894
"5953","La Paz","El Alto","Colegio Puerto Del Rosario - Recinto 1403",53,0,5,0,110,2,28,1,5,204,4,4,212,226,0.539,0.938
"5954","La Paz","El Alto","Colegio Puerto Del Rosario - Recinto 1403",46,1,6,1,110,3,28,0,0,195,1,10,206,226,0.564,0.912
"5955","La Paz","El Alto","Colegio Puerto Del Rosario - Recinto 1403",53,0,6,2,98,5,33,2,3,202,1,3,206,225,0.485,0.916
"5956","La Paz","El Alto","Colegio Puerto Del Rosario - Recinto 1403",59,0,2,1,114,1,27,0,0,204,1,7,212,227,0.559,0.934
"5957","La Paz","El Alto","Colegio Puerto Del Rosario - Recinto 1403",46,0,1,0,125,0,29,2,2,205,1,9,215,229,0.61,0.939
"5958","La Paz","El Alto","Colegio Puerto Del Rosario - Recinto 1403",58,3,6,1,96,1,28,0,5,198,0,3,201,220,0.485,0.914
"5959","La Paz","El Alto","Colegio Puerto Del Rosario - Recinto 1403",66,0,4,1,109,1,24,0,2,207,1,1,209,224,0.527,0.933
"5960","La Paz","El Alto","Colegio Puerto Del Rosario - Recinto 1403",52,1,10,0,105,0,24,0,2,194,2,8,204,220,0.541,0.927
"5961","La Paz","El Alto","Colegio Puerto Del Rosario - Recinto 1403",62,1,6,1,89,2,35,0,1,197,2,7,206,224,0.452,0.92
"5962","La Paz","El Alto","Colegio Puerto Del Rosario - Recinto 1403",62,0,7,1,107,2,24,0,3,206,1,4,211,230,0.519,0.917
"5963","La Paz","El Alto","Colegio Puerto Del Rosario - Recinto 1403",57,2,8,1,107,3,29,1,2,210,1,2,213,230,0.51,0.926
"5964","La Paz","El Alto","Colegio Puerto Del Rosario - Recinto 1403",56,0,4,0,104,1,31,1,1,198,0,11,209,225,0.525,0.929
"5965","La Paz","El Alto","Colegio Puerto Del Rosario - Recinto 1403",74,2,4,0,99,3,16,0,1,199,1,10,210,227,0.497,0.925
"5966","La Paz","El Alto","Colegio Puerto Del Rosario - Recinto 1403",56,1,6,1,110,1,21,0,0,196,1,6,203,219,0.561,0.927
"5967","La Paz","El Alto","Colegio Puerto Del Rosario - Recinto 1403",47,1,3,0,104,1,31,0,3,190,0,11,201,220,0.547,0.914
"5968","La Paz","El Alto","Colegio Puerto Del Rosario - Recinto 1403",55,1,5,1,102,2,32,1,2,201,1,5,207,222,0.507,0.932
"5969","La Paz","El Alto","Colegio Puerto Del Rosario - Recinto 1403",42,1,6,1,114,2,30,1,1,198,0,7,205,223,0.576,0.919
"5970","La Paz","El Alto","Colegio Puerto Del Rosario - Recinto 1403",64,0,3,0,99,2,22,0,3,193,2,3,198,225,0.513,0.88
"5971","La Paz","El Alto","Colegio Puerto Del Rosario - Recinto 1403",40,2,5,0,117,2,24,2,1,193,3,7,203,210,0.606,0.967
"5972","La Paz","El Alto","Colegio Puerto Del Rosario - Recinto 1403",56,0,8,0,102,2,38,0,1,207,0,4,211,225,0.493,0.938
"5973","La Paz","El Alto","Colegio Puerto Del Rosario - Recinto 1403",41,0,5,0,115,1,36,1,2,201,2,7,210,226,0.572,0.929
"5974","La Paz","El Alto","Colegio Puerto Del Rosario - Recinto 1403",56,0,3,0,110,1,27,0,2,199,2,5,206,225,0.553,0.916
"5975","La Paz","El Alto","Colegio Puerto Del Rosario - Recinto 1403",55,0,4,0,115,2,25,0,2,203,1,9,213,231,0.567,0.922
"5976","La Paz","El Alto","Colegio Puerto Del Rosario - Recinto 1403",75,0,3,0,101,1,19,0,1,200,3,10,213,225,0.505,0.947
"5977","La Paz","El Alto","Colegio Puerto Del Rosario - Recinto 1403",71,0,4,1,98,0,25,0,3,202,1,12,215,228,0.485,0.943
"5978","La Paz","El Alto","Colegio Puerto Del Rosario - Recinto 1403",61,1,5,0,100,2,29,1,2,201,0,10,211,234,0.498,0.902
"5979","La Paz","El Alto","Colegio Puerto Del Rosario - Recinto 1403",68,1,4,0,101,0,21,1,1,197,2,13,212,223,0.513,0.951
"5980","La Paz","El Alto","Colegio Puerto Del Rosario - Recinto 1403",72,2,4,0,103,0,24,1,3,209,3,3,215,234,0.493,0.919
"5981","La Paz","El Alto","Colegio Puerto Del Rosario - Recinto 1403",42,1,5,1,115,0,30,1,3,198,0,6,204,226,0.581,0.903
"5982","La Paz","El Alto","Colegio Puerto Del Rosario - Recinto 1403",69,0,7,1,102,2,16,1,0,198,0,3,201,219,0.515,0.918
"5983","La Paz","El Alto","Colegio Puerto Del Rosario - Recinto 1403",59,0,5,0,100,2,41,1,3,211,0,6,217,231,0.474,0.939
"5984","La Paz","El Alto","Colegio Puerto Del Rosario - Recinto 1403",55,3,10,1,111,2,23,1,1,207,3,7,217,229,0.536,0.948
"5985","La Paz","El Alto","Colegio Puerto Del Rosario - Recinto 1403",78,0,10,0,92,1,15,1,2,199,1,6,206,223,0.462,0.924
"5986","La Paz","El Alto","Colegio Puerto Del Rosario - Recinto 1403",68,1,3,0,85,9,26,0,2,194,2,6,202,230,0.438,0.878
"5987","La Paz","El Alto","Colegio Puerto Del Rosario - Recinto 1403",70,0,5,0,109,0,34,0,0,218,1,5,224,233,0.5,0.961
"5988","La Paz","El Alto","Colegio Puerto Del Rosario - Recinto 1403",61,0,3,0,109,0,22,0,2,197,3,9,209,224,0.553,0.933
"5989","La Paz","El Alto","Colegio Puerto Del Rosario - Recinto 1403",51,0,1,0,115,0,32,0,2,201,2,5,208,227,0.572,0.916
"5990","La Paz","El Alto","Colegio Puerto Del Rosario - Recinto 1403",72,1,5,1,102,1,19,1,1,203,1,10,214,230,0.502,0.93
"5991","La Paz","El Alto","Colegio Puerto Del Rosario - Recinto 1403",78,0,0,0,100,3,20,1,2,204,3,8,215,229,0.49,0.939
"5992","La Paz","El Alto","Colegio Puerto Del Rosario - Recinto 1403",61,1,6,1,96,2,26,0,0,193,1,9,203,229,0.497,0.886
"5993","La Paz","El Alto","Colegio Puerto Del Rosario - Recinto 1403",66,2,6,0,83,1,24,1,2,185,3,11,199,222,0.449,0.896
"5994","La Paz","El Alto","U.E. Villa Victoria ""B""",43,0,4,0,90,3,36,0,1,177,0,5,182,199,0.508,0.915
"5995","La Paz","El Alto","Unidad Educativa Union Europea",68,1,5,0,112,2,18,1,3,210,2,2,214,225,0.533,0.951
"5996","La Paz","El Alto","Unidad Educativa Union Europea",89,1,0,1,76,3,26,1,2,199,0,8,207,222,0.382,0.932
"5997","La Paz","El Alto","Unidad Educativa Union Europea",84,1,7,0,76,5,18,1,1,193,1,8,202,220,0.394,0.918
"5998","La Paz","El Alto","Unidad Educativa Union Europea",57,0,4,1,108,0,31,0,1,202,0,4,206,226,0.535,0.912
"5999","La Paz","El Alto","Unidad Educativa Union Europea",85,0,4,0,89,1,20,0,3,202,0,4,206,221,0.441,0.932
"6000","La Paz","El Alto","Unidad Educativa Union Europea",86,0,1,0,83,3,24,0,2,199,2,7,208,227,0.417,0.916
"6001","La Paz","El Alto","Unidad Educativa Union Europea",84,0,1,0,88,2,22,2,2,201,3,4,208,227,0.438,0.916
"6002","La Paz","El Alto","Unidad Educativa Union Europea",86,0,4,1,84,5,0,0,0,180,2,2,184,226,0.467,0.814
"6003","La Paz","El Alto","Unidad Educativa Union Europea",64,1,1,1,84,3,34,1,5,194,3,9,206,229,0.433,0.9
"6004","La Paz","El Alto","Unidad Educativa Union Europea",66,1,4,1,98,7,25,0,1,203,0,2,205,222,0.483,0.923
"6005","La Paz","El Alto","Unidad Educativa Union Europea",66,0,0,1,100,1,28,2,3,201,1,4,206,218,0.498,0.945
"6006","La Paz","El Alto","Unidad Educativa Union Europea",67,0,8,1,106,1,26,0,3,212,1,7,220,236,0.5,0.932
"6007","La Paz","El Alto","Unidad Educativa Union Europea",74,1,8,0,96,0,26,0,3,208,2,3,213,225,0.462,0.947
"6008","La Paz","El Alto","Unidad Educativa Union Europea",66,1,3,1,89,3,38,0,4,205,0,5,210,227,0.434,0.925
"6009","La Paz","El Alto","Unidad Educativa Union Europea",63,1,5,3,91,6,32,0,2,203,0,5,208,227,0.448,0.916
"6010","La Paz","El Alto","Unidad Educativa Union Europea",63,0,4,2,99,3,28,1,1,201,2,5,208,220,0.493,0.945
"6011","La Paz","El Alto","Unidad Educativa Union Europea",72,0,7,0,91,5,31,1,1,208,1,2,211,227,0.438,0.93
"6012","La Paz","El Alto","Unidad Educativa Union Europea",75,1,5,0,90,0,35,0,1,207,1,2,210,227,0.435,0.925
"6013","La Paz","El Alto","Unidad Educativa Union Europea",70,1,6,0,101,3,19,0,3,203,3,4,210,225,0.498,0.933
"6014","La Paz","El Alto","Unidad Educativa Union Europea",82,0,5,0,98,3,15,0,2,205,0,2,207,226,0.478,0.916
"6015","La Paz","El Alto","Unidad Educativa Union Europea",67,2,3,1,94,2,14,0,2,185,2,7,194,217,0.508,0.894
"6016","La Paz","El Alto","Unidad Educativa Union Europea",77,2,6,0,85,1,23,2,0,196,1,7,204,216,0.434,0.944
"6017","La Paz","El Alto","Unidad Educativa Union Europea",78,0,6,0,81,5,22,1,1,194,0,5,199,218,0.418,0.913
"6018","La Paz","El Alto","Unidad Educativa Union Europea",71,1,3,0,105,3,21,0,2,206,2,6,214,225,0.51,0.951
"6019","La Paz","El Alto","Unidad Educativa Union Europea",67,0,6,0,111,3,10,0,0,197,3,6,206,224,0.563,0.92
"6020","La Paz","El Alto","Unidad Educativa Union Europea",71,0,2,2,80,4,24,2,3,188,2,5,195,221,0.426,0.882
"6021","La Paz","El Alto","Unidad Educativa Union Europea",53,0,5,0,113,5,20,1,4,201,2,3,206,226,0.562,0.912
"6022","La Paz","El Alto","Unidad Educativa Union Europea",53,3,2,1,100,3,29,0,4,195,1,7,203,225,0.513,0.902
"6023","La Paz","El Alto","Unidad Educativa Union Europea",68,0,7,0,107,4,26,0,0,212,3,2,217,229,0.505,0.948
"6024","La Paz","El Alto","Unidad Educativa Union Europea",75,2,4,0,84,4,35,0,4,208,2,4,214,231,0.404,0.926
"6025","La Paz","El Alto","Unidad Educativa Union Europea",66,0,7,0,98,1,26,2,3,203,2,5,210,226,0.483,0.929
"6026","La Paz","El Alto","Unidad Educativa Union Europea",84,1,3,1,87,1,23,1,1,202,1,5,208,226,0.431,0.92
"6027","La Paz","El Alto","Unidad Educativa Union Europea",55,0,7,1,104,2,24,1,1,195,1,6,202,217,0.533,0.931
"6028","La Paz","El Alto","Unidad Educativa Union Europea",64,0,6,1,101,2,29,0,3,206,2,8,216,229,0.49,0.943
"6029","La Paz","El Alto","Unidad Educativa Union Europea",70,2,6,0,103,2,27,1,1,212,1,3,216,231,0.486,0.935
"6030","La Paz","El Alto","Unidad Educativa Union Europea",60,1,6,0,109,4,28,0,1,209,1,5,215,227,0.522,0.947
"6031","La Paz","El Alto","Unidad Educativa Union Europea",73,1,5,0,97,2,22,0,2,202,4,3,209,228,0.48,0.917
"6032","La Paz","El Alto","Unidad Educativa Union Europea",91,0,7,1,78,1,19,0,4,201,1,9,211,232,0.388,0.909
"6033","La Paz","El Alto","Unidad Educativa Union Europea",77,1,1,1,94,1,30,1,1,207,1,3,211,226,0.454,0.934
"6034","La Paz","El Alto","Unidad Educativa Union Europea",72,0,1,2,87,3,22,0,2,189,0,6,195,217,0.46,0.899
"6035","La Paz","El Alto","Unidad Educativa Union Europea",81,1,4,1,88,4,15,1,5,200,2,5,207,223,0.44,0.928
"6036","La Paz","El Alto","Unidad Educativa Union Europea",80,1,5,0,103,2,14,0,2,207,1,4,212,226,0.498,0.938
"6037","La Paz","El Alto","Unidad Educativa Union Europea",64,1,5,2,102,2,18,1,2,197,1,7,205,222,0.518,0.923
"6038","La Paz","El Alto","Unidad Educativa Union Europea",73,0,1,1,84,2,42,0,3,206,3,4,213,230,0.408,0.926
"6039","La Paz","El Alto","Unidad Educativa Union Europea",54,0,5,1,111,4,27,0,0,202,0,5,207,225,0.55,0.92
"6040","La Paz","El Alto","Unidad Educativa Union Europea",73,1,5,1,80,1,24,1,3,189,1,4,194,216,0.423,0.898
"6041","La Paz","El Alto","Unidad Educativa Union Europea",59,0,6,1,113,1,23,0,1,204,0,4,208,224,0.554,0.929
"6042","La Paz","El Alto","Unidad Educativa Union Europea",53,0,7,1,102,3,34,1,2,203,3,3,209,227,0.502,0.921
"6043","La Paz","El Alto","Unidad Educativa Union Europea",71,0,6,0,86,3,36,1,2,205,1,4,210,226,0.42,0.929
"6044","La Paz","El Alto","Unidad Educativa Union Europea",79,1,2,1,88,1,29,2,1,204,0,6,210,227,0.431,0.925
"6045","La Paz","El Alto","Unidad Educativa Union Europea",79,0,1,1,79,3,32,1,3,199,1,4,204,228,0.397,0.895
"6046","La Paz","El Alto","Unidad Educativa Union Europea",77,0,4,1,94,3,23,2,0,204,2,5,211,228,0.461,0.925
"6047","La Paz","El Alto","Unidad Educativa Union Europea",61,3,1,0,105,3,25,1,2,201,18,6,225,225,0.522,1
"6048","La Paz","El Alto","Unidad Educativa Union Europea",71,1,3,1,91,2,27,2,2,200,0,4,204,223,0.455,0.915
"6049","La Paz","El Alto","Unidad Educativa Union Europea",72,0,2,0,101,2,22,2,2,203,1,6,210,228,0.498,0.921
"6050","La Paz","El Alto","Unidad Educativa Union Europea",72,2,4,1,109,2,23,0,0,213,3,7,223,231,0.512,0.965
"6051","La Paz","El Alto","Unidad Educativa Union Europea",85,2,5,0,77,2,29,0,2,202,1,12,215,231,0.381,0.931
"6052","La Paz","El Alto","Unidad Educativa Union Europea",86,0,4,2,81,3,24,0,0,200,0,8,208,227,0.405,0.916
"6053","La Paz","El Alto","Unidad Educativa Union Europea",73,0,4,2,96,1,24,1,3,204,2,6,212,223,0.471,0.951
"6054","La Paz","El Alto","Unidad Educativa Union Europea",85,1,4,0,78,4,25,0,3,200,0,8,208,225,0.39,0.924
"6055","La Paz","El Alto","Unidad Educativa Union Europea",70,1,2,1,91,4,32,1,1,203,3,5,211,228,0.448,0.925
"6056","La Paz","El Alto","Unidad Educativa Union Europea",67,2,0,0,66,4,19,0,4,162,0,4,166,184,0.407,0.902
"6057","La Paz","El Alto","Sede Vecinal",111,0,3,0,59,3,22,2,0,200,1,3,204,222,0.295,0.919
"6058","La Paz","El Alto","Sede Vecinal",76,2,8,0,77,4,30,0,2,199,0,5,204,223,0.387,0.915
"6059","La Paz","El Alto","Col. Libertador S. Bolivar",64,0,2,0,109,3,27,0,0,205,2,3,210,224,0.532,0.938
"6060","La Paz","El Alto","Col. Libertador S. Bolivar",68,1,5,1,108,3,23,0,1,210,0,6,216,229,0.514,0.943
"6061","La Paz","El Alto","Col. Libertador S. Bolivar",62,0,1,0,104,4,32,0,0,203,1,9,213,227,0.512,0.938
"6062","La Paz","El Alto","Col. Libertador S. Bolivar",69,2,8,0,102,1,20,1,1,204,0,7,211,226,0.5,0.934
"6063","La Paz","El Alto","Col. Libertador S. Bolivar",65,0,2,0,106,2,26,1,2,204,2,7,213,226,0.52,0.942
"6064","La Paz","El Alto","Col. Libertador S. Bolivar",59,0,4,0,103,2,34,0,3,205,1,4,210,229,0.502,0.917
"6065","La Paz","El Alto","Col. Libertador S. Bolivar",66,1,4,0,109,3,25,0,1,209,1,3,213,230,0.522,0.926
"6066","La Paz","El Alto","Col. Libertador S. Bolivar",73,1,3,1,113,0,20,1,2,214,0,4,218,226,0.528,0.965
"6067","La Paz","El Alto","Col. Libertador S. Bolivar",75,1,7,0,90,4,24,0,1,202,2,8,212,232,0.446,0.914
"6068","La Paz","El Alto","Col. Libertador S. Bolivar",64,1,8,0,101,5,25,2,0,206,2,6,214,226,0.49,0.947
"6069","La Paz","El Alto","Col. Libertador S. Bolivar",84,1,3,1,84,5,30,0,2,210,0,1,211,229,0.4,0.921
"6070","La Paz","El Alto","Col. Libertador S. Bolivar",54,1,5,0,114,1,17,0,1,193,1,6,200,219,0.591,0.913
"6071","La Paz","El Alto","Col. Libertador S. Bolivar",43,1,14,0,107,3,24,1,5,198,4,5,207,232,0.54,0.892
"6072","La Paz","El Alto","Col. Libertador S. Bolivar",76,1,9,2,80,2,26,1,1,198,4,9,211,228,0.404,0.925
"6073","La Paz","El Alto","Col. Libertador S. Bolivar",72,1,6,0,79,5,41,0,3,207,4,3,214,227,0.382,0.943
"6074","La Paz","El Alto","Col. Libertador S. Bolivar",67,1,4,0,93,3,29,0,3,200,1,7,208,226,0.465,0.92
"6075","La Paz","El Alto","Col. Libertador S. Bolivar",69,0,7,1,103,1,16,0,2,199,5,8,212,231,0.518,0.918
"6076","La Paz","El Alto","Col. Libertador S. Bolivar",69,0,4,0,95,2,28,2,1,201,0,6,207,223,0.473,0.928
"6077","La Paz","El Alto","Col. Libertador S. Bolivar",70,0,5,1,99,4,17,0,1,197,0,7,204,223,0.503,0.915
"6078","La Paz","El Alto","Col. Libertador S. Bolivar",76,0,6,1,97,3,19,0,3,205,1,8,214,230,0.473,0.93
"6079","La Paz","El Alto","Col. Libertador S. Bolivar",57,0,1,0,112,2,29,0,1,202,2,8,212,225,0.554,0.942
"6080","La Paz","El Alto","Col. Libertador S. Bolivar",64,0,4,1,106,3,28,3,3,212,0,4,216,230,0.5,0.939
"6081","La Paz","El Alto","Col. Libertador S. Bolivar",58,1,5,1,102,1,40,0,1,209,0,2,211,228,0.488,0.925
"6082","La Paz","El Alto","Col. Eduardo Avaroa",49,5,7,2,106,1,27,2,1,200,2,6,208,232,0.53,0.897
"6083","La Paz","El Alto","Col. Eduardo Avaroa",59,1,7,0,106,2,29,2,2,208,1,4,213,229,0.51,0.93
"6084","La Paz","El Alto","Col. Eduardo Avaroa",49,2,3,2,103,3,35,1,2,200,0,5,205,220,0.515,0.932
"6085","La Paz","El Alto","Col. Eduardo Avaroa",57,1,7,1,100,3,29,0,1,199,1,6,206,221,0.503,0.932
"6086","La Paz","El Alto","Col. Eduardo Avaroa",65,1,8,0,100,1,17,0,2,194,1,6,201,223,0.515,0.901
"6087","La Paz","El Alto","Col. Eduardo Avaroa",47,0,7,0,110,1,34,0,2,201,2,10,213,231,0.547,0.922
"6088","La Paz","El Alto","Col. Eduardo Avaroa",61,0,8,2,90,0,48,1,1,211,0,5,216,229,0.427,0.943
"6089","La Paz","El Alto","Col. Eduardo Avaroa",51,0,5,0,118,1,20,1,0,196,3,4,203,225,0.602,0.902
"6090","La Paz","El Alto","Col. Eduardo Avaroa",51,1,3,4,114,0,28,3,0,204,2,10,216,228,0.559,0.947
"6091","La Paz","El Alto","Col. Eduardo Avaroa",49,0,3,0,108,4,37,2,3,206,1,9,216,226,0.524,0.956
"6092","La Paz","El Alto","Col. Eduardo Avaroa",53,0,8,0,101,2,39,0,2,205,3,4,212,227,0.493,0.934
"6093","La Paz","El Alto","Col. Eduardo Avaroa",55,1,8,2,95,2,25,2,3,193,1,2,196,226,0.492,0.867
"6094","La Paz","El Alto","Col. Eduardo Avaroa",47,1,8,0,109,2,28,0,2,197,1,10,208,220,0.553,0.945
"6095","La Paz","El Alto","Col. Eduardo Avaroa",58,1,0,2,88,3,22,0,2,176,0,6,182,190,0.5,0.958
"6096","La Paz","El Alto","Unid. Educ.  M. Quiroga Santa Cruz",64,0,7,1,110,1,20,0,1,204,0,6,210,225,0.539,0.933
"6097","La Paz","El Alto","Unid. Educ.  M. Quiroga Santa Cruz",62,0,3,0,102,3,27,0,3,200,1,9,210,222,0.51,0.946
"6098","La Paz","El Alto","Unid. Educ.  M. Quiroga Santa Cruz",64,0,2,0,107,0,25,1,1,200,5,9,214,229,0.535,0.934
"6099","La Paz","El Alto","Unid. Educ.  M. Quiroga Santa Cruz",69,2,7,0,88,3,37,0,1,207,3,7,217,229,0.425,0.948
"6100","La Paz","El Alto","Unid. Educ.  M. Quiroga Santa Cruz",69,3,5,0,93,3,26,1,1,201,2,7,210,222,0.463,0.946
"6101","La Paz","El Alto","Unid. Educ.  M. Quiroga Santa Cruz",60,2,8,0,103,1,24,0,4,202,0,6,208,228,0.51,0.912
"6102","La Paz","El Alto","Unid. Educ.  M. Quiroga Santa Cruz",56,0,3,0,105,1,37,0,0,202,0,4,206,226,0.52,0.912
"6103","La Paz","El Alto","Unid. Educ.  M. Quiroga Santa Cruz",59,2,7,0,114,0,20,0,2,204,0,4,208,229,0.559,0.908
"6104","La Paz","El Alto","Unid. Educ.  M. Quiroga Santa Cruz",65,1,6,1,105,2,24,0,1,205,0,6,211,225,0.512,0.938
"6105","La Paz","El Alto","Unid. Educ.  M. Quiroga Santa Cruz",76,1,1,1,83,3,31,0,0,196,3,7,206,223,0.423,0.924
"6106","La Paz","El Alto","Unid. Educ.  M. Quiroga Santa Cruz",52,1,2,1,111,2,27,1,1,198,0,14,212,229,0.561,0.926
"6107","La Paz","El Alto","Unid. Educ.  M. Quiroga Santa Cruz",64,0,6,3,85,2,30,0,2,192,3,4,199,221,0.443,0.9
"6108","La Paz","El Alto","Unid. Educ.  M. Quiroga Santa Cruz",66,1,6,0,95,1,27,0,1,197,1,10,208,220,0.482,0.945
"6109","La Paz","El Alto","Unid. Educ.  M. Quiroga Santa Cruz",44,0,7,1,96,0,20,0,2,170,2,3,175,191,0.565,0.916
"6110","La Paz","El Alto","Unidad Educativa Carlos Palenque",43,0,6,0,122,3,27,0,2,203,0,8,211,226,0.601,0.934
"6111","La Paz","El Alto","Unidad Educativa Carlos Palenque",55,0,4,0,99,4,46,0,4,212,4,4,220,228,0.467,0.965
"6112","La Paz","El Alto","Unidad Educativa Carlos Palenque",54,2,3,3,112,2,23,0,7,206,3,8,217,232,0.544,0.935
"6113","La Paz","El Alto","Unidad Educativa Carlos Palenque",69,0,6,0,96,3,35,0,1,210,0,2,212,226,0.457,0.938
"6114","La Paz","El Alto","Unidad Educativa Carlos Palenque",55,2,6,0,101,1,30,0,2,197,1,6,204,221,0.513,0.923
"6115","La Paz","El Alto","Unidad Educativa Carlos Palenque",43,0,3,0,102,4,35,0,3,190,1,8,199,224,0.537,0.888
"6116","La Paz","El Alto","Unidad Educativa Carlos Palenque",60,0,7,2,88,3,24,4,0,188,1,10,199,228,0.468,0.873
"6117","La Paz","El Alto","Unidad Educativa Carlos Palenque",50,0,5,0,119,2,28,1,1,206,3,3,212,228,0.578,0.93
"6118","La Paz","El Alto","Unidad Educativa Carlos Palenque",55,1,4,0,107,4,26,2,1,200,2,5,207,223,0.535,0.928
"6119","La Paz","El Alto","Unidad Educativa Carlos Palenque",70,0,4,0,83,4,34,2,3,200,1,7,208,226,0.415,0.92
"6120","La Paz","El Alto","Unidad Educativa Carlos Palenque",43,0,3,1,100,3,42,0,2,194,0,11,205,226,0.515,0.907
"6121","La Paz","El Alto","Unidad Educativa Carlos Palenque",47,2,3,0,107,2,35,1,8,205,0,8,213,227,0.522,0.938
"6122","La Paz","El Alto","Unidad Educativa Carlos Palenque",50,0,3,1,120,2,28,0,0,204,2,3,209,222,0.588,0.941
"6123","La Paz","El Alto","Unidad Educativa Carlos Palenque",60,3,3,0,110,2,21,0,2,201,1,8,210,223,0.547,0.942
"6124","La Paz","El Alto","Unidad Educativa Carlos Palenque",53,0,10,0,117,4,21,0,1,206,3,2,211,227,0.568,0.93
"6125","La Paz","El Alto","Unidad Educativa Carlos Palenque",83,1,4,0,87,2,30,1,4,212,2,7,221,229,0.41,0.965
"6126","La Paz","El Alto","Unidad Educativa  Alto De La Alianza",46,1,6,0,119,2,31,1,1,207,1,9,217,228,0.575,0.952
"6127","La Paz","El Alto","Unidad Educativa  Alto De La Alianza",60,0,7,1,105,1,24,0,4,202,0,5,207,228,0.52,0.908
"6128","La Paz","El Alto","Unidad Educativa  Alto De La Alianza",56,0,6,0,115,0,1,30,1,209,1,6,216,232,0.55,0.931
"6129","La Paz","El Alto","Unidad Educativa  Alto De La Alianza",58,2,6,1,96,1,26,1,4,195,3,12,210,230,0.492,0.913
"6130","La Paz","El Alto","Unidad Educativa  Alto De La Alianza",38,8,11,3,66,2,39,2,0,169,40,5,214,228,0.391,0.939
"6131","La Paz","El Alto","Unidad Educativa  Alto De La Alianza",49,2,5,2,122,1,26,1,1,209,0,5,214,228,0.584,0.939
"6132","La Paz","El Alto","Unidad Educativa  Alto De La Alianza",61,1,7,0,86,2,37,0,2,196,0,7,203,229,0.439,0.886
"6133","La Paz","El Alto","Unidad Educativa  Alto De La Alianza",51,0,8,0,113,5,24,1,4,206,1,6,213,233,0.549,0.914
"6134","La Paz","El Alto","Unidad Educativa  Alto De La Alianza",46,1,8,0,110,7,33,0,2,207,6,6,219,234,0.531,0.936
"6135","La Paz","El Alto","Unidad Educativa  Alto De La Alianza",31,1,10,1,133,5,25,0,2,208,2,8,218,229,0.639,0.952
"6136","La Paz","El Alto","Unidad Educativa  Alto De La Alianza",21,1,12,1,128,1,39,0,1,204,3,6,213,231,0.627,0.922
"6137","La Paz","El Alto","Unidad Educativa  Alto De La Alianza",63,0,5,1,110,1,29,0,2,211,0,4,215,227,0.521,0.947
"6138","La Paz","El Alto","Unidad Educativa  Alto De La Alianza",50,0,9,0,116,6,29,1,3,214,1,3,218,234,0.542,0.932
"6139","La Paz","El Alto","Unidad Educativa  Alto De La Alianza",49,0,11,0,109,1,29,1,4,204,1,6,211,229,0.534,0.921
"6140","La Paz","El Alto","Unidad Educativa  Alto De La Alianza",32,1,7,0,121,0,40,2,2,205,1,5,211,225,0.59,0.938
"6141","La Paz","El Alto","Unidad Educativa  Alto De La Alianza",60,0,3,1,106,3,24,1,5,203,3,6,212,228,0.522,0.93
"6142","La Paz","El Alto","Unidad Educativa  Alto De La Alianza",52,1,4,0,120,1,24,0,3,205,2,4,211,226,0.585,0.934
"6143","La Paz","El Alto","Unidad Educativa  Alto De La Alianza",59,0,5,1,106,2,37,0,0,210,1,7,218,231,0.505,0.944
"6144","La Paz","El Alto","Unidad Educativa Republica de Cuba - Pacajes - 1704",49,0,10,2,116,3,17,0,3,200,1,4,205,226,0.58,0.907
"6145","La Paz","El Alto","Unidad Educativa Republica de Cuba - Pacajes - 1704",69,0,4,1,100,1,28,0,1,204,1,3,208,227,0.49,0.916
"6146","La Paz","El Alto","Unidad Educativa Republica de Cuba - Pacajes - 1704",48,0,1,0,108,2,35,0,2,196,1,5,202,226,0.551,0.894
"6147","La Paz","El Alto","Unidad Educativa Republica de Cuba - Pacajes - 1704",56,0,9,3,99,0,23,1,2,193,2,3,198,222,0.513,0.892
"6148","La Paz","El Alto","Unidad Educativa Republica de Cuba - Pacajes - 1704",61,2,4,0,102,2,27,1,0,199,1,7,207,225,0.513,0.92
"6149","La Paz","El Alto","Unidad Educativa Adela Zamudio",63,2,4,0,95,4,28,0,5,201,2,13,216,226,0.473,0.956
"6150","La Paz","El Alto","Unidad Educativa Adela Zamudio",48,3,5,0,92,0,20,0,2,170,0,45,215,228,0.541,0.943
"6151","La Paz","El Alto","Unidad Educativa Adela Zamudio",54,0,6,0,122,0,24,1,1,208,3,11,222,232,0.587,0.957
"6152","La Paz","El Alto","Unidad Educativa Adela Zamudio",56,1,7,0,117,1,31,0,5,218,2,3,223,231,0.537,0.965
"6153","La Paz","El Alto","Unidad Educativa Adela Zamudio",60,1,7,0,106,2,21,1,2,200,3,6,209,223,0.53,0.937
"6154","La Paz","El Alto","Unidad Educativa Adela Zamudio",39,0,7,0,116,1,32,0,2,197,2,9,208,224,0.589,0.929
"6155","La Paz","El Alto","Unidad Educativa Adela Zamudio",52,0,9,0,114,3,26,0,1,205,3,7,215,226,0.556,0.951
"6156","La Paz","El Alto","Unidad Educativa Adela Zamudio",63,2,12,0,112,2,21,0,2,214,0,6,220,230,0.523,0.957
"6157","La Paz","El Alto","Unidad Educativa Adela Zamudio",45,0,11,0,118,2,32,0,3,211,0,7,218,228,0.559,0.956
"6158","La Paz","El Alto","Unidad Educativa Adela Zamudio",51,0,8,2,81,1,30,0,5,178,1,32,211,226,0.455,0.934
"6159","La Paz","El Alto","Unidad Educativa Adela Zamudio",52,0,5,0,97,2,17,0,1,174,0,9,183,193,0.557,0.948
"6160","La Paz","El Alto","Col. Calama",49,0,3,0,106,0,31,1,1,191,0,6,197,224,0.555,0.879
"6161","La Paz","El Alto","Col. Calama",46,0,4,1,128,3,32,0,0,214,1,7,222,232,0.598,0.957
"6162","La Paz","El Alto","Col. Calama",48,1,8,1,113,1,22,1,7,202,0,5,207,221,0.559,0.937
"6163","La Paz","El Alto","Col. Calama",54,1,9,9,95,2,27,1,1,199,0,16,215,223,0.477,0.964
"6164","La Paz","El Alto","Col. Calama",57,2,2,0,102,4,29,10,1,207,0,5,212,230,0.493,0.922
"6165","La Paz","El Alto","Col. Calama",60,0,6,1,109,1,29,1,3,210,0,4,214,230,0.519,0.93
"6166","La Paz","El Alto","Col. Calama",54,2,3,0,120,6,17,1,2,205,2,8,215,232,0.585,0.927
"6167","La Paz","El Alto","Col. Calama",54,3,2,0,115,6,30,1,1,212,0,7,219,231,0.542,0.948
"6168","La Paz","El Alto","Col. Calama",62,1,5,2,101,4,26,0,1,202,0,3,205,224,0.5,0.915
"6169","La Paz","El Alto","Col. Calama",48,1,8,0,110,3,28,0,5,203,2,7,212,226,0.542,0.938
"6170","La Paz","El Alto","Col. Calama",49,0,11,0,115,0,30,0,4,209,0,5,214,226,0.55,0.947
"6171","La Paz","El Alto","Col. Calama",63,1,2,0,99,4,29,0,4,202,2,5,209,227,0.49,0.921
"6172","La Paz","El Alto","Col. Calama",64,1,2,2,113,2,17,0,5,206,0,8,214,230,0.549,0.93
"6173","La Paz","El Alto","Col. Calama",62,0,6,0,109,1,25,0,1,204,2,11,217,232,0.534,0.935
"6174","La Paz","El Alto","Col. Calama",55,1,8,0,105,2,33,0,1,205,2,7,214,236,0.512,0.907
"6175","La Paz","El Alto","Col. Calama",51,1,10,1,110,2,23,0,0,198,0,14,212,226,0.556,0.938
"6176","La Paz","El Alto","Col. Calama",53,1,9,0,111,1,24,0,1,200,0,9,209,225,0.555,0.929
"6177","La Paz","El Alto","Col. Calama",44,0,6,2,122,0,26,1,2,203,2,5,210,224,0.601,0.938
"6178","La Paz","El Alto","Col. Calama",64,0,6,1,92,0,36,1,2,202,3,8,213,227,0.455,0.938
"6179","La Paz","El Alto","Col. Calama",54,1,7,1,112,4,26,0,3,208,1,7,216,226,0.538,0.956
"6180","La Paz","El Alto","Col. Calama",46,1,4,0,125,2,21,0,1,200,2,9,211,228,0.625,0.925
"6181","La Paz","El Alto","Col. Calama",46,1,11,1,113,1,24,0,2,199,0,5,204,232,0.568,0.879
"6182","La Paz","El Alto","Col. Calama",66,0,7,1,94,3,30,0,4,205,0,13,218,231,0.459,0.944
"6183","La Paz","El Alto","Col. Calama",70,0,2,1,107,3,23,0,4,210,0,4,214,230,0.51,0.93
"6184","La Paz","El Alto","Col. Calama",66,0,4,2,105,0,29,0,3,209,0,4,213,231,0.502,0.922
"6185","La Paz","El Alto","Col. Calama",51,0,1,3,123,2,30,1,1,212,0,5,217,231,0.58,0.939
"6186","La Paz","El Alto","Col. Calama",68,0,5,0,102,2,22,0,3,202,2,8,212,226,0.505,0.938
"6187","La Paz","El Alto","Col. Calama",46,2,9,1,113,1,31,1,2,206,3,6,215,228,0.549,0.943
"6188","La Paz","El Alto","Col. Calama",53,0,5,1,101,0,44,0,2,206,2,5,213,228,0.49,0.934
"6189","La Paz","El Alto","Col. Calama",57,2,1,1,105,0,33,0,3,202,2,7,211,225,0.52,0.938
"6190","La Paz","El Alto","Col. Calama",85,1,3,2,86,3,17,0,2,199,3,7,209,225,0.432,0.929
"6191","La Paz","El Alto","Col. Calama",64,1,8,1,107,3,25,0,3,212,1,4,217,228,0.505,0.952
"6192","La Paz","El Alto","Col. Calama",53,1,8,0,106,1,31,3,2,205,1,10,216,226,0.517,0.956
"6193","La Paz","El Alto","Col. Calama",59,0,4,1,98,2,36,1,1,202,1,10,213,223,0.485,0.955
"6194","La Paz","El Alto","Col. Calama",66,1,7,0,109,0,31,0,1,215,2,5,222,235,0.507,0.945
"6195","La Paz","El Alto","Col. Calama",64,1,7,2,100,2,28,1,2,207,0,5,212,234,0.483,0.906
"6196","La Paz","El Alto","Col. 1ro de Mayo",81,0,5,0,93,4,31,0,2,216,1,4,221,228,0.431,0.969
"6197","La Paz","El Alto","Col. 1ro de Mayo",102,0,2,0,69,2,25,2,0,202,2,4,208,218,0.342,0.954
"6198","La Paz","El Alto","Col. 1ro de Mayo",74,0,1,0,93,2,23,1,3,197,0,2,199,218,0.472,0.913
"6199","La Paz","El Alto","Col. 1ro de Mayo",74,2,7,0,92,2,26,0,2,205,1,6,212,230,0.449,0.922
"6200","La Paz","El Alto","Col. 1ro de Mayo",80,0,3,0,99,3,13,0,0,198,3,4,205,223,0.5,0.919
"6201","La Paz","El Alto","Col. 1ro de Mayo",61,0,8,0,107,1,29,1,1,208,1,3,212,230,0.514,0.922
"6202","La Paz","El Alto","Col. 1ro de Mayo",100,0,2,1,76,2,19,0,2,202,2,10,214,226,0.376,0.947
"6203","La Paz","El Alto","Col. 1ro de Mayo",60,0,2,2,107,2,23,0,1,197,0,9,206,223,0.543,0.924
"6204","La Paz","El Alto","Col. 1ro de Mayo",56,1,5,1,112,4,29,1,0,209,2,6,217,230,0.536,0.943
"6205","La Paz","El Alto","Col. 1ro de Mayo",67,0,9,1,95,0,28,0,3,203,1,8,212,232,0.468,0.914
"6206","La Paz","El Alto","Col. 1ro de Mayo",63,0,1,0,103,1,39,1,4,212,2,11,225,231,0.486,0.974
"6207","La Paz","El Alto","Col. 1ro de Mayo",76,0,3,1,97,4,28,1,4,214,1,6,221,232,0.453,0.953
"6208","La Paz","El Alto","Col. 1ro de Mayo",74,2,4,1,100,0,26,0,2,209,1,3,213,228,0.478,0.934
"6209","La Paz","El Alto","Col. 1ro de Mayo",85,0,3,0,95,1,23,0,1,208,0,4,212,226,0.457,0.938
"6210","La Paz","El Alto","Col. 1ro de Mayo",90,1,2,0,88,2,18,2,2,205,1,10,216,230,0.429,0.939
"6211","La Paz","El Alto","Col. 1ro de Mayo",70,2,3,1,82,4,29,0,1,192,3,11,206,221,0.427,0.932
"6212","La Paz","El Alto","Col. 1ro de Mayo",81,3,5,2,93,1,21,4,0,210,2,9,221,229,0.443,0.965
"6213","La Paz","El Alto","Col. 1ro de Mayo",65,0,7,1,104,2,26,1,2,208,1,3,212,228,0.5,0.93
"6214","La Paz","El Alto","Col. 1ro de Mayo",65,1,6,1,92,2,35,0,4,206,0,5,211,226,0.447,0.934
"6215","La Paz","El Alto","Col. 1ro de Mayo",74,1,3,2,92,0,31,0,1,204,1,1,206,224,0.451,0.92
"6216","La Paz","El Alto","Col. 1ro de Mayo",62,1,7,0,107,3,15,0,5,200,0,5,205,225,0.535,0.911
"6217","La Paz","El Alto","Col. 1ro de Mayo",55,1,10,0,116,2,20,1,2,207,0,6,213,228,0.56,0.934
"6218","La Paz","El Alto","Col. 1ro de Mayo",40,0,6,0,134,1,30,0,1,212,2,3,217,231,0.632,0.939
"6219","La Paz","El Alto","Col. 1ro de Mayo",48,1,5,0,125,2,20,0,2,203,2,5,210,226,0.616,0.929
"6220","La Paz","El Alto","Col. 1ro de Mayo",77,1,1,0,90,2,29,1,2,203,2,11,216,229,0.443,0.943
"6221","La Paz","El Alto","Col. 1ro de Mayo",89,1,6,0,70,3,26,0,0,195,2,7,204,228,0.359,0.895
"6222","La Paz","El Alto","Col. 1ro de Mayo",74,1,1,2,98,4,25,1,2,208,3,3,214,230,0.471,0.93
"6223","La Paz","El Alto","Col. 1ro de Mayo",85,1,4,0,90,3,27,0,1,211,1,5,217,228,0.427,0.952
"6224","La Paz","El Alto","Col. 1ro de Mayo",57,1,2,0,108,2,26,1,3,200,0,1,201,225,0.54,0.893
"6225","La Paz","El Alto","Col. 1ro de Mayo",81,1,8,0,86,0,37,0,2,215,2,3,220,227,0.4,0.969
"6226","La Paz","El Alto","Col. 1ro de Mayo",64,2,5,1,101,3,26,0,4,206,2,10,218,232,0.49,0.94
"6227","La Paz","El Alto","Col. 1ro de Mayo",55,1,2,0,108,3,34,0,3,206,0,10,216,225,0.524,0.96
"6228","La Paz","El Alto","Col. 1ro de Mayo",91,0,5,0,84,3,13,0,1,197,0,4,201,228,0.426,0.882
"6229","La Paz","El Alto","Col. 1ro de Mayo",82,1,1,1,82,5,29,0,1,202,1,3,206,227,0.406,0.907
"6230","La Paz","El Alto","Col. 1ro de Mayo",90,2,3,0,77,3,19,1,4,199,3,0,202,220,0.387,0.918
"6231","La Paz","El Alto","Col. 1ro de Mayo",73,0,2,1,92,3,35,0,2,208,0,7,215,228,0.442,0.943
"6232","La Paz","El Alto","Col. 1ro de Mayo",77,1,3,0,91,2,31,2,0,207,1,6,214,231,0.44,0.926
"6233","La Paz","El Alto","Col. 1ro de Mayo",84,0,9,1,89,2,25,0,3,213,1,5,219,232,0.418,0.944
"6234","La Paz","El Alto","Col. 1ro de Mayo",81,1,4,2,87,0,25,2,2,204,2,3,209,225,0.426,0.929
"6235","La Paz","El Alto","Col. 1ro de Mayo",61,2,2,1,86,3,26,0,0,181,1,9,191,214,0.475,0.893
"6236","La Paz","El Alto","Esc. Primavera",47,0,10,0,105,2,34,1,0,199,3,6,208,224,0.528,0.929
"6237","La Paz","El Alto","Esc. Primavera",50,0,6,0,114,0,28,1,1,200,1,2,203,227,0.57,0.894
"6238","La Paz","El Alto","Esc. Primavera",44,2,10,3,92,4,37,0,6,198,1,7,206,233,0.465,0.884
"6239","La Paz","El Alto","Esc. Primavera",55,0,11,1,101,2,31,1,5,207,4,4,215,226,0.488,0.951
"6240","La Paz","El Alto","Esc. Primavera",51,3,6,0,93,0,28,1,2,184,1,9,194,217,0.505,0.894
"6241","La Paz","El Alto","Esc. Primavera",46,2,10,1,100,0,34,2,0,195,2,8,205,224,0.513,0.915
"6242","La Paz","El Alto","Esc. Primavera",54,0,6,2,105,1,29,1,5,203,5,6,214,227,0.517,0.943
"6243","La Paz","El Alto","Esc. Primavera",47,2,5,0,72,1,23,1,2,153,1,4,158,167,0.471,0.946
"6244","La Paz","El Alto","Unidad Educativa La Paz",61,0,2,2,99,2,28,1,3,198,0,11,209,225,0.5,0.929
"6245","La Paz","El Alto","Unidad Educativa La Paz",58,1,3,3,107,3,23,0,0,198,0,7,205,227,0.54,0.903
"6246","La Paz","El Alto","Unidad Educativa La Paz",52,2,1,1,115,2,26,0,3,202,4,4,210,220,0.569,0.955
"6247","La Paz","El Alto","Unidad Educativa La Paz",64,1,2,0,97,2,36,0,0,202,2,6,210,228,0.48,0.921
"6248","La Paz","El Alto","Unidad Educativa La Paz",42,0,4,0,107,0,38,1,0,192,0,9,201,223,0.557,0.901
"6249","La Paz","El Alto","Unidad Educativa La Paz",77,2,2,0,80,2,27,3,0,193,1,11,205,221,0.415,0.928
"6250","La Paz","El Alto","Unidad Educativa La Paz",70,0,4,1,98,0,19,3,2,197,2,7,206,222,0.497,0.928
"6251","La Paz","El Alto","Unidad Educativa La Paz",71,1,6,0,86,2,34,0,0,200,1,2,203,223,0.43,0.91
"6252","La Paz","El Alto","Unidad Educativa La Paz",44,2,8,1,101,3,34,1,2,196,2,2,200,225,0.515,0.889
"6253","La Paz","El Alto","Unidad Educativa La Paz",77,0,5,1,84,2,18,0,4,191,0,9,200,223,0.44,0.897
"6254","La Paz","El Alto","Unidad Educativa La Paz",75,1,4,1,98,2,22,0,2,205,0,4,209,222,0.478,0.941
"6255","La Paz","El Alto","Unidad Educativa La Paz",62,2,6,1,103,1,25,2,0,202,1,4,207,225,0.51,0.92
"6256","La Paz","El Alto","Unidad Educativa La Paz",74,1,4,1,95,2,20,0,3,200,1,8,209,226,0.475,0.925
"6257","La Paz","El Alto","Unidad Educativa La Paz",62,1,7,1,113,3,23,0,0,210,3,5,218,228,0.538,0.956
"6258","La Paz","El Alto","Unidad Educativa La Paz",59,2,3,2,111,3,25,1,2,208,0,5,213,228,0.534,0.934
"6259","La Paz","El Alto","Unidad Educativa 3 de Mayo",37,1,6,0,129,2,34,0,2,211,2,6,219,230,0.611,0.952
"6260","La Paz","El Alto","Unidad Educativa 3 de Mayo",28,2,7,0,140,3,31,0,1,212,1,3,216,232,0.66,0.931
"6261","La Paz","El Alto","Unidad Educativa 3 de Mayo",26,1,9,2,128,4,26,1,2,199,5,9,213,228,0.643,0.934
"6262","La Paz","El Alto","Unidad Educativa 3 de Mayo",33,0,10,1,133,1,29,1,1,209,0,5,214,231,0.636,0.926
"6263","La Paz","El Alto","Unidad Educativa 3 de Mayo",29,0,5,0,146,3,25,0,1,209,2,4,215,230,0.699,0.935
"6264","La Paz","El Alto","Unidad Educativa 3 de Mayo",40,0,5,0,139,5,19,0,2,210,1,8,219,234,0.662,0.936
"6265","La Paz","El Alto","Unidad Educativa 3 de Mayo",24,1,5,1,139,1,26,1,5,203,2,8,213,228,0.685,0.934
"6266","La Paz","El Alto","Unidad Educativa 3 de Mayo",29,2,6,0,144,1,36,0,1,219,1,7,227,231,0.658,0.983
"6267","La Paz","El Alto","Unidad Educativa 3 de Mayo",20,0,3,1,146,4,29,0,4,207,0,8,215,230,0.705,0.935
"6268","La Paz","El Alto","Unidad Educativa 3 de Mayo",42,0,2,1,126,3,22,0,5,201,1,11,213,233,0.627,0.914
"6269","La Paz","El Alto","Unidad Educativa 3 de Mayo",44,0,6,0,121,2,32,1,1,207,0,6,213,225,0.585,0.947
"6270","La Paz","El Alto","Unidad Educativa 3 de Mayo",34,1,6,0,126,4,33,2,1,207,2,7,216,227,0.609,0.952
"6271","La Paz","El Alto","Unidad Educativa 3 de Mayo",33,0,7,0,132,0,34,0,1,207,1,13,221,235,0.638,0.94
"6272","La Paz","El Alto","Unidad Educativa 3 de Mayo",34,1,8,0,137,2,38,1,2,223,1,6,230,237,0.614,0.97
"6273","La Paz","El Alto","Unidad Educativa 3 de Mayo",32,0,10,0,133,0,29,0,3,207,0,7,214,232,0.643,0.922
"6274","La Paz","El Alto","Unidad Educativa 3 de Mayo",31,0,6,0,142,3,24,1,2,209,1,9,219,227,0.679,0.965
"6275","La Paz","El Alto","Unidad Educativa 3 de Mayo",26,1,6,1,132,5,26,0,3,200,2,11,213,228,0.66,0.934
"6276","La Paz","El Alto","Unidad Educativa 3 de Mayo",24,2,7,0,142,2,28,0,1,206,1,6,213,229,0.689,0.93
"6277","La Paz","El Alto","Unidad Educativa 3 de Mayo",38,0,5,0,138,1,31,2,1,216,1,7,224,234,0.639,0.957
"6278","La Paz","El Alto","Unidad Educativa 3 de Mayo",46,0,6,1,121,1,25,1,0,201,1,7,209,222,0.602,0.941
"6279","La Paz","El Alto","Unidad Educativa 3 de Mayo",22,1,7,0,143,1,29,0,3,206,2,3,211,234,0.694,0.902
"6280","La Paz","El Alto","Unidad Educativa 3 de Mayo",32,3,7,0,133,3,26,1,3,208,2,10,220,229,0.639,0.961
"6281","La Paz","El Alto","Unidad Educativa 3 de Mayo",32,0,6,0,126,2,33,1,2,202,3,6,211,224,0.624,0.942
"6282","La Paz","El Alto","Unidad Educativa 3 de Mayo",32,1,5,0,133,3,36,0,1,211,0,12,223,232,0.63,0.961
"6283","La Paz","El Alto","Unidad Educativa 3 de Mayo",26,0,5,1,146,2,30,1,1,212,0,7,219,235,0.689,0.932
"6284","La Paz","El Alto","Unidad Educativa 3 de Mayo",24,5,6,1,138,5,24,1,1,205,2,10,217,228,0.673,0.952
"6285","La Paz","El Alto","Unidad Educativa 3 de Mayo",28,2,4,1,129,3,38,0,1,206,0,13,219,231,0.626,0.948
"6286","La Paz","El Alto","Unidad Educativa 3 de Mayo",37,2,7,0,131,3,28,0,2,210,0,5,215,233,0.624,0.923
"6287","La Paz","El Alto","Unidad Educativa 3 de Mayo",32,3,5,2,121,0,43,1,4,211,1,7,219,232,0.573,0.944
"6288","La Paz","El Alto","Unidad Educativa 3 de Mayo",36,1,8,2,133,1,29,0,4,214,0,7,221,229,0.621,0.965
"6289","La Paz","El Alto","Unidad Educativa San Luis",64,1,11,0,108,2,22,0,2,210,2,11,223,234,0.514,0.953
"6290","La Paz","El Alto","Unidad Educativa San Luis",57,0,9,0,123,1,21,0,4,215,0,6,221,232,0.572,0.953
"6291","La Paz","El Alto","Unidad Educativa San Luis",58,1,5,0,106,2,31,0,4,207,0,6,213,230,0.512,0.926
"6292","La Paz","El Alto","Unidad Educativa San Luis",51,1,7,2,112,3,27,0,4,207,2,12,221,231,0.541,0.957
"6293","La Paz","El Alto","Unidad Educativa San Luis",60,2,11,1,92,8,25,2,4,205,4,8,217,232,0.449,0.935
"6294","La Paz","El Alto","Unidad Educativa San Luis",41,0,8,0,115,5,25,0,5,199,1,9,209,229,0.578,0.913
"6295","La Paz","El Alto","Unidad Educativa San Luis",56,0,7,0,111,3,30,0,4,211,0,3,214,225,0.526,0.951
"6296","La Paz","El Alto","Unidad Educativa San Luis",44,1,6,3,129,0,30,0,1,214,1,4,219,233,0.603,0.94
"6297","La Paz","El Alto","Unidad Educativa San Luis",38,0,9,1,132,1,24,0,4,209,2,4,215,230,0.632,0.935
"6298","La Paz","El Alto","Unidad Educativa San Luis",44,2,2,0,114,0,42,0,3,207,3,5,215,229,0.551,0.939
"6299","La Paz","El Alto","Unidad Educativa San Luis",45,1,1,0,126,9,19,0,1,202,0,8,210,231,0.624,0.909
"6300","La Paz","El Alto","Unidad Educativa San Luis",66,2,7,1,110,4,24,1,1,216,0,2,218,232,0.509,0.94
"6301","La Paz","El Alto","Unidad Educativa San Luis",55,2,5,2,107,2,34,0,2,209,0,5,214,230,0.512,0.93
"6302","La Paz","El Alto","Unidad Educativa San Luis",55,0,6,0,107,4,25,0,1,198,2,5,205,226,0.54,0.907
"6303","La Paz","El Alto","Unidad Educativa San Luis",41,4,7,0,131,5,27,1,0,216,0,1,217,229,0.606,0.948
"6304","La Paz","El Alto","Unidad Educativa San Luis",40,1,8,0,122,4,28,0,6,209,1,7,217,227,0.584,0.956
"6305","La Paz","El Alto","Unidad Educativa San Luis",56,1,8,0,100,5,26,1,2,199,2,12,213,228,0.503,0.934
"6306","La Paz","El Alto","Unidad Educativa San Luis",51,1,7,0,118,3,24,1,2,207,3,6,216,223,0.57,0.969
"6307","La Paz","El Alto","Unidad Educativa San Luis",53,1,6,0,101,2,37,1,6,207,2,8,217,232,0.488,0.935
"6308","La Paz","El Alto","Unidad Educativa San Luis",55,1,13,1,0,88,6,4,0,168,31,2,201,226,0,0.889
"6309","La Paz","El Alto","Unidad Educativa San Luis",38,0,9,2,119,2,32,0,4,206,0,6,212,225,0.578,0.942
"6310","La Paz","El Alto","Unidad Educativa San Luis",43,0,3,0,111,2,35,0,3,197,3,9,209,228,0.563,0.917
"6311","La Paz","El Alto","Unidad Educativa San Luis",53,4,4,1,96,1,29,0,5,193,1,14,208,227,0.497,0.916
"6312","La Paz","El Alto","Unidad Educativa San Luis",46,0,7,0,128,4,24,0,1,210,1,6,217,231,0.61,0.939
"6313","La Paz","El Alto","Unidad Educativa San Luis",30,1,8,0,115,5,36,0,3,198,3,7,208,223,0.581,0.933
"6314","La Paz","El Alto","Unidad Educativa San Luis",45,2,10,0,109,3,35,0,6,210,4,9,223,231,0.519,0.965
"6315","La Paz","El Alto","Unidad Educativa San Luis",62,1,10,1,93,1,37,0,2,207,0,5,212,230,0.449,0.922
"6316","La Paz","El Alto","Colegio Illimani",28,2,3,0,144,0,29,0,0,206,3,5,214,226,0.699,0.947
"6317","La Paz","El Alto","Colegio Illimani",25,0,4,1,143,0,31,0,3,207,4,6,217,232,0.691,0.935
"6318","La Paz","El Alto","Colegio Illimani",29,1,11,0,130,2,28,1,0,202,2,10,214,227,0.644,0.943
"6319","La Paz","El Alto","Colegio Illimani",52,1,6,0,106,5,27,0,3,200,3,6,209,226,0.53,0.925
"6320","La Paz","El Alto","Colegio Illimani",42,1,5,3,120,1,21,2,0,195,1,9,205,231,0.615,0.887
"6321","La Paz","El Alto","Colegio Illimani",42,2,3,1,120,0,30,0,2,200,3,8,211,230,0.6,0.917
"6322","La Paz","El Alto","Colegio Illimani",41,2,4,1,119,1,34,0,0,202,1,7,210,223,0.589,0.942
"6323","La Paz","El Alto","Colegio Illimani",53,0,1,2,104,2,33,2,3,200,2,4,206,224,0.52,0.92
"6324","La Paz","El Alto","Colegio Illimani",38,1,9,1,128,3,27,0,3,210,2,3,215,231,0.61,0.931
"6325","La Paz","El Alto","Colegio Illimani",30,1,9,1,136,2,30,0,0,209,4,8,221,230,0.651,0.961
"6326","La Paz","El Alto","Colegio Illimani",34,0,13,2,117,2,31,0,7,206,1,4,211,233,0.568,0.906
"6327","La Paz","El Alto","Colegio Illimani",33,1,7,0,137,4,27,0,1,210,1,11,222,235,0.652,0.945
"6328","La Paz","El Alto","Colegio Illimani",30,1,4,2,133,1,31,1,2,205,1,11,217,229,0.649,0.948
"6329","La Paz","El Alto","Colegio Illimani",33,1,9,1,135,1,27,1,2,210,0,8,218,227,0.643,0.96
"6330","La Paz","El Alto","Colegio Illimani",33,2,4,1,115,4,34,0,4,197,1,9,207,223,0.584,0.928
"6331","La Paz","El Alto","Colegio Illimani",41,0,7,0,127,4,30,0,0,209,3,5,217,232,0.608,0.935
"6332","La Paz","El Alto","Colegio Illimani",44,0,8,0,120,1,36,0,2,211,1,5,217,229,0.569,0.948
"6333","La Paz","El Alto","Colegio Illimani",43,1,8,0,112,3,25,1,3,196,3,10,209,223,0.571,0.937
"6334","La Paz","El Alto","Colegio Illimani",29,3,5,1,132,3,37,0,2,212,1,3,216,226,0.623,0.956
"6335","La Paz","El Alto","Colegio Illimani",35,1,4,0,110,1,40,0,10,201,1,11,213,229,0.547,0.93
"6336","La Paz","El Alto","Colegio Illimani",24,0,8,1,124,4,37,0,1,199,1,6,206,226,0.623,0.912
"6337","La Paz","El Alto","Colegio Illimani",36,0,6,1,124,0,35,0,1,203,0,4,207,228,0.611,0.908
"6338","La Paz","El Alto","Colegio Illimani",26,0,3,1,135,1,27,0,0,193,6,4,203,220,0.699,0.923
"6339","La Paz","El Alto","Colegio Illimani",31,2,5,0,129,4,34,1,4,210,0,9,219,232,0.614,0.944
"6340","La Paz","El Alto","Colegio Illimani",16,0,4,0,159,2,26,1,1,209,2,6,217,227,0.761,0.956
"6341","La Paz","El Alto","Colegio Illimani",23,2,10,0,140,0,29,0,1,205,1,6,212,229,0.683,0.926
"6342","La Paz","El Alto","Colegio Illimani",35,0,3,0,119,2,37,1,1,198,1,9,208,228,0.601,0.912
"6343","La Paz","El Alto","Colegio Illimani",33,0,10,3,117,2,27,0,7,199,0,9,208,224,0.588,0.929
"6344","La Paz","El Alto","Colegio Illimani",33,2,5,0,117,2,34,1,3,197,2,8,207,226,0.594,0.916
"6345","La Paz","El Alto","Colegio Illimani",45,2,2,7,107,2,1,2,1,169,1,6,176,230,0.633,0.765
"6346","La Paz","El Alto","Colegio Illimani",36,0,5,0,128,1,35,0,3,208,4,6,218,229,0.615,0.952
"6347","La Paz","El Alto","Colegio Illimani",41,1,9,1,119,4,32,0,0,207,1,4,212,228,0.575,0.93
"6348","La Paz","El Alto","Colegio Illimani",31,0,12,0,135,3,27,0,1,209,1,3,213,227,0.646,0.938
"6349","La Paz","El Alto","Colegio Illimani",33,2,3,0,121,3,44,0,0,206,2,5,213,232,0.587,0.918
"6350","La Paz","El Alto","Colegio Illimani",41,2,5,0,135,1,23,0,4,211,2,1,214,225,0.64,0.951
"6351","La Paz","El Alto","Colegio Illimani",43,0,10,0,129,0,28,1,1,212,3,2,217,231,0.608,0.939
"6352","La Paz","El Alto","Colegio Illimani",45,0,6,1,120,1,28,0,2,203,1,10,214,223,0.591,0.96
"6353","La Paz","El Alto","Colegio Illimani",28,0,6,1,135,2,37,0,2,211,0,6,217,225,0.64,0.964
"6354","La Paz","El Alto","Colegio Illimani",33,1,9,1,125,1,36,0,3,209,0,10,219,232,0.598,0.944
"6355","La Paz","El Alto","Colegio Illimani",33,0,4,0,129,2,33,0,2,203,1,7,211,228,0.635,0.925
"6356","La Paz","El Alto","Colegio Illimani",39,1,2,1,120,4,37,0,1,205,2,4,211,224,0.585,0.942
"6357","La Paz","El Alto","Colegio Illimani",48,0,2,0,110,2,31,1,3,197,3,9,209,229,0.558,0.913
"6358","La Paz","El Alto","Unidad Educativa Juan Jose Torres",45,3,8,0,112,1,23,0,5,197,1,2,200,212,0.569,0.943
"6359","La Paz","El Alto","Unidad Educativa Juan Jose Torres",24,0,2,0,131,1,34,0,1,193,0,12,205,227,0.679,0.903
"6360","La Paz","El Alto","Unidad Educativa Juan Jose Torres",57,4,2,0,110,3,26,0,2,204,2,4,210,226,0.539,0.929
"6361","La Paz","El Alto","Unidad Educativa Juan Jose Torres",34,1,2,1,133,4,24,0,2,201,3,10,214,223,0.662,0.96
"6362","La Paz","El Alto","Unidad Educativa Juan Jose Torres",31,1,7,1,137,1,32,0,3,213,1,7,221,233,0.643,0.948
"6363","La Paz","El Alto","Unidad Educativa Juan Jose Torres",40,2,2,0,137,1,28,1,0,211,3,4,218,227,0.649,0.96
"6364","La Paz","El Alto","Unidad Educativa Juan Jose Torres",49,0,1,1,118,4,31,1,6,211,0,9,220,230,0.559,0.957
"6365","La Paz","El Alto","Unidad Educativa Juan Jose Torres",26,1,8,1,120,1,39,1,2,199,3,8,210,227,0.603,0.925
"6366","La Paz","El Alto","Unidad Educativa Juan Jose Torres",42,1,9,0,117,2,46,0,1,218,3,3,224,231,0.537,0.97
"6367","La Paz","El Alto","Unidad Educativa Juan Jose Torres",75,2,8,1,85,4,25,1,1,202,3,8,213,233,0.421,0.914
"6368","La Paz","El Alto","Unidad Educativa Juan Jose Torres",48,2,5,1,108,3,40,1,1,209,2,4,215,229,0.517,0.939
"6369","La Paz","El Alto","Unidad Educativa Juan Jose Torres",32,1,9,0,122,3,35,0,3,205,0,8,213,227,0.595,0.938
"6370","La Paz","El Alto","Unidad Educativa Juan Jose Torres",40,0,3,0,126,2,31,1,0,203,1,6,210,229,0.621,0.917
"6371","La Paz","El Alto","Unidad Educativa Juan Jose Torres",52,0,6,1,112,4,24,0,5,204,2,7,213,228,0.549,0.934
"6372","La Paz","El Alto","Unidad Educativa Juan Jose Torres",33,3,6,1,124,1,31,0,4,203,2,9,214,224,0.611,0.955
"6373","La Paz","El Alto","Unidad Educativa Juan Jose Torres",34,1,10,1,126,3,37,0,1,213,1,11,225,233,0.592,0.966
"6374","La Paz","El Alto","Unidad Educativa Juan Jose Torres",38,0,7,0,122,1,26,1,5,200,2,6,208,227,0.61,0.916
"6375","La Paz","El Alto","Unidad Educativa Juan Jose Torres",69,0,11,0,99,3,18,0,2,202,3,6,211,228,0.49,0.925
"6376","La Paz","El Alto","Unidad Educativa Juan Jose Torres",53,2,7,2,106,1,35,1,1,208,0,7,215,227,0.51,0.947
"6377","La Paz","El Alto","Unidad Educativa Juan Jose Torres",49,1,5,0,118,1,20,1,5,200,5,6,211,229,0.59,0.921
"6378","La Paz","El Alto","Unidad Educativa Juan Jose Torres",31,0,6,1,114,3,32,0,2,189,3,7,199,220,0.603,0.905
"6379","La Paz","El Alto","Unidad Educativa Juan Jose Torres",32,0,5,0,139,3,23,0,2,204,4,12,220,232,0.681,0.948
"6380","La Paz","El Alto","Unidad Educativa Juan Jose Torres",49,1,5,0,118,0,36,0,1,210,0,8,218,228,0.562,0.956
"6381","La Paz","El Alto","Unidad Educativa Juan Jose Torres",52,1,8,0,105,2,30,3,1,202,1,10,213,228,0.52,0.934
"6382","La Paz","El Alto","Unidad Educativa Juan Jose Torres",36,1,8,0,132,2,28,0,3,210,0,5,215,232,0.629,0.927
"6383","La Paz","El Alto","Unidad Educativa Juan Jose Torres",46,2,5,1,125,1,25,1,1,207,2,5,214,231,0.604,0.926
"6384","La Paz","El Alto","Unidad Educativa Juan Jose Torres",55,1,5,0,114,3,23,1,2,204,4,8,216,227,0.559,0.952
"6385","La Paz","El Alto","Colegio Nestor Paz",35,0,6,0,132,0,24,0,2,199,6,7,212,234,0.663,0.906
"6386","La Paz","El Alto","Colegio Nestor Paz",35,0,8,0,123,3,30,0,3,202,2,5,209,224,0.609,0.933
"6387","La Paz","El Alto","Colegio Nestor Paz",49,0,8,0,92,2,33,0,6,190,0,9,199,228,0.484,0.873
"6388","La Paz","El Alto","Colegio Nestor Paz",49,2,13,0,101,1,27,0,2,195,3,10,208,225,0.518,0.924
"6389","La Paz","El Alto","Colegio Nestor Paz",45,1,7,1,117,4,20,0,3,198,3,9,210,227,0.591,0.925
"6390","La Paz","El Alto","Colegio Nestor Paz",47,0,4,1,98,3,32,1,1,187,3,9,199,221,0.524,0.9
"6391","La Paz","El Alto","Colegio Nestor Paz",30,1,6,0,139,1,26,0,1,204,0,10,214,235,0.681,0.911
"6392","La Paz","El Alto","Colegio Nestor Paz",37,1,6,0,124,2,33,0,4,207,2,13,222,231,0.599,0.961
"6393","La Paz","El Alto","Colegio Nestor Paz",35,0,6,0,136,2,0,36,0,215,0,6,221,231,0.633,0.957
"6394","La Paz","El Alto","Colegio Nestor Paz",44,1,7,1,123,1,32,1,4,214,3,3,220,233,0.575,0.944
"6395","La Paz","El Alto","Colegio Nestor Paz",47,1,4,2,108,3,30,0,3,198,3,5,206,230,0.545,0.896
"6396","La Paz","El Alto","Colegio Nestor Paz",45,0,7,0,122,1,29,0,1,205,5,3,213,229,0.595,0.93
"6397","La Paz","El Alto","Colegio Nestor Paz",35,1,6,1,135,3,39,1,1,222,3,2,227,231,0.608,0.983
"6398","La Paz","El Alto","Colegio Nestor Paz",43,1,5,1,132,1,33,1,1,218,0,2,220,229,0.606,0.961
"6399","La Paz","El Alto","Colegio Nestor Paz",39,0,0,1,126,4,29,1,1,201,3,7,211,227,0.627,0.93
"6400","La Paz","El Alto","Colegio Nestor Paz",30,0,9,2,138,1,30,0,1,211,1,6,218,230,0.654,0.948
"6401","La Paz","El Alto","Colegio Nestor Paz",24,0,4,0,146,1,39,1,0,215,1,6,222,232,0.679,0.957
"6402","La Paz","El Alto","Colegio Nestor Paz",30,0,7,0,129,1,32,0,4,203,3,11,217,232,0.635,0.935
"6403","La Paz","El Alto","Colegio Nestor Paz",45,1,6,0,131,0,24,0,0,207,0,6,213,233,0.633,0.914
"6404","La Paz","El Alto","Colegio Nestor Paz",52,0,4,0,123,2,27,0,3,211,0,9,220,232,0.583,0.948
"6405","La Paz","El Alto","Colegio Nestor Paz",40,1,5,3,119,2,33,0,3,206,1,13,220,231,0.578,0.952
"6406","La Paz","El Alto","Colegio Nestor Paz",45,0,8,0,124,1,23,0,3,204,2,7,213,225,0.608,0.947
"6407","La Paz","El Alto","Colegio Nestor Paz",29,0,8,0,131,3,23,0,6,200,1,7,208,229,0.655,0.908
"6408","La Paz","El Alto","Colegio Nestor Paz",36,0,10,2,136,2,21,2,2,211,1,5,217,231,0.645,0.939
"6409","La Paz","El Alto","Colegio Nestor Paz",56,0,5,2,111,1,28,0,0,203,2,9,214,230,0.547,0.93
"6410","La Paz","El Alto","Colegio Nestor Paz",48,1,6,0,130,1,20,0,1,207,0,8,215,232,0.628,0.927
"6411","La Paz","El Alto","Colegio Nestor Paz",41,1,6,1,122,1,22,1,2,197,0,8,205,228,0.619,0.899
"6412","La Paz","El Alto","Colegio Nestor Paz",34,0,4,0,113,1,40,0,1,193,0,6,199,228,0.585,0.873
"6413","La Paz","El Alto","Colegio Nestor Paz",44,2,7,1,115,1,29,1,3,203,0,11,214,226,0.567,0.947
"6414","La Paz","El Alto","Colegio Don Bosco",42,0,5,1,124,4,26,0,3,205,3,5,213,234,0.605,0.91
"6415","La Paz","El Alto","Colegio Don Bosco",39,1,5,1,127,2,19,0,1,195,3,7,205,227,0.651,0.903
"6416","La Paz","El Alto","Colegio Don Bosco",44,0,3,0,139,4,20,2,2,214,2,3,219,237,0.65,0.924
"6417","La Paz","El Alto","Colegio Don Bosco",50,1,3,2,123,1,32,0,3,215,3,4,222,236,0.572,0.941
"6418","La Paz","El Alto","Colegio Don Bosco",50,0,11,0,112,0,28,0,1,202,2,13,217,230,0.554,0.943
"6419","La Paz","El Alto","Colegio Don Bosco",35,2,11,1,134,3,26,0,1,213,3,8,224,235,0.629,0.953
"6420","La Paz","El Alto","Colegio Don Bosco",39,1,4,0,133,3,33,0,3,216,3,5,224,233,0.616,0.961
"6421","La Paz","El Alto","Colegio Don Bosco",41,1,8,0,125,2,27,1,1,206,0,1,207,235,0.607,0.881
"6422","La Paz","El Alto","Colegio Don Bosco",34,2,11,1,115,3,33,0,3,202,0,9,211,230,0.569,0.917
"6423","La Paz","El Alto","Colegio Don Bosco",41,1,3,2,131,4,24,0,3,209,1,7,217,232,0.627,0.935
"6424","La Paz","El Alto","Colegio Don Bosco",27,0,3,2,155,0,31,0,1,219,4,4,227,234,0.708,0.97
"6425","La Paz","El Alto","Colegio Don Bosco",39,1,8,0,129,2,24,0,3,206,1,5,212,232,0.626,0.914
"6426","La Paz","El Alto","Colegio Don Bosco",44,1,8,0,124,5,21,0,1,204,1,5,210,228,0.608,0.921
"6427","La Paz","El Alto","Colegio Don Bosco",45,2,4,0,124,1,25,0,1,202,1,8,211,226,0.614,0.934
"6428","La Paz","El Alto","Colegio Don Bosco",48,0,8,0,124,1,24,1,2,208,1,7,216,231,0.596,0.935
"6429","La Paz","El Alto","Colegio Don Bosco",41,1,3,1,120,1,37,0,0,204,1,5,210,228,0.588,0.921
"6430","La Paz","El Alto","Colegio Don Bosco",49,2,4,0,113,3,41,0,3,215,1,4,220,234,0.526,0.94
"6431","La Paz","El Alto","Colegio Don Bosco",46,1,8,0,121,1,34,0,3,214,2,7,223,233,0.565,0.957
"6432","La Paz","El Alto","Colegio Don Bosco",31,1,5,2,141,1,25,0,2,208,2,1,211,232,0.678,0.909
"6433","La Paz","El Alto","Colegio Don Bosco",52,0,7,0,126,1,16,0,1,203,4,5,212,230,0.621,0.922
"6434","La Paz","El Alto","Colegio Don Bosco",52,1,5,0,116,1,28,0,0,203,0,11,214,231,0.571,0.926
"6435","La Paz","El Alto","Colegio Don Bosco",21,0,4,2,131,2,38,0,3,201,2,11,214,229,0.652,0.934
"6436","La Paz","El Alto","Colegio Don Bosco",35,0,9,1,133,1,27,0,0,206,1,9,216,234,0.646,0.923
"6437","La Paz","El Alto","Colegio Don Bosco",26,1,6,1,138,1,35,0,0,208,2,5,215,231,0.663,0.931
"6438","La Paz","El Alto","Colegio Don Bosco",48,1,3,0,116,3,34,1,3,209,3,6,218,230,0.555,0.948
"6439","La Paz","El Alto","Colegio Don Bosco",56,3,4,0,114,4,23,0,3,207,1,8,216,236,0.551,0.915
"6440","La Paz","El Alto","Colegio Don Bosco",46,0,6,0,111,2,31,1,6,203,0,7,210,227,0.547,0.925
"6441","La Paz","El Alto","Colegio Don Bosco",37,1,6,2,133,2,23,0,2,206,1,4,211,231,0.646,0.913
"6442","La Paz","El Alto","Colegio Don Bosco",36,2,8,1,125,3,30,1,0,206,0,4,210,229,0.607,0.917
"6443","La Paz","El Alto","Colegio Don Bosco",45,0,3,2,127,3,22,1,1,204,1,4,209,226,0.623,0.925
"6444","La Paz","El Alto","Colegio Don Bosco",32,2,7,1,133,3,24,1,0,203,1,6,210,231,0.655,0.909
"6445","La Paz","El Alto","Colegio Don Bosco",25,0,4,0,143,0,31,0,2,205,0,5,210,232,0.698,0.905
"6446","La Paz","El Alto","Colegio Don Bosco",48,0,6,1,129,4,19,0,5,212,0,3,215,233,0.608,0.923
"6447","La Paz","El Alto","Colegio Don Bosco",54,1,9,2,113,2,28,0,1,210,0,4,214,230,0.538,0.93
"6448","La Paz","El Alto","Colegio Don Bosco",58,2,5,1,112,3,31,1,0,213,2,6,221,234,0.526,0.944
"6449","La Paz","El Alto","Colegio Don Bosco",49,0,7,1,118,5,25,0,2,207,3,3,213,225,0.57,0.947
"6450","La Paz","El Alto","Colegio Don Bosco",36,0,4,0,129,1,38,0,2,210,3,3,216,230,0.614,0.939
"6451","La Paz","El Alto","Colegio Don Bosco",48,3,5,0,140,2,21,0,3,222,0,8,230,235,0.631,0.979
"6452","La Paz","El Alto","Colegio Don Bosco",53,0,1,0,118,3,25,0,0,200,1,5,206,226,0.59,0.912
"6453","La Paz","El Alto","Colegio Don Bosco",47,1,1,0,112,1,18,1,2,183,2,6,191,204,0.612,0.936
"6454","La Paz","El Alto","Unidad Educativa Mercedes Elio De Rivero",44,1,2,0,128,4,26,1,1,207,5,8,220,230,0.618,0.957
"6455","La Paz","El Alto","Unidad Educativa Mercedes Elio De Rivero",40,1,3,1,134,2,28,0,4,213,3,4,220,230,0.629,0.957
"6456","La Paz","El Alto","Unidad Educativa Mercedes Elio De Rivero",30,0,11,0,140,3,21,1,2,208,1,3,212,228,0.673,0.93
"6457","La Paz","El Alto","Unidad Educativa Mercedes Elio De Rivero",28,2,4,0,148,2,20,0,0,204,0,8,212,232,0.725,0.914
"6458","La Paz","El Alto","Unidad Educativa Mercedes Elio De Rivero",40,0,5,0,127,9,30,0,4,215,0,10,225,235,0.591,0.957
"6459","La Paz","El Alto","Unidad Educativa Mercedes Elio De Rivero",28,0,4,1,154,0,21,0,0,208,2,9,219,235,0.74,0.932
"6460","La Paz","El Alto","Unidad Educativa Mercedes Elio De Rivero",25,0,6,1,155,0,30,0,2,219,3,3,225,232,0.708,0.97
"6461","La Paz","El Alto","Unidad Educativa Mercedes Elio De Rivero",27,2,5,0,153,2,19,0,2,210,0,5,215,232,0.729,0.927
"6462","La Paz","El Alto","Unidad Educativa Mercedes Elio De Rivero",35,2,4,0,145,3,27,0,1,217,0,7,224,235,0.668,0.953
"6463","La Paz","El Alto","Unidad Educativa Mercedes Elio De Rivero",25,1,5,2,157,0,18,0,2,210,3,9,222,235,0.748,0.945
"6464","La Paz","El Alto","Unidad Educativa Mercedes Elio De Rivero",23,1,6,2,142,4,32,0,3,213,4,7,224,231,0.667,0.97
"6465","La Paz","El Alto","Unidad Educativa Mercedes Elio De Rivero",21,1,8,0,145,2,24,1,1,203,1,8,212,231,0.714,0.918
"6466","La Paz","El Alto","Unidad Educativa Mercedes Elio De Rivero",22,1,11,0,166,0,21,0,1,222,4,6,232,236,0.748,0.983
"6467","La Paz","El Alto","Unidad Educativa Mercedes Elio De Rivero",27,2,3,3,145,2,27,0,1,210,1,6,217,229,0.69,0.948
"6468","La Paz","El Alto","Unidad Educativa Mercedes Elio De Rivero",44,0,10,1,131,1,30,0,3,220,3,3,226,233,0.595,0.97
"6469","La Paz","El Alto","Unidad Educativa Mercedes Elio De Rivero",31,1,14,0,121,4,37,0,1,209,3,3,215,227,0.579,0.947
"6470","La Paz","El Alto","Unidad Educativa Mercedes Elio De Rivero",19,0,8,2,146,1,29,2,2,209,3,5,217,230,0.699,0.943
"6471","La Paz","El Alto","Unidad Educativa Mercedes Elio De Rivero",19,1,8,0,150,4,35,0,3,220,2,4,226,236,0.682,0.958
"6472","La Paz","El Alto","Unidad Educativa Mercedes Elio De Rivero",46,0,1,1,134,1,33,0,2,218,0,7,225,237,0.615,0.949
"6473","La Paz","El Alto","Unidad Educativa Mercedes Elio De Rivero",34,1,7,0,133,5,30,1,1,212,1,8,221,230,0.627,0.961
"6474","La Paz","El Alto","Unidad Educativa Mercedes Elio De Rivero",34,1,3,1,138,2,32,0,2,213,2,4,219,236,0.648,0.928
"6475","La Paz","El Alto","Unidad Educativa Mercedes Elio De Rivero",38,2,9,0,128,3,29,1,1,211,2,7,220,231,0.607,0.952
"6476","La Paz","El Alto","U.E. República de Canadá",42,0,8,1,132,4,27,1,1,216,2,11,229,240,0.611,0.954
"6477","La Paz","El Alto","U.E. República de Canadá",45,3,9,0,127,1,24,0,1,210,1,6,217,233,0.605,0.931
"6478","La Paz","El Alto","U.E. República de Canadá",43,1,2,2,137,0,29,2,1,217,1,8,226,236,0.631,0.958
"6479","La Paz","El Alto","Colegio Martin Cardenas",81,0,4,0,87,4,24,0,3,203,0,12,215,228,0.429,0.943
"6480","La Paz","El Alto","Colegio Martin Cardenas",72,1,1,1,95,5,24,1,0,200,3,11,214,227,0.475,0.943
"6481","La Paz","El Alto","Colegio Martin Cardenas",71,1,0,0,92,5,25,1,2,197,1,7,205,220,0.467,0.932
"6482","La Paz","El Alto","Colegio Martin Cardenas",69,0,8,3,97,8,16,0,1,202,1,5,208,226,0.48,0.92
"6483","La Paz","El Alto","Colegio Martin Cardenas",75,3,2,0,93,3,26,1,1,204,1,6,211,231,0.456,0.913
"6484","La Paz","El Alto","Colegio Martin Cardenas",103,1,3,1,80,2,13,0,1,204,19,2,225,225,0.392,1
"6485","La Paz","El Alto","Colegio Martin Cardenas",109,1,1,0,62,2,25,2,4,206,2,6,214,235,0.301,0.911
"6486","La Paz","El Alto","Colegio Martin Cardenas",64,0,2,0,100,2,29,0,1,198,2,8,208,225,0.505,0.924
"6487","La Paz","El Alto","Colegio Martin Cardenas",87,1,1,0,85,0,23,1,1,199,0,7,206,226,0.427,0.912
"6488","La Paz","El Alto","Colegio Martin Cardenas",74,0,4,0,101,4,17,0,2,202,1,6,209,228,0.5,0.917
"6489","La Paz","El Alto","Colegio Martin Cardenas",74,0,5,1,84,3,27,1,0,195,2,9,206,231,0.431,0.892
"6490","La Paz","El Alto","Colegio Martin Cardenas",70,2,5,1,97,2,24,0,4,205,4,6,215,229,0.473,0.939
"6491","La Paz","El Alto","Colegio Martin Cardenas",73,0,4,1,101,0,21,0,5,205,1,5,211,227,0.493,0.93
"6492","La Paz","El Alto","Colegio Martin Cardenas",54,2,2,0,101,3,27,3,3,195,1,6,202,222,0.518,0.91
"6493","La Paz","El Alto","Colegio Martin Cardenas",57,0,5,1,80,4,44,0,2,193,4,7,204,225,0.415,0.907
"6494","La Paz","El Alto","Colegio Martin Cardenas",90,0,2,1,85,5,20,1,2,206,1,7,214,225,0.413,0.951
"6495","La Paz","El Alto","Colegio Martin Cardenas",86,0,5,1,78,7,23,0,0,200,2,3,205,223,0.39,0.919
"6496","La Paz","El Alto","Colegio Martin Cardenas",89,1,4,1,80,1,29,0,1,206,1,7,214,229,0.388,0.934
"6497","La Paz","El Alto","Colegio Martin Cardenas",75,1,1,1,101,1,26,0,0,206,0,2,208,227,0.49,0.916
"6498","La Paz","El Alto","Colegio Martin Cardenas",101,0,3,1,68,0,14,2,2,191,4,5,200,216,0.356,0.926
"6499","La Paz","El Alto","Colegio Martin Cardenas",86,0,2,0,88,1,21,0,2,200,0,5,205,227,0.44,0.903
"6500","La Paz","El Alto","Colegio Martin Cardenas",69,0,4,1,95,4,27,0,4,204,1,5,210,224,0.466,0.938
"6501","La Paz","El Alto","Colegio Martin Cardenas",60,0,8,1,94,1,35,1,3,203,2,6,211,227,0.463,0.93
"6502","La Paz","El Alto","Colegio Martin Cardenas",85,1,1,1,86,3,26,0,0,203,2,4,209,225,0.424,0.929
"6503","La Paz","El Alto","Colegio Martin Cardenas",99,0,2,1,86,4,15,2,1,210,1,5,216,228,0.41,0.947
"6504","La Paz","El Alto","Colegio Martin Cardenas",69,0,5,0,84,4,31,0,3,196,0,7,203,223,0.429,0.91
"6505","La Paz","El Alto","Colegio Martin Cardenas",85,1,1,0,95,4,21,0,1,208,0,5,213,228,0.457,0.934
"6506","La Paz","El Alto","Colegio Martin Cardenas",43,2,4,1,128,5,21,0,1,205,1,5,211,223,0.624,0.946
"6507","La Paz","El Alto","Colegio Martin Cardenas",58,0,3,1,103,6,28,0,1,200,2,3,205,222,0.515,0.923
"6508","La Paz","El Alto","Colegio Martin Cardenas",55,2,5,1,114,1,24,0,2,204,2,6,212,226,0.559,0.938
"6509","La Paz","El Alto","Colegio Martin Cardenas",73,4,4,0,85,5,31,1,1,204,1,5,210,228,0.417,0.921
"6510","La Paz","El Alto","Colegio Martin Cardenas",81,1,2,0,95,2,23,0,0,204,2,6,212,232,0.466,0.914
"6511","La Paz","El Alto","Colegio Martin Cardenas",85,0,2,1,79,2,28,1,4,202,1,4,207,227,0.391,0.912
"6512","La Paz","El Alto","Colegio Martin Cardenas",83,0,3,1,87,0,23,1,3,201,0,6,207,223,0.433,0.928
"6513","La Paz","El Alto","Colegio Martin Cardenas",84,0,0,0,92,3,24,0,1,204,2,2,208,224,0.451,0.929
"6514","La Paz","El Alto","Colegio Martin Cardenas",96,0,3,0,89,1,13,1,0,203,3,1,207,222,0.438,0.932
"6515","La Paz","El Alto","Colegio Martin Cardenas",80,0,4,0,99,2,25,0,0,210,1,3,214,236,0.471,0.907
"6516","La Paz","El Alto","Colegio Martin Cardenas",76,0,4,0,82,2,30,1,3,198,1,7,206,226,0.414,0.912
"6517","La Paz","El Alto","Colegio Martin Cardenas",86,1,2,0,91,3,26,1,0,210,0,2,212,230,0.433,0.922
"6518","La Paz","El Alto","Colegio Martin Cardenas",41,1,5,1,112,3,32,1,3,199,1,5,205,224,0.563,0.915
"6519","La Paz","El Alto","Colegio Martin Cardenas",59,1,4,2,112,2,27,0,1,208,3,3,214,231,0.538,0.926
"6520","La Paz","El Alto","Colegio Martin Cardenas",76,0,0,0,84,1,34,0,0,195,1,3,199,219,0.431,0.909
"6521","La Paz","El Alto","Colegio Martin Cardenas",96,1,3,0,70,4,21,2,0,197,0,5,202,221,0.355,0.914
"6522","La Paz","El Alto","Colegio Martin Cardenas",91,0,1,1,89,1,11,5,1,200,0,1,201,228,0.445,0.882
"6523","La Paz","El Alto","Colegio Martin Cardenas",81,0,2,0,75,2,32,0,3,195,2,9,206,227,0.385,0.907
"6524","La Paz","El Alto","Colegio Martin Cardenas",72,0,1,2,105,0,26,0,1,207,2,3,212,229,0.507,0.926
"6525","La Paz","El Alto","Colegio Martin Cardenas",78,0,5,1,90,1,30,0,0,205,1,4,210,228,0.439,0.921
"6526","La Paz","El Alto","Colegio Martin Cardenas",80,3,2,0,82,2,30,0,2,201,2,7,210,233,0.408,0.901
"6527","La Paz","El Alto","Colegio Martin Cardenas",92,1,3,0,85,3,19,0,0,203,1,7,211,223,0.419,0.946
"6528","La Paz","El Alto","Colegio Martin Cardenas",76,1,6,2,91,2,16,0,0,194,0,11,205,225,0.469,0.911
"6529","La Paz","El Alto","Colegio Martin Cardenas",68,0,2,1,93,2,37,2,3,208,3,0,211,221,0.447,0.955
"6530","La Paz","El Alto","Colegio Martin Cardenas",55,1,3,1,71,0,19,0,1,151,1,5,157,171,0.47,0.918
"6531","La Paz","El Alto","U. E. Villa Adela Yunguyo - Av. Puerto Acosta 1454 - 2003",63,4,8,4,84,3,21,2,3,192,3,4,199,218,0.438,0.913
"6532","La Paz","El Alto","U. E. Villa Adela Yunguyo - Av. Puerto Acosta 1454 - 2003",82,0,12,0,82,4,26,0,1,207,3,4,214,229,0.396,0.934
"6533","La Paz","El Alto","U. E. Villa Adela Yunguyo - Av. Puerto Acosta 1454 - 2003",57,2,4,1,111,1,23,0,2,201,2,5,208,225,0.552,0.924
"6534","La Paz","El Alto","U. E. Villa Adela Yunguyo - Av. Puerto Acosta 1454 - 2003",54,0,2,0,105,2,26,1,2,192,3,7,202,222,0.547,0.91
"6535","La Paz","El Alto","U. E. Villa Adela Yunguyo - Av. Puerto Acosta 1454 - 2003",69,0,3,0,113,3,19,0,2,209,0,0,209,225,0.541,0.929
"6536","La Paz","El Alto","U. E. Villa Adela Yunguyo - Av. Puerto Acosta 1454 - 2003",77,1,3,0,93,3,21,0,0,198,1,3,202,222,0.47,0.91
"6537","La Paz","El Alto","Unidad Educativa San Juan de Calama",46,1,4,0,108,4,42,0,2,207,1,6,214,225,0.522,0.951
"6538","La Paz","El Alto","Unidad Educativa San Juan de Calama",42,1,5,0,118,2,33,0,2,203,1,10,214,230,0.581,0.93
"6539","La Paz","El Alto","Unidad Educativa San Juan de Calama",58,0,7,0,91,3,31,0,4,194,3,12,209,224,0.469,0.933
"6540","La Paz","El Alto","Unidad Educativa San Juan de Calama",64,1,3,1,103,1,26,1,2,202,2,3,207,222,0.51,0.932
"6541","La Paz","El Alto","Unidad Educativa San Juan de Calama",45,0,5,1,125,2,27,1,5,211,3,6,220,228,0.592,0.965
"6542","La Paz","El Alto","Unidad Educativa San Juan de Calama",71,1,12,0,93,1,22,0,2,202,1,6,209,223,0.46,0.937
"6543","La Paz","El Alto","Unidad Educativa San Juan de Calama",65,1,7,0,98,0,28,1,1,201,0,4,205,228,0.488,0.899
"6544","La Paz","El Alto","Unidad Educativa San Juan de Calama",42,1,5,0,123,0,33,1,2,207,3,7,217,233,0.594,0.931
"6545","La Paz","El Alto","Unidad Educativa San Juan de Calama",52,0,4,0,106,4,37,0,6,209,1,2,212,229,0.507,0.926
"6546","La Paz","El Alto","Unidad Educativa San Juan de Calama",47,1,5,1,120,0,22,0,3,199,4,7,210,232,0.603,0.905
"6547","La Paz","El Alto","Unidad Educativa San Juan de Calama",35,1,11,1,111,4,38,0,5,206,2,3,211,228,0.539,0.925
"6548","La Paz","El Alto","Unidad Educativa San Juan de Calama",62,0,3,0,114,1,27,0,0,207,0,3,210,227,0.551,0.925
"6549","La Paz","El Alto","Unidad Educativa San Juan de Calama",62,0,11,1,105,3,23,1,3,209,2,5,216,228,0.502,0.947
"6550","La Paz","El Alto","Unidad Educativa San Juan de Calama",59,0,8,0,109,2,32,2,1,213,3,3,219,230,0.512,0.952
"6551","La Paz","El Alto","Unidad Educativa San Juan de Calama",49,0,4,0,112,1,40,1,0,207,5,7,219,232,0.541,0.944
"6552","La Paz","El Alto","Unidad Educativa San Juan de Calama",67,0,8,0,93,2,35,0,2,207,2,4,213,228,0.449,0.934
"6553","La Paz","El Alto","Unidad Educativa San Juan de Calama",47,2,9,1,116,1,24,0,3,203,1,10,214,231,0.571,0.926
"6554","La Paz","El Alto","Unidad Educativa San Juan de Calama",43,0,4,1,118,1,34,0,0,201,2,4,207,230,0.587,0.9
"6555","La Paz","El Alto","U.E. Amigos Del Chaco",69,0,3,1,106,3,20,0,1,203,1,7,211,228,0.522,0.925
"6556","La Paz","El Alto","U.E. Amigos Del Chaco",74,1,2,0,96,1,26,0,2,202,1,3,206,224,0.475,0.92
"6557","La Paz","El Alto","U.E. Amigos Del Chaco",54,0,4,2,115,2,30,1,3,211,2,6,219,229,0.545,0.956
"6558","La Paz","El Alto","U.E. Amigos Del Chaco",59,1,3,0,113,1,23,1,4,205,1,9,215,230,0.551,0.935
"6559","La Paz","El Alto","U.E. Amigos Del Chaco",63,0,2,0,107,2,38,0,1,213,1,4,218,230,0.502,0.948
"6560","La Paz","El Alto","U.E. Amigos Del Chaco",54,1,5,0,73,2,14,2,0,151,1,5,157,173,0.483,0.908
"6561","La Paz","El Alto","Colegio Luis Espinal Camps (Aeropuerto)",46,1,8,2,113,3,32,0,1,206,3,9,218,232,0.549,0.94
"6562","La Paz","El Alto","Colegio Luis Espinal Camps (Aeropuerto)",53,1,6,0,123,2,27,0,1,213,1,0,214,231,0.577,0.926
"6563","La Paz","El Alto","Colegio Luis Espinal Camps (Aeropuerto)",40,0,8,1,109,5,32,0,3,198,1,7,206,227,0.551,0.907
"6564","La Paz","El Alto","Colegio Luis Espinal Camps (Aeropuerto)",30,3,8,1,123,3,35,1,5,209,0,5,214,231,0.589,0.926
"6565","La Paz","El Alto","Colegio Luis Espinal Camps (Aeropuerto)",36,3,9,1,117,0,32,0,4,202,0,3,205,227,0.579,0.903
"6566","La Paz","El Alto","Colegio Luis Espinal Camps (Aeropuerto)",63,0,2,0,114,3,25,0,3,210,2,6,218,230,0.543,0.948
"6567","La Paz","El Alto","Colegio Luis Espinal Camps (Aeropuerto)",37,2,8,1,122,2,35,0,7,214,2,2,218,231,0.57,0.944
"6568","La Paz","El Alto","Colegio Luis Espinal Camps (Aeropuerto)",44,1,7,1,106,6,36,1,2,204,2,5,211,233,0.52,0.906
"6569","La Paz","El Alto","Colegio Luis Espinal Camps (Aeropuerto)",27,1,12,0,125,1,38,0,2,206,2,3,211,225,0.607,0.938
"6570","La Paz","El Alto","Colegio Luis Espinal Camps (Aeropuerto)",36,0,8,1,110,2,37,0,2,196,0,9,205,231,0.561,0.887
"6571","La Paz","El Alto","Colegio Luis Espinal Camps (Aeropuerto)",51,1,13,0,110,1,27,0,1,204,0,6,210,231,0.539,0.909
"6572","La Paz","El Alto","Colegio Luis Espinal Camps (Aeropuerto)",42,1,15,0,109,1,34,1,1,204,1,4,209,228,0.534,0.917
"6573","La Paz","El Alto","Colegio Luis Espinal Camps (Aeropuerto)",43,1,12,0,114,0,43,0,4,217,1,6,224,236,0.525,0.949
"6574","La Paz","El Alto","Colegio Luis Espinal Camps (Aeropuerto)",44,0,14,0,104,5,38,1,1,207,2,7,216,231,0.502,0.935
"6575","La Paz","El Alto","Colegio Luis Espinal Camps (Aeropuerto)",57,1,9,2,102,1,32,0,0,204,1,4,209,227,0.5,0.921
"6576","La Paz","El Alto","Colegio Luis Espinal Camps (Aeropuerto)",39,0,7,0,86,0,33,1,3,169,1,7,177,188,0.509,0.941
"6577","La Paz","El Alto","Unidad Educativa Villa Alemania",71,1,7,0,84,2,32,1,3,201,3,5,209,224,0.418,0.933
"6578","La Paz","El Alto","Unidad Educativa Villa Alemania",52,1,10,1,101,1,33,0,2,201,1,6,208,228,0.502,0.912
"6579","La Paz","El Alto","Unidad Educativa Villa Alemania",47,0,8,2,112,3,26,0,7,205,2,6,213,231,0.546,0.922
"6580","La Paz","El Alto","Unidad Educativa Villa Alemania",67,1,3,2,97,1,26,2,2,201,1,4,206,226,0.483,0.912
"6581","La Paz","El Alto","Unidad Educativa Villa Alemania",78,0,8,0,84,1,27,0,2,200,2,6,208,227,0.42,0.916
"6582","La Paz","El Alto","Unidad Educativa Villa Alemania",77,0,1,1,95,1,26,0,3,204,1,7,212,233,0.466,0.91
"6583","La Paz","El Alto","Unidad Educativa Villa Alemania",74,2,8,0,87,1,36,0,1,209,1,5,215,229,0.416,0.939
"6584","La Paz","El Alto","Unidad Educativa Villa Alemania",50,1,9,0,101,2,32,0,1,196,3,9,208,225,0.515,0.924
"6585","La Paz","El Alto","Unidad Educativa Villa Alemania",63,0,9,1,93,5,34,0,4,209,0,11,220,231,0.445,0.952
"6586","La Paz","El Alto","Unidad Educativa Villa Alemania",81,0,3,0,93,4,22,0,4,207,0,9,216,230,0.449,0.939
"6587","La Paz","El Alto","Unidad Educativa Villa Alemania",58,0,5,0,104,2,25,0,2,196,2,9,207,226,0.531,0.916
"6588","La Paz","El Alto","Unidad Educativa Villa Alemania",49,1,7,2,105,1,38,0,1,204,2,2,208,225,0.515,0.924
"6589","La Paz","El Alto","Unidad Educativa Villa Alemania",72,4,5,1,96,5,24,0,3,210,0,5,215,228,0.457,0.943
"6590","La Paz","El Alto","Unidad Educativa Villa Alemania",73,0,5,1,94,1,23,0,0,197,3,7,207,222,0.477,0.932
"6591","La Paz","El Alto","Unidad Educativa Villa Alemania",52,1,12,0,103,4,27,0,4,203,0,6,209,227,0.507,0.921
"6592","La Paz","El Alto","U. E. Villa Adela Yunguyo - Distrito 20 - 2605",55,1,8,1,2,110,30,0,1,208,0,4,212,228,0.01,0.93
"6593","La Paz","El Alto","U. E. Villa Adela Yunguyo - Distrito 20 - 2605",51,2,7,1,99,3,27,1,2,193,3,10,206,231,0.513,0.892
"6594","La Paz","El Alto","U. E. Villa Adela Yunguyo - Distrito 20 - 2605",36,1,8,1,138,4,26,1,1,216,4,3,223,234,0.639,0.953
"6595","La Paz","El Alto","U. E. Villa Adela Yunguyo - Distrito 20 - 2605",48,0,6,0,119,3,29,0,5,210,3,5,218,231,0.567,0.944
"6596","La Paz","El Alto","U. E. Villa Adela Yunguyo - Distrito 20 - 2605",47,0,5,3,110,4,21,3,3,196,1,11,208,223,0.561,0.933
"6597","La Paz","El Alto","U. E. Villa Adela Yunguyo - Distrito 20 - 2605",46,1,9,1,110,3,36,1,2,209,1,8,218,228,0.526,0.956
"6598","La Paz","El Alto","U. E. Villa Adela Yunguyo - Distrito 20 - 2605",42,1,14,0,115,0,35,0,2,209,1,8,218,229,0.55,0.952
"6599","La Paz","El Alto","U. E. Villa Adela Yunguyo - Distrito 20 - 2605",42,2,5,2,119,2,27,1,0,200,1,6,207,233,0.595,0.888
"6600","La Paz","El Alto","U. E. Villa Adela Yunguyo - Distrito 20 - 2605",50,0,12,1,103,3,37,0,1,207,1,5,213,229,0.498,0.93
"6601","La Paz","El Alto","U. E. Villa Adela Yunguyo - Distrito 20 - 2605",32,1,16,0,124,3,30,1,2,209,1,7,217,234,0.593,0.927
"6602","La Paz","El Alto","U. E. Villa Adela Yunguyo - Distrito 20 - 2605",59,1,7,0,96,2,28,3,4,200,3,4,207,228,0.48,0.908
"6603","La Paz","El Alto","U. E. Villa Adela Yunguyo - Distrito 20 - 2605",44,1,9,2,123,1,30,0,4,214,1,11,226,234,0.575,0.966
"6604","La Paz","El Alto","U.E. Villa el Carmen",69,0,2,2,94,3,42,0,2,214,3,14,231,240,0.439,0.963
"6605","La Paz","El Alto","U.E. Villa el Carmen",62,0,1,0,107,2,43,0,3,218,2,10,230,239,0.491,0.962
"6606","La Paz","El Alto","U.E. Villa el Carmen",55,1,7,0,113,2,40,1,1,220,1,5,226,240,0.514,0.942
"6607","La Paz","El Alto","U.E. Villa el Carmen",58,1,2,0,89,4,29,0,1,184,0,10,194,202,0.484,0.96
"6608","La Paz","El Alto","Colegio Luis Espinal Camps",27,2,3,0,139,3,29,1,1,205,3,9,217,225,0.678,0.964
"6609","La Paz","El Alto","Colegio Luis Espinal Camps",36,3,9,2,115,2,27,0,3,197,1,9,207,228,0.584,0.908
"6610","La Paz","El Alto","Colegio Luis Espinal Camps",37,3,12,2,122,2,20,1,4,203,4,10,217,233,0.601,0.931
"6611","La Paz","El Alto","Colegio Luis Espinal Camps",35,2,7,0,126,5,29,0,5,209,2,6,217,234,0.603,0.927
"6612","La Paz","El Alto","Colegio Luis Espinal Camps",53,1,7,0,115,2,24,0,1,203,3,3,209,226,0.567,0.925
"6613","La Paz","El Alto","Colegio Luis Espinal Camps",49,1,11,0,108,1,35,0,0,205,2,6,213,230,0.527,0.926
"6614","La Paz","El Alto","Colegio Luis Espinal Camps",42,0,10,1,118,3,28,0,3,205,3,2,210,224,0.576,0.938
"6615","La Paz","El Alto","Colegio Luis Espinal Camps",31,0,7,1,130,3,27,0,1,200,1,8,209,224,0.65,0.933
"6616","La Paz","El Alto","Colegio Luis Espinal Camps",46,1,6,0,118,0,32,0,4,207,1,9,217,229,0.57,0.948
"6617","La Paz","El Alto","Colegio Luis Espinal Camps",37,0,7,0,121,2,23,0,3,193,3,9,205,220,0.627,0.932
"6618","La Paz","El Alto","Colegio Luis Espinal Camps",40,1,13,1,119,2,26,0,4,206,1,8,215,227,0.578,0.947
"6619","La Paz","El Alto","Colegio Luis Espinal Camps",34,0,4,0,128,2,26,0,2,196,1,6,203,228,0.653,0.89
"6620","La Paz","El Alto","Colegio Luis Espinal Camps",42,0,14,0,125,2,21,0,5,209,0,6,215,230,0.598,0.935
"6621","La Paz","El Alto","Colegio Luis Espinal Camps",29,1,7,1,119,4,39,0,2,202,4,5,211,222,0.589,0.95
"6622","La Paz","El Alto","Colegio Luis Espinal Camps",47,3,5,1,114,1,26,1,2,200,0,3,203,226,0.57,0.898
"6623","La Paz","El Alto","Colegio Luis Espinal Camps",36,0,10,0,111,2,32,1,2,194,2,7,203,228,0.572,0.89
"6624","La Paz","El Alto","Colegio Luis Espinal Camps",49,2,2,0,121,2,27,0,2,205,3,9,217,227,0.59,0.956
"6625","La Paz","El Alto","Colegio Luis Espinal Camps",43,0,8,2,113,3,22,1,2,194,4,4,202,226,0.582,0.894
"6626","La Paz","El Alto","Colegio Luis Espinal Camps",39,3,3,2,118,0,34,1,2,202,3,4,209,223,0.584,0.937
"6627","La Paz","El Alto","Colegio Luis Espinal Camps",31,0,13,1,125,0,28,0,1,199,0,14,213,230,0.628,0.926
"6628","La Paz","El Alto","Colegio Luis Espinal Camps",49,1,2,1,123,1,27,0,3,207,0,7,214,233,0.594,0.918
"6629","La Paz","El Alto","Colegio Luis Espinal Camps",39,0,2,1,119,4,36,0,1,202,5,5,212,229,0.589,0.926
"6630","La Paz","El Alto","Colegio Luis Espinal Camps",47,0,5,0,112,1,37,1,4,207,2,6,215,226,0.541,0.951
"6631","La Paz","El Alto","Colegio Luis Espinal Camps",29,0,6,1,134,2,22,0,1,195,1,10,206,225,0.687,0.916
"6632","La Paz","El Alto","Colegio Luis Espinal Camps",32,2,6,0,130,1,31,1,1,204,4,6,214,229,0.637,0.934
"6633","La Paz","El Alto","Colegio Luis Espinal Camps",28,1,8,0,152,0,23,0,0,212,1,4,217,229,0.717,0.948
"6634","La Paz","El Alto","Colegio Luis Espinal Camps",23,0,4,2,137,3,25,1,1,196,3,5,204,220,0.699,0.927
"6635","La Paz","El Alto","Colegio Luis Espinal Camps",37,0,4,0,120,2,34,0,3,200,2,10,212,227,0.6,0.934
"6636","La Paz","El Alto","Colegio Luis Espinal Camps",40,1,3,1,118,2,29,1,1,196,1,9,206,228,0.602,0.904
"6637","La Paz","El Alto","Colegio Luis Espinal Camps",51,0,2,0,109,0,41,1,0,204,4,11,219,234,0.534,0.936
"6638","La Paz","El Alto","Colegio Luis Espinal Camps",29,1,6,0,128,3,29,2,1,199,0,9,208,225,0.643,0.924
"6639","La Paz","El Alto","Colegio Luis Espinal Camps",45,0,4,0,118,4,28,1,3,203,3,10,216,231,0.581,0.935
"6640","La Paz","El Alto","Colegio Luis Espinal Camps",39,2,12,1,121,2,22,0,2,201,3,8,212,232,0.602,0.914
"6641","La Paz","El Alto","Colegio Luis Espinal Camps",33,0,5,0,123,3,26,1,5,196,3,7,206,221,0.628,0.932
"6642","La Paz","El Alto","Colegio Luis Espinal Camps",38,0,8,0,114,3,32,0,2,197,3,4,204,223,0.579,0.915
"6643","La Paz","El Alto","Colegio Luis Espinal Camps",35,3,8,1,116,4,29,0,5,201,2,9,212,226,0.577,0.938
"6644","La Paz","El Alto","Colegio Luis Espinal Camps",41,0,5,0,121,6,37,0,5,215,0,4,219,240,0.563,0.912
"6645","La Paz","El Alto","Colegio Luis Espinal Camps",42,1,8,1,124,0,27,0,5,208,2,6,216,235,0.596,0.919
"6646","La Paz","El Alto","Colegio Luis Espinal Camps",51,0,7,0,105,2,35,0,2,202,3,5,210,225,0.52,0.933
"6647","La Paz","El Alto","Colegio Luis Espinal Camps",35,1,5,1,129,0,32,0,2,205,2,5,212,229,0.629,0.926
"6648","La Paz","El Alto","Colegio Luis Espinal Camps",33,0,7,0,135,2,31,1,2,211,4,4,219,230,0.64,0.952
"6649","La Paz","El Alto","Colegio Luis Espinal Camps",25,3,7,0,133,2,28,0,2,200,1,7,208,220,0.665,0.945
"6650","La Paz","El Alto","Colegio Luis Espinal Camps",34,0,7,0,116,4,37,0,10,208,0,2,210,224,0.558,0.938
"6651","La Paz","El Alto","Colegio Luis Espinal Camps",46,0,3,0,122,0,32,0,3,206,3,10,219,230,0.592,0.952
"6652","La Paz","El Alto","Colegio Luis Espinal Camps",39,2,7,0,101,3,20,1,3,176,1,7,184,201,0.574,0.915
"6653","La Paz","El Alto","Unidad Educativa 6 de Junio",34,1,9,1,126,2,24,2,1,200,1,8,209,231,0.63,0.905
"6654","La Paz","El Alto","Unidad Educativa 6 de Junio",46,0,6,0,125,2,26,2,1,208,3,8,219,233,0.601,0.94
"6655","La Paz","El Alto","Unidad Educativa 6 de Junio",36,2,2,0,112,5,33,0,1,191,4,8,203,226,0.586,0.898
"6656","La Paz","El Alto","Unidad Educativa 6 de Junio",44,0,5,0,110,1,38,0,2,200,3,14,217,237,0.55,0.916
"6657","La Paz","El Alto","Unidad Educativa 6 de Junio",46,1,6,0,128,4,19,0,0,204,1,4,209,230,0.627,0.909
"6658","La Paz","El Alto","Unidad Educativa 6 de Junio",30,0,6,1,130,0,35,1,9,212,3,4,219,233,0.613,0.94
"6659","La Paz","El Alto","Unidad Educativa 6 de Junio",46,1,5,0,122,4,30,1,4,213,3,7,223,235,0.573,0.949
"6660","La Paz","El Alto","Unidad Educativa 6 de Junio",31,1,7,0,130,2,27,0,1,199,1,7,207,232,0.653,0.892
"6661","La Paz","El Alto","Unidad Educativa 6 de Junio",45,0,3,1,118,6,24,0,4,201,0,10,211,232,0.587,0.909
"6662","La Paz","El Alto","Unidad Educativa 6 de Junio",52,1,4,0,103,2,33,0,3,198,1,4,203,224,0.52,0.906
"6663","La Paz","El Alto","Unidad Educativa 6 de Junio",38,1,3,2,108,3,37,0,7,199,1,12,212,231,0.543,0.918
"6664","La Paz","El Alto","Unidad Educativa 6 de Junio",36,0,5,1,123,0,32,0,4,201,2,7,210,231,0.612,0.909
"6665","La Paz","El Alto","Unidad Educativa 6 de Junio",42,0,4,0,122,4,33,0,1,206,1,6,213,232,0.592,0.918
"6666","La Paz","El Alto","Unidad Educativa 6 de Junio",43,0,11,0,124,0,21,0,0,199,0,10,209,221,0.623,0.946
"6667","La Paz","El Alto","Unidad Educativa 6 de Junio",23,0,6,0,129,2,37,0,2,199,2,10,211,227,0.648,0.93
"6668","La Paz","El Alto","Unidad Educativa 6 de Junio",31,0,8,0,127,0,28,0,1,195,1,14,210,233,0.651,0.901
"6669","La Paz","El Alto","Unidad Educativa 6 de Junio",27,0,5,1,137,5,26,0,3,204,3,8,215,232,0.672,0.927
"6670","La Paz","El Alto","Unidad Educativa 6 de Junio",45,1,4,1,117,3,33,0,3,207,1,9,217,231,0.565,0.939
"6671","La Paz","El Alto","Unidad Educativa 6 de Junio",25,0,7,1,136,6,31,1,1,208,1,4,213,230,0.654,0.926
"6672","La Paz","El Alto","Unidad Educativa 6 de Junio",19,0,4,2,158,1,27,0,2,213,1,8,222,232,0.742,0.957
"6673","La Paz","El Alto","Unidad Educativa 6 de Junio",43,1,3,0,142,1,23,1,1,215,1,5,221,233,0.66,0.948
"6674","La Paz","El Alto","Unidad Educativa 6 de Junio",27,1,10,2,134,2,25,0,1,202,1,9,212,233,0.663,0.91
"6675","La Paz","El Alto","Unidad Educativa 6 de Junio",45,0,4,1,121,2,25,0,4,202,0,7,209,228,0.599,0.917
"6676","La Paz","El Alto","Unidad Educativa 6 de Junio",39,3,6,0,124,3,25,0,4,204,3,5,212,234,0.608,0.906
"6677","La Paz","El Alto","Unidad Educativa 6 de Junio",48,1,7,1,113,2,26,1,3,202,0,7,209,228,0.559,0.917
"6678","La Paz","El Alto","Unidad Educativa 6 de Junio",46,0,8,0,111,3,33,0,0,201,4,9,214,235,0.552,0.911
"6679","La Paz","El Alto","Unidad Educativa 6 de Junio",36,0,4,1,141,2,16,0,2,202,1,10,213,231,0.698,0.922
"6680","La Paz","El Alto","U.E. Juan Pablo II",34,1,8,0,121,2,39,2,3,210,1,12,223,240,0.576,0.929
"6681","La Paz","El Alto","U.E. Juan Pablo II",37,0,5,0,126,5,40,0,3,216,0,10,226,239,0.583,0.946
"6682","La Paz","El Alto","U.E. Juan Pablo II",40,1,3,0,131,3,40,0,2,220,4,3,227,238,0.595,0.954
"6683","La Paz","El Alto","U.E. Juan Pablo II",30,1,4,1,142,1,42,0,2,223,1,7,231,239,0.637,0.967
"6684","La Paz","El Alto","U.E. Juan Pablo II",39,0,6,0,105,5,17,0,1,173,2,2,177,193,0.607,0.917
"6685","La Paz","El Alto","Colegio Fernando Nogales Castro",64,0,6,1,107,5,16,0,2,201,1,11,213,227,0.532,0.938
"6686","La Paz","El Alto","Colegio Fernando Nogales Castro",70,3,9,0,98,4,24,1,2,211,1,11,223,234,0.464,0.953
"6687","La Paz","El Alto","Colegio Fernando Nogales Castro",94,0,4,0,85,1,30,1,1,216,2,5,223,232,0.394,0.961
"6688","La Paz","El Alto","Colegio Fernando Nogales Castro",72,2,3,1,108,3,17,0,5,211,4,10,225,237,0.512,0.949
"6689","La Paz","El Alto","Colegio Fernando Nogales Castro",56,1,10,0,119,2,27,0,2,217,3,3,223,234,0.548,0.953
"6690","La Paz","El Alto","Colegio Fernando Nogales Castro",49,0,3,0,130,0,27,1,2,212,2,8,222,231,0.613,0.961
"6691","La Paz","El Alto","Colegio Fernando Nogales Castro",62,0,4,0,121,2,21,0,2,212,1,7,220,232,0.571,0.948
"6692","La Paz","El Alto","Colegio Fernando Nogales Castro",63,1,1,0,116,0,29,1,1,212,0,4,216,230,0.547,0.939
"6693","La Paz","El Alto","Colegio Fernando Nogales Castro",70,2,6,0,102,3,24,0,2,209,2,7,218,229,0.488,0.952
"6694","La Paz","El Alto","Colegio Fernando Nogales Castro",63,2,6,0,103,2,35,0,1,212,4,7,223,232,0.486,0.961
"6695","La Paz","El Alto","Colegio Fernando Nogales Castro",66,1,3,1,108,1,25,0,3,208,4,6,218,232,0.519,0.94
"6696","La Paz","El Alto","Colegio Fernando Nogales Castro",44,2,6,0,124,2,31,1,0,210,2,8,220,232,0.59,0.948
"6697","La Paz","El Alto","Colegio Fernando Nogales Castro",53,2,7,0,115,4,27,0,1,209,2,3,214,231,0.55,0.926
"6698","La Paz","El Alto","Colegio Fernando Nogales Castro",70,1,9,1,104,3,23,2,2,215,2,8,225,231,0.484,0.974
"6699","La Paz","El Alto","Colegio Fernando Nogales Castro",81,0,7,1,91,4,27,2,2,215,1,2,218,233,0.423,0.936
"6700","La Paz","El Alto","Colegio Fernando Nogales Castro",78,0,7,0,92,3,22,1,4,207,2,9,218,232,0.444,0.94
"6701","La Paz","El Alto","Colegio Fernando Nogales Castro",68,0,5,2,94,2,26,0,1,198,0,6,204,223,0.475,0.915
"6702","La Paz","El Alto","Colegio Fernando Nogales Castro",42,2,8,0,133,0,26,1,2,214,4,4,222,232,0.621,0.957
"6703","La Paz","El Alto","Colegio Fernando Nogales Castro",70,1,1,0,115,3,2,0,1,193,2,5,200,231,0.596,0.866
"6704","La Paz","El Alto","Colegio Fernando Nogales Castro",66,1,6,0,112,2,19,1,0,207,0,5,212,229,0.541,0.926
"6705","La Paz","El Alto","Colegio Fernando Nogales Castro",61,1,7,0,112,2,28,1,2,214,2,4,220,236,0.523,0.932
"6706","La Paz","El Alto","Colegio Fernando Nogales Castro",83,1,8,0,104,1,18,0,0,215,2,7,224,236,0.484,0.949
"6707","La Paz","El Alto","Colegio Fernando Nogales Castro",68,1,6,0,129,5,13,0,1,223,1,4,228,243,0.578,0.938
"6708","La Paz","El Alto","Unidad Educativa Rep. Del Uruguay",29,2,11,1,119,7,34,0,0,203,2,10,215,227,0.586,0.947
"6709","La Paz","El Alto","Unidad Educativa Rep. Del Uruguay",25,0,4,0,118,4,25,0,2,178,5,10,193,202,0.663,0.955
"6710","La Paz","El Alto","Unidad Educativa Rep. Del Uruguay",26,0,14,1,127,5,47,0,2,222,4,8,234,241,0.572,0.971
"6711","La Paz","El Alto","Escuela Republica de China Popular",19,1,15,0,131,4,39,0,4,213,0,10,223,232,0.615,0.961
"6712","La Paz","El Alto","Escuela Republica de China Popular",21,1,3,1,143,2,41,0,1,213,1,8,222,234,0.671,0.949
"6713","La Paz","El Alto","Escuela Republica de China Popular",34,1,9,0,119,1,35,0,4,203,1,15,219,231,0.586,0.948
"6714","La Paz","El Alto","Escuela Republica de China Popular",23,0,5,0,158,3,28,1,3,221,0,4,225,235,0.715,0.957
"6715","La Paz","El Alto","Escuela Republica de China Popular",21,2,6,0,134,3,40,0,1,207,3,3,213,233,0.647,0.914
"6716","La Paz","El Alto","Escuela Republica de China Popular",29,0,8,0,139,2,34,0,0,212,0,9,221,231,0.656,0.957
"6717","La Paz","El Alto","Escuela Republica de China Popular",21,0,12,1,134,2,35,0,2,207,7,8,222,232,0.647,0.957
"6718","La Paz","El Alto","Escuela Republica de China Popular",19,1,9,1,136,1,31,1,1,200,3,21,224,236,0.68,0.949
"6719","La Paz","El Alto","Escuela Republica de China Popular",30,1,4,1,124,2,45,0,1,208,1,7,216,229,0.596,0.943
"6720","La Paz","El Alto","Escuela Republica de China Popular",21,0,16,1,119,5,39,1,2,204,4,14,222,236,0.583,0.941
"6721","La Paz","El Alto","Escuela Republica de China Popular",24,1,7,0,142,1,29,1,0,205,4,7,216,233,0.693,0.927
"6722","La Paz","El Alto","Escuela Republica de China Popular",20,0,4,1,137,2,36,1,1,202,1,7,210,229,0.678,0.917
"6723","La Paz","El Alto","Escuela Republica de China Popular",29,1,12,1,140,0,24,0,3,210,2,10,222,234,0.667,0.949
"6724","La Paz","El Alto","Escuela Republica de China Popular",23,1,14,1,124,1,45,0,1,210,2,9,221,236,0.59,0.936
"6725","La Paz","El Alto","Escuela Republica de China Popular",19,0,7,1,127,0,48,2,3,207,2,9,218,235,0.614,0.928
"6726","La Paz","El Alto","Escuela Republica de China Popular",24,1,8,1,112,5,43,0,0,194,4,35,233,233,0.577,1
"6727","La Paz","El Alto","Escuela Republica de China Popular",26,4,6,1,129,5,22,0,5,198,2,22,222,222,0.652,1
"6728","La Paz","El Alto","Escuela Republica de China Popular",22,2,9,1,143,1,41,0,1,220,1,8,229,235,0.65,0.974
"6729","La Paz","El Alto","Escuela Republica de China Popular",22,0,13,2,147,1,27,1,1,214,3,16,233,233,0.687,1
"6730","La Paz","El Alto","Escuela Republica de China Popular",35,1,9,0,134,2,30,0,1,212,1,16,229,229,0.632,1
"6731","La Paz","El Alto","Escuela Republica de China Popular",39,0,7,0,134,1,29,2,2,214,0,21,235,235,0.626,1
"6732","La Paz","El Alto","Escuela Republica de China Popular",24,1,8,0,133,5,44,0,2,217,2,4,223,236,0.613,0.945
"6733","La Paz","El Alto","Escuela Republica de China Popular",25,1,5,1,139,3,34,1,1,210,2,9,221,231,0.662,0.957
"6734","La Paz","El Alto","Escuela Republica de China Popular",11,1,13,1,150,1,30,1,2,210,6,5,221,229,0.714,0.965
"6735","La Paz","El Alto","Escuela Republica de China Popular",12,0,10,0,146,2,37,0,1,208,3,9,220,232,0.702,0.948
"6736","La Paz","El Alto","Escuela Republica de China Popular",26,0,3,0,131,1,38,0,5,204,2,6,212,233,0.642,0.91
"6737","La Paz","El Alto","Escuela Republica de China Popular",25,1,10,0,130,1,41,0,2,210,0,4,214,231,0.619,0.926
"6738","La Paz","El Alto","Escuela Republica de China Popular",35,1,8,0,131,4,26,0,0,205,6,13,224,233,0.639,0.961
"6739","La Paz","El Alto","Escuela Republica de China Popular",24,2,4,0,146,2,27,0,1,206,0,7,213,232,0.709,0.918
"6740","La Paz","El Alto","Escuela Republica de China Popular",26,0,7,0,135,0,33,0,1,202,2,6,210,230,0.668,0.913
"6741","La Paz","El Alto","Escuela Republica de China Popular",28,1,4,2,132,1,35,1,1,205,0,11,216,233,0.644,0.927
"6742","La Paz","El Alto","Instituto Educativo Jesus de Nazareth",63,0,2,1,111,1,27,0,2,207,2,9,218,227,0.536,0.96
"6743","La Paz","El Alto","Instituto Educativo Jesus de Nazareth",70,0,7,1,93,3,27,0,5,206,1,6,213,229,0.451,0.93
"6744","La Paz","El Alto","Instituto Educativo Jesus de Nazareth",59,1,8,1,93,3,35,1,1,202,0,6,208,229,0.46,0.908
"6745","La Paz","El Alto","Instituto Educativo Jesus de Nazareth",62,1,1,2,104,4,23,1,1,199,3,10,212,227,0.523,0.934
"6746","La Paz","El Alto","Instituto Educativo Jesus de Nazareth",62,1,5,2,109,0,22,0,1,202,3,5,210,229,0.54,0.917
"6747","La Paz","El Alto","Instituto Educativo Jesus de Nazareth",61,0,2,0,92,0,34,1,5,195,0,9,204,229,0.472,0.891
"6748","La Paz","El Alto","Instituto Educativo Jesus de Nazareth",58,4,11,1,89,0,35,1,2,201,3,10,214,228,0.443,0.939
"6749","La Paz","El Alto","Instituto Educativo Jesus de Nazareth",66,1,2,2,97,3,30,0,3,204,1,4,209,229,0.475,0.913
"6750","La Paz","El Alto","Instituto Educativo Jesus de Nazareth",69,0,8,1,82,1,36,1,0,198,1,3,202,219,0.414,0.922
"6751","La Paz","El Alto","Instituto Educativo Jesus de Nazareth",68,0,4,1,97,1,26,0,4,201,0,9,210,229,0.483,0.917
"6752","La Paz","El Alto","Instituto Educativo Jesus de Nazareth",59,1,7,0,110,1,32,0,2,212,1,1,214,228,0.519,0.939
"6753","La Paz","El Alto","Instituto Educativo Jesus de Nazareth",45,1,4,0,102,4,37,1,5,199,1,10,210,229,0.513,0.917
"6754","La Paz","El Alto","Instituto Educativo Jesus de Nazareth",84,0,3,1,96,0,21,0,4,209,0,8,217,230,0.459,0.943
"6755","La Paz","El Alto","Instituto Educativo Jesus de Nazareth",66,0,4,0,93,3,30,0,1,197,0,7,204,228,0.472,0.895
"6756","La Paz","El Alto","Instituto Educativo Jesus de Nazareth",56,0,5,0,99,3,25,0,3,191,1,11,203,223,0.518,0.91
"6757","La Paz","El Alto","Instituto Educativo Jesus de Nazareth",48,1,2,0,110,1,31,0,4,197,2,10,209,228,0.558,0.917
"6758","La Paz","El Alto","Instituto Educativo Jesus de Nazareth",77,4,6,0,95,2,24,1,4,213,4,1,218,231,0.446,0.944
"6759","La Paz","El Alto","Instituto Educativo Jesus de Nazareth",92,0,1,0,83,4,26,0,1,207,2,6,215,230,0.401,0.935
"6760","La Paz","El Alto","Instituto Educativo Jesus de Nazareth",73,0,2,0,104,5,22,0,2,208,1,5,214,227,0.5,0.943
"6761","La Paz","El Alto","Instituto Educativo Jesus de Nazareth",60,1,3,0,110,4,23,0,5,206,3,8,217,231,0.534,0.939
"6762","La Paz","El Alto","Unidad Educativa Franz Tamayo",21,0,5,1,134,2,36,0,2,201,2,6,209,231,0.667,0.905
"6763","La Paz","El Alto","Unidad Educativa Franz Tamayo",22,1,7,1,143,1,34,0,1,210,6,7,223,235,0.681,0.949
"6764","La Paz","El Alto","Unidad Educativa Franz Tamayo",29,1,5,0,132,1,37,0,5,210,2,7,219,231,0.629,0.948
"6765","La Paz","El Alto","Unidad Educativa Franz Tamayo",30,0,2,1,125,3,35,1,4,201,2,12,215,231,0.622,0.931
"6766","La Paz","El Alto","Unidad Educativa Franz Tamayo",30,3,6,0,140,1,28,0,3,211,4,6,221,233,0.664,0.948
"6767","La Paz","El Alto","Unidad Educativa Franz Tamayo",24,0,4,0,138,1,34,0,2,203,2,6,211,227,0.68,0.93
"6768","La Paz","El Alto","Unidad Educativa Franz Tamayo",16,0,9,2,146,2,35,0,1,211,1,9,221,234,0.692,0.944
"6769","La Paz","El Alto","Unidad Educativa Franz Tamayo",16,0,9,0,156,2,32,0,1,216,2,6,224,235,0.722,0.953
"6770","La Paz","El Alto","Unidad Educativa Franz Tamayo",21,1,5,1,145,3,32,0,0,208,1,7,216,231,0.697,0.935
"6771","La Paz","El Alto","Unidad Educativa Franz Tamayo",17,2,10,0,147,0,27,0,3,206,4,8,218,234,0.714,0.932
"6772","La Paz","El Alto","Unidad Educativa Franz Tamayo",20,2,10,1,135,3,34,0,0,205,2,8,215,228,0.659,0.943
"6773","La Paz","El Alto","Unidad Educativa Franz Tamayo",28,1,4,2,144,3,22,0,3,207,3,8,218,231,0.696,0.944
"6774","La Paz","El Alto","Unidad Educativa Franz Tamayo",25,1,7,0,139,2,23,0,2,199,0,5,204,230,0.698,0.887
"6775","La Paz","El Alto","Unidad Educativa Franz Tamayo",26,1,6,1,148,2,21,0,3,208,1,10,219,234,0.712,0.936
"6776","La Paz","El Alto","Unidad Educativa Franz Tamayo",29,0,5,1,136,1,33,0,2,207,2,9,218,227,0.657,0.96
"6777","La Paz","El Alto","Unidad Educativa Franz Tamayo",18,2,8,0,137,2,32,0,2,201,2,14,217,231,0.682,0.939
"6778","La Paz","El Alto","Unidad Educativa Franz Tamayo",25,1,10,1,138,0,28,0,2,205,0,8,213,231,0.673,0.922
"6779","La Paz","El Alto","Unidad Educativa Franz Tamayo",17,2,10,1,149,1,22,0,4,206,5,4,215,230,0.723,0.935
"6780","La Paz","El Alto","Unidad Educativa Franz Tamayo",18,1,7,0,142,2,44,0,2,216,1,1,218,236,0.657,0.924
"6781","La Paz","El Alto","Unidad Educativa Franz Tamayo",19,0,7,1,135,1,37,1,0,201,1,10,212,231,0.672,0.918
"6782","La Paz","El Alto","Unidad Educativa Franz Tamayo",40,2,9,0,114,5,37,0,3,210,3,11,224,232,0.543,0.966
"6783","La Paz","El Alto","Unidad Educativa Franz Tamayo",16,0,7,0,147,1,32,1,3,207,2,16,225,237,0.71,0.949
"6784","La Paz","El Alto","Unidad Educativa Franz Tamayo",26,0,7,1,144,4,29,0,1,212,2,2,216,229,0.679,0.943
"6785","La Paz","El Alto","Unidad Educativa Franz Tamayo",20,1,11,2,140,4,26,0,3,207,2,9,218,230,0.676,0.948
"6786","La Paz","El Alto","Unidad Educativa Franz Tamayo",18,0,5,1,156,1,33,0,1,215,3,1,219,233,0.726,0.94
"6787","La Paz","El Alto","Unidad Educativa Franz Tamayo",20,0,10,0,140,2,27,0,4,203,2,13,218,227,0.69,0.96
"6788","La Paz","El Alto","Unidad Educativa Franz Tamayo",20,0,10,0,143,2,35,0,5,215,3,4,222,235,0.665,0.945
"6789","La Paz","El Alto","Unidad Educativa Franz Tamayo",17,0,5,0,146,3,39,1,3,214,2,6,222,233,0.682,0.953
"6790","La Paz","El Alto","Unidad Educativa Franz Tamayo",28,0,6,0,136,3,23,2,3,201,1,10,212,232,0.677,0.914
"6791","La Paz","El Alto","Unidad Educativa Franz Tamayo",27,1,4,1,131,2,35,0,1,202,2,12,216,230,0.649,0.939
"6792","La Paz","El Alto","Unidad Educativa Franz Tamayo",17,9,0,0,146,0,40,1,1,214,1,6,221,230,0.682,0.961
"6793","La Paz","El Alto","Unidad Educativa Franz Tamayo",32,2,10,0,111,1,46,0,0,202,3,17,222,233,0.55,0.953
"6794","La Paz","El Alto","Unidad Educativa Franz Tamayo",16,0,0,1,141,1,38,0,2,199,0,9,208,231,0.709,0.9
"6795","La Paz","El Alto","Unidad Educativa Franz Tamayo",32,1,6,0,107,4,30,0,4,184,3,9,196,212,0.582,0.925
"6796","La Paz","El Alto","Unidad Educativa Venezuela",29,0,12,0,125,1,33,0,1,201,4,9,214,237,0.622,0.903
"6797","La Paz","El Alto","Unidad Educativa Venezuela",22,1,13,0,160,2,19,0,4,221,1,7,229,238,0.724,0.962
"6798","La Paz","El Alto","Unidad Educativa Venezuela",32,1,8,0,146,1,32,1,2,223,2,7,232,240,0.655,0.967
"6799","La Paz","El Alto","Unidad Educativa Venezuela",19,1,9,0,146,1,22,0,2,200,6,12,218,234,0.73,0.932
"6800","La Paz","El Alto","Unidad Educativa Venezuela",24,0,4,1,153,0,31,1,2,216,0,9,225,236,0.708,0.953
"6801","La Paz","El Alto","Unidad Educativa Venezuela",18,1,8,1,153,2,32,1,4,220,1,9,230,239,0.695,0.962
"6802","La Paz","El Alto","Unidad Educativa Venezuela",20,7,9,0,148,2,34,0,2,222,1,5,228,237,0.667,0.962
"6803","La Paz","El Alto","Col. San Vicente De Paul",45,0,7,2,108,4,32,1,6,205,1,9,215,230,0.527,0.935
"6804","La Paz","El Alto","Col. San Vicente De Paul",35,1,5,0,124,5,29,2,2,203,0,4,207,223,0.611,0.928
"6805","La Paz","El Alto","Col. San Vicente De Paul",49,0,6,1,105,1,38,0,3,203,0,7,210,224,0.517,0.938
"6806","La Paz","El Alto","Col. San Vicente De Paul",48,1,4,3,97,2,30,0,4,189,1,15,205,221,0.513,0.928
"6807","La Paz","El Alto","Col. San Vicente De Paul",44,2,2,3,99,3,45,0,0,198,2,10,210,219,0.5,0.959
"6808","La Paz","El Alto","Col. San Vicente De Paul",45,0,10,1,110,1,30,0,4,201,2,10,213,227,0.547,0.938
"6809","La Paz","El Alto","Col. San Vicente De Paul",36,0,6,0,117,0,44,1,2,206,2,14,222,237,0.568,0.937
"6810","La Paz","El Alto","Col. San Vicente De Paul",36,1,6,2,119,1,36,1,4,206,0,4,210,227,0.578,0.925
"6811","La Paz","El Alto","Col. San Vicente De Paul",55,2,4,0,108,2,36,0,3,210,1,8,219,233,0.514,0.94
"6812","La Paz","El Alto","Col. San Vicente De Paul",34,2,4,1,117,2,39,2,3,204,1,12,217,232,0.574,0.935
"6813","La Paz","El Alto","Col. San Vicente De Paul",36,1,8,0,118,2,37,0,2,204,3,6,213,232,0.578,0.918
"6814","La Paz","El Alto","Col. San Vicente De Paul",41,1,5,0,121,3,39,0,2,212,3,2,217,229,0.571,0.948
"6815","La Paz","El Alto","Col. San Vicente De Paul",36,1,5,1,123,3,30,0,3,202,1,12,215,230,0.609,0.935
"6816","La Paz","El Alto","Col. San Vicente De Paul",28,1,7,4,116,4,35,0,3,198,2,3,203,223,0.586,0.91
"6817","La Paz","El Alto","Col. San Vicente De Paul",43,1,12,1,104,1,41,0,3,206,1,8,215,230,0.505,0.935
"6818","La Paz","El Alto","Col. San Vicente De Paul",44,0,7,0,124,1,28,2,2,208,3,3,214,228,0.596,0.939
"6819","La Paz","El Alto","Col. San Vicente De Paul",34,1,5,1,120,1,40,0,1,203,2,13,218,228,0.591,0.956
"6820","La Paz","El Alto","Col. San Vicente De Paul",41,1,7,0,112,1,43,0,1,206,1,4,211,228,0.544,0.925
"6821","La Paz","El Alto","Col. San Vicente De Paul",35,1,6,1,112,0,45,0,2,202,2,6,210,227,0.554,0.925
"6822","La Paz","El Alto","Col. San Vicente De Paul",34,0,5,0,122,2,39,0,4,206,3,7,216,227,0.592,0.952
"6823","La Paz","El Alto","Col. San Vicente De Paul",38,0,9,0,119,4,28,0,4,202,0,10,212,230,0.589,0.922
"6824","La Paz","El Alto","Col. San Vicente De Paul",30,2,6,2,125,5,41,0,2,213,1,5,219,229,0.587,0.956
"6825","La Paz","El Alto","Col. San Vicente De Paul",31,0,6,0,136,1,29,0,1,204,3,11,218,230,0.667,0.948
"6826","La Paz","El Alto","Col. San Vicente De Paul",34,0,6,0,125,4,35,0,1,205,4,11,220,232,0.61,0.948
"6827","La Paz","El Alto","Col. San Vicente De Paul",44,1,2,0,114,3,29,1,2,196,0,7,203,217,0.582,0.935
"6828","La Paz","El Alto","Col. San Vicente De Paul",31,1,8,1,129,2,36,0,2,210,0,11,221,228,0.614,0.969
"6829","La Paz","El Alto","Col. San Vicente De Paul",36,0,8,0,122,1,41,0,4,212,2,6,220,231,0.575,0.952
"6830","La Paz","El Alto","Col. San Vicente De Paul",43,0,9,0,122,1,27,0,1,203,5,2,210,227,0.601,0.925
"6831","La Paz","El Alto","Col. San Vicente De Paul",56,0,8,2,104,0,27,1,0,198,0,11,209,224,0.525,0.933
"6832","La Paz","El Alto","Col. San Vicente De Paul",29,0,10,1,123,1,34,0,3,201,3,14,218,228,0.612,0.956
"6833","La Paz","El Alto","Col. San Vicente De Paul",46,1,5,0,103,3,39,1,1,199,1,13,213,226,0.518,0.942
"6834","La Paz","El Alto","Col. San Vicente De Paul",37,0,7,0,123,0,41,0,4,212,1,8,221,232,0.58,0.953
"6835","La Paz","El Alto","Col. San Vicente De Paul",36,1,4,1,118,1,38,1,2,202,1,7,210,226,0.584,0.929
"6836","La Paz","El Alto","Col. San Vicente De Paul",40,0,9,1,115,5,34,1,2,207,2,11,220,233,0.556,0.944
"6837","La Paz","El Alto","Col. San Vicente De Paul",35,3,3,0,128,4,26,0,5,204,1,7,212,231,0.627,0.918
"6838","La Paz","El Alto","Col. San Vicente De Paul",36,1,5,1,107,3,49,0,3,205,2,8,215,230,0.522,0.935
"6839","La Paz","El Alto","Col. San Vicente De Paul",48,1,5,1,107,1,33,0,3,199,2,6,207,226,0.538,0.916
"6840","La Paz","El Alto","Col. San Vicente De Paul",38,2,12,1,105,5,34,0,1,198,3,8,209,229,0.53,0.913
"6841","La Paz","El Alto","Escuela Raul Salmon De La Barra",45,1,10,0,115,5,29,2,3,210,0,11,221,232,0.548,0.953
"6842","La Paz","El Alto","Escuela Raul Salmon De La Barra",53,0,9,1,108,2,29,3,0,205,0,2,207,223,0.527,0.928
"6843","La Paz","El Alto","Escuela Raul Salmon De La Barra",54,0,5,0,92,3,39,1,4,198,3,8,209,227,0.465,0.921
"6844","La Paz","El Alto","Escuela Raul Salmon De La Barra",38,0,12,0,116,1,42,0,3,212,2,1,215,225,0.547,0.956
"6845","La Paz","El Alto","Escuela Raul Salmon De La Barra",48,0,7,2,106,4,31,0,2,200,3,10,213,224,0.53,0.951
"6846","La Paz","El Alto","Escuela Raul Salmon De La Barra",61,0,8,0,94,3,30,1,1,198,3,6,207,227,0.475,0.912
"6847","La Paz","El Alto","Escuela Raul Salmon De La Barra",44,2,9,1,105,2,32,1,0,196,2,14,212,225,0.536,0.942
"6848","La Paz","El Alto","Escuela Raul Salmon De La Barra",47,0,6,1,115,2,27,0,2,200,0,8,208,225,0.575,0.924
"6849","La Paz","El Alto","Escuela Raul Salmon De La Barra",63,1,7,0,94,0,26,1,1,193,1,10,204,219,0.487,0.932
"6850","La Paz","El Alto","Escuela Raul Salmon De La Barra",58,2,4,0,112,1,25,0,1,203,0,11,214,228,0.552,0.939
"6851","La Paz","El Alto","Escuela Raul Salmon De La Barra",43,1,4,0,105,4,42,0,2,201,0,4,205,218,0.522,0.94
"6852","La Paz","El Alto","Escuela Raul Salmon De La Barra",59,0,13,1,100,3,26,0,1,203,2,4,209,225,0.493,0.929
"6853","La Paz","El Alto","Escuela Raul Salmon De La Barra",27,1,8,0,126,3,44,1,1,211,4,5,220,231,0.597,0.952
"6854","La Paz","El Alto","Escuela Raul Salmon De La Barra",65,0,11,0,102,2,31,1,1,213,1,6,220,232,0.479,0.948
"6855","La Paz","El Alto","Escuela Raul Salmon De La Barra",63,0,3,1,112,3,19,0,3,204,2,9,215,224,0.549,0.96
"6856","La Paz","El Alto","Escuela Raul Salmon De La Barra",53,3,4,2,93,1,32,1,6,195,1,10,206,218,0.477,0.945
"6857","La Paz","El Alto","Escuela Juan Carlos Flores Bedregal - San José de Yunguyo - 2202",37,1,17,2,98,4,45,0,0,204,6,5,215,229,0.48,0.939
"6858","La Paz","El Alto","Escuela Juan Carlos Flores Bedregal - San José de Yunguyo - 2202",49,3,10,1,108,2,31,1,2,207,3,2,212,226,0.522,0.938
"6859","La Paz","El Alto","Escuela Juan Carlos Flores Bedregal - San José de Yunguyo - 2202",48,0,4,1,121,2,27,1,0,204,1,4,209,230,0.593,0.909
"6860","La Paz","El Alto","Escuela Juan Carlos Flores Bedregal - San José de Yunguyo - 2202",37,1,6,0,118,0,46,1,2,211,1,7,219,230,0.559,0.952
"6861","La Paz","El Alto","Escuela Juan Carlos Flores Bedregal - San José de Yunguyo - 2202",35,3,9,0,122,2,37,0,2,210,1,2,213,229,0.581,0.93
"6862","La Paz","El Alto","Escuela Juan Carlos Flores Bedregal - San José de Yunguyo - 2202",33,2,5,0,135,0,28,1,3,207,1,6,214,228,0.652,0.939
"6863","La Paz","El Alto","Escuela Juan Carlos Flores Bedregal - San José de Yunguyo - 2202",27,2,8,1,117,1,48,1,0,205,2,9,216,230,0.571,0.939
"6864","La Paz","El Alto","Escuela Juan Carlos Flores Bedregal - San José de Yunguyo - 2202",43,1,9,0,106,2,40,0,2,203,3,11,217,227,0.522,0.956
"6865","La Paz","El Alto","Escuela Juan Carlos Flores Bedregal - San José de Yunguyo - 2202",41,1,7,0,115,2,39,0,1,206,0,9,215,226,0.558,0.951
"6866","La Paz","El Alto","Escuela Juan Carlos Flores Bedregal - San José de Yunguyo - 2202",46,1,5,2,115,8,34,1,5,217,1,6,224,235,0.53,0.953
"6867","La Paz","El Alto","Escuela Juan Carlos Flores Bedregal - San José de Yunguyo - 2202",39,1,17,1,98,1,42,1,3,203,1,8,212,228,0.483,0.93
"6868","La Paz","El Alto","Escuela Juan Carlos Flores Bedregal - San José de Yunguyo - 2202",49,1,12,105,0,0,41,0,7,215,3,4,222,230,0,0.965
"6869","La Paz","El Alto","Escuela Juan Carlos Flores Bedregal - San José de Yunguyo - 2202",49,1,8,2,101,0,41,0,1,203,0,5,208,229,0.498,0.908
"6870","La Paz","El Alto","Escuela Juan Carlos Flores Bedregal - San José de Yunguyo - 2202",46,2,9,0,105,2,40,0,4,208,2,12,222,231,0.505,0.961
"6871","La Paz","El Alto","Escuela Juan Carlos Flores Bedregal - San José de Yunguyo - 2202",28,2,3,0,135,2,31,0,2,203,4,3,210,227,0.665,0.925
"6872","La Paz","El Alto","Escuela Juan Carlos Flores Bedregal - San José de Yunguyo - 2202",39,1,13,0,102,8,41,0,1,205,1,9,215,229,0.498,0.939
"6873","La Paz","El Alto","Escuela Juan Carlos Flores Bedregal - San José de Yunguyo - 2202",49,1,4,0,122,1,23,0,1,201,5,5,211,227,0.607,0.93
"6874","La Paz","El Alto","Escuela Juan Carlos Flores Bedregal - San José de Yunguyo - 2202",37,0,9,0,111,1,40,1,0,199,2,7,208,230,0.558,0.904
"6875","La Paz","El Alto","Escuela Juan Carlos Flores Bedregal - San José de Yunguyo - 2202",37,1,5,0,123,0,36,0,1,203,2,9,214,228,0.606,0.939
"6876","La Paz","El Alto","Escuela Juan Carlos Flores Bedregal - San José de Yunguyo - 2202",45,3,7,0,121,3,24,0,3,206,1,9,216,230,0.587,0.939
"6877","La Paz","El Alto","Escuela Juan Carlos Flores Bedregal - San José de Yunguyo - 2202",45,0,9,0,114,2,31,1,2,204,1,9,214,227,0.559,0.943
"6878","La Paz","El Alto","Escuela Juan Carlos Flores Bedregal - San José de Yunguyo - 2202",29,1,8,1,119,2,26,0,1,187,0,5,192,221,0.636,0.869
"6879","La Paz","El Alto","Escuela Juan Carlos Flores Bedregal - San José de Yunguyo - 2202",30,3,9,0,116,0,38,1,3,200,1,6,207,220,0.58,0.941
"6880","La Paz","El Alto","Escuela Juan Carlos Flores Bedregal - San José de Yunguyo - 2202",42,3,7,1,113,4,27,0,6,203,5,4,212,227,0.557,0.934
"6881","La Paz","El Alto","Escuela Juan Carlos Flores Bedregal - San José de Yunguyo - 2202",48,0,10,0,99,2,42,1,4,206,2,5,213,229,0.481,0.93
"6882","La Paz","El Alto","Escuela Juan Carlos Flores Bedregal - San José de Yunguyo - 2202",41,1,8,1,118,1,29,0,1,200,4,10,214,229,0.59,0.934
"6883","La Paz","El Alto","Escuela Juan Carlos Flores Bedregal - San José de Yunguyo - 2202",38,2,7,1,115,2,31,0,0,196,1,5,202,217,0.587,0.931
"6884","La Paz","El Alto","Escuela Juan Carlos Flores Bedregal - San José de Yunguyo - 2202",46,1,6,0,96,1,50,1,2,203,5,6,214,232,0.473,0.922
"6885","La Paz","El Alto","Escuela Juan Carlos Flores Bedregal - San José de Yunguyo - 2202",38,3,10,1,114,3,33,0,1,203,3,7,213,226,0.562,0.942
"6886","La Paz","El Alto","Escuela Juan Carlos Flores Bedregal - San José de Yunguyo - 2202",48,1,6,0,98,1,39,0,2,195,2,8,205,228,0.503,0.899
"6887","La Paz","El Alto","Escuela Juan Carlos Flores Bedregal - San José de Yunguyo - 2202",35,0,6,1,120,1,35,0,4,202,5,11,218,229,0.594,0.952
"6888","La Paz","El Alto","Escuela Juan Carlos Flores Bedregal - 23 de Marzo - 2203",42,0,10,1,105,1,44,1,3,207,3,5,215,231,0.507,0.931
"6889","La Paz","El Alto","Escuela Juan Carlos Flores Bedregal - 23 de Marzo - 2203",40,2,7,0,111,3,29,1,4,197,1,9,207,230,0.563,0.9
"6890","La Paz","El Alto","Escuela Juan Carlos Flores Bedregal - 23 de Marzo - 2203",42,0,10,1,103,4,41,0,3,204,0,5,209,235,0.505,0.889
"6891","La Paz","El Alto","Escuela Juan Carlos Flores Bedregal - 23 de Marzo - 2203",40,1,6,0,114,2,32,0,1,196,2,9,207,230,0.582,0.9
"6892","La Paz","El Alto","Escuela Juan Carlos Flores Bedregal - 23 de Marzo - 2203",33,1,9,0,113,5,40,1,3,205,0,8,213,231,0.551,0.922
"6893","La Paz","El Alto","Escuela Juan Carlos Flores Bedregal - 23 de Marzo - 2203",46,0,8,0,111,1,46,1,1,214,2,5,221,234,0.519,0.944
"6894","La Paz","El Alto","Escuela Juan Carlos Flores Bedregal - 23 de Marzo - 2203",50,1,13,0,93,2,44,0,3,206,3,8,217,236,0.451,0.919
"6895","La Paz","El Alto","Escuela Juan Carlos Flores Bedregal - 23 de Marzo - 2203",44,0,3,0,77,3,34,0,1,162,5,3,170,186,0.475,0.914
"6896","La Paz","El Alto","Escuela 16 de Febrero",41,1,3,0,128,1,29,0,2,205,2,3,210,225,0.624,0.933
"6897","La Paz","El Alto","Escuela 16 de Febrero",48,1,9,0,112,2,24,1,2,199,1,9,209,225,0.563,0.929
"6898","La Paz","El Alto","Escuela 16 de Febrero",42,1,4,1,119,3,30,0,2,202,4,7,213,223,0.589,0.955
"6899","La Paz","El Alto","Escuela 16 de Febrero",38,2,3,0,119,1,29,0,5,197,2,8,207,225,0.604,0.92
"6900","La Paz","El Alto","Escuela 16 de Febrero",59,1,6,1,106,1,22,0,3,199,2,10,211,227,0.533,0.93
"6901","La Paz","El Alto","Escuela 16 de Febrero",36,1,5,0,129,3,23,0,3,200,0,11,211,231,0.645,0.913
"6902","La Paz","El Alto","Escuela 16 de Febrero",61,2,7,0,105,4,26,0,1,206,1,7,214,229,0.51,0.934
"6903","La Paz","El Alto","Escuela 16 de Febrero",36,2,8,0,121,0,36,0,3,206,3,10,219,236,0.587,0.928
"6904","La Paz","El Alto","Escuela 16 de Febrero",25,1,2,0,117,8,47,0,1,201,3,7,211,226,0.582,0.934
"6905","La Paz","El Alto","Escuela 16 de Febrero",37,1,7,2,107,5,45,0,4,208,1,7,216,231,0.514,0.935
"6906","La Paz","El Alto","Escuela 16 de Febrero",33,2,5,1,130,3,31,0,2,207,3,7,217,228,0.628,0.952
"6907","La Paz","El Alto","Escuela 16 de Febrero",39,0,7,2,107,4,33,0,4,196,2,9,207,227,0.546,0.912
"6908","La Paz","El Alto","Escuela 16 de Febrero",32,2,3,0,126,3,35,1,1,203,2,10,215,227,0.621,0.947
"6909","La Paz","El Alto","Escuela 16 de Febrero",53,1,10,1,101,3,32,0,4,205,2,6,213,231,0.493,0.922
"6910","La Paz","El Alto","Escuela 16 de Febrero",51,0,8,3,98,2,39,0,3,204,0,5,209,228,0.48,0.917
"6911","La Paz","El Alto","Escuela 16 de Febrero",47,1,6,1,124,3,22,0,3,207,0,6,213,230,0.599,0.926
"6912","La Paz","El Alto","Escuela 16 de Febrero",40,2,4,1,91,1,21,0,6,166,2,39,207,230,0.548,0.9
"6913","La Paz","El Alto","Escuela 16 de Febrero",34,1,7,1,135,3,19,2,3,205,2,2,209,232,0.659,0.901
"6914","La Paz","El Alto","Escuela 16 de Febrero",36,1,8,1,115,1,26,0,1,189,1,24,214,236,0.608,0.907
"6915","La Paz","El Alto","Escuela 16 de Febrero",44,0,7,0,118,4,25,1,5,204,1,11,216,229,0.578,0.943
"6916","La Paz","El Alto","Escuela 16 de Febrero",48,2,2,0,128,3,21,0,3,207,3,3,213,224,0.618,0.951
"6917","La Paz","El Alto","Escuela 16 de Febrero",32,1,11,0,120,4,30,1,1,200,3,4,207,219,0.6,0.945
"6918","La Paz","El Alto","Escuela 16 de Febrero",24,1,4,1,142,3,22,1,4,202,2,4,208,228,0.703,0.912
"6919","La Paz","El Alto","Escuela 16 de Febrero",41,0,2,0,135,4,29,0,2,213,1,4,218,232,0.634,0.94
"6920","La Paz","El Alto","Escuela 16 de Febrero",49,0,7,2,122,5,21,0,1,207,2,2,211,229,0.589,0.921
"6921","La Paz","El Alto","Escuela 16 de Febrero",44,1,7,0,118,1,27,1,2,201,0,14,215,232,0.587,0.927
"6922","La Paz","El Alto","Escuela 16 de Febrero",48,0,5,1,118,5,24,0,3,204,2,10,216,233,0.578,0.927
"6923","La Paz","El Alto","Escuela 16 de Febrero",47,1,9,0,99,4,38,0,0,198,0,15,213,226,0.5,0.942
"6924","La Paz","El Alto","Escuela 16 de Febrero",45,1,3,0,115,2,34,1,1,202,1,5,208,225,0.569,0.924
"6925","La Paz","El Alto","Escuela 16 de Febrero",47,1,4,0,117,0,24,3,1,197,3,15,215,226,0.594,0.951
"6926","La Paz","El Alto","Escuela 16 de Febrero",29,3,1,0,135,1,29,0,2,200,2,7,209,231,0.675,0.905
"6927","La Paz","El Alto","Escuela 16 de Febrero",41,1,5,2,123,3,38,1,0,214,1,4,219,233,0.575,0.94
"6928","La Paz","El Alto","Escuela 16 de Febrero",47,0,9,0,106,4,43,0,1,210,1,3,214,231,0.505,0.926
"6929","La Paz","El Alto","Escuela 16 de Febrero",54,1,11,0,104,4,36,0,3,213,0,6,219,234,0.488,0.936
"6930","La Paz","El Alto","Escuela 16 de Febrero",48,2,9,1,98,2,38,0,5,203,3,9,215,231,0.483,0.931
"6931","La Paz","El Alto","Escuela 16 de Febrero",48,1,7,1,113,4,31,1,0,206,18,6,230,230,0.549,1
"6932","La Paz","El Alto","Escuela 16 de Febrero",45,1,4,0,121,0,28,0,2,201,1,7,209,234,0.602,0.893
"6933","La Paz","El Alto","Escuela 16 de Febrero",47,0,3,2,109,6,21,1,3,192,5,8,205,225,0.568,0.911
"6934","La Paz","El Alto","Escuela 16 de Febrero",49,0,5,0,105,1,40,0,1,201,2,9,212,227,0.522,0.934
"6935","La Paz","El Alto","Escuela 16 de Febrero",32,1,7,0,89,2,22,2,1,156,3,4,163,180,0.571,0.906
"6936","La Paz","El Alto","Unidad Educativa 25 de Julio",27,0,4,0,134,4,23,0,3,195,1,13,209,222,0.687,0.941
"6937","La Paz","El Alto","Unidad Educativa 25 de Julio",31,0,8,0,134,0,26,0,4,203,1,11,215,229,0.66,0.939
"6938","La Paz","El Alto","Unidad Educativa 25 de Julio",31,0,9,0,132,1,31,0,1,205,4,7,216,231,0.644,0.935
"6939","La Paz","El Alto","Unidad Educativa 25 de Julio",30,1,2,0,117,2,35,1,4,192,1,16,209,230,0.609,0.909
"6940","La Paz","El Alto","Unidad Educativa 25 de Julio",41,1,8,0,111,2,36,0,5,204,2,4,210,230,0.544,0.913
"6941","La Paz","El Alto","Unidad Educativa 25 de Julio",39,1,3,0,122,1,38,0,5,209,6,4,219,232,0.584,0.944
"6942","La Paz","El Alto","Unidad Educativa 25 de Julio",41,1,8,1,101,0,46,0,4,202,1,7,210,234,0.5,0.897
"6943","La Paz","El Alto","Unidad Educativa 25 de Julio",24,0,6,1,136,2,28,0,1,198,2,12,212,231,0.687,0.918
"6944","La Paz","El Alto","Unidad Educativa 25 de Julio",44,0,8,0,110,3,32,0,4,201,6,4,211,234,0.547,0.902
"6945","La Paz","El Alto","Unidad Educativa 25 de Julio",28,2,11,0,123,1,31,0,1,197,1,10,208,229,0.624,0.908
"6946","La Paz","El Alto","Unidad Educativa 25 de Julio",32,3,5,0,122,3,33,0,1,199,1,12,212,222,0.613,0.955
"6947","La Paz","El Alto","Unidad Educativa 25 de Julio",30,1,11,1,117,2,33,0,2,197,5,5,207,230,0.594,0.9
"6948","La Paz","El Alto","Unidad Educativa 25 de Julio",32,1,11,0,124,0,29,0,7,204,3,8,215,230,0.608,0.935
"6949","La Paz","El Alto","Unidad Educativa 25 de Julio",35,1,14,1,113,3,24,1,4,196,3,11,210,232,0.577,0.905
"6950","La Paz","El Alto","Unidad Educativa 25 de Julio",30,0,3,0,123,1,39,2,2,200,1,10,211,228,0.615,0.925
"6951","La Paz","El Alto","Unidad Educativa 25 de Julio",45,0,6,0,97,5,41,2,7,203,1,6,210,233,0.478,0.901
"6952","La Paz","El Alto","Unidad Educativa 25 de Julio",39,0,7,0,106,2,33,2,3,192,1,12,205,228,0.552,0.899
"6953","La Paz","El Alto","Unidad Educativa 25 de Julio",26,0,7,0,136,4,31,0,3,207,3,12,222,231,0.657,0.961
"6954","La Paz","El Alto","Unidad Educativa 25 de Julio",26,0,7,1,149,1,25,0,1,210,1,7,218,229,0.71,0.952
"6955","La Paz","El Alto","Unidad Educativa 25 de Julio",35,1,6,0,116,5,23,0,5,191,1,9,201,225,0.607,0.893
"6956","La Paz","El Alto","Unidad Educativa 25 de Julio",28,3,5,1,113,2,27,2,4,185,5,28,218,232,0.611,0.94
"6957","La Paz","El Alto","Unidad Educativa 25 de Julio",26,1,2,1,125,4,36,0,3,198,2,15,215,229,0.631,0.939
"6958","La Paz","El Alto","Escuela Brasil",57,0,2,0,107,5,33,0,2,206,0,8,214,231,0.519,0.926
"6959","La Paz","El Alto","Escuela Brasil",38,2,9,1,117,4,34,0,2,207,2,7,216,230,0.565,0.939
"6960","La Paz","El Alto","Escuela Brasil",66,1,7,1,98,2,31,0,1,207,2,4,213,233,0.473,0.914
"6961","La Paz","El Alto","Escuela Brasil",65,1,8,1,94,2,36,0,4,211,2,4,217,233,0.445,0.931
"6962","La Paz","El Alto","Escuela Brasil",63,0,6,1,102,0,25,1,5,203,1,4,208,225,0.502,0.924
"6963","La Paz","El Alto","Escuela Brasil",47,0,6,0,120,1,27,0,3,204,0,7,211,223,0.588,0.946
"6964","La Paz","El Alto","Escuela Brasil",50,2,3,0,95,5,48,0,1,204,2,7,213,228,0.466,0.934
"6965","La Paz","El Alto","Escuela Brasil",59,1,3,1,99,7,26,0,3,199,2,8,209,225,0.497,0.929
"6966","La Paz","El Alto","Escuela Brasil",56,1,5,0,102,1,27,0,7,199,3,7,209,232,0.513,0.901
"6967","La Paz","El Alto","Escuela Brasil",49,0,4,0,94,3,31,1,4,186,0,15,201,222,0.505,0.905
"6968","La Paz","El Alto","Escuela Brasil",54,1,6,0,110,4,25,1,0,201,0,4,205,221,0.547,0.928
"6969","La Paz","El Alto","Escuela Brasil",66,1,6,1,98,2,36,0,6,216,0,5,221,230,0.454,0.961
"6970","La Paz","El Alto","Escuela Brasil",57,1,3,0,98,1,36,0,5,201,1,8,210,229,0.488,0.917
"6971","La Paz","El Alto","Escuela Brasil",54,1,8,0,100,1,39,1,6,210,1,3,214,231,0.476,0.926
"6972","La Paz","El Alto","Escuela Brasil",51,1,8,0,101,3,37,0,3,204,2,5,211,229,0.495,0.921
"6973","La Paz","El Alto","Escuela Brasil",46,0,13,1,97,4,54,0,4,219,1,3,223,234,0.443,0.953
"6974","La Paz","El Alto","Escuela Brasil",47,0,2,1,107,1,48,0,2,208,2,7,217,231,0.514,0.939
"6975","La Paz","El Alto","Escuela Brasil",50,0,6,2,110,3,38,1,6,216,2,5,223,234,0.509,0.953
"6976","La Paz","El Alto","Escuela Brasil",58,0,8,2,86,1,50,0,1,206,0,8,214,229,0.417,0.934
"6977","La Paz","El Alto","Escuela Brasil",56,0,4,0,105,1,32,0,2,200,0,8,208,233,0.525,0.893
"6978","La Paz","El Alto","Escuela Brasil",41,1,9,1,119,4,30,0,2,207,1,3,211,229,0.575,0.921
"6979","La Paz","El Alto","Escuela Brasil",46,0,12,0,81,1,47,1,2,190,4,14,208,231,0.426,0.9
"6980","La Paz","El Alto","Escuela Brasil",59,1,3,0,94,2,36,0,3,198,1,7,206,225,0.475,0.916
"6981","La Paz","El Alto","Escuela Brasil",66,0,10,0,86,3,30,2,4,201,1,5,207,221,0.428,0.937
"6982","La Paz","El Alto","Escuela Brasil",65,1,7,0,92,5,28,1,3,202,0,7,209,223,0.455,0.937
"6983","La Paz","El Alto","Escuela Brasil",47,0,7,2,104,3,34,1,1,199,0,7,206,223,0.523,0.924
"6984","La Paz","El Alto","Escuela Brasil",48,1,7,0,118,4,29,0,3,210,3,7,220,229,0.562,0.961
"6985","La Paz","El Alto","Colegio Walter Alpire 1er Patio",81,0,2,0,74,4,25,3,3,192,1,13,206,222,0.385,0.928
"6986","La Paz","El Alto","Colegio Walter Alpire 1er Patio",82,0,3,1,82,2,29,0,0,199,2,5,206,230,0.412,0.896
"6987","La Paz","El Alto","Colegio Walter Alpire 1er Patio",97,2,2,2,69,2,24,2,3,203,2,1,206,221,0.34,0.932
"6988","La Paz","El Alto","Colegio Walter Alpire 1er Patio",81,0,6,2,82,4,18,0,2,195,1,8,204,227,0.421,0.899
"6989","La Paz","El Alto","Colegio Walter Alpire 1er Patio",78,2,6,1,86,5,24,0,0,202,2,4,208,224,0.426,0.929
"6990","La Paz","El Alto","Colegio Walter Alpire 1er Patio",67,1,3,0,93,1,21,0,4,190,0,7,197,226,0.489,0.872
"6991","La Paz","El Alto","Colegio Walter Alpire 1er Patio",68,0,4,1,86,5,27,1,4,196,0,10,206,228,0.439,0.904
"6992","La Paz","El Alto","Colegio Walter Alpire 1er Patio",55,1,5,1,116,2,29,0,1,210,1,7,218,234,0.552,0.932
"6993","La Paz","El Alto","Colegio Walter Alpire 1er Patio",74,0,3,1,87,4,23,0,1,193,3,10,206,223,0.451,0.924
"6994","La Paz","El Alto","Colegio Walter Alpire 1er Patio",106,2,4,2,61,2,24,0,1,202,2,2,206,228,0.302,0.904
"6995","La Paz","El Alto","Colegio Walter Alpire 1er Patio",96,0,3,0,76,3,19,0,5,202,2,4,208,230,0.376,0.904
"6996","La Paz","El Alto","Colegio Walter Alpire 1er Patio",73,1,4,0,86,4,30,0,3,201,1,4,206,221,0.428,0.932
"6997","La Paz","El Alto","Colegio Walter Alpire 1er Patio",80,1,1,1,96,3,22,1,2,207,0,7,214,228,0.464,0.939
"6998","La Paz","El Alto","Colegio Walter Alpire 1er Patio",83,2,2,0,94,3,17,1,0,202,0,8,210,224,0.465,0.938
"6999","La Paz","El Alto","Colegio Walter Alpire 1er Patio",48,0,6,1,103,4,26,0,1,189,7,6,202,225,0.545,0.898
"7000","La Paz","El Alto","Colegio Walter Alpire 1er Patio",87,0,4,1,78,4,29,0,2,205,0,7,212,228,0.38,0.93
"7001","La Paz","El Alto","Colegio Walter Alpire 1er Patio",85,1,4,1,82,3,21,0,0,197,1,7,205,222,0.416,0.923
"7002","La Paz","El Alto","Colegio Walter Alpire 1er Patio",73,0,5,1,88,1,29,0,4,201,0,6,207,226,0.438,0.916
"7003","La Paz","El Alto","Colegio Walter Alpire 1er Patio",71,0,3,0,86,1,37,0,3,201,2,2,205,221,0.428,0.928
"7004","La Paz","El Alto","Colegio Walter Alpire 1er Patio",66,1,6,1,83,6,32,1,1,197,1,11,209,224,0.421,0.933
"7005","La Paz","El Alto","Colegio Walter Alpire 1er Patio",57,0,6,3,102,0,35,0,2,205,1,5,211,223,0.498,0.946
"7006","La Paz","El Alto","Colegio Walter Alpire 1er Patio",72,0,4,0,75,1,38,0,1,191,1,3,195,214,0.393,0.911
"7007","La Paz","El Alto","Colegio Walter Alpire 1er Patio",74,2,3,0,88,2,25,0,1,195,0,10,205,226,0.451,0.907
"7008","La Paz","El Alto","Colegio Walter Alpire 1er Patio",71,0,3,0,86,2,35,0,3,200,2,9,211,226,0.43,0.934
"7009","La Paz","El Alto","Colegio Walter Alpire 1er Patio",101,0,2,0,71,2,26,0,1,203,0,3,206,230,0.35,0.896
"7010","La Paz","El Alto","Colegio Walter Alpire 1er Patio",85,0,6,0,82,1,22,1,2,199,1,10,210,224,0.412,0.938
"7011","La Paz","El Alto","Colegio Walter Alpire 2do Patio",84,3,2,2,85,4,18,0,2,200,0,8,208,224,0.425,0.929
"7012","La Paz","El Alto","Colegio Walter Alpire 2do Patio",89,2,5,0,88,2,21,1,2,210,1,7,218,228,0.419,0.956
"7013","La Paz","El Alto","Colegio Walter Alpire 2do Patio",88,0,1,3,89,0,15,1,1,198,3,6,207,221,0.449,0.937
"7014","La Paz","El Alto","Colegio Walter Alpire 2do Patio",67,0,6,1,102,4,23,0,3,206,2,3,211,228,0.495,0.925
"7015","La Paz","El Alto","Colegio Walter Alpire 2do Patio",94,3,5,0,82,1,18,0,4,207,1,11,219,230,0.396,0.952
"7016","La Paz","El Alto","Colegio Walter Alpire 2do Patio",94,2,2,3,77,1,19,1,2,201,0,7,208,228,0.383,0.912
"7017","La Paz","El Alto","Colegio Walter Alpire 2do Patio",75,0,4,0,87,1,37,2,0,206,0,7,213,226,0.422,0.942
"7018","La Paz","El Alto","Colegio Walter Alpire 2do Patio",61,0,4,2,102,3,29,0,2,203,1,3,207,218,0.502,0.95
"7019","La Paz","El Alto","Colegio Walter Alpire 2do Patio",102,0,2,0,72,0,20,1,0,197,1,7,205,226,0.365,0.907
"7020","La Paz","El Alto","Colegio Walter Alpire 2do Patio",83,1,3,0,83,4,25,2,1,202,1,6,209,227,0.411,0.921
"7021","La Paz","El Alto","Colegio Walter Alpire 2do Patio",61,1,7,1,102,5,27,0,0,204,20,5,229,229,0.5,1
"7022","La Paz","El Alto","Colegio Walter Alpire 2do Patio",92,1,6,0,78,3,21,3,1,205,0,3,208,226,0.38,0.92
"7023","La Paz","El Alto","Colegio Walter Alpire 2do Patio",90,1,3,0,87,2,23,0,1,207,2,6,215,234,0.42,0.919
"7024","La Paz","El Alto","Colegio Walter Alpire 2do Patio",118,0,2,0,58,1,21,1,2,203,1,3,207,218,0.286,0.95
"7025","La Paz","El Alto","Colegio Particular San Miguel",68,0,7,0,77,3,34,1,5,195,4,5,204,225,0.395,0.907
"7026","La Paz","El Alto","Colegio Particular San Miguel",60,1,8,0,95,2,22,0,6,194,0,13,207,224,0.49,0.924
"7027","La Paz","El Alto","Colegio Particular San Miguel",50,0,4,0,97,2,31,1,5,190,1,18,209,232,0.511,0.901
"7028","La Paz","El Alto","Colegio Particular San Miguel",75,0,7,0,89,0,20,0,1,192,1,7,200,219,0.464,0.913
"7029","La Paz","El Alto","Colegio Particular San Miguel",86,2,4,0,80,2,28,1,3,206,0,3,209,224,0.388,0.933
"7030","La Paz","El Alto","Colegio Particular San Miguel",59,1,5,1,97,0,27,1,4,195,0,4,199,222,0.497,0.896
"7031","La Paz","El Alto","Colegio Particular San Miguel",97,0,5,1,73,1,23,0,5,205,0,10,215,230,0.356,0.935
"7032","La Paz","El Alto","Colegio Particular San Miguel",61,1,4,2,93,2,28,0,0,191,0,9,200,224,0.487,0.893
"7033","La Paz","El Alto","Colegio Particular San Miguel",64,3,3,2,93,1,31,0,2,199,2,7,208,225,0.467,0.924
"7034","La Paz","El Alto","Colegio Particular San Miguel",82,2,5,0,78,3,34,1,1,206,1,7,214,230,0.379,0.93
"7035","La Paz","El Alto","Unidad Educativa Tecnica Yunguyo",31,1,13,0,112,5,34,0,6,202,3,12,217,233,0.554,0.931
"7036","La Paz","El Alto","Unidad Educativa Tecnica Yunguyo",35,1,11,1,104,2,55,0,0,209,1,8,218,233,0.498,0.936
"7037","La Paz","El Alto","Unidad Educativa Tecnica Yunguyo",25,3,9,0,116,4,38,1,4,200,3,8,211,228,0.58,0.925
"7038","La Paz","El Alto","Unidad Educativa Tecnica Yunguyo",34,1,12,3,114,2,34,0,1,201,2,10,213,230,0.567,0.926
"7039","La Paz","El Alto","Unidad Educativa Tecnica Yunguyo",32,0,10,0,118,1,42,0,3,206,2,8,216,231,0.573,0.935
"7040","La Paz","El Alto","Unidad Educativa Tecnica Yunguyo",30,1,6,0,125,3,41,0,2,208,2,9,219,231,0.601,0.948
"7041","La Paz","El Alto","Unidad Educativa Tecnica Yunguyo",31,1,19,0,119,4,34,0,4,212,3,7,222,230,0.561,0.965
"7042","La Paz","El Alto","Unidad Educativa Tecnica Yunguyo",28,1,5,2,114,4,52,0,0,206,7,7,220,233,0.553,0.944
"7043","La Paz","El Alto","Unidad Educativa Tecnica Yunguyo",23,1,3,0,140,5,31,1,1,205,0,8,213,232,0.683,0.918
"7044","La Paz","El Alto","Unidad Educativa Tecnica Yunguyo",27,0,6,1,124,2,37,0,3,200,3,13,216,230,0.62,0.939
"7045","La Paz","El Alto","Unidad Educativa Tecnica Yunguyo",39,2,7,1,109,0,40,1,4,203,0,9,212,223,0.537,0.951
"7046","La Paz","El Alto","Unidad Educativa Tecnica Yunguyo",28,0,9,1,117,3,42,2,4,206,1,9,216,231,0.568,0.935
"7047","La Paz","El Alto","Unidad Educativa Tecnica Yunguyo",22,1,10,0,121,3,48,0,1,206,1,12,219,232,0.587,0.944
"7048","La Paz","El Alto","Unidad Educativa Tecnica Yunguyo",37,0,6,0,126,1,27,1,2,200,2,5,207,223,0.63,0.928
"7049","La Paz","El Alto","Unidad Educativa Tecnica Yunguyo",26,1,18,1,132,4,30,0,1,213,1,2,216,232,0.62,0.931
"7050","La Paz","El Alto","Unidad Educativa Tecnica Yunguyo",19,1,13,0,129,1,31,1,3,198,3,14,215,231,0.652,0.931
"7051","La Paz","El Alto","Unidad Educativa Tecnica Yunguyo",32,0,5,0,111,2,49,0,2,201,0,5,206,227,0.552,0.907
"7052","La Paz","El Alto","Unidad Educativa Tecnica Yunguyo",34,0,5,1,129,1,40,0,5,215,1,5,221,228,0.6,0.969
"7053","La Paz","El Alto","Unidad Educativa Tecnica Yunguyo",27,0,8,0,141,2,29,1,2,210,1,5,216,233,0.671,0.927
"7054","La Paz","El Alto","Unidad Educativa Tecnica Yunguyo",18,0,6,0,127,2,38,0,7,198,3,10,211,226,0.641,0.934
"7055","La Paz","El Alto","Unidad Educativa Tecnica Yunguyo",33,0,9,0,110,2,57,0,1,212,3,10,225,235,0.519,0.957
"7056","La Paz","El Alto","Unidad Educativa Tecnica Yunguyo",28,1,10,1,122,2,49,0,2,215,0,5,220,233,0.567,0.944
"7057","La Paz","El Alto","Unidad Educativa Tecnica Yunguyo",46,1,13,0,114,1,27,0,0,202,0,16,218,231,0.564,0.944
"7058","La Paz","El Alto","Unidad Educativa Tecnica Yunguyo",35,0,12,2,111,5,40,0,6,211,1,7,219,232,0.526,0.944
"7059","La Paz","El Alto","Unidad Educativa Tecnica Yunguyo",38,1,7,1,123,1,41,0,3,215,0,7,222,231,0.572,0.961
"7060","La Paz","El Alto","Unidad Educativa Tecnica Yunguyo",25,1,8,0,139,2,35,1,5,216,2,9,227,233,0.644,0.974
"7061","La Paz","El Alto","Unidad Educativa Bautista Saavedra",23,3,11,0,133,2,31,0,4,207,4,6,217,231,0.643,0.939
"7062","La Paz","El Alto","Unidad Educativa Bautista Saavedra",25,3,8,0,109,3,40,1,2,191,3,9,203,227,0.571,0.894
"7063","La Paz","El Alto","Unidad Educativa Bautista Saavedra",28,1,17,1,124,1,36,0,1,209,3,5,217,228,0.593,0.952
"7064","La Paz","El Alto","Unidad Educativa Bautista Saavedra",30,0,9,1,124,2,30,0,7,203,4,6,213,231,0.611,0.922
"7065","La Paz","El Alto","Unidad Educativa Bautista Saavedra",35,1,13,0,114,2,41,0,4,210,6,5,221,234,0.543,0.944
"7066","La Paz","El Alto","Unidad Educativa Bautista Saavedra",20,0,8,0,128,5,35,0,4,200,0,10,210,232,0.64,0.905
"7067","La Paz","El Alto","Unidad Educativa Bautista Saavedra",30,1,12,0,120,2,37,0,0,202,2,6,210,229,0.594,0.917
"7068","La Paz","El Alto","Unidad Educativa Bautista Saavedra",25,2,6,0,129,4,32,0,1,199,3,11,213,229,0.648,0.93
"7069","La Paz","El Alto","Unidad Educativa Bautista Saavedra",19,0,7,1,137,2,38,0,0,204,4,6,214,229,0.672,0.934
"7070","La Paz","El Alto","Unidad Educativa Bautista Saavedra",29,0,9,0,113,5,45,0,4,205,6,5,216,234,0.551,0.923
"7071","La Paz","El Alto","Unidad Educativa Bautista Saavedra",19,1,13,1,122,3,31,1,2,193,3,6,202,226,0.632,0.894
"7072","La Paz","El Alto","Unidad Educativa Bautista Saavedra",22,1,17,3,123,5,27,0,0,198,3,16,217,229,0.621,0.948
"7073","La Paz","El Alto","Unidad Educativa Bautista Saavedra",18,1,8,0,139,2,33,0,1,202,3,8,213,227,0.688,0.938
"7074","La Paz","El Alto","Unidad Educativa Bautista Saavedra",17,0,17,2,117,5,37,1,5,201,2,15,218,228,0.582,0.956
"7075","La Paz","El Alto","Unidad Educativa Bautista Saavedra",26,0,11,1,120,0,45,0,6,209,1,7,217,229,0.574,0.948
"7076","La Paz","El Alto","Unidad Educativa Bautista Saavedra",36,1,11,0,113,4,38,0,1,204,0,11,215,227,0.554,0.947
"7077","La Paz","El Alto","Unidad Educativa Bautista Saavedra",37,2,14,0,113,6,30,0,0,202,4,13,219,233,0.559,0.94
"7078","La Paz","El Alto","Unidad Educativa Bautista Saavedra",19,0,6,1,119,2,43,1,4,195,2,15,212,229,0.61,0.926
"7079","La Paz","El Alto","Unidad Educativa Bautista Saavedra",25,1,7,1,130,2,32,1,3,202,3,13,218,230,0.644,0.948
"7080","La Paz","El Alto","Unidad Educativa Bautista Saavedra",22,2,6,1,128,3,38,0,5,205,2,6,213,226,0.624,0.942
"7081","La Paz","El Alto","Unidad Educativa Bautista Saavedra",37,1,8,0,129,5,26,0,4,210,0,6,216,230,0.614,0.939
"7082","La Paz","El Alto","Unidad Educativa Bautista Saavedra",28,0,6,0,122,2,37,1,1,197,4,7,208,229,0.619,0.908
"7083","La Paz","El Alto","Unidad Educativa Bautista Saavedra",27,2,10,1,125,3,36,1,4,209,4,5,218,234,0.598,0.932
"7084","La Paz","El Alto","Unidad Educativa Bautista Saavedra",28,1,8,0,127,6,29,0,3,202,1,9,212,227,0.629,0.934
"7085","La Paz","El Alto","Unidad Educativa Bautista Saavedra",17,2,17,0,127,1,35,0,4,203,3,7,213,227,0.626,0.938
"7086","La Paz","El Alto","Unidad Educativa Bautista Saavedra",17,1,15,0,134,1,28,0,3,199,2,12,213,230,0.673,0.926
"7087","La Paz","El Alto","Unidad Educativa Bautista Saavedra",18,1,16,0,121,3,38,0,2,199,5,5,209,229,0.608,0.913
"7088","La Paz","El Alto","Unidad Educativa Bautista Saavedra",25,1,13,0,124,1,31,0,2,197,1,11,209,229,0.629,0.913
"7089","La Paz","El Alto","Unidad Educativa Bautista Saavedra",25,0,12,1,108,3,50,1,1,201,0,6,207,230,0.537,0.9
"7090","La Paz","El Alto","Unidad Educativa Bautista Saavedra",26,0,7,0,118,1,45,0,2,199,5,12,216,228,0.593,0.947
"7091","La Paz","El Alto","Unidad Educativa Bautista Saavedra",15,3,17,1,136,1,36,0,0,209,2,12,223,234,0.651,0.953
"7092","La Paz","El Alto","Unidad Educativa Bautista Saavedra",17,0,10,0,117,5,48,0,3,200,4,12,216,229,0.585,0.943
"7093","La Paz","El Alto","Unidad Educativa Bautista Saavedra",35,0,14,0,127,2,29,0,4,211,1,11,223,233,0.602,0.957
"7094","La Paz","El Alto","Unidad Educativa Bautista Saavedra",20,0,9,0,127,0,47,0,3,206,5,9,220,237,0.617,0.928
"7095","La Paz","El Alto","Unidad Educativa Bautista Saavedra",13,0,8,0,140,1,40,0,1,203,2,6,211,234,0.69,0.902
"7096","La Paz","El Alto","Unidad Educativa Bautista Saavedra",19,1,11,1,121,4,36,0,2,195,1,16,212,233,0.621,0.91
"7097","La Paz","El Alto","Unidad Educativa Bautista Saavedra",23,4,12,0,124,1,41,1,1,207,2,8,217,235,0.599,0.923
"7098","La Paz","El Alto","Unidad Educativa Bautista Saavedra",46,0,9,2,115,1,40,0,4,217,0,5,222,238,0.53,0.933
"7099","La Paz","El Alto","Unidad Educativa Bautista Saavedra",34,0,10,0,123,0,38,1,4,210,1,8,219,231,0.586,0.948
"7100","La Paz","El Alto","Unidad Educativa Bautista Saavedra",25,1,17,0,125,3,37,0,1,209,4,7,220,238,0.598,0.924
"7101","La Paz","El Alto","Unidad Educativa Bautista Saavedra",32,0,6,0,119,4,49,1,4,215,2,5,222,237,0.553,0.937
"7102","La Paz","El Alto","Unidad Educativa Bautista Saavedra",24,2,14,0,110,1,55,0,2,208,1,6,215,236,0.529,0.911
"7103","La Paz","El Alto","Unidad Educativa Bautista Saavedra",19,1,10,0,140,2,35,0,1,208,2,7,217,234,0.673,0.927
"7104","La Paz","El Alto","Unidad Educativa Bautista Saavedra",42,1,11,1,97,2,51,1,2,208,0,13,221,234,0.466,0.944
"7105","La Paz","El Alto","Unidad Educativa Bautista Saavedra",36,2,5,0,120,3,35,0,5,206,0,12,218,236,0.583,0.924
"7106","La Paz","El Alto","Unidad Educativa Bautista Saavedra",19,0,5,0,125,1,48,0,5,203,1,13,217,237,0.616,0.916
"7107","La Paz","El Alto","Unidad Educativa Bautista Saavedra",28,2,10,1,127,3,37,2,4,214,4,5,223,236,0.593,0.945
"7108","La Paz","El Alto","Unidad Educativa Bautista Saavedra",30,1,9,1,114,1,51,1,4,212,1,9,222,235,0.538,0.945
"7109","La Paz","El Alto","U.E. Oscar Alfaro",25,0,17,1,120,2,42,0,2,209,4,13,226,235,0.574,0.962
"7110","La Paz","El Alto","U.E. Oscar Alfaro",27,1,8,0,139,2,36,0,3,216,2,7,225,235,0.644,0.957
"7111","La Paz","El Alto","U.E. Oscar Alfaro",18,0,11,0,135,3,37,2,3,209,2,6,217,236,0.646,0.919
"7112","La Paz","El Alto","U.E. Oscar Alfaro",23,0,14,0,121,2,56,0,0,216,2,1,219,237,0.56,0.924
"7113","La Paz","El Alto","U.E. Oscar Alfaro",22,1,12,0,141,3,29,8,8,224,1,2,227,236,0.629,0.962
"7114","La Paz","El Alto","U.E. Oscar Alfaro",14,1,6,0,149,2,34,2,5,213,3,6,222,236,0.7,0.941
"7115","La Paz","El Alto","U.E. Oscar Alfaro",26,0,8,0,145,5,32,0,2,218,3,7,228,236,0.665,0.966
"7116","La Paz","El Alto","U.E. Oscar Alfaro",24,1,13,0,136,2,24,0,6,206,6,8,220,230,0.66,0.957
"7117","La Paz","El Alto","U.E. Oscar Alfaro",23,1,12,0,128,3,35,0,5,207,4,8,219,231,0.618,0.948
"7118","La Paz","El Alto","U.E. Oscar Alfaro",9,3,16,1,130,3,30,0,4,196,3,12,211,227,0.663,0.93
"7119","La Paz","El Alto","U.E. Oscar Alfaro",19,0,12,0,139,1,29,0,1,201,4,6,211,226,0.692,0.934
"7120","La Paz","El Alto","U.E. Oscar Alfaro",21,3,11,1,127,3,26,0,4,196,3,9,208,219,0.648,0.95
"7121","La Paz","El Alto","U.E. Oscar Alfaro",27,0,14,0,119,0,32,0,1,193,6,7,206,222,0.617,0.928
"7122","La Paz","El Alto","U.E. Oscar Alfaro",23,0,15,0,110,3,40,1,9,201,1,9,211,223,0.547,0.946
"7123","La Paz","El Alto","U.E. Oscar Alfaro",27,2,6,0,140,0,27,2,3,207,1,5,213,226,0.676,0.942
"7124","La Paz","El Alto","U.E. Oscar Alfaro",27,1,12,0,117,1,31,1,3,193,2,13,208,223,0.606,0.933
"7125","La Paz","El Alto","U.E. Oscar Alfaro",26,3,13,1,125,4,27,0,1,200,1,9,210,221,0.625,0.95
"7126","La Paz","El Alto","U.E. Oscar Alfaro",24,1,7,0,145,1,30,0,1,209,4,7,220,230,0.694,0.957
"7127","La Paz","El Alto","U.E. Oscar Alfaro",31,2,14,1,107,5,42,0,4,206,4,5,215,229,0.519,0.939
"7128","La Paz","El Alto","U.E. Oscar Alfaro",22,2,15,1,111,3,39,2,2,197,4,7,208,235,0.563,0.885
"7129","La Paz","El Alto","U.E. Oscar Alfaro",22,1,14,0,114,0,40,1,6,198,2,4,204,220,0.576,0.927
"7130","La Paz","El Alto","U.E. Oscar Alfaro",18,1,18,0,131,1,28,0,2,199,2,8,209,228,0.658,0.917
"7131","La Paz","El Alto","U.E. Oscar Alfaro",29,2,16,0,121,0,33,1,2,204,2,6,212,220,0.593,0.964
"7132","La Paz","El Alto","U.E. Oscar Alfaro",13,2,12,0,130,3,38,0,4,202,1,7,210,222,0.644,0.946
"7133","La Paz","El Alto","U.E. Oscar Alfaro",30,2,17,0,109,4,40,0,2,204,2,7,213,227,0.534,0.938
"7134","La Paz","El Alto","U.E. Oscar Alfaro",29,1,14,0,118,2,25,0,7,196,6,9,211,224,0.602,0.942
"7135","La Paz","El Alto","U.E. Oscar Alfaro",25,1,12,1,128,0,30,0,1,198,3,14,215,225,0.646,0.956
"7136","La Paz","El Alto","U.E. Oscar Alfaro",21,2,13,0,119,3,17,0,2,177,5,7,189,198,0.672,0.955
"7137","La Paz","El Alto","Unidad Educativa San Roque",13,0,8,1,145,1,30,1,2,201,2,7,210,231,0.721,0.909
"7138","La Paz","El Alto","Unidad Educativa San Roque",20,2,6,2,126,2,37,0,2,197,7,8,212,227,0.64,0.934
"7139","La Paz","El Alto","Unidad Educativa San Roque",10,1,12,1,142,5,34,1,0,206,0,14,220,234,0.689,0.94
"7140","La Paz","El Alto","Unidad Educativa San Roque",26,1,10,0,147,2,19,0,1,206,4,15,225,232,0.714,0.97
"7141","La Paz","El Alto","Unidad Educativa San Roque",19,16,0,1,130,4,31,0,1,202,3,11,216,233,0.644,0.927
"7142","La Paz","El Alto","Unidad Educativa San Roque",21,1,12,0,126,3,29,1,1,194,2,14,210,228,0.649,0.921
"7143","La Paz","El Alto","Unidad Educativa San Roque",19,2,10,0,120,1,51,0,2,205,3,7,215,230,0.585,0.935
"7144","La Paz","El Alto","Unidad Educativa San Roque",13,2,20,0,128,4,25,1,3,196,3,12,211,232,0.653,0.909
"7145","La Paz","El Alto","Unidad Educativa San Roque",16,0,13,1,148,0,31,0,0,209,4,8,221,230,0.708,0.961
"7146","La Paz","El Alto","Unidad Educativa San Roque",27,1,14,1,128,2,31,1,0,205,3,9,217,230,0.624,0.943
"7147","La Paz","El Alto","Unidad Educativa San Roque",17,2,17,0,122,3,44,0,0,205,4,12,221,227,0.595,0.974
"7148","La Paz","El Alto","Unidad Educativa San Roque",15,0,10,0,156,1,32,0,1,215,2,5,222,234,0.726,0.949
"7149","La Paz","El Alto","Unidad Educativa San Roque",29,0,12,1,134,2,29,0,0,207,6,5,218,235,0.647,0.928
"7150","La Paz","El Alto","Unidad Educativa San Roque",13,2,4,0,142,2,40,1,1,205,2,12,219,229,0.693,0.956
"7151","La Paz","El Alto","Unidad Educativa San Roque",13,2,11,0,141,2,41,1,1,212,2,6,220,232,0.665,0.948
"7152","La Paz","El Alto","Unidad Educativa San Roque",18,1,15,0,136,2,27,0,0,199,4,13,216,231,0.683,0.935
"7153","La Paz","El Alto","Unidad Educativa San Roque",28,2,9,1,133,2,32,0,0,207,3,8,218,231,0.643,0.944
"7154","La Paz","El Alto","Unidad Educativa San Roque",16,2,16,0,122,3,33,2,4,198,4,9,211,229,0.616,0.921
"7155","La Paz","El Alto","Unidad Educativa San Roque",17,1,17,1,120,6,29,0,3,194,1,12,207,220,0.619,0.941
"7156","La Paz","El Alto","Unidad Educativa San Roque",13,2,16,1,143,2,27,0,3,207,3,7,217,232,0.691,0.935
"7157","La Paz","El Alto","Unidad Educativa San Roque",25,2,14,0,123,1,31,1,3,200,2,13,215,228,0.615,0.943
"7158","La Paz","El Alto","Unidad Educativa San Roque",25,0,10,0,133,2,31,0,0,201,4,8,213,230,0.662,0.926
"7159","La Paz","El Alto","Unidad Educativa San Roque",28,4,12,0,124,2,26,1,1,198,18,15,231,231,0.626,1
"7160","La Paz","El Alto","Unidad Educativa San Roque",25,3,10,1,120,6,36,0,5,206,4,5,215,232,0.583,0.927
"7161","La Paz","El Alto","Unidad Educativa San Roque",17,3,5,1,124,4,35,0,2,191,2,10,203,223,0.649,0.91
"7162","La Paz","El Alto","Unidad Educativa San Roque",22,2,13,0,144,2,32,0,2,217,5,4,226,237,0.664,0.954
"7163","La Paz","El Alto","Unidad Educativa San Roque",15,2,7,0,127,2,26,0,1,180,5,21,206,231,0.706,0.892
"7164","La Paz","El Alto","Unidad Educativa San Roque",21,2,13,0,137,2,29,1,1,206,1,8,215,229,0.665,0.939
"7165","La Paz","El Alto","Unidad Educativa San Roque",32,0,13,0,123,1,38,2,2,211,4,11,226,236,0.583,0.958
"7166","La Paz","El Alto","Unidad Educativa San Roque",10,0,13,1,136,5,32,0,1,198,2,19,219,234,0.687,0.936
"7167","La Paz","El Alto","Unidad Educativa San Roque",18,1,15,1,140,1,22,0,0,198,2,13,213,233,0.707,0.914
"7168","La Paz","El Alto","Unidad Educativa San Roque",19,0,11,1,137,2,35,0,2,207,3,9,219,230,0.662,0.952
"7169","La Paz","El Alto","Unidad Educativa San Roque",31,1,11,0,143,0,27,0,2,215,1,3,219,231,0.665,0.948
"7170","La Paz","El Alto","Unidad Educativa San Roque",9,0,8,0,142,3,25,1,0,188,6,8,202,220,0.755,0.918
"7171","La Paz","El Alto","Unidad Educativa San Roque",11,0,10,1,135,1,24,0,1,183,4,14,201,221,0.738,0.91
"7172","La Paz","El Alto","Unidad Educativa San Roque",16,2,6,0,133,2,44,0,2,205,3,14,222,231,0.649,0.961
"7173","La Paz","El Alto","Unidad Educativa San Roque",20,0,10,0,136,5,27,0,2,200,4,12,216,235,0.68,0.919
"7174","La Paz","El Alto","Unidad Educativa San Roque",12,2,12,0,137,1,39,0,0,203,2,8,213,228,0.675,0.934
"7175","La Paz","El Alto","Unidad Educativa San Roque",13,5,18,0,147,1,27,1,1,213,4,7,224,233,0.69,0.961
"7176","La Paz","El Alto","Unidad Educativa San Roque",23,2,8,0,133,3,34,0,0,203,2,11,216,227,0.655,0.952
"7177","La Paz","El Alto","Unidad Educativa San Roque",18,3,13,0,141,2,27,0,1,205,1,7,213,232,0.688,0.918
"7178","La Paz","El Alto","Unidad Educativa San Roque",16,1,9,0,137,1,41,0,3,208,0,12,220,234,0.659,0.94
"7179","La Paz","El Alto","Unidad Educativa San Roque",13,0,9,0,138,2,31,1,3,197,4,11,212,232,0.701,0.914
"7180","La Paz","El Alto","Unidad Educativa San Roque",12,2,16,1,134,2,31,0,4,202,3,7,212,227,0.663,0.934
"7181","La Paz","El Alto","Unidad Educativa San Roque",20,3,8,0,139,2,29,0,1,202,3,8,213,228,0.688,0.934
"7182","La Paz","El Alto","Unidad Educativa San Roque",23,4,10,0,124,2,37,1,2,203,2,12,217,230,0.611,0.943
"7183","La Paz","El Alto","Unidad Educativa San Roque",20,3,9,2,128,0,40,2,3,207,4,4,215,233,0.618,0.923
"7184","La Paz","El Alto","Unidad Educativa San Roque",12,1,15,0,134,2,37,0,4,205,3,4,212,227,0.654,0.934
"7185","La Paz","El Alto","Unidad Educativa San Roque",13,1,15,0,140,1,37,0,2,209,3,11,223,234,0.67,0.953
"7186","La Paz","El Alto","Unidad Educativa San Roque",16,2,14,0,150,1,32,0,1,216,2,5,223,237,0.694,0.941
"7187","La Paz","El Alto","Unidad Educativa San Roque",18,2,8,0,127,3,33,0,1,192,4,11,207,225,0.661,0.92
"7188","La Paz","El Alto","Unidad Educativa San Roque",13,1,12,0,149,0,35,0,1,211,6,3,220,232,0.706,0.948
"7189","La Paz","El Alto","Unidad Educativa San Roque",17,2,14,0,137,2,28,1,2,203,2,10,215,225,0.675,0.956
"7190","La Paz","El Alto","Unidad Educativa San Roque",18,0,8,0,129,1,32,1,1,190,2,14,206,227,0.679,0.907
"7191","La Paz","El Alto","Unidad Educativa San Roque",20,2,10,1,131,5,32,0,3,204,3,10,217,236,0.642,0.919
"7192","La Paz","El Alto","Unidad Educativa San Roque",22,1,9,4,130,1,35,0,4,206,2,10,218,232,0.631,0.94
"7193","La Paz","El Alto","Unidad Educativa San Roque",19,2,11,1,138,2,20,1,2,196,7,8,211,230,0.704,0.917
"7194","La Paz","El Alto","Unidad Educativa San Roque",28,6,13,1,113,1,44,1,2,209,1,5,215,231,0.541,0.931
"7195","La Paz","El Alto","Unidad Educativa San Roque",23,0,11,1,136,4,29,0,1,205,3,8,216,234,0.663,0.923
"7196","La Paz","El Alto","Unidad Educativa San Roque",23,1,14,1,122,0,36,0,2,199,2,14,215,225,0.613,0.956
"7197","La Paz","El Alto","Unidad Educativa San Roque",24,1,16,0,142,2,22,0,2,209,2,12,223,231,0.679,0.965
"7198","La Paz","El Alto","Unidad Educativa San Roque",24,0,10,0,136,1,24,0,3,198,5,15,218,230,0.687,0.948
"7199","La Paz","El Alto","Unidad Educativa San Roque",26,1,13,0,122,5,35,0,3,205,3,9,217,231,0.595,0.939
"7200","La Paz","El Alto","Unidad Educativa San Roque",20,0,8,0,144,2,32,0,2,208,2,10,220,229,0.692,0.961
"7201","La Paz","El Alto","Unidad Educativa San Roque",10,0,17,0,147,3,23,0,2,202,4,9,215,230,0.728,0.935
"7202","La Paz","El Alto","Unidad Educativa San Roque",21,3,14,1,119,4,48,1,2,213,3,6,222,230,0.559,0.965
"7203","La Paz","El Alto","Unidad Educativa San Roque",6,0,11,0,118,1,29,0,2,167,1,3,171,194,0.707,0.881
"7204","La Paz","El Alto","U.E. Ernesto Che Guevara",28,2,3,0,139,0,33,0,2,207,4,5,216,237,0.671,0.911
"7205","La Paz","El Alto","U.E. Ernesto Che Guevara",14,1,5,0,153,2,40,0,2,217,2,6,225,240,0.705,0.938
"7206","La Paz","El Alto","U.E. Ernesto Che Guevara",18,1,9,0,133,3,41,1,0,206,7,13,226,240,0.646,0.942
"7207","La Paz","El Alto","U.E. Ernesto Che Guevara",12,1,5,0,140,2,55,1,0,216,3,8,227,238,0.648,0.954
"7208","La Paz","El Alto","U.E. Ernesto Che Guevara",13,1,12,0,137,5,43,0,4,215,3,3,221,240,0.637,0.921
"7209","La Paz","El Alto","U.E. Ernesto Che Guevara",20,2,6,0,142,2,48,0,1,221,4,8,233,240,0.643,0.971
"7210","La Paz","El Alto","U.E. Ernesto Che Guevara",11,2,7,1,137,2,48,0,2,210,5,6,221,235,0.652,0.94
"7211","La Paz","El Alto","U.E. Ernesto Che Guevara",20,0,9,0,138,0,38,0,2,207,8,9,224,240,0.667,0.933
"7212","La Paz","El Alto","U.E. Ernesto Che Guevara",12,2,9,0,140,2,45,0,2,212,2,9,223,237,0.66,0.941
"7213","La Paz","El Alto","Unidad Educativa Villa Cooperativa",28,2,12,0,140,4,27,0,0,213,2,6,221,233,0.657,0.948
"7214","La Paz","El Alto","Unidad Educativa Villa Cooperativa",35,1,6,0,132,0,35,0,4,213,0,13,226,234,0.62,0.966
"7215","La Paz","El Alto","Unidad Educativa Villa Cooperativa",34,4,6,1,110,4,39,1,1,200,0,5,205,233,0.55,0.88
"7216","La Paz","El Alto","Unidad Educativa Villa Cooperativa",34,0,4,0,129,3,28,0,2,200,3,3,206,227,0.645,0.907
"7217","La Paz","El Alto","Unidad Educativa Villa Cooperativa",23,1,7,1,137,0,33,0,3,205,0,8,213,230,0.668,0.926
"7218","La Paz","El Alto","Unidad Educativa Villa Cooperativa",19,5,13,0,109,5,0,46,3,200,8,0,208,227,0.545,0.916
"7219","La Paz","El Alto","Unidad Educativa Villa Cooperativa",22,0,4,0,147,2,27,1,1,204,2,10,216,229,0.721,0.943
"7220","La Paz","El Alto","Unidad Educativa Villa Cooperativa",19,2,8,2,158,1,23,0,2,215,2,8,225,235,0.735,0.957
"7221","La Paz","El Alto","Unidad Educativa Villa Cooperativa",42,1,5,0,125,5,26,0,2,206,0,7,213,226,0.607,0.942
"7222","La Paz","El Alto","Unidad Educativa Villa Cooperativa",28,1,7,1,129,3,25,1,1,196,4,13,213,230,0.658,0.926
"7223","La Paz","El Alto","Unidad Educativa Villa Cooperativa",14,2,8,1,131,5,32,1,3,197,1,9,207,229,0.665,0.904
"7224","La Paz","El Alto","Unidad Educativa Villa Cooperativa",20,1,15,1,139,8,23,0,0,207,1,5,213,228,0.671,0.934
"7225","La Paz","El Alto","Unidad Educativa Villa Cooperativa",24,4,12,1,119,0,42,0,0,202,3,10,215,231,0.589,0.931
"7226","La Paz","El Alto","Unidad Educativa Villa Cooperativa",22,0,15,1,122,1,36,0,2,199,2,9,210,230,0.613,0.913
"7227","La Paz","El Alto","Unidad Educativa Villa Cooperativa",25,1,8,0,130,3,32,1,0,200,4,4,208,230,0.65,0.904
"7228","La Paz","El Alto","Unidad Educativa Villa Cooperativa",38,1,6,0,123,0,24,1,2,195,2,13,210,229,0.631,0.917
"7229","La Paz","El Alto","Unidad Educativa Villa Cooperativa",13,0,7,0,135,7,32,0,4,198,4,9,211,230,0.682,0.917
"7230","La Paz","El Alto","Unidad Educativa Villa Cooperativa",21,1,9,1,136,7,32,0,3,210,2,10,222,233,0.648,0.953
"7231","La Paz","El Alto","Unidad Educativa Villa Cooperativa",21,1,10,0,134,2,38,1,1,208,1,7,216,235,0.644,0.919
"7232","La Paz","El Alto","Unidad Educativa Villa Cooperativa",40,1,5,1,123,2,26,0,2,200,5,9,214,228,0.615,0.939
"7233","La Paz","El Alto","Unidad Educativa Villa Cooperativa",29,3,9,1,131,2,19,0,3,197,2,15,214,227,0.665,0.943
"7234","La Paz","El Alto","Unidad Educativa Villa Cooperativa",22,2,9,0,131,2,34,0,3,203,6,7,216,229,0.645,0.943
"7235","La Paz","El Alto","Unidad Educativa Villa Cooperativa",29,2,7,0,121,4,37,1,3,204,3,7,214,232,0.593,0.922
"7236","La Paz","El Alto","Unidad Educativa Progreso",15,2,8,1,133,2,45,0,1,207,3,14,224,238,0.643,0.941
"7237","La Paz","El Alto","Unidad Educativa Progreso",18,2,12,0,146,3,35,0,0,216,0,8,224,236,0.676,0.949
"7238","La Paz","El Alto","Unidad Educativa Progreso",28,1,10,0,130,2,44,1,2,218,1,5,224,235,0.596,0.953
"7239","La Paz","El Alto","Unidad Educativa Progreso",19,0,17,1,125,1,38,1,1,203,5,10,218,232,0.616,0.94
"7240","La Paz","El Alto","Unidad Educativa Progreso",18,3,6,0,131,3,36,0,1,198,2,12,212,230,0.662,0.922
"7241","La Paz","El Alto","Unidad Educativa Progreso",20,1,15,1,123,4,41,2,0,207,4,7,218,237,0.594,0.92
"7242","La Paz","El Alto","Unidad Educativa Progreso",23,0,7,1,130,6,43,0,1,211,4,7,222,231,0.616,0.961
"7243","La Paz","El Alto","Unidad Educativa Progreso",24,3,15,1,133,3,31,2,5,217,2,5,224,233,0.613,0.961
"7244","La Paz","El Alto","Unidad Educativa Progreso",23,1,14,0,123,2,29,0,5,197,3,16,216,233,0.624,0.927
"7245","La Paz","El Alto","Unidad Educativa Progreso",40,2,13,0,115,2,35,0,2,209,3,7,219,233,0.55,0.94
"7246","La Paz","El Alto","Unidad Educativa Progreso",21,1,13,1,142,3,26,0,2,209,4,9,222,234,0.679,0.949
"7247","La Paz","El Alto","Unidad Educativa Progreso",31,1,15,1,129,2,33,0,3,215,2,7,224,237,0.6,0.945
"7248","La Paz","El Alto","Unidad Educativa Progreso",15,2,13,1,144,1,39,0,3,218,2,5,225,236,0.661,0.953
"7249","La Paz","El Alto","Unidad Educativa Progreso",18,2,12,1,123,3,35,0,5,199,3,18,220,230,0.618,0.957
"7250","La Paz","El Alto","Unidad Educativa Progreso",26,3,7,1,139,1,34,1,5,217,3,8,228,236,0.641,0.966
"7251","La Paz","El Alto","Unidad Educativa Progreso",18,0,12,2,143,3,37,0,1,216,1,9,226,234,0.662,0.966
"7252","La Paz","El Alto","Unidad Educativa Progreso",8,4,14,1,158,2,24,0,0,211,2,12,225,236,0.749,0.953
"7253","La Paz","El Alto","Unidad Educativa Progreso",24,0,11,1,134,3,38,0,1,212,2,10,224,232,0.632,0.966
"7254","La Paz","El Alto","Unidad Educativa Progreso",21,0,7,0,145,2,31,0,2,208,5,10,223,234,0.697,0.953
"7255","La Paz","El Alto","Unidad Educativa Progreso",21,0,16,1,123,3,35,0,2,201,6,15,222,232,0.612,0.957
"7256","La Paz","El Alto","Unidad Educativa Progreso",18,2,5,0,132,4,35,0,0,196,4,15,215,229,0.673,0.939
"7257","La Paz","El Alto","Unidad Educativa Progreso",14,1,9,0,122,2,47,0,2,197,3,18,218,235,0.619,0.928
"7258","La Paz","El Alto","Unidad Educativa Progreso",26,1,14,0,121,2,41,1,2,208,0,15,223,238,0.582,0.937
"7259","La Paz","El Alto","Unidad Educativa Progreso",21,4,9,2,127,1,37,0,3,204,3,16,223,233,0.623,0.957
"7260","La Paz","El Alto","Unidad Educativa Progreso",19,1,6,2,120,3,33,1,4,189,1,33,223,235,0.635,0.949
"7261","La Paz","El Alto","Unidad Educativa Progreso",24,1,17,1,141,2,29,0,2,217,1,7,225,234,0.65,0.962
"7262","La Paz","El Alto","Unidad Educativa Progreso",19,0,11,1,129,4,40,1,3,208,3,8,219,232,0.62,0.944
"7263","La Paz","El Alto","Unidad Educativa Progreso",23,0,10,1,125,4,40,0,2,205,2,12,219,230,0.61,0.952
"7264","La Paz","El Alto","Unidad Educativa Progreso",22,2,7,1,136,1,36,0,3,208,3,13,224,236,0.654,0.949
"7265","La Paz","El Alto","Unidad Educativa Progreso",29,4,6,0,131,1,30,1,2,204,3,14,221,240,0.642,0.921
"7266","La Paz","El Alto","Unidad Educativa Progreso",25,2,12,2,134,1,28,2,1,207,6,3,216,231,0.647,0.935
"7267","La Paz","El Alto","Unidad Educativa Progreso",22,1,15,1,133,1,31,0,3,207,2,13,222,235,0.643,0.945
"7268","La Paz","El Alto","Unidad Educativa Progreso",24,2,12,0,128,1,49,0,1,217,1,5,223,237,0.59,0.941
"7269","La Paz","El Alto","Unidad Educativa Progreso",25,0,12,2,126,3,35,3,3,209,7,9,225,234,0.603,0.962
"7270","La Paz","El Alto","Unidad Educativa Progreso",32,1,9,0,109,4,52,1,2,210,3,5,218,234,0.519,0.932
"7271","La Paz","El Alto","Unidad Educativa Progreso",34,3,18,1,118,2,39,0,1,216,1,3,220,234,0.546,0.94
"7272","La Paz","El Alto","Unidad Educativa Progreso",23,0,6,0,139,1,30,1,2,202,1,6,209,228,0.688,0.917
"7273","La Paz","El Alto","Unidad Educativa Progreso",17,1,15,0,129,2,36,0,1,201,2,15,218,232,0.642,0.94
"7274","La Paz","El Alto","Unidad Educativa Progreso",18,0,15,0,122,2,47,0,2,206,1,19,226,234,0.592,0.966
"7275","La Paz","El Alto","Unidad Educativa Progreso",22,0,5,0,128,2,41,0,3,201,3,11,215,231,0.637,0.931
"7276","La Paz","El Alto","U.E. Fuerza Aerea Argentina",17,2,9,0,126,1,48,1,2,206,2,14,222,231,0.612,0.961
"7277","La Paz","El Alto","U.E. Fuerza Aerea Argentina",26,1,7,0,129,4,40,1,5,213,4,5,222,235,0.606,0.945
"7278","La Paz","El Alto","U.E. Fuerza Aerea Argentina",20,0,11,0,144,3,30,0,2,210,1,10,221,233,0.686,0.948
"7279","La Paz","El Alto","U.E. Fuerza Aerea Argentina",19,1,9,0,151,0,22,0,3,205,1,9,215,230,0.737,0.935
"7280","La Paz","El Alto","U.E. Fuerza Aerea Argentina",24,0,14,1,137,3,32,0,0,211,4,6,221,235,0.649,0.94
"7281","La Paz","El Alto","U.E. Fuerza Aerea Argentina",18,2,7,0,139,4,39,0,2,211,2,8,221,231,0.659,0.957
"7282","La Paz","El Alto","U.E. Heroes de Octubre",5,1,16,1,157,0,18,0,2,200,5,19,224,238,0.785,0.941
"7283","La Paz","El Alto","U.E. Heroes de Octubre",13,0,8,0,160,0,26,1,2,210,3,17,230,239,0.762,0.962
"7284","La Paz","El Alto","U.E. Heroes de Octubre",4,0,10,0,171,0,25,0,1,211,2,17,230,239,0.81,0.962
"7285","La Paz","El Alto","U.E. Heroes de Octubre",10,0,14,1,179,4,17,0,0,225,1,7,233,240,0.796,0.971
"7286","La Paz","El Alto","U.E. Heroes de Octubre",6,1,5,0,147,0,14,0,2,175,5,9,189,195,0.84,0.969
"7287","La Paz","El Alto","Unidad Educativa Mariscal Antonio Jose E",21,2,8,1,119,2,55,0,0,208,2,9,219,230,0.572,0.952
"7288","La Paz","El Alto","Unidad Educativa Mariscal Antonio Jose E",31,0,12,0,114,1,47,1,1,207,2,10,219,232,0.551,0.944
"7289","La Paz","El Alto","Unidad Educativa Mariscal Antonio Jose E",27,1,11,0,122,4,37,0,2,204,2,7,213,232,0.598,0.918
"7290","La Paz","El Alto","Unidad Educativa Mariscal Antonio Jose E",23,4,6,0,119,1,43,0,1,197,4,6,207,234,0.604,0.885
"7291","La Paz","El Alto","Unidad Educativa Mariscal Antonio Jose E",14,0,8,1,140,1,45,0,3,212,3,5,220,230,0.66,0.957
"7292","La Paz","El Alto","Unidad Educativa Mariscal Antonio Jose E",19,2,16,1,130,0,39,0,2,209,2,10,221,236,0.622,0.936
"7293","La Paz","El Alto","Unidad Educativa Mariscal Antonio Jose E",26,1,15,1,113,0,37,0,5,198,2,10,210,228,0.571,0.921
"7294","La Paz","El Alto","Unidad Educativa Mariscal Antonio Jose E",26,1,7,0,124,2,42,0,1,203,0,14,217,232,0.611,0.935
"7295","La Paz","El Alto","Unidad Educativa Mariscal Antonio Jose E",18,2,8,0,140,1,19,1,1,190,0,8,198,226,0.737,0.876
"7296","La Paz","El Alto","Unidad Educativa Mariscal Antonio Jose E",24,0,10,0,136,3,30,1,0,204,2,8,214,227,0.667,0.943
"7297","La Paz","El Alto","Unidad Educativa Mariscal Antonio Jose E",27,1,12,1,127,4,35,0,5,212,2,7,221,231,0.599,0.957
"7298","La Paz","El Alto","Unidad Educativa Mariscal Antonio Jose E",30,0,10,1,118,2,40,0,7,208,2,10,220,229,0.567,0.961
"7299","La Paz","El Alto","Unidad Educativa Mariscal Antonio Jose E",21,0,10,1,134,4,33,0,2,205,3,7,215,233,0.654,0.923
"7300","La Paz","El Alto","Unidad Educativa Mariscal Antonio Jose E",22,2,10,1,130,0,35,0,1,201,5,13,219,230,0.647,0.952
"7301","La Paz","El Alto","Unidad Educativa Mariscal Antonio Jose E",16,2,5,0,121,0,42,1,4,191,1,15,207,228,0.634,0.908
"7302","La Paz","El Alto","Unidad Educativa Mariscal Antonio Jose E",26,1,10,0,123,3,39,0,3,205,6,11,222,232,0.6,0.957
"7303","La Paz","El Alto","Unidad Educativa Mariscal Antonio Jose E",25,1,13,0,124,1,28,0,2,194,2,8,204,224,0.639,0.911
"7304","La Paz","El Alto","Unidad Educativa Mariscal Antonio Jose E",28,1,14,0,113,8,43,0,1,208,0,5,213,231,0.543,0.922
"7305","La Paz","El Alto","Unidad Educativa Mariscal Antonio Jose E",25,1,8,0,122,1,42,0,3,202,2,10,214,232,0.604,0.922
"7306","La Paz","El Alto","Unidad Educativa Mariscal Antonio Jose E",26,3,9,0,117,2,42,0,1,200,3,9,212,231,0.585,0.918
"7307","La Paz","El Alto","Unidad Educativa Mariscal Antonio Jose E",16,0,14,0,124,4,48,0,0,206,1,7,214,230,0.602,0.93
"7308","La Paz","El Alto","Unidad Educativa Mariscal Antonio Jose E",26,0,8,1,115,2,36,0,4,192,3,13,208,227,0.599,0.916
"7309","La Paz","El Alto","Unidad Educativa Mariscal Antonio Jose E",31,0,7,0,125,4,37,0,2,206,0,8,214,230,0.607,0.93
"7310","La Paz","El Alto","Unidad Educativa Mariscal Antonio Jose E",25,2,15,0,106,0,37,0,2,187,4,12,203,224,0.567,0.906
"7311","La Paz","El Alto","Unidad Educativa Mariscal Antonio Jose E",23,2,10,0,116,0,39,0,4,194,3,16,213,225,0.598,0.947
"7312","La Paz","El Alto","Unidad Educativa Mariscal Antonio Jose E",26,0,13,0,107,2,54,0,5,207,3,8,218,233,0.517,0.936
"7313","La Paz","El Alto","Unidad Educativa Mariscal Antonio Jose E",24,1,11,1,125,0,27,1,3,193,3,12,208,227,0.648,0.916
"7314","La Paz","El Alto","Unidad Educativa Mariscal Antonio Jose E",34,2,12,0,125,5,28,0,2,208,2,7,217,235,0.601,0.923
"7315","La Paz","El Alto","Unidad Educativa Mariscal Antonio Jose E",24,0,13,0,134,0,34,0,4,209,5,10,224,233,0.641,0.961
"7316","La Paz","El Alto","Unidad Educativa Mariscal Antonio Jose E",24,0,9,0,122,4,39,1,4,203,1,9,213,236,0.601,0.903
"7317","La Paz","El Alto","Unidad Educativa Mariscal Antonio Jose E",18,1,5,0,140,1,40,0,3,208,3,3,214,228,0.673,0.939
"7318","La Paz","El Alto","Unidad Educativa Mariscal Antonio Jose E",20,1,11,0,126,4,33,1,1,197,3,10,210,226,0.64,0.929
"7319","La Paz","El Alto","Unidad Educativa Mariscal Antonio Jose E",27,2,14,0,122,3,31,0,2,201,2,11,214,229,0.607,0.934
"7320","La Paz","El Alto","Colegio M Quiroga Santa Cruz",40,3,11,1,93,0,46,0,3,197,1,11,209,225,0.472,0.929
"7321","La Paz","El Alto","Colegio M Quiroga Santa Cruz",42,1,6,0,104,4,34,0,4,195,2,13,210,222,0.533,0.946
"7322","La Paz","El Alto","Colegio M Quiroga Santa Cruz",32,2,11,1,122,3,31,1,3,206,2,4,212,227,0.592,0.934
"7323","La Paz","El Alto","Colegio M Quiroga Santa Cruz",54,1,11,0,88,3,45,1,3,206,4,9,219,236,0.427,0.928
"7324","La Paz","El Alto","Colegio M Quiroga Santa Cruz",46,1,9,0,101,0,44,0,1,202,2,7,211,224,0.5,0.942
"7325","La Paz","El Alto","Colegio M Quiroga Santa Cruz",32,0,10,0,113,3,45,0,5,208,0,8,216,233,0.543,0.927
"7326","La Paz","El Alto","Colegio M Quiroga Santa Cruz",43,2,19,1,106,4,24,0,3,202,1,9,212,230,0.525,0.922
"7327","La Paz","El Alto","Colegio M Quiroga Santa Cruz",44,1,12,0,105,4,28,0,3,197,1,10,208,226,0.533,0.92
"7328","La Paz","El Alto","Colegio M Quiroga Santa Cruz",39,2,1,1,108,5,45,0,8,209,1,9,219,230,0.517,0.952
"7329","La Paz","El Alto","Colegio M Quiroga Santa Cruz",53,1,7,2,111,1,25,0,4,204,1,11,216,230,0.544,0.939
"7330","La Paz","El Alto","Colegio M Quiroga Santa Cruz",46,0,5,1,110,1,35,0,9,207,3,8,218,233,0.531,0.936
"7331","La Paz","El Alto","Colegio M Quiroga Santa Cruz",55,1,8,1,99,1,42,0,1,208,0,8,216,223,0.476,0.969
"7332","La Paz","El Alto","Colegio M Quiroga Santa Cruz",39,2,6,0,104,4,36,0,2,193,0,12,205,222,0.539,0.923
"7333","La Paz","El Alto","Colegio M Quiroga Santa Cruz",54,1,9,0,108,2,31,0,1,206,2,8,216,227,0.524,0.952
"7334","La Paz","El Alto","Colegio M Quiroga Santa Cruz",53,1,10,0,94,2,46,0,5,211,0,7,218,230,0.445,0.948
"7335","La Paz","El Alto","Colegio M Quiroga Santa Cruz",41,1,11,2,108,2,41,0,2,208,0,8,216,226,0.519,0.956
"7336","La Paz","El Alto","Colegio M Quiroga Santa Cruz",49,2,7,1,96,3,41,1,3,203,3,10,216,228,0.473,0.947
"7337","La Paz","El Alto","Colegio M Quiroga Santa Cruz",47,2,11,1,107,4,35,0,4,211,2,7,220,229,0.507,0.961
"7338","La Paz","El Alto","Colegio M Quiroga Santa Cruz",32,3,9,0,129,0,33,0,1,207,4,9,220,229,0.623,0.961
"7339","La Paz","El Alto","Colegio M Quiroga Santa Cruz",49,1,6,0,106,2,41,1,4,210,2,4,216,224,0.505,0.964
"7340","La Paz","El Alto","Colegio M Quiroga Santa Cruz",60,0,6,0,110,0,30,0,1,207,2,9,218,229,0.531,0.952
"7341","La Paz","El Alto","Colegio M Quiroga Santa Cruz",43,5,12,3,95,3,34,1,4,200,1,9,210,230,0.475,0.913
"7342","La Paz","El Alto","Colegio M Quiroga Santa Cruz",48,2,5,0,102,2,40,0,2,201,2,12,215,227,0.507,0.947
"7343","La Paz","El Alto","Colegio M Quiroga Santa Cruz",37,1,8,0,108,3,44,1,4,206,1,10,217,229,0.524,0.948
"7344","La Paz","El Alto","Colegio Andres de Sta. Cruz",39,1,5,0,121,3,44,1,1,215,1,5,221,232,0.563,0.953
"7345","La Paz","El Alto","Colegio Andres de Sta. Cruz",38,1,4,1,122,3,32,1,3,205,6,5,216,224,0.595,0.964
"7346","La Paz","El Alto","Colegio Andres de Sta. Cruz",50,0,7,1,117,1,22,2,0,200,1,16,217,227,0.585,0.956
"7347","La Paz","El Alto","Colegio Andres de Sta. Cruz",40,2,8,0,93,1,48,3,4,199,3,6,208,228,0.467,0.912
"7348","La Paz","El Alto","Colegio Andres de Sta. Cruz",20,1,11,2,121,1,42,0,3,201,4,7,212,226,0.602,0.938
"7349","La Paz","El Alto","Colegio Andres de Sta. Cruz",36,1,5,1,107,4,29,1,5,189,2,10,201,221,0.566,0.91
"7350","La Paz","El Alto","Colegio Andres de Sta. Cruz",32,1,12,0,122,2,32,0,4,205,3,13,221,235,0.595,0.94
"7351","La Paz","El Alto","Colegio Andres de Sta. Cruz",29,3,6,2,114,1,53,0,4,212,2,6,220,229,0.538,0.961
"7352","La Paz","El Alto","Colegio Andres de Sta. Cruz",49,1,11,0,103,1,32,0,2,199,3,9,211,229,0.518,0.921
"7353","La Paz","El Alto","Colegio Andres de Sta. Cruz",31,0,9,0,128,2,26,0,4,200,4,10,214,235,0.64,0.911
"7354","La Paz","El Alto","Colegio Andres de Sta. Cruz",31,1,8,0,128,1,34,0,4,207,3,5,215,229,0.618,0.939
"7355","La Paz","El Alto","Colegio Andres de Sta. Cruz",37,1,9,1,113,4,32,0,2,199,3,11,213,227,0.568,0.938
"7356","La Paz","El Alto","Colegio Andres de Sta. Cruz",35,1,5,0,128,1,30,1,8,209,1,7,217,231,0.612,0.939
"7357","La Paz","El Alto","Colegio Andres de Sta. Cruz",53,0,9,1,117,1,25,1,2,209,1,9,219,229,0.56,0.956
"7358","La Paz","El Alto","Colegio Andres de Sta. Cruz",45,1,9,0,110,5,30,1,3,204,5,8,217,228,0.539,0.952
"7359","La Paz","El Alto","Colegio Andres de Sta. Cruz",30,3,12,0,127,0,32,0,3,207,5,8,220,232,0.614,0.948
"7360","La Paz","El Alto","Colegio Andres de Sta. Cruz",40,0,7,0,110,1,34,0,5,197,3,12,212,229,0.558,0.926
"7361","La Paz","El Alto","Colegio Andres de Sta. Cruz",42,0,26,2,65,18,0,3,2,158,46,6,210,229,0.411,0.917
"7362","La Paz","El Alto","Colegio Andres de Sta. Cruz",29,2,10,0,127,0,34,0,2,204,2,10,216,228,0.623,0.947
"7363","La Paz","El Alto","Colegio Andres de Sta. Cruz",32,2,10,0,130,2,27,0,3,206,4,10,220,228,0.631,0.965
"7364","La Paz","El Alto","Colegio Andres de Sta. Cruz",40,1,2,0,117,1,32,0,3,196,2,12,210,229,0.597,0.917
"7365","La Paz","El Alto","Colegio Andres de Sta. Cruz",33,0,7,0,114,3,43,0,1,201,4,8,213,230,0.567,0.926
"7366","La Paz","El Alto","Colegio Andres de Sta. Cruz",39,1,4,0,118,6,36,0,3,207,2,6,215,226,0.57,0.951
"7367","La Paz","El Alto","Colegio Andres de Sta. Cruz",48,1,15,0,101,3,35,1,2,206,1,9,216,228,0.49,0.947
"7368","La Paz","El Alto","Colegio Andres de Sta. Cruz",39,2,14,0,106,2,34,0,2,199,0,8,207,226,0.533,0.916
"7369","La Paz","El Alto","Colegio Andres de Sta. Cruz",39,1,11,0,120,3,25,0,3,202,6,6,214,226,0.594,0.947
"7370","La Paz","El Alto","Colegio Andres de Sta. Cruz",30,0,16,2,109,0,29,0,6,192,1,18,211,225,0.568,0.938
"7371","La Paz","El Alto","Colegio Andres de Sta. Cruz",43,1,15,3,95,6,42,1,3,209,1,8,218,231,0.455,0.944
"7372","La Paz","El Alto","Colegio Andres de Sta. Cruz",27,3,8,1,114,2,43,0,3,201,1,4,206,219,0.567,0.941
"7373","La Paz","El Alto","Colegio Andres de Sta. Cruz",33,1,8,0,128,0,39,0,2,211,1,6,218,229,0.607,0.952
"7374","La Paz","El Alto","Colegio Andres de Sta. Cruz",41,4,8,0,92,4,43,2,0,194,2,11,207,225,0.474,0.92
"7375","La Paz","El Alto","Colegio Andres de Sta. Cruz",43,1,9,1,101,5,36,0,4,200,2,8,210,221,0.505,0.95
"7376","La Paz","El Alto","Colegio Andres de Sta. Cruz",29,0,5,0,119,5,34,0,0,192,2,7,201,225,0.62,0.893
"7377","La Paz","El Alto","Colegio Andres de Sta. Cruz",51,0,7,1,86,4,47,0,6,202,1,16,219,231,0.426,0.948
"7378","La Paz","El Alto","Colegio Andres de Sta. Cruz",35,1,13,0,119,3,37,1,2,211,1,7,219,228,0.564,0.961
"7379","La Paz","El Alto","Colegio Antonio Paredes Candia",30,1,8,1,119,3,42,1,2,207,1,6,214,229,0.575,0.934
"7380","La Paz","El Alto","Colegio Antonio Paredes Candia",37,3,3,1,109,3,38,0,0,194,3,19,216,232,0.562,0.931
"7381","La Paz","El Alto","Colegio Antonio Paredes Candia",27,1,11,1,129,1,31,1,2,204,0,7,211,231,0.632,0.913
"7382","La Paz","El Alto","Colegio Antonio Paredes Candia",24,0,6,1,139,0,42,0,1,213,1,3,217,229,0.653,0.948
"7383","La Paz","El Alto","Colegio Antonio Paredes Candia",34,1,9,2,119,2,39,0,1,207,1,12,220,233,0.575,0.944
"7384","La Paz","El Alto","Colegio Antonio Paredes Candia",33,2,9,1,114,4,40,0,1,204,2,4,210,225,0.559,0.933
"7385","La Paz","El Alto","Colegio Antonio Paredes Candia",24,0,8,2,134,0,38,0,5,211,2,10,223,234,0.635,0.953
"7386","La Paz","El Alto","Colegio Antonio Paredes Candia",37,1,8,0,108,1,37,0,4,196,2,11,209,230,0.551,0.909
"7387","La Paz","El Alto","Colegio Antonio Paredes Candia",35,1,15,0,118,0,34,2,3,208,3,7,218,229,0.567,0.952
"7388","La Paz","El Alto","Colegio Antonio Paredes Candia",25,2,6,2,126,1,40,0,1,203,0,8,211,231,0.621,0.913
"7389","La Paz","El Alto","Colegio Antonio Paredes Candia",34,0,11,0,115,2,40,1,1,204,1,9,214,224,0.564,0.955
"7390","La Paz","El Alto","Colegio Antonio Paredes Candia",33,0,10,2,105,5,40,0,0,195,2,5,202,223,0.538,0.906
"7391","La Paz","El Alto","Colegio Antonio Paredes Candia",33,3,7,1,110,3,39,0,0,196,3,12,211,229,0.561,0.921
"7392","La Paz","El Alto","Colegio Antonio Paredes Candia",30,1,8,0,131,3,34,2,5,214,2,11,227,236,0.612,0.962
"7393","La Paz","El Alto","Colegio Antonio Paredes Candia",36,1,11,2,104,1,38,0,3,196,1,10,207,229,0.531,0.904
"7394","La Paz","El Alto","Colegio Antonio Paredes Candia",21,2,9,0,123,1,43,0,4,203,2,10,215,226,0.606,0.951
"7395","La Paz","El Alto","Colegio Antonio Paredes Candia",22,1,14,3,131,1,31,0,3,206,2,11,219,235,0.636,0.932
"7396","La Paz","El Alto","Colegio Antonio Paredes Candia",16,2,6,0,139,3,36,0,3,205,0,11,216,229,0.678,0.943
"7397","La Paz","El Alto","Colegio Antonio Paredes Candia",33,1,7,0,123,5,36,1,1,207,1,6,214,234,0.594,0.915
"7398","La Paz","El Alto","Colegio Antonio Paredes Candia",36,1,9,1,112,2,40,0,7,208,0,4,212,226,0.538,0.938
"7399","La Paz","El Alto","Colegio Antonio Paredes Candia",26,1,10,1,117,0,45,2,1,203,0,12,215,229,0.576,0.939
"7400","La Paz","El Alto","Colegio Antonio Paredes Candia",47,0,6,0,120,2,39,0,2,216,3,7,226,235,0.556,0.962
"7401","La Paz","El Alto","Colegio Antonio Paredes Candia",24,0,7,0,124,3,39,0,3,200,2,5,207,225,0.62,0.92
"7402","La Paz","El Alto","Colegio Antonio Paredes Candia",26,0,11,1,121,1,44,0,4,208,2,5,215,233,0.582,0.923
"7403","La Paz","El Alto","Colegio Antonio Paredes Candia",27,2,5,0,124,3,27,0,5,193,3,3,199,230,0.642,0.865
"7404","La Paz","El Alto","Colegio Antonio Paredes Candia",27,2,14,0,105,2,46,0,4,200,1,10,211,230,0.525,0.917
"7405","La Paz","El Alto","Colegio Antonio Paredes Candia",28,1,11,1,115,6,47,0,3,212,2,8,222,235,0.542,0.945
"7406","La Paz","El Alto","Colegio Antonio Paredes Candia",33,3,14,0,128,4,24,0,1,207,1,9,217,234,0.618,0.927
"7407","La Paz","El Alto","Colegio Antonio Paredes Candia",24,2,16,0,117,5,31,0,6,201,2,8,211,227,0.582,0.93
"7408","La Paz","El Alto","Colegio Antonio Paredes Candia",25,4,8,1,122,2,27,0,1,190,8,7,205,227,0.642,0.903
"7409","La Paz","El Alto","Colegio Antonio Paredes Candia",28,1,7,0,115,5,32,0,6,194,4,10,208,226,0.593,0.92
"7410","La Paz","El Alto","Colegio Antonio Paredes Candia",35,0,6,0,118,3,29,0,4,195,1,8,204,231,0.605,0.883
"7411","La Paz","El Alto","Colegio Antonio Paredes Candia",27,0,9,0,118,4,38,1,2,199,5,7,211,229,0.593,0.921
"7412","La Paz","El Alto","Colegio Antonio Paredes Candia",35,2,11,0,118,1,30,1,6,204,0,10,214,231,0.578,0.926
"7413","La Paz","El Alto","Colegio Antonio Paredes Candia",22,3,6,0,120,3,33,2,1,190,6,12,208,229,0.632,0.908
"7414","La Paz","El Alto","Colegio Antonio Paredes Candia",33,1,13,0,112,2,45,0,2,208,3,6,217,234,0.538,0.927
"7415","La Paz","El Alto","Colegio Antonio Paredes Candia",23,1,9,0,123,2,35,0,3,196,3,5,204,227,0.628,0.899
"7416","La Paz","El Alto","Colegio Antonio Paredes Candia",33,1,4,0,121,6,32,3,8,208,0,7,215,227,0.582,0.947
"7417","La Paz","El Alto","Colegio Antonio Paredes Candia",34,1,12,0,117,3,40,0,1,208,3,5,216,228,0.562,0.947
"7418","La Paz","El Alto","Colegio Antonio Paredes Candia",45,1,11,0,103,0,41,1,3,205,1,10,216,230,0.502,0.939
"7419","La Paz","El Alto","Colegio Antonio Paredes Candia",31,0,4,0,130,0,36,0,2,203,2,6,211,225,0.64,0.938
"7420","La Paz","El Alto","Colegio Antonio Paredes Candia",39,2,16,0,110,3,33,0,2,205,1,5,211,229,0.537,0.921
"7421","La Paz","El Alto","Colegio Antonio Paredes Candia",31,4,10,0,118,1,24,1,0,189,2,3,194,216,0.624,0.898
"7422","La Paz","El Alto","Colegio Antonio Paredes Candia",29,0,10,2,122,4,30,0,6,203,3,12,218,231,0.601,0.944
"7423","La Paz","El Alto","Colegio Antonio Paredes Candia",21,0,10,1,121,3,46,1,4,207,0,9,216,232,0.585,0.931
"7424","La Paz","El Alto","Colegio Antonio Paredes Candia",28,1,12,2,124,2,37,1,2,209,2,9,220,233,0.593,0.944
"7425","La Paz","El Alto","Colegio Antonio Paredes Candia",27,1,8,0,122,3,41,1,4,207,4,9,220,234,0.589,0.94
"7426","La Paz","El Alto","Colegio Antonio Paredes Candia",36,0,10,2,115,4,35,1,1,204,1,7,212,228,0.564,0.93
"7427","La Paz","El Alto","Colegio Antonio Paredes Candia",27,1,10,1,115,1,45,0,7,207,3,9,219,231,0.556,0.948
"7428","La Paz","El Alto","Colegio Antonio Paredes Candia",22,0,5,0,122,5,36,1,2,193,3,9,205,230,0.632,0.891
"7429","La Paz","El Alto","Colegio Antonio Paredes Candia",27,1,9,1,130,2,36,2,2,210,2,5,217,229,0.619,0.948
"7430","La Paz","El Alto","Colegio Antonio Paredes Candia",48,0,6,0,114,3,34,0,1,206,2,6,214,227,0.553,0.943
"7431","La Paz","El Alto","Colegio Antonio Paredes Candia",38,1,11,0,114,3,37,0,2,206,2,9,217,228,0.553,0.952
"7432","La Paz","El Alto","Colegio Antonio Paredes Candia",27,2,9,0,126,3,36,1,6,210,1,3,214,227,0.6,0.943
"7433","La Paz","El Alto","Colegio Antonio Paredes Candia",34,1,11,0,112,1,36,0,4,199,4,6,209,226,0.563,0.925
"7434","La Paz","El Alto","Colegio Antonio Paredes Candia",28,0,7,1,127,1,31,0,6,201,3,10,214,231,0.632,0.926
"7435","La Paz","El Alto","Colegio Antonio Paredes Candia",36,2,13,0,108,1,43,1,4,208,3,8,219,228,0.519,0.961
"7436","La Paz","El Alto","Colegio Antonio Paredes Candia",22,1,9,0,107,3,40,1,5,188,1,3,192,207,0.569,0.928
"7437","La Paz","El Alto","Unidad Educativa The Strongest",30,0,8,0,116,2,52,0,1,209,1,7,217,227,0.555,0.956
"7438","La Paz","El Alto","Unidad Educativa The Strongest",34,0,9,0,115,7,33,0,4,202,4,11,217,233,0.569,0.931
"7439","La Paz","El Alto","Unidad Educativa The Strongest",20,1,10,0,126,3,35,0,7,202,2,7,211,230,0.624,0.917
"7440","La Paz","El Alto","Unidad Educativa The Strongest",32,1,11,0,118,5,34,0,2,203,1,4,208,226,0.581,0.92
"7441","La Paz","El Alto","Unidad Educativa The Strongest",25,1,9,0,127,0,45,0,1,208,4,4,216,227,0.611,0.952
"7442","La Paz","El Alto","Unidad Educativa The Strongest",30,2,4,0,126,3,39,2,2,208,2,6,216,227,0.606,0.952
"7443","La Paz","El Alto","Unidad Educativa The Strongest",20,0,10,1,126,3,42,0,2,204,2,9,215,231,0.618,0.931
"7444","La Paz","El Alto","Unidad Educativa The Strongest",46,0,12,0,113,1,39,1,3,215,1,6,222,232,0.526,0.957
"7445","La Paz","El Alto","Unidad Educativa The Strongest",49,0,7,0,114,4,38,0,2,214,1,5,220,233,0.533,0.944
"7446","La Paz","El Alto","Unidad Educativa The Strongest",30,0,11,3,116,0,38,1,4,203,3,10,216,229,0.571,0.943
"7447","La Paz","El Alto","Unidad Educativa The Strongest",19,0,4,0,108,1,23,0,1,156,1,6,163,181,0.692,0.901
"7448","La Paz","El Alto","Unidad Educativa Republica de Cuba - Villa Ingenio - 2603",22,1,7,0,135,2,40,0,3,210,2,5,217,231,0.643,0.939
"7449","La Paz","El Alto","Unidad Educativa Republica de Cuba - Villa Ingenio - 2603",15,2,5,0,130,4,39,0,2,197,3,14,214,229,0.66,0.934
"7450","La Paz","El Alto","Unidad Educativa Republica de Cuba - Villa Ingenio - 2603",28,3,8,0,121,2,45,0,4,211,4,11,226,232,0.573,0.974
"7451","La Paz","El Alto","Unidad Educativa Republica de Cuba - Villa Ingenio - 2603",22,3,4,0,127,3,26,0,0,185,1,13,199,217,0.686,0.917
"7452","La Paz","El Alto","Unidad Educativa Republica de Cuba - Villa Ingenio - 2603",28,2,8,0,134,1,30,1,2,206,3,2,211,229,0.65,0.921
"7453","La Paz","El Alto","Unidad Educativa Republica de Cuba - Villa Ingenio - 2603",17,2,11,0,141,1,40,1,1,214,3,14,231,231,0.659,1
"7454","La Paz","El Alto","Unidad Educativa Republica de Cuba - Villa Ingenio - 2603",13,0,10,0,155,2,33,0,0,213,3,8,224,235,0.728,0.953
"7455","La Paz","El Alto","Unidad Educativa Republica de Cuba - Villa Ingenio - 2603",24,0,15,0,125,5,36,0,1,206,5,14,225,233,0.607,0.966
"7456","La Paz","El Alto","Unidad Educativa Republica de Cuba - Villa Ingenio - 2603",37,0,7,0,101,2,42,1,7,197,4,10,211,229,0.513,0.921
"7457","La Paz","El Alto","Unidad Educativa Republica de Cuba - Villa Ingenio - 2603",28,4,5,0,131,5,36,1,3,213,4,7,224,230,0.615,0.974
"7458","La Paz","El Alto","Unidad Educativa Republica de Cuba - Villa Ingenio - 2603",13,2,10,2,138,2,36,2,3,208,5,9,222,230,0.663,0.965
"7459","La Paz","El Alto","Unidad Educativa Republica de Cuba - Villa Ingenio - 2603",14,0,10,0,151,4,29,0,3,211,4,3,218,233,0.716,0.936
"7460","La Paz","El Alto","Unidad Educativa Republica de Cuba - Villa Ingenio - 2603",22,3,11,0,132,3,28,0,7,206,1,9,216,227,0.641,0.952
"7461","La Paz","El Alto","Unidad Educativa Republica de Cuba - Villa Ingenio - 2603",19,1,18,0,129,2,37,0,2,208,3,11,222,230,0.62,0.965
"7462","La Paz","El Alto","Unidad Educativa Republica de Cuba - Villa Ingenio - 2603",21,1,8,1,136,2,40,1,1,211,6,5,222,232,0.645,0.957
"7463","La Paz","El Alto","Unidad Educativa Republica de Cuba - Villa Ingenio - 2603",24,1,5,1,133,4,34,0,1,203,4,4,211,225,0.655,0.938
"7464","La Paz","El Alto","Unidad Educativa Republica de Cuba - Villa Ingenio - 2603",18,1,11,0,127,3,44,0,3,207,5,12,224,231,0.614,0.97
"7465","La Paz","El Alto","Unidad Educativa Republica de Cuba - Villa Ingenio - 2603",19,0,7,2,142,2,34,0,2,208,1,7,216,227,0.683,0.952
"7466","La Paz","El Alto","Unidad Educativa Republica de Cuba - Villa Ingenio - 2603",22,2,9,0,132,4,31,0,3,203,4,15,222,238,0.65,0.933
"7467","La Paz","El Alto","Unidad Educativa Republica de Cuba - Villa Ingenio - 2603",23,1,8,0,145,3,27,1,5,213,0,8,221,230,0.681,0.961
"7468","La Paz","El Alto","Unidad Educativa Republica de Cuba - Villa Ingenio - 2603",13,3,13,0,136,2,44,0,2,213,2,7,222,234,0.638,0.949
"7469","La Paz","El Alto","Unidad Educativa Republica de Cuba - Villa Ingenio - 2603",25,0,10,0,132,3,34,1,1,206,8,7,221,235,0.641,0.94
"7470","La Paz","El Alto","Unidad Educativa Republica de Cuba - Villa Ingenio - 2603",13,1,9,0,150,1,33,0,3,210,4,6,220,235,0.714,0.936
"7471","La Paz","El Alto","Unidad Educativa Republica de Cuba - Villa Ingenio - 2603",25,1,8,2,145,2,30,0,2,215,1,7,223,234,0.674,0.953
"7472","La Paz","El Alto","Unidad Educativa Eduardo Avaroa I",11,1,5,6,159,2,13,0,3,200,3,15,218,225,0.795,0.969
"7473","La Paz","El Alto","Unidad Educativa Eduardo Avaroa I",10,2,6,2,156,4,17,0,1,198,9,10,217,224,0.788,0.969
"7474","La Paz","El Alto","Unidad Educativa Eduardo Avaroa I",12,0,8,0,150,2,22,1,3,198,6,11,215,227,0.758,0.947
"7475","La Paz","Achacachi","Esc. Simon Boliviar",48,8,18,3,56,3,51,1,3,191,7,4,202,224,0.293,0.902
"7476","La Paz","Achacachi","Esc. Simon Boliviar",53,9,17,2,61,6,40,1,1,190,7,6,203,223,0.321,0.91
"7477","La Paz","Achacachi","Esc. Simon Boliviar",35,5,26,2,66,7,28,0,4,173,8,23,204,215,0.382,0.949
"7478","La Paz","Achacachi","Esc. Simon Boliviar",50,6,19,3,86,7,23,0,1,195,2,10,207,219,0.441,0.945
"7479","La Paz","Achacachi","Esc. Simon Boliviar",39,8,23,4,68,8,32,1,2,185,4,13,202,221,0.368,0.914
"7480","La Paz","Achacachi","Esc. Simon Boliviar",40,2,23,2,60,1,28,0,3,159,12,18,189,210,0.377,0.9
"7481","La Paz","Achacachi","Esc. Simon Boliviar",47,9,16,3,72,5,36,1,3,192,4,14,210,227,0.375,0.925
"7482","La Paz","Achacachi","Esc. Simon Boliviar",50,7,23,0,56,2,35,0,6,179,5,12,196,215,0.313,0.912
"7483","La Paz","Achacachi","Esc. Simon Boliviar",49,2,24,1,66,5,19,2,3,171,4,18,193,219,0.386,0.881
"7484","La Paz","Achacachi","Esc. Simon Boliviar",49,2,30,1,62,5,20,0,2,171,10,12,193,220,0.363,0.877
"7485","La Paz","Achacachi","Esc. Simon Boliviar",48,4,26,3,57,3,28,0,1,170,9,13,192,211,0.335,0.91
"7486","La Paz","Achacachi","Esc. Simon Boliviar",53,4,21,1,53,4,39,0,4,179,7,18,204,221,0.296,0.923
"7487","La Paz","Achacachi","Esc. Simon Boliviar",57,5,14,1,73,4,26,1,2,183,6,18,207,227,0.399,0.912
"7488","La Paz","Achacachi","Esc. Simon Boliviar",48,4,15,3,61,4,33,2,7,177,3,14,194,220,0.345,0.882
"7489","La Paz","Achacachi","Colegio Mariscal Santa Cruz",41,5,13,1,61,8,35,1,1,166,7,9,182,214,0.367,0.85
"7490","La Paz","Achacachi","Colegio Mariscal Santa Cruz",62,3,12,0,59,3,35,0,1,175,3,16,194,221,0.337,0.878
"7491","La Paz","Achacachi","Colegio Mariscal Santa Cruz",56,5,13,1,70,3,36,1,4,189,4,10,203,223,0.37,0.91
"7492","La Paz","Achacachi","Colegio Mariscal Santa Cruz",41,7,21,2,64,2,31,1,3,172,5,13,190,214,0.372,0.888
"7493","La Paz","Achacachi","Colegio Mariscal Santa Cruz",50,4,16,0,71,0,29,0,3,173,9,10,192,215,0.41,0.893
"7494","La Paz","Achacachi","Colegio Mariscal Santa Cruz",59,3,23,1,69,5,22,0,3,185,7,8,200,217,0.373,0.922
"7495","La Paz","Achacachi","Colegio Mariscal Santa Cruz",57,4,19,1,52,6,24,0,1,164,6,9,179,210,0.317,0.852
"7496","La Paz","Achacachi","Colegio Mariscal Santa Cruz",63,3,16,1,68,2,34,0,2,189,8,11,208,227,0.36,0.916
"7497","La Paz","Achacachi","Colegio Mariscal Santa Cruz",56,6,9,1,63,4,41,1,3,184,2,18,204,220,0.342,0.927
"7498","La Paz","Achacachi","Colegio Mariscal Santa Cruz",62,2,12,6,72,2,29,1,2,188,0,12,200,222,0.383,0.901
"7499","La Paz","Achacachi","Colegio Mariscal Santa Cruz",56,5,16,3,58,3,40,0,3,184,5,14,203,227,0.315,0.894
"7500","La Paz","Achacachi","Colegio Mariscal Santa Cruz",46,4,21,0,60,3,37,1,5,177,3,15,195,217,0.339,0.899
"7501","La Paz","Achacachi","Colegio Mariscal Santa Cruz",58,3,21,1,54,5,38,0,3,183,6,8,197,225,0.295,0.876
"7502","La Paz","Achacachi","Colegio Mariscal Santa Cruz",58,2,15,0,72,0,24,0,0,171,5,16,192,213,0.421,0.901
"7503","La Paz","Achacachi","Colegio Mariscal Santa Cruz",37,9,16,1,57,3,31,0,3,157,8,22,187,212,0.363,0.882
"7504","La Paz","Achacachi","Colegio Mariscal Santa Cruz",67,5,18,3,58,1,35,1,3,191,2,13,206,227,0.304,0.907
"7505","La Paz","Achacachi","Colegio Mariscal Santa Cruz",75,1,11,2,50,4,35,0,4,182,5,14,201,228,0.275,0.882
"7506","La Paz","Achacachi","Colegio Mariscal Santa Cruz",67,1,12,2,58,4,39,1,3,187,0,9,196,220,0.31,0.891
"7507","La Paz","Achacachi","Colegio Mariscal Santa Cruz",48,6,14,2,83,3,26,1,0,183,6,11,200,225,0.454,0.889
"7508","La Paz","Achacachi","Colegio Omasuyos",28,7,20,0,64,1,45,3,1,169,10,15,194,221,0.379,0.878
"7509","La Paz","Achacachi","Colegio Omasuyos",48,2,13,1,88,3,28,1,0,184,2,10,196,223,0.478,0.879
"7510","La Paz","Achacachi","Colegio Omasuyos",51,3,24,2,57,2,36,1,2,178,6,13,197,221,0.32,0.891
"7511","La Paz","Achacachi","Colegio Omasuyos",48,3,9,1,59,1,40,1,3,165,11,11,187,222,0.358,0.842
"7512","La Paz","Achacachi","Colegio Omasuyos",52,9,13,1,59,1,29,2,0,166,10,6,182,209,0.355,0.871
"7513","La Paz","Achacachi","Colegio Omasuyos",38,6,20,1,75,4,34,3,4,185,5,10,200,222,0.405,0.901
"7514","La Paz","Achacachi","Colegio Omasuyos",56,5,24,1,62,2,33,0,1,184,5,12,201,223,0.337,0.901
"7515","La Paz","Achacachi","Colegio Omasuyos",46,4,15,1,62,3,44,2,3,180,6,11,197,221,0.344,0.891
"7516","La Paz","Achacachi","Colegio Omasuyos",45,10,15,1,74,1,33,0,0,179,8,13,200,221,0.413,0.905
"7517","La Paz","Achacachi","Colegio Omasuyos",50,6,13,1,82,4,26,0,0,182,10,15,207,223,0.451,0.928
"7518","La Paz","Achacachi","Colegio Omasuyos",54,8,14,2,60,2,33,1,2,176,4,18,198,221,0.341,0.896
"7519","La Paz","Achacachi","Colegio Omasuyos",53,4,19,1,54,4,48,0,1,184,4,12,200,224,0.293,0.893
"7520","La Paz","Achacachi","Colegio Omasuyos",46,3,20,1,66,5,31,1,3,176,5,14,195,223,0.375,0.874
"7521","La Paz","Achacachi","Colegio Omasuyos",65,6,12,0,57,6,26,0,3,175,15,9,199,226,0.326,0.881
"7522","La Paz","Achacachi","Colegio Omasuyos",44,5,16,0,69,3,28,2,1,168,9,20,197,224,0.411,0.879
"7523","La Paz","Achacachi","Colegio Omasuyos",54,3,15,1,62,5,34,0,0,174,7,13,194,223,0.356,0.87
"7524","La Paz","Achacachi","Colegio Omasuyos",56,3,16,1,59,4,32,1,1,173,7,12,192,225,0.341,0.853
"7525","La Paz","Achacachi","Colegio Omasuyos",64,3,8,2,61,5,35,0,5,183,2,14,199,220,0.333,0.905
"7526","La Paz","Achacachi","Colegio Omasuyos",51,2,21,1,60,6,28,1,4,174,6,18,198,226,0.345,0.876
"7527","La Paz","Achacachi","Colegio Omasuyos",65,11,11,1,72,3,29,1,3,196,7,8,211,229,0.367,0.921
"7528","La Paz","Achacachi","Escuela Central Casamaya",5,3,39,1,108,2,14,0,1,173,16,15,204,217,0.624,0.94
"7529","La Paz","Achacachi","Escuela Central Casamaya",5,4,33,1,88,3,17,0,0,151,6,9,166,171,0.583,0.971
"7530","La Paz","Achacachi","Colegio Antofagasta",5,2,14,2,128,1,42,0,3,197,3,6,206,221,0.65,0.932
"7531","La Paz","Achacachi","Colegio Antofagasta",14,6,13,0,121,3,27,0,2,186,10,9,205,217,0.651,0.945
"7532","La Paz","Achacachi","Colegio Antofagasta",8,4,6,2,140,3,26,0,1,190,2,7,199,211,0.737,0.943
"7533","La Paz","Achacachi","Escuela Belen",16,7,12,1,123,8,21,1,1,190,3,13,206,216,0.647,0.954
"7534","La Paz","Achacachi","Escuela Belen",13,6,21,0,111,1,19,1,3,175,11,9,195,213,0.634,0.915
"7535","La Paz","Achacachi","Colegio Simon Bolivar",3,2,10,0,114,5,33,2,1,170,8,26,204,212,0.671,0.962
"7536","La Paz","Achacachi","Colegio Simon Bolivar",4,1,16,1,120,1,26,6,1,176,13,10,199,205,0.682,0.971
"7537","La Paz","Achacachi","Escuela Apuraya",3,3,11,0,127,5,25,1,0,175,2,14,191,208,0.726,0.918
"7538","La Paz","Achacachi","Escuela Apuraya",4,1,11,3,127,2,24,2,0,174,9,16,199,210,0.73,0.948
"7539","La Paz","Achacachi","Escuela Apuraya",5,0,16,3,118,3,27,1,0,173,4,24,201,212,0.682,0.948
"7540","La Paz","Achacachi","Escuela Apuraya",3,2,18,1,99,1,34,1,3,162,6,9,177,184,0.611,0.962
"7541","La Paz","Achacachi","Escuela Villa Lipe",6,4,20,2,125,1,18,0,0,176,9,13,198,209,0.71,0.947
"7542","La Paz","Achacachi","Escuela Villa Lipe",5,2,14,1,139,2,7,0,2,172,4,8,184,196,0.808,0.939
"7543","La Paz","Achacachi","Escuela Villa Lipe",8,3,13,0,132,5,8,1,0,170,8,11,189,202,0.776,0.936
"7544","La Paz","Achacachi","U. E. Jancko Amaya ""A""",12,3,13,6,137,1,11,0,1,184,7,1,192,209,0.745,0.919
"7545","La Paz","Achacachi","U. E. Jancko Amaya ""A""",7,4,13,0,134,2,15,0,0,175,7,6,188,206,0.766,0.913
"7546","La Paz","Achacachi","U. E. Jancko Amaya ""A""",4,3,6,0,138,1,16,0,0,168,4,8,180,200,0.821,0.9
"7547","La Paz","Achacachi","U. E. Jancko Amaya ""A""",8,9,14,1,113,4,25,4,2,180,7,7,194,205,0.628,0.946
"7548","La Paz","Achacachi","Escuela Ajllata Grande",10,6,26,0,106,3,12,0,1,164,14,16,194,211,0.646,0.919
"7549","La Paz","Achacachi","Escuela Ajllata Grande",16,6,25,2,124,3,9,1,1,187,10,11,208,217,0.663,0.959
"7550","La Paz","Achacachi","Escuela Ajllata Grande",21,6,26,0,110,2,16,2,2,185,6,6,197,209,0.595,0.943
"7551","La Paz","Achacachi","Escuela Ajllata Grande",16,8,22,2,106,4,18,1,4,181,4,10,195,212,0.586,0.92
"7552","La Paz","Achacachi","Escuela Ajllata Grande",15,2,34,5,105,1,13,1,1,177,5,16,198,214,0.593,0.925
"7553","La Paz","Achacachi","Escuela Ajllata Grande",17,3,20,1,120,0,6,1,4,172,9,7,188,195,0.698,0.964
"7554","La Paz","Achacachi","Escuela Aplicacion Huarizata",14,3,13,3,105,1,30,1,5,175,16,14,205,218,0.6,0.94
"7555","La Paz","Achacachi","Escuela Aplicacion Huarizata",14,4,15,0,112,2,13,1,0,161,13,9,183,205,0.696,0.893
"7556","La Paz","Achacachi","Escuela Aplicacion Huarizata",5,2,9,0,133,1,31,1,4,186,8,11,205,219,0.715,0.936
"7557","La Paz","Achacachi","Escuela Aplicacion Huarizata",2,6,12,2,116,5,18,0,1,162,14,10,186,207,0.716,0.899
"7558","La Paz","Achacachi","Escuela Aplicacion Huarizata",15,2,13,1,127,9,17,0,3,187,6,10,203,213,0.679,0.953
"7559","La Paz","Achacachi","Escuela Aplicacion Huarizata",7,1,11,2,122,2,31,0,1,177,6,14,197,214,0.689,0.921
"7560","La Paz","Achacachi","Escuela Aplicacion Huarizata",7,1,13,0,140,0,23,0,1,185,2,14,201,213,0.757,0.944
"7561","La Paz","Achacachi","Nucleo Tacamara",9,4,34,2,120,1,7,1,2,180,12,19,211,217,0.667,0.972
"7562","La Paz","Achacachi","Nucleo Tacamara",4,3,34,1,106,1,11,0,1,161,15,23,199,214,0.658,0.93
"7563","La Paz","Achacachi","Nucleo Tacamara",3,1,36,3,118,5,9,2,0,177,9,15,201,215,0.667,0.935
"7564","La Paz","Achacachi","Nucleo Tacamara",5,8,23,0,140,1,4,0,0,181,7,24,212,224,0.773,0.946
"7565","La Paz","Achacachi","Escuela Walata Chico",1,5,20,2,104,2,27,4,1,166,9,9,184,201,0.627,0.915
"7566","La Paz","Achacachi","Nucleo Ecolar Murumamani",2,4,19,0,153,1,21,0,1,201,3,7,211,224,0.761,0.942
"7567","La Paz","Achacachi","Nucleo Ecolar Murumamani",6,6,14,1,136,5,23,0,0,191,4,12,207,216,0.712,0.958
"7568","La Paz","Achacachi","Colegio Suñasivi",5,4,13,2,113,1,12,0,1,151,7,19,177,202,0.748,0.876
"7569","La Paz","Achacachi","Colegio Suñasivi",3,3,21,1,119,4,15,1,2,169,8,6,183,204,0.704,0.897
"7570","La Paz","Achacachi","Colegio Suñasivi",11,3,16,2,122,1,19,1,0,175,1,7,183,210,0.697,0.871
"7571","La Paz","Achacachi","Colegio Franz Tamayo",2,11,21,0,111,4,23,2,2,176,12,15,203,217,0.631,0.935
"7572","La Paz","Achacachi","Colegio Franz Tamayo",8,7,15,1,110,1,21,2,3,168,11,16,195,207,0.655,0.942
"7573","La Paz","Achacachi","Colegio Franz Tamayo",11,10,14,3,108,3,29,0,1,179,8,7,194,207,0.603,0.937
"7574","La Paz","Achacachi","U. E. Jaime Escalante",6,1,55,2,97,2,16,0,0,179,17,8,204,221,0.542,0.923
"7575","La Paz","Achacachi","U. E. Jaime Escalante",6,0,43,0,125,0,15,0,1,190,10,7,207,223,0.658,0.928
"7576","La Paz","Achacachi","U. E. Jaime Escalante",7,2,58,1,87,2,13,0,0,170,4,4,178,198,0.512,0.899
"7577","La Paz","Achacachi","Nucleo Educativo Tahari",18,2,12,0,155,0,27,1,0,215,1,7,223,225,0.721,0.991
"7578","La Paz","Achacachi","Nucleo Educativo Tahari",10,0,14,2,155,0,32,0,0,213,3,10,226,235,0.728,0.962
"7579","La Paz","Achacachi","Núcleo Escolar Challuyo",5,2,23,4,137,0,20,1,0,192,17,10,219,230,0.714,0.952
"7580","La Paz","Achacachi","Núcleo Escolar Challuyo",9,3,8,2,126,3,24,0,2,177,19,10,206,229,0.712,0.9
"7581","La Paz","Villa Ancoraimes","Escuela Franz Tamayo",6,2,6,0,137,1,34,1,0,187,7,7,201,219,0.733,0.918
"7582","La Paz","Villa Ancoraimes","Escuela Franz Tamayo",5,0,12,2,109,1,51,2,0,182,3,6,191,207,0.599,0.923
"7583","La Paz","Villa Ancoraimes","Escuela Franz Tamayo",12,7,10,0,109,1,31,0,0,170,8,14,192,210,0.641,0.914
"7584","La Paz","Villa Ancoraimes","Escuela Franz Tamayo",7,5,10,3,114,4,24,0,0,167,6,18,191,213,0.683,0.897
"7585","La Paz","Villa Ancoraimes","Escuela Franz Tamayo",9,4,8,2,100,3,36,0,1,163,10,10,183,208,0.613,0.88
"7586","La Paz","Villa Ancoraimes","Escuela Franz Tamayo",5,2,8,1,124,2,23,1,3,169,5,8,182,214,0.734,0.85
"7587","La Paz","Villa Ancoraimes","U. E. Morocollo",8,2,20,2,114,2,20,0,0,168,10,14,192,212,0.679,0.906
"7588","La Paz","Villa Ancoraimes","U. E. Morocollo",7,3,14,1,139,1,20,2,0,187,1,4,192,208,0.743,0.923
"7589","La Paz","Villa Ancoraimes","U. E. Morocollo",11,2,8,4,115,7,21,2,2,172,9,18,199,215,0.669,0.926
"7590","La Paz","Villa Ancoraimes","U. E. Morocollo",5,6,9,1,119,2,18,1,1,162,15,14,191,211,0.735,0.905
"7591","La Paz","Villa Ancoraimes","Escuela Turrini",8,7,11,2,113,1,30,0,0,172,5,11,188,210,0.657,0.895
"7592","La Paz","Villa Ancoraimes","U. E. Inca Huayna Capac",9,10,10,1,133,1,20,1,0,185,4,6,195,213,0.719,0.915
"7593","La Paz","Villa Ancoraimes","Colegio Macamaca",8,7,14,1,109,2,36,2,1,180,15,16,211,221,0.606,0.955
"7594","La Paz","Villa Ancoraimes","Colegio Macamaca",4,6,13,0,147,1,30,1,0,202,2,13,217,223,0.728,0.973
"7595","La Paz","Villa Ancoraimes","Colegio Macamaca",7,8,23,3,111,2,27,0,0,181,7,15,203,210,0.613,0.967
"7596","La Paz","Villa Ancoraimes","U.E. Gualberto Villarroel",10,6,21,2,126,3,18,1,1,188,4,7,199,218,0.67,0.913
"7597","La Paz","Villa Ancoraimes","U.E. Gualberto Villarroel",6,6,18,1,120,0,14,0,0,165,11,16,192,209,0.727,0.919
"7598","La Paz","Villa Ancoraimes","U.E. Gualberto Villarroel",6,8,21,2,113,1,20,1,1,173,10,14,197,213,0.653,0.925
"7599","La Paz","Villa Ancoraimes","U.E. Gualberto Villarroel",3,6,17,1,127,0,16,2,0,172,6,9,187,205,0.738,0.912
"7600","La Paz","Villa Ancoraimes","U.E. Gualberto Villarroel",7,3,19,1,116,2,11,1,0,160,3,7,170,183,0.725,0.929
"7601","La Paz","Villa Ancoraimes","Colegio Cajiata",3,9,3,0,140,2,20,0,0,177,3,10,190,203,0.791,0.936
"7602","La Paz","Villa Ancoraimes","Escuela Sotalaya",5,7,3,0,159,0,13,0,0,187,6,6,199,214,0.85,0.93
"7603","La Paz","Villa Ancoraimes","Tec. Humanista Pocoata Grande",7,6,17,2,118,5,10,0,0,165,10,16,191,213,0.715,0.897
"7604","La Paz","Villa Ancoraimes","Tec. Humanista Pocoata Grande",5,4,12,1,115,0,27,1,4,169,20,19,208,218,0.68,0.954
"7605","La Paz","Villa Ancoraimes","Tec. Humanista Pocoata Grande",9,6,13,3,121,3,35,2,2,194,10,14,218,228,0.624,0.956
"7606","La Paz","Chua Cocani","Unidad Educativa Compi",11,2,9,1,139,3,15,1,2,183,7,9,199,209,0.76,0.952
"7607","La Paz","Chua Cocani","Unidad Educativa Compi",13,1,7,0,134,1,16,2,0,174,6,8,188,205,0.77,0.917
"7608","La Paz","Chua Cocani","Unidad Educativa Compi",13,0,8,2,140,1,13,1,2,180,3,3,186,199,0.778,0.935
"7609","La Paz","Chua Cocani","U. E. Pedro Domingo Murillo",15,4,18,2,108,1,23,2,2,175,4,4,183,207,0.617,0.884
"7610","La Paz","Chua Cocani","U. E. Pedro Domingo Murillo",18,3,8,1,120,1,25,1,2,179,1,12,192,212,0.67,0.906
"7611","La Paz","Chua Cocani","Escuela Corpachilaya",14,0,11,3,106,1,25,0,2,162,2,2,166,179,0.654,0.927
"7612","La Paz","Chua Cocani","Escuela Chua Cocani",4,0,10,1,134,3,20,0,3,175,2,9,186,221,0.766,0.842
"7613","La Paz","Chua Cocani","Escuela Chua Cocani",8,1,8,1,125,4,30,2,2,181,5,2,188,218,0.691,0.862
"7614","La Paz","Chua Cocani","Escuela Chua Cocani",12,1,9,2,111,2,27,1,3,168,1,13,182,219,0.661,0.831
"7615","La Paz","Chua Cocani","Escuela Chua Cocani",16,3,3,1,116,0,26,0,1,166,1,10,177,206,0.699,0.859
"7616","La Paz","Huarina","Escuela Mariscal De Santa Cruz",26,1,10,1,119,1,16,0,4,178,2,9,189,206,0.669,0.917
"7617","La Paz","Huarina","Escuela Mariscal De Santa Cruz",24,3,15,4,110,1,21,2,2,182,2,6,190,214,0.604,0.888
"7618","La Paz","Huarina","Escuela Mariscal De Santa Cruz",10,3,17,3,119,2,9,1,2,166,12,3,181,196,0.717,0.923
"7619","La Paz","Huarina","Escuela Mariscal De Santa Cruz",16,6,16,3,112,2,11,1,3,170,8,7,185,204,0.659,0.907
"7620","La Paz","Huarina","Escuela Mariscal De Santa Cruz",20,0,13,2,127,2,8,0,2,174,6,6,186,209,0.73,0.89
"7621","La Paz","Huarina","Escuela Mariscal De Santa Cruz",22,2,18,3,97,1,11,1,0,155,5,23,183,200,0.626,0.915
"7622","La Paz","Huarina","Escuela Mariscal De Santa Cruz",24,2,15,2,100,4,17,1,6,171,6,4,181,207,0.585,0.874
"7623","La Paz","Huarina","Escuela Mariscal De Santa Cruz",6,0,19,0,126,2,13,0,4,170,0,9,179,200,0.741,0.895
"7624","La Paz","Huarina","Escuela Mariscal De Santa Cruz",16,2,17,2,120,1,15,0,1,174,6,9,189,216,0.69,0.875
"7625","La Paz","Huarina","Escuela Mariscal De Santa Cruz",13,1,15,1,133,0,14,1,1,179,8,5,192,210,0.743,0.914
"7626","La Paz","Huarina","Escuela Mariscal De Santa Cruz",18,2,16,1,130,2,14,0,2,185,2,7,194,213,0.703,0.911
"7627","La Paz","Huarina","Escuela Bernabe Ledezma",17,1,34,0,98,2,26,3,2,183,3,8,194,211,0.536,0.919
"7628","La Paz","Huarina","Escuela Bernabe Ledezma",8,1,37,0,117,1,18,0,1,183,6,5,194,212,0.639,0.915
"7629","La Paz","Huarina","Escuela Bernabe Ledezma",14,0,50,2,95,6,17,0,2,186,7,10,203,214,0.511,0.949
"7630","La Paz","Huarina","Escuela Unidad Educativa Coromata Baja",9,1,29,1,131,5,10,0,3,189,8,4,201,217,0.693,0.926
"7631","La Paz","Huarina","Escuela Unidad Educativa Coromata Baja",10,0,18,0,113,2,9,1,0,153,4,6,163,175,0.739,0.931
"7632","La Paz","Huarina","Escuela Apuvillque Morocollo",8,2,9,2,114,2,21,1,2,161,4,10,175,191,0.708,0.916
"7633","La Paz","Huarina","U.E. Copancara",15,1,9,0,130,0,4,0,0,159,4,13,176,205,0.818,0.859
"7634","La Paz","Huarina","U.E. Copancara",16,1,7,1,150,0,9,0,1,185,4,11,200,213,0.811,0.939
"7635","La Paz","Santiago de Huata","Colegio Santiago De Huata",15,7,16,2,116,0,16,1,1,174,13,10,197,207,0.667,0.952
"7636","La Paz","Santiago de Huata","Colegio Santiago De Huata",15,4,9,1,124,0,23,2,1,179,3,12,194,214,0.693,0.907
"7637","La Paz","Santiago de Huata","Colegio Santiago De Huata",13,8,23,1,110,1,9,0,3,168,9,14,191,213,0.655,0.897
"7638","La Paz","Santiago de Huata","Colegio Santiago De Huata",18,9,7,1,110,0,17,1,2,165,7,11,183,207,0.667,0.884
"7639","La Paz","Santiago de Huata","Colegio Santiago De Huata",17,0,15,3,105,1,15,2,2,160,12,18,190,204,0.656,0.931
"7640","La Paz","Santiago de Huata","Colegio Santiago De Huata",12,6,11,0,112,3,19,1,2,166,5,11,182,204,0.675,0.892
"7641","La Paz","Santiago de Huata","Colegio Santiago De Huata",16,8,14,0,94,3,15,0,2,152,8,14,174,202,0.618,0.861
"7642","La Paz","Santiago de Huata","Colegio Santiago De Huata",10,9,14,1,119,2,11,0,0,166,7,13,186,207,0.717,0.899
"7643","La Paz","Santiago de Huata","Colegio Santiago De Huata",13,2,13,2,123,3,21,0,1,178,6,5,189,207,0.691,0.913
"7644","La Paz","Santiago de Huata","Colegio Central Porejoni",5,5,9,2,125,1,12,2,1,162,8,5,175,192,0.772,0.911
"7645","La Paz","Santiago de Huata","U. E. Kalaque",9,2,22,1,128,3,9,0,0,174,1,5,180,194,0.736,0.928
"7646","La Paz","Santiago de Huata","U. E. Kalaque",3,1,20,2,138,2,5,0,0,171,7,6,184,209,0.807,0.88
"7647","La Paz","Santiago de Huata","U. E. Kalaque",6,0,13,0,140,1,19,1,0,180,10,6,196,210,0.778,0.933
"7648","La Paz","Santiago de Huata","Escuela Watari",6,1,12,2,111,3,12,2,2,151,5,19,175,192,0.735,0.911
"7649","La Paz","Santiago de Huata","Escuela Watari",4,10,7,1,130,1,19,0,0,172,3,6,181,199,0.756,0.91
"7650","La Paz","Santiago de Huata","Escuela Watari",6,10,18,2,103,0,14,1,0,154,2,5,161,173,0.669,0.931
"7651","La Paz","Huatajata","Colegio Nacional Mixto Huatajata",18,3,17,2,103,0,26,2,1,172,4,5,181,204,0.599,0.887
"7652","La Paz","Huatajata","Colegio Nacional Mixto Huatajata",26,5,17,4,101,2,22,3,0,180,3,5,188,202,0.561,0.931
"7653","La Paz","Huatajata","Colegio Nacional Mixto Huatajata",16,1,22,0,114,4,13,1,1,172,1,4,177,194,0.663,0.912
"7654","La Paz","Huatajata","Colegio Nacional Mixto Huatajata",36,3,29,3,90,2,13,0,1,177,8,4,189,201,0.508,0.94
"7655","La Paz","Huatajata","Colegio Nacional Mixto Huatajata",16,5,20,1,114,2,14,2,1,175,4,10,189,202,0.651,0.936
"7656","La Paz","Huatajata","Colegio Nacional Mixto Huatajata",21,4,16,2,109,1,19,0,4,176,4,11,191,204,0.619,0.936
"7657","La Paz","Huatajata","Colegio Nacional Mixto Huatajata",29,2,18,1,111,2,17,0,3,183,4,4,191,210,0.607,0.91
"7658","La Paz","Huatajata","Escuela Sanca Jahuira",14,1,19,3,116,2,15,2,1,173,2,9,184,200,0.671,0.92
"7659","La Paz","Corocoro","Esc. Vicenta Juariste Eguino",31,1,3,1,130,0,7,0,1,174,2,4,180,222,0.747,0.811
"7660","La Paz","Corocoro","Esc. Vicenta Juariste Eguino",27,0,5,0,140,2,7,0,0,181,5,8,194,227,0.773,0.855
"7661","La Paz","Corocoro","Esc. Vicenta Juariste Eguino",21,3,3,0,137,1,7,0,0,172,3,7,182,214,0.797,0.85
"7662","La Paz","Corocoro","Esc. Vicenta Juariste Eguino",22,1,0,0,143,2,12,0,0,180,0,2,182,220,0.794,0.827
"7663","La Paz","Corocoro","Esc. Vicenta Juariste Eguino",17,0,3,0,141,5,6,0,3,175,1,7,183,222,0.806,0.824
"7664","La Paz","Corocoro","Esc. Vicenta Juariste Eguino",24,1,4,0,123,2,19,1,0,174,2,4,180,222,0.707,0.811
"7665","La Paz","Corocoro","Esc. Vicenta Juariste Eguino",20,1,5,0,132,1,12,1,1,173,1,6,180,220,0.763,0.818
"7666","La Paz","Corocoro","Casa de  Gobierno",10,2,5,0,154,1,23,0,0,195,2,3,200,213,0.79,0.939
"7667","La Paz","Corocoro","Esc. Topohoco",8,2,21,1,142,2,13,1,0,190,3,8,201,220,0.747,0.914
"7668","La Paz","Corocoro","Esc. Pedro Domingo Murillo",4,0,13,1,171,1,6,0,0,196,5,6,207,217,0.872,0.954
"7669","La Paz","Corocoro","Nucleo Esc. Central Enequella",4,1,8,0,163,0,13,2,0,191,3,11,205,221,0.853,0.928
"7670","La Paz","Corocoro","Colegio Jose Manuel Pando",11,0,10,0,161,2,11,1,0,196,2,2,200,221,0.821,0.905
"7671","La Paz","Corocoro","Colegio Jose Manuel Pando",11,1,11,1,141,2,26,1,1,195,0,6,201,218,0.723,0.922
"7672","La Paz","Corocoro","U.E Janko Marca Sirpa",6,1,17,3,124,3,16,0,0,170,2,2,174,204,0.729,0.853
"7673","La Paz","Corocoro","U.E. Santiago De Quilloma",0,3,6,2,155,1,9,0,0,176,6,10,192,216,0.881,0.889
"7674","La Paz","Corocoro","U.E. Elizardo Pérez",14,2,8,0,128,1,10,1,0,164,4,8,176,207,0.78,0.85
"7675","La Paz","Corocoro","Esc. Seccional Anco Aque",6,5,13,2,134,3,28,3,0,194,9,17,220,225,0.691,0.978
"7676","La Paz","Caquiaviri","Esc. Caquiaviri",14,2,15,1,128,2,10,0,0,172,3,10,185,212,0.744,0.873
"7677","La Paz","Caquiaviri","Esc. Caquiaviri",2,1,8,0,144,2,5,1,1,164,2,13,179,213,0.878,0.84
"7678","La Paz","Caquiaviri","Esc. Caquiaviri",11,3,5,1,139,1,9,2,1,172,2,3,177,211,0.808,0.839
"7679","La Paz","Caquiaviri","Esc. Caquiaviri",15,1,13,0,132,1,10,1,0,173,4,10,187,213,0.763,0.878
"7680","La Paz","Caquiaviri","Esc. Caquiaviri",12,5,15,1,128,1,3,0,1,166,4,8,178,204,0.771,0.873
"7681","La Paz","Caquiaviri","Esc. Achiri",13,3,14,1,117,0,10,1,1,160,5,6,171,197,0.731,0.868
"7682","La Paz","Caquiaviri","Esc. Achiri",9,0,12,0,124,2,4,0,0,151,2,13,166,203,0.821,0.818
"7683","La Paz","Caquiaviri","Esc. Achiri",8,1,12,0,130,0,7,0,1,159,4,10,173,212,0.818,0.816
"7684","La Paz","Caquiaviri","Nucleo Escolar Vichaya",12,1,11,0,140,4,21,0,2,191,4,8,203,220,0.733,0.923
"7685","La Paz","Caquiaviri","Esc. Jihuacuta",4,2,4,1,135,0,5,0,1,152,5,11,168,191,0.888,0.88
"7686","La Paz","Caquiaviri","Esc. Antaquira Villa Belen",7,0,8,1,127,6,15,2,1,167,5,6,178,206,0.76,0.864
"7687","La Paz","Caquiaviri","Esc. Villa Chocorosi",19,0,34,1,110,2,20,0,0,186,3,7,196,214,0.591,0.916
"7688","La Paz","Caquiaviri","Esc. Central",7,2,6,1,139,16,2,0,0,173,7,12,192,211,0.803,0.91
"7689","La Paz","Caquiaviri","U.E. Mcal. Sucre",1,0,7,1,149,0,13,1,0,172,5,13,190,213,0.866,0.892
"7690","La Paz","Caquiaviri","U.E. Kasillunca",7,3,12,3,133,2,12,1,0,173,5,4,182,199,0.769,0.915
"7691","La Paz","Calacoto","Esc. Pablo Lavadens",21,0,8,0,142,3,6,0,0,180,1,5,186,209,0.789,0.89
"7692","La Paz","Calacoto","Esc. Pablo Lavadens",8,1,21,1,122,1,7,1,0,162,6,11,179,203,0.753,0.882
"7693","La Paz","Calacoto","Col. Camacho",21,2,3,0,127,0,5,1,1,160,2,8,170,214,0.794,0.794
"7694","La Paz","Calacoto","U.E. Simón Bolívar de Audiencia",11,1,11,0,160,0,9,0,0,192,3,3,198,212,0.833,0.934
"7695","La Paz","Calacoto","U.E. Simón Bolívar de Audiencia",3,1,18,1,134,1,4,0,0,162,2,6,170,188,0.827,0.904
"7696","La Paz","Calacoto","Escuela Playa Verde",5,2,15,0,144,1,6,1,0,174,10,6,190,202,0.828,0.941
"7697","La Paz","Calacoto","Col. Antofagasta",7,1,10,2,138,5,5,0,0,168,2,12,182,190,0.821,0.958
"7698","La Paz","Calacoto","Esc. Ulloma",14,0,18,2,131,1,15,0,0,181,0,0,181,200,0.724,0.905
"7699","La Paz","Calacoto","Esc. N. Lerco",9,2,14,0,118,1,8,0,1,153,5,7,165,194,0.771,0.851
"7700","La Paz","Calacoto","Colegio Franz Tamayo",5,2,20,2,136,1,4,1,0,171,5,6,182,202,0.795,0.901
"7701","La Paz","Comanche","Colegio Comanche",9,4,12,0,153,2,8,0,3,191,3,3,197,213,0.801,0.925
"7702","La Paz","Comanche","Colegio Comanche",9,1,13,1,149,2,14,1,0,190,6,6,202,222,0.784,0.91
"7703","La Paz","Comanche","Colegio Comanche",16,1,17,2,122,3,11,0,1,173,6,10,189,213,0.705,0.887
"7704","La Paz","Comanche","Colegio Comanche",7,2,15,1,139,0,13,0,1,178,1,6,185,214,0.781,0.864
"7705","La Paz","Comanche","Colegio Comanche",9,1,13,0,140,2,10,1,0,176,3,7,186,206,0.795,0.903
"7706","La Paz","Comanche","U.E. José Ballivian",11,0,11,0,121,3,7,1,2,156,1,4,161,179,0.776,0.899
"7707","La Paz","Comanche","Col. Tocopilla Cantuyo",3,1,18,0,148,2,13,1,0,186,2,3,191,201,0.796,0.95
"7708","La Paz","Charaña","Colegio Eduardo Avaroa",45,1,12,2,74,1,19,0,4,158,6,11,175,224,0.468,0.781
"7709","La Paz","Charaña","Colegio Eduardo Avaroa",55,1,12,1,67,2,15,5,3,161,5,11,177,223,0.416,0.794
"7710","La Paz","Waldo Ballivian","U.E. Antofagasta",7,0,23,0,140,1,14,0,0,185,2,20,207,221,0.757,0.937
"7711","La Paz","Waldo Ballivian","U.E. Antofagasta",3,0,24,2,138,2,25,0,0,194,0,13,207,216,0.711,0.958
"7712","La Paz","Waldo Ballivian","U.E. Antofagasta",2,1,17,2,142,1,23,1,0,189,4,12,205,213,0.751,0.962
"7713","La Paz","Waldo Ballivian","U.E. Antofagasta",9,1,19,2,147,0,17,0,0,195,6,11,212,223,0.754,0.951
"7714","La Paz","Waldo Ballivian","U.E. Antofagasta",4,0,28,2,150,1,12,0,0,197,2,11,210,221,0.761,0.95
"7715","La Paz","Nazacara de Pacajes","U.E. Nazacara",5,0,6,1,134,1,15,0,1,163,3,7,173,210,0.822,0.824
"7716","La Paz","Santiago de Callapa","U.E. Nacional Santiago de Callapa",12,0,16,0,111,3,11,2,1,156,6,5,167,199,0.712,0.839
"7717","La Paz","Santiago de Callapa","Esc. N. Canuhuta",8,3,11,0,147,3,13,1,0,186,2,1,189,214,0.79,0.883
"7718","La Paz","Santiago de Callapa","U.E. Nacional De Calteca",11,0,7,1,146,2,14,2,1,184,12,10,206,219,0.793,0.941
"7719","La Paz","Santiago de Callapa","P. S. Francisco Yaribay",7,2,14,1,144,1,7,0,0,176,1,4,181,210,0.818,0.862
"7720","La Paz","Santiago de Callapa","Escuela Romero Pampa",18,2,14,1,110,3,15,1,0,164,10,13,187,195,0.671,0.959
"7721","La Paz","Santiago de Callapa","U.E. Villa Puchuni",8,3,26,0,98,3,14,0,1,153,2,7,162,173,0.641,0.936
"7722","La Paz","Santiago de Callapa","Col. Tecnico Humanistico Tupac Amaru",17,1,12,2,122,2,9,0,0,165,7,8,180,211,0.739,0.853
"7723","La Paz","Puerto Acosta","Col. Nicolas Acosta",23,1,15,1,80,4,29,3,2,158,4,16,178,201,0.506,0.886
"7724","La Paz","Puerto Acosta","Col. Nicolas Acosta",13,0,27,2,93,2,24,1,2,164,11,10,185,201,0.567,0.92
"7725","La Paz","Puerto Acosta","Col. Nicolas Acosta",12,1,24,2,86,3,37,1,1,167,10,9,186,203,0.515,0.916
"7726","La Paz","Puerto Acosta","Col. Nicolas Acosta",25,0,13,0,95,2,34,2,1,172,4,18,194,212,0.552,0.915
"7727","La Paz","Puerto Acosta","Col. Nicolas Acosta",17,2,24,2,78,2,29,0,2,156,7,15,178,202,0.5,0.881
"7728","La Paz","Puerto Acosta","Col. Nicolas Acosta",17,1,21,1,83,1,30,1,1,156,5,14,175,207,0.532,0.845
"7729","La Paz","Puerto Acosta","Esc. Puerto Belen",7,2,9,0,149,0,15,1,4,187,8,9,204,211,0.797,0.967
"7730","La Paz","Puerto Acosta","Esc. Puerto Belen",11,1,9,0,119,0,12,0,7,159,5,3,167,174,0.748,0.96
"7731","La Paz","Puerto Acosta","Esc. Cota Pata",10,2,7,3,116,1,18,0,1,158,8,12,178,196,0.734,0.908
"7732","La Paz","Puerto Acosta","Esc. Jupani",2,4,9,1,110,6,26,1,1,160,12,21,193,214,0.688,0.902
"7733","La Paz","Puerto Acosta","U.E. Iquipuni",7,1,22,2,122,1,19,1,1,176,6,4,186,196,0.693,0.949
"7734","La Paz","Puerto Acosta","U.E. Iquipuni",13,4,17,0,110,1,14,0,1,160,4,10,174,187,0.688,0.93
"7735","La Paz","Puerto Acosta","U.E. Iquipuni",11,2,30,0,110,1,14,0,13,181,1,5,187,190,0.608,0.984
"7736","La Paz","Puerto Acosta","Colegio Nacional Mixto Chiñaya",6,2,12,4,110,2,14,1,2,153,22,8,183,202,0.719,0.906
"7737","La Paz","Puerto Acosta","Colegio Nacional Sallacucho",4,1,8,1,160,1,10,2,0,187,2,10,199,218,0.856,0.913
"7738","La Paz","Puerto Acosta","U.E. Parajachi II",3,1,8,1,168,4,24,2,2,213,13,0,226,235,0.789,0.962
"7739","La Paz","Puerto Acosta","U.E. Pococata",5,1,4,0,162,1,28,0,0,201,1,21,223,231,0.806,0.965
"7740","La Paz","Mocomoco","U.E. Eliodoro Camacho de Mocomoco",9,4,19,2,111,1,8,1,1,156,24,12,192,211,0.712,0.91
"7741","La Paz","Mocomoco","U.E. Eliodoro Camacho de Mocomoco",13,6,17,1,101,1,21,1,0,161,12,12,185,212,0.627,0.873
"7742","La Paz","Mocomoco","U.E. Eliodoro Camacho de Mocomoco",14,2,18,3,103,2,5,5,1,153,15,14,182,206,0.673,0.883
"7743","La Paz","Mocomoco","Unidad Educativa Italaque",4,3,16,2,113,1,12,1,1,153,16,11,180,204,0.739,0.882
"7744","La Paz","Mocomoco","Unidad Educativa Italaque",7,3,18,1,112,3,11,1,1,157,10,14,181,205,0.713,0.883
"7745","La Paz","Mocomoco","Nucleo Escolar Pumana",12,0,13,2,112,1,14,0,0,154,12,34,200,217,0.727,0.922
"7746","La Paz","Mocomoco","Esc. Tuntunani",2,2,4,0,155,1,17,0,0,181,11,5,197,227,0.856,0.868
"7747","La Paz","Mocomoco","Col. Tajani",10,2,15,2,115,4,13,1,3,165,6,7,178,202,0.697,0.881
"7748","La Paz","Mocomoco","Col. Tajani",4,2,4,3,133,1,16,1,5,169,7,8,184,199,0.787,0.925
"7749","La Paz","Mocomoco","Esc. Unidad Educativa Pacaures",1,1,11,1,161,2,4,3,1,185,4,6,195,201,0.87,0.97
"7750","La Paz","Mocomoco","Esc. Unidad Educativa Pacaures",1,2,12,1,127,2,10,2,0,157,9,23,189,205,0.809,0.922
"7751","La Paz","Mocomoco","Col. San Luis Wila Cala",11,0,13,0,139,1,10,1,2,177,5,10,192,208,0.785,0.923
"7752","La Paz","Mocomoco","Col. San Luis Wila Cala",9,0,14,0,129,0,18,1,8,179,6,13,198,218,0.721,0.908
"7753","La Paz","Mocomoco","Col. San Luis Wila Cala",7,1,10,0,139,2,19,1,1,180,5,10,195,209,0.772,0.933
"7754","La Paz","Mocomoco","Col. San Jose",3,1,8,0,150,2,21,0,0,185,11,9,205,213,0.811,0.962
"7755","La Paz","Mocomoco","U.E. Ilave",6,0,6,0,141,4,11,0,0,168,18,5,191,212,0.839,0.901
"7756","La Paz","Mocomoco","U.E. Ilave",7,4,6,1,143,1,15,1,0,178,12,6,196,219,0.803,0.895
"7757","La Paz","Mocomoco","Esc. Quillima",5,3,11,2,134,1,27,2,0,185,4,8,197,211,0.724,0.934
"7758","La Paz","Mocomoco","Esc. Quillima",13,3,5,1,154,1,10,0,0,187,4,5,196,203,0.824,0.966
"7759","La Paz","Mocomoco","Colegio Tecnico Yocarguaya",6,2,5,1,124,4,25,0,0,167,21,5,193,219,0.743,0.881
"7760","La Paz","Mocomoco","Unidad Educativa Queñi",5,2,30,2,93,1,22,0,0,155,21,15,191,219,0.6,0.872
"7761","La Paz","Mocomoco","Núcleo Escolar Taypi Ayca",4,0,5,2,142,0,8,0,0,161,5,6,172,184,0.882,0.935
"7762","La Paz","Puerto Mayor de Carabuco","Colegio Martin Cardenas",23,5,18,0,83,3,34,0,2,168,7,11,186,217,0.494,0.857
"7763","La Paz","Puerto Mayor de Carabuco","Colegio Martin Cardenas",18,1,10,0,111,2,24,1,2,169,4,4,177,221,0.657,0.801
"7764","La Paz","Puerto Mayor de Carabuco","Colegio Martin Cardenas",18,3,8,1,109,1,33,0,4,177,1,7,185,206,0.616,0.898
"7765","La Paz","Puerto Mayor de Carabuco","Colegio Martin Cardenas",21,3,10,1,90,1,28,0,1,155,6,18,179,212,0.581,0.844
"7766","La Paz","Puerto Mayor de Carabuco","Colegio Martin Cardenas",28,0,10,1,90,5,27,1,3,165,9,10,184,207,0.545,0.889
"7767","La Paz","Puerto Mayor de Carabuco","Colegio Martin Cardenas",27,3,12,0,85,5,25,0,0,157,9,16,182,210,0.541,0.867
"7768","La Paz","Puerto Mayor de Carabuco","Centro de Orientación Sisasani",5,1,11,2,123,2,21,0,0,165,11,13,189,210,0.745,0.9
"7769","La Paz","Puerto Mayor de Carabuco","Centro de Orientación Sisasani",8,2,8,1,122,1,23,0,1,166,8,11,185,204,0.735,0.907
"7770","La Paz","Puerto Mayor de Carabuco","Esc. S. M. De Yaricoa",2,1,5,4,134,0,10,2,0,158,14,21,193,209,0.848,0.923
"7771","La Paz","Puerto Mayor de Carabuco","Esc. Mcal. Sucre",9,3,9,2,135,0,6,0,0,164,4,20,188,220,0.823,0.855
"7772","La Paz","Puerto Mayor de Carabuco","Esc. Mcal. Sucre",14,4,9,3,123,1,6,0,0,160,9,10,179,211,0.769,0.848
"7773","La Paz","Puerto Mayor de Carabuco","U. E. Copusquia ""A""",2,5,12,0,158,2,18,0,1,198,2,7,207,219,0.798,0.945
"7774","La Paz","Puerto Mayor de Carabuco","U. E. Copusquia ""A""",3,1,5,1,160,0,16,1,2,189,5,6,200,222,0.847,0.901
"7775","La Paz","Puerto Mayor de Carabuco","U. E. Copusquia ""A""",2,2,6,2,110,1,40,1,0,164,3,4,171,184,0.671,0.929
"7776","La Paz","Puerto Mayor de Carabuco","Colegio Nacional Mixto Chuani",5,2,19,1,119,3,29,1,0,179,4,7,190,214,0.665,0.888
"7777","La Paz","Puerto Mayor de Carabuco","Unid. Educ. Ursula Goyzueta",10,4,7,1,115,1,25,0,0,163,3,12,178,204,0.706,0.873
"7778","La Paz","Puerto Mayor de Carabuco","Unid. Educ. Ursula Goyzueta",19,2,11,0,120,3,19,3,0,177,5,7,189,209,0.678,0.904
"7779","La Paz","Puerto Mayor de Carabuco","Unid. Educ. Ursula Goyzueta",16,1,7,3,112,2,19,0,1,161,8,20,189,211,0.696,0.896
"7780","La Paz","Puerto Mayor de Carabuco","Unid. Educ. Ursula Goyzueta",15,2,7,1,110,0,25,0,1,161,8,14,183,203,0.683,0.901
"7781","La Paz","Puerto Mayor de Carabuco","Unid. Educ. Ursula Goyzueta",13,0,7,5,124,3,31,0,2,185,2,9,196,211,0.67,0.929
"7782","La Paz","Puerto Mayor de Carabuco","Unid. Educ. Ursula Goyzueta",28,3,17,1,78,1,33,1,2,164,7,14,185,203,0.476,0.911
"7783","La Paz","Puerto Mayor de Carabuco","Unid. Educ. Ursula Goyzueta",16,2,7,1,127,0,24,1,1,179,8,10,197,213,0.709,0.925
"7784","La Paz","Puerto Mayor de Carabuco","Unid. Educ. Ursula Goyzueta",11,0,3,1,132,1,15,1,0,164,9,6,179,201,0.805,0.891
"7785","La Paz","Puerto Mayor de Carabuco","Colegio Pasarani",21,1,17,0,118,0,15,2,2,176,5,5,186,220,0.67,0.845
"7786","La Paz","Puerto Mayor de Carabuco","Colegio Pasarani",11,0,27,2,112,1,17,0,3,173,6,10,189,219,0.647,0.863
"7787","La Paz","Puerto Mayor de Carabuco","Escuela Huilacunca",9,4,8,0,135,0,3,0,2,161,4,16,181,208,0.839,0.87
"7788","La Paz","Puerto Mayor de Carabuco","U.E. Mollipongo",3,4,3,0,138,0,14,0,0,162,2,7,171,178,0.852,0.961
"7789","La Paz","Humanata","Esc. S.J. De Pacollo",3,1,25,3,156,2,7,1,1,199,2,11,212,240,0.784,0.883
"7790","La Paz","Humanata","Col. San Francisco De Padua",7,2,13,3,116,1,19,1,1,163,11,14,188,208,0.712,0.904
"7791","La Paz","Humanata","Col. San Francisco De Padua",5,1,16,3,105,4,15,2,0,151,30,16,197,213,0.695,0.925
"7792","La Paz","Humanata","Col. San Francisco De Padua",13,1,21,2,109,1,19,1,0,167,13,11,191,207,0.653,0.923
"7793","La Paz","Humanata","Col. San Francisco De Padua",1,3,19,0,131,2,12,1,1,170,11,19,200,217,0.771,0.922
"7794","La Paz","Humanata","Col. San Francisco De Padua",6,1,22,1,128,5,12,1,1,177,2,12,191,211,0.723,0.905
"7795","La Paz","Humanata","Col. San Francisco De Padua",16,2,15,1,115,2,19,0,1,171,4,11,186,214,0.673,0.869
"7796","La Paz","Humanata","Col. San Francisco De Padua",7,2,25,1,108,3,14,0,1,161,17,14,192,208,0.671,0.923
"7797","La Paz","Humanata","Col. Santa Ana De Cutucutu",2,0,27,0,136,2,8,1,1,177,10,12,199,226,0.768,0.881
"7798","La Paz","Escoma","Colegio Don Bosco",12,0,12,0,149,0,4,1,5,183,6,11,200,215,0.814,0.93
"7799","La Paz","Escoma","Colegio Don Bosco",10,3,10,0,137,3,15,0,1,179,3,8,190,214,0.765,0.888
"7800","La Paz","Escoma","Colegio Don Bosco",3,0,10,2,124,2,23,2,1,167,9,8,184,202,0.743,0.911
"7801","La Paz","Escoma","Colegio Don Bosco",10,0,4,3,145,1,11,1,1,176,5,12,193,213,0.824,0.906
"7802","La Paz","Escoma","Colegio Don Bosco",7,3,4,1,143,0,13,0,1,172,8,8,188,207,0.831,0.908
"7803","La Paz","Escoma","Colegio Don Bosco",13,1,11,1,133,0,18,1,2,180,8,12,200,211,0.739,0.948
"7804","La Paz","Escoma","Colegio Don Bosco",6,2,9,2,133,1,5,0,4,162,7,10,179,201,0.821,0.891
"7805","La Paz","Escoma","Colegio Don Bosco",9,4,6,0,137,2,13,1,0,172,12,8,192,211,0.797,0.91
"7806","La Paz","Escoma","Colegio Don Bosco",4,0,8,0,154,0,20,0,1,187,3,11,201,213,0.824,0.944
"7807","La Paz","Escoma","Colegio Don Bosco",12,2,7,1,133,2,13,1,0,171,5,9,185,203,0.778,0.911
"7808","La Paz","Escoma","Colegio Don Bosco",11,2,8,1,115,1,39,0,1,178,8,7,193,209,0.646,0.923
"7809","La Paz","Escoma","Colegio Don Bosco",6,1,11,1,127,3,12,3,1,165,10,8,183,204,0.77,0.897
"7810","La Paz","Escoma","Colegio Don Bosco",6,8,6,4,138,1,12,1,3,179,5,8,192,207,0.771,0.928
"7811","La Paz","Escoma","U.E. Villa Puni",15,1,14,0,118,4,17,2,7,178,7,8,193,202,0.663,0.955
"7812","La Paz","Escoma","Plaza 26 de Octubre",8,0,9,1,130,1,9,0,2,160,4,10,174,195,0.812,0.892
"7813","La Paz","Chuma","Escuela Maximiliano Ortiz",11,4,15,1,100,0,21,2,0,154,7,15,176,216,0.649,0.815
"7814","La Paz","Chuma","Escuela Maximiliano Ortiz",7,6,11,1,108,1,26,0,1,161,15,11,187,223,0.671,0.839
"7815","La Paz","Chuma","Escuela Maximiliano Ortiz",9,3,9,1,117,2,41,1,0,183,6,9,198,222,0.639,0.892
"7816","La Paz","Chuma","Escuela Maximiliano Ortiz",10,1,5,2,108,2,23,0,1,152,12,19,183,233,0.711,0.785
"7817","La Paz","Chuma","Escuela de Luquisani",14,0,24,2,116,4,20,2,1,183,15,7,205,223,0.634,0.919
"7818","La Paz","Chuma","Escuela Central Titicachi",9,4,6,3,107,4,22,1,2,158,13,9,180,213,0.677,0.845
"7819","La Paz","Chuma","Escuela Central Titicachi",10,2,14,3,128,3,19,0,1,180,6,7,193,220,0.711,0.877
"7820","La Paz","Chuma","Esc. Timusi",4,0,6,1,162,0,13,1,0,187,6,7,200,220,0.866,0.909
"7821","La Paz","Chuma","Escuela de Tuiluni",3,1,12,3,121,2,14,1,1,158,4,15,177,212,0.766,0.835
"7822","La Paz","Chuma","Escuela Chajlaya",5,0,8,1,145,3,14,0,0,176,7,8,191,207,0.824,0.923
"7823","La Paz","Chuma","Escuela Chajlaya",6,2,3,2,160,0,9,0,0,182,1,7,190,205,0.879,0.927
"7824","La Paz","Chuma","Colegio Humanistico Sococoni",6,0,10,1,140,0,18,1,0,176,6,5,187,208,0.795,0.899
"7825","La Paz","Chuma","Colegio Humanistico Sococoni",13,3,11,0,124,0,18,0,0,169,6,9,184,209,0.734,0.88
"7826","La Paz","Chuma","Colegio Humanistico Sococoni",4,6,15,0,112,0,18,1,0,156,2,15,173,180,0.718,0.961
"7827","La Paz","Chuma","U. E. Cusahuaya",1,0,11,1,181,1,11,1,0,207,2,2,211,220,0.874,0.959
"7828","La Paz","Ayata","Escuela Nucleo Elizardo Perez De M.",14,1,18,7,90,2,22,0,0,154,22,8,184,223,0.584,0.825
"7829","La Paz","Ayata","Escuela Nucleo Elizardo Perez De M.",11,12,23,1,87,5,16,0,4,159,11,16,186,221,0.547,0.842
"7830","La Paz","Ayata","Esc. San Juanito",2,2,7,0,151,3,11,0,0,176,9,8,193,217,0.858,0.889
"7831","La Paz","Ayata","Esc. San Juanito",2,0,7,0,146,0,11,2,0,168,0,11,179,195,0.869,0.918
"7832","La Paz","Ayata","U.E. Mcal. Andrés de Santa Cruz",26,3,12,1,117,4,8,2,0,173,6,12,191,214,0.676,0.893
"7833","La Paz","Ayata","U.E. Mcal. Andrés de Santa Cruz",15,0,9,1,107,5,15,3,0,155,11,18,184,216,0.69,0.852
"7834","La Paz","Ayata","Escuela Saihuani",15,2,6,1,142,2,6,0,2,176,7,5,188,237,0.807,0.793
"7835","La Paz","Ayata","Escuela Seccional Multigrado Upani",16,3,12,4,121,2,24,0,0,182,12,9,203,226,0.665,0.898
"7836","La Paz","Aucapata","Escuela Dr. Angel Gemio Ergueta",27,2,21,2,70,1,33,2,1,159,4,11,174,222,0.44,0.784
"7837","La Paz","Aucapata","Nucleo Escolar Yanahuaya",8,6,17,3,121,3,17,2,0,177,5,15,197,230,0.684,0.857
"7838","La Paz","Aucapata","Nucleo Escolar Yanahuaya",13,8,13,1,111,4,28,1,2,181,5,18,204,230,0.613,0.887
"7839","La Paz","Aucapata","Iglesia Santo Domingo",3,2,3,2,133,4,8,0,0,155,9,17,181,228,0.858,0.794
"7840","La Paz","Aucapata","Colegio 2 de Agosto",3,3,9,0,155,1,11,1,0,183,5,11,199,221,0.847,0.9
"7841","La Paz","Aucapata","Colegio 2 de Agosto",0,3,7,3,139,1,7,0,0,160,12,12,184,210,0.869,0.876
"7842","La Paz","Aucapata","Unidad Educativa Rosario",11,2,2,1,117,4,40,1,0,178,7,10,195,234,0.657,0.833
"7843","La Paz","Aucapata","Unidad Educativa Rosario",4,4,8,0,120,3,33,0,0,172,10,7,189,229,0.698,0.825
"7844","La Paz","Sorata","Col. Juan XXIII",39,2,19,2,84,1,34,0,1,182,6,4,192,216,0.462,0.889
"7845","La Paz","Sorata","Col. Juan XXIII",15,0,21,1,110,1,40,1,1,190,7,5,202,219,0.579,0.922
"7846","La Paz","Sorata","Col. Juan XXIII",22,0,18,0,100,2,35,0,0,177,8,9,194,213,0.565,0.911
"7847","La Paz","Sorata","Col. Juan XXIII",22,1,19,1,99,2,39,0,1,184,3,4,191,214,0.538,0.893
"7848","La Paz","Sorata","Col. Juan XXIII",35,0,21,1,91,1,25,1,0,175,8,7,190,215,0.52,0.884
"7849","La Paz","Sorata","Col. Juan XXIII",23,0,20,1,103,1,40,0,0,188,8,8,204,219,0.548,0.932
"7850","La Paz","Sorata","Col. Juan XXIII",22,3,20,0,86,1,45,0,0,177,10,8,195,218,0.486,0.894
"7851","La Paz","Sorata","Col. Juan XXIII",17,3,21,5,91,1,35,0,1,174,4,9,187,211,0.523,0.886
"7852","La Paz","Sorata","Col. Juan XXIII",25,4,12,2,96,2,34,0,1,176,6,11,193,212,0.545,0.91
"7853","La Paz","Sorata","H.A.M. de Sorata",22,2,25,2,93,1,24,2,1,172,19,9,200,220,0.541,0.909
"7854","La Paz","Sorata","H.A.M. de Sorata",22,6,26,0,98,0,30,0,1,183,8,11,202,220,0.536,0.918
"7855","La Paz","Sorata","H.A.M. de Sorata",17,3,26,0,98,2,35,0,1,182,11,16,209,222,0.538,0.941
"7856","La Paz","Sorata","H.A.M. de Sorata",26,3,21,0,99,5,21,0,3,178,12,7,197,217,0.556,0.908
"7857","La Paz","Sorata","H.A.M. de Sorata",13,2,21,0,99,2,43,0,0,180,10,13,203,223,0.55,0.91
"7858","La Paz","Sorata","H.A.M. de Sorata",17,1,13,1,101,2,33,0,1,169,19,16,204,224,0.598,0.911
"7859","La Paz","Sorata","H.A.M. de Sorata",22,4,19,1,101,3,33,1,1,185,10,10,205,229,0.546,0.895
"7860","La Paz","Sorata","H.A.M. de Sorata",9,2,24,1,96,1,38,1,0,172,17,5,194,217,0.558,0.894
"7861","La Paz","Sorata","H.A.M. de Sorata",13,2,18,0,104,1,34,0,2,174,10,5,189,216,0.598,0.875
"7862","La Paz","Sorata","H.A.M. de Sorata",30,3,16,2,90,5,31,0,0,177,12,10,199,215,0.508,0.926
"7863","La Paz","Sorata","Esc. Nucleo Laripata",6,5,26,1,93,5,42,1,1,180,13,11,204,211,0.517,0.967
"7864","La Paz","Sorata","Esc. Nucleo Laripata",10,0,28,2,102,2,36,1,0,181,12,12,205,220,0.564,0.932
"7865","La Paz","Sorata","Esc. Nucleo Laripata",12,3,38,0,78,1,32,1,1,166,13,17,196,208,0.47,0.942
"7866","La Paz","Sorata","Esc. Nucleo Laripata",9,3,32,1,111,0,28,0,0,184,7,11,202,212,0.603,0.953
"7867","La Paz","Sorata","Esc. Nemecio Ayala",11,4,14,0,125,3,9,0,1,167,16,11,194,215,0.749,0.902
"7868","La Paz","Sorata","Esc. Central Carazani",5,3,23,1,133,0,7,2,0,174,1,24,199,206,0.764,0.966
"7869","La Paz","Sorata","Esc. Fernando Eloy Guachalla",0,3,11,1,130,2,10,1,0,158,13,12,183,202,0.823,0.906
"7870","La Paz","Sorata","Esc. Fernando Eloy Guachalla",5,0,14,0,127,1,9,2,1,159,13,6,178,201,0.799,0.886
"7871","La Paz","Sorata","Esc. Fernando Eloy Guachalla",8,5,24,3,121,0,4,3,1,169,11,6,186,194,0.716,0.959
"7872","La Paz","Sorata","Esc. Central Cheje",7,2,5,2,146,2,12,1,0,177,10,7,194,218,0.825,0.89
"7873","La Paz","Sorata","Esc. Central de Yani",47,3,29,1,63,4,44,0,0,191,5,8,204,218,0.33,0.936
"7874","La Paz","Sorata","Esc. Central de Yani",42,2,29,1,58,4,48,2,1,187,6,7,200,223,0.31,0.897
"7875","La Paz","Sorata","Esc. Central de Yani",49,3,23,3,56,2,44,1,1,182,5,13,200,220,0.308,0.909
"7876","La Paz","Sorata","Esc. Secc. de Ankoma Sur",5,1,20,0,64,4,65,0,0,159,2,18,179,194,0.403,0.923
"7877","La Paz","Sorata","Esc. Nucleo San Antonio de Millipa",2,4,33,1,121,1,22,2,2,188,10,6,204,216,0.644,0.944
"7878","La Paz","Sorata","Esc. Nucleo San Antonio de Millipa",13,2,40,1,110,1,34,0,1,202,4,6,212,218,0.545,0.972
"7879","La Paz","Sorata","Esc. Nucleo San Antonio de Millipa",8,1,27,0,107,5,33,0,0,181,9,10,200,212,0.591,0.943
"7880","La Paz","Sorata","Esc. Nucleo San Antonio de Millipa",8,1,37,0,87,0,40,0,1,174,1,6,181,191,0.5,0.948
"7881","La Paz","Sorata","Esc. Nucleo Abispaya",9,1,22,1,113,4,10,2,3,165,16,10,191,215,0.685,0.888
"7882","La Paz","Sorata","Esc. Nucleo Abispaya",11,3,12,4,103,2,16,2,0,153,15,9,177,198,0.673,0.894
"7883","La Paz","Sorata","Esc. Nucleo Cocoy",14,5,35,2,103,5,33,0,2,199,10,19,228,230,0.518,0.991
"7884","La Paz","Sorata","Esc. Seccional Chussi",15,1,5,1,129,6,32,0,0,189,26,5,220,235,0.683,0.936
"7885","La Paz","Sorata","Escuela Machacamarca",3,0,19,1,154,2,23,0,0,202,0,1,203,219,0.762,0.927
"7886","La Paz","Sorata","Escuela Pacollo",2,4,4,0,137,3,22,0,0,172,0,13,185,198,0.797,0.934
"7887","La Paz","Sorata","Escuela Santa Maria",16,0,7,0,124,2,23,0,1,173,12,8,193,228,0.717,0.846
"7888","La Paz","Guanay","Unidad Educativa Nacional Guanay",42,0,5,0,99,7,20,0,2,175,4,7,186,230,0.566,0.809
"7889","La Paz","Guanay","Unidad Educativa Nacional Guanay",52,2,6,0,79,5,28,0,3,175,7,8,190,224,0.451,0.848
"7890","La Paz","Guanay","Unidad Educativa Nacional Guanay",47,2,7,0,93,10,17,3,2,181,4,5,190,220,0.514,0.864
"7891","La Paz","Guanay","Unidad Educativa Nacional Guanay",55,2,6,0,75,5,24,0,1,168,4,12,184,224,0.446,0.821
"7892","La Paz","Guanay","Unidad Educativa Nacional Guanay",43,1,8,1,101,8,15,0,2,179,9,6,194,226,0.564,0.858
"7893","La Paz","Guanay","Unidad Educativa Nacional Guanay",29,1,7,1,105,5,29,1,1,179,6,13,198,224,0.587,0.884
"7894","La Paz","Guanay","Unidad Educativa Nacional Guanay",64,2,3,1,77,7,19,0,4,177,10,0,187,225,0.435,0.831
"7895","La Paz","Guanay","Unidad Educativa Nacional Guanay",41,2,9,0,86,10,20,0,0,168,5,14,187,223,0.512,0.839
"7896","La Paz","Guanay","Unidad Educativa Nacional Guanay",57,1,6,0,75,9,16,1,2,167,8,20,195,228,0.449,0.855
"7897","La Paz","Guanay","Unidad Educativa Nacional Guanay",59,1,3,0,85,5,18,0,3,174,8,18,200,231,0.489,0.866
"7898","La Paz","Guanay","Esc. C. Crespo",65,4,5,1,83,3,32,1,0,194,4,6,204,223,0.428,0.915
"7899","La Paz","Guanay","Esc. C. Crespo",54,0,6,2,89,10,21,1,1,184,3,9,196,228,0.484,0.86
"7900","La Paz","Guanay","Esc. C. Crespo",40,8,0,4,104,4,17,1,2,180,9,9,198,224,0.578,0.884
"7901","La Paz","Guanay","Esc. C. Crespo",43,1,4,0,97,4,24,1,2,176,5,6,187,222,0.551,0.842
"7902","La Paz","Guanay","Esc. C. Crespo",49,3,4,0,86,5,25,2,2,176,3,11,190,222,0.489,0.856
"7903","La Paz","Guanay","Esc. C. Crespo",51,2,3,0,93,6,18,1,4,178,6,5,189,225,0.522,0.84
"7904","La Paz","Guanay","Esc. C. Crespo",56,0,3,2,79,6,21,0,1,168,12,16,196,222,0.47,0.883
"7905","La Paz","Guanay","Esc. C. Crespo",46,0,2,0,98,7,23,1,2,179,5,10,194,221,0.547,0.878
"7906","La Paz","Guanay","Esc. C. Crespo",49,4,2,0,95,7,20,0,0,177,3,12,192,220,0.537,0.873
"7907","La Paz","Guanay","Esc. C. Crespo",41,0,10,1,92,5,33,0,0,182,7,1,190,224,0.505,0.848
"7908","La Paz","Guanay","U.E. Carura B",15,2,22,0,114,6,31,0,2,192,7,15,214,229,0.594,0.934
"7909","La Paz","Guanay","U.E. Carura B",18,1,17,0,109,6,36,0,1,188,7,7,202,233,0.58,0.867
"7910","La Paz","Guanay","Esc. Secc. de Poroma",8,0,3,0,149,2,13,0,8,183,2,3,188,199,0.814,0.945
"7911","La Paz","Guanay","La Aguada",65,3,26,1,83,3,7,1,2,191,3,7,201,220,0.435,0.914
"7912","La Paz","Guanay","Unidad Educativa Buenos Aires",19,0,10,3,152,1,8,0,0,193,9,6,208,225,0.788,0.924
"7913","La Paz","Guanay","Unidad Educativa Candelaria",17,0,10,1,131,5,19,0,2,185,0,9,194,224,0.708,0.866
"7914","La Paz","Guanay","Unidad Educativa Candelaria",17,0,11,0,137,2,19,0,1,187,6,13,206,228,0.733,0.904
"7915","La Paz","Guanay","Esc. Secc. Trapicheponte",15,0,5,0,174,0,4,0,1,199,9,6,214,239,0.874,0.895
"7916","La Paz","Tacacoma","Escuela XVI De Julio",18,2,21,0,67,2,65,1,1,177,14,14,205,221,0.379,0.928
"7917","La Paz","Tacacoma","Escuela XVI De Julio",22,4,22,0,74,3,56,0,0,181,11,9,201,216,0.409,0.931
"7918","La Paz","Tacacoma","Escuela XVI De Julio",16,0,19,0,81,3,64,0,0,183,15,10,208,217,0.443,0.959
"7919","La Paz","Tacacoma","Escuela XVI De Julio",9,2,17,0,65,2,92,0,0,187,6,10,203,222,0.348,0.914
"7920","La Paz","Tacacoma","Escuela XVI De Julio",17,3,19,1,80,2,68,0,1,191,8,8,207,226,0.419,0.916
"7921","La Paz","Tacacoma","Esc. Ananea",26,4,23,2,85,1,50,1,0,192,10,9,211,221,0.443,0.955
"7922","La Paz","Tacacoma","Col. Central San Agustin",23,2,3,1,96,4,41,2,1,173,8,12,193,226,0.555,0.854
"7923","La Paz","Tacacoma","Col. Central San Agustin",21,0,10,2,90,5,35,1,0,164,3,8,175,199,0.549,0.879
"7924","La Paz","Tacacoma","U. E. Incachaca",41,1,8,0,101,5,19,0,0,175,5,10,190,228,0.577,0.833
"7925","La Paz","Tacacoma","Esc. Central Chumisa",8,4,23,0,102,2,56,1,0,196,6,8,210,224,0.52,0.938
"7926","La Paz","Tacacoma","Esc. Central Chumisa",7,1,6,0,129,2,47,0,1,193,5,6,204,219,0.668,0.932
"7927","La Paz","Tacacoma","Escuela Pallayunga",10,0,5,0,119,0,43,0,0,177,2,13,192,226,0.672,0.85
"7928","La Paz","Quiabaya","Esc. Mixta Julio Cordero",6,4,18,2,108,4,26,0,1,169,10,16,195,223,0.639,0.874
"7929","La Paz","Quiabaya","Esc. Mixta Julio Cordero",11,4,18,2,97,2,36,0,0,170,14,11,195,218,0.571,0.894
"7930","La Paz","Quiabaya","Esc. Mixta Julio Cordero",8,2,14,3,101,3,26,3,1,161,18,15,194,210,0.627,0.924
"7931","La Paz","Quiabaya","Esc. Mixta Julio Cordero",13,3,23,1,96,4,35,1,2,178,11,16,205,225,0.539,0.911
"7932","La Paz","Quiabaya","Esc. Mixta Julio Cordero",9,3,16,3,112,1,25,2,1,172,14,8,194,218,0.651,0.89
"7933","La Paz","Quiabaya","Esc. Mixta Julio Cordero",8,4,21,1,87,3,41,0,2,167,16,15,198,223,0.521,0.888
"7934","La Paz","Combaya","Unidad Educativa Eduardo Avaroa",10,2,14,3,106,3,20,0,0,158,6,10,174,200,0.671,0.87
"7935","La Paz","Combaya","Esc. Nucleo Ticamblaya",7,6,25,2,106,3,24,0,1,174,9,14,197,218,0.609,0.904
"7936","La Paz","Combaya","Esc. Central Sorejaya",13,2,4,2,145,0,25,1,2,194,8,4,206,208,0.747,0.99
"7937","La Paz","Combaya","Esc. Central Sorejaya",14,2,11,2,105,2,20,0,0,156,3,7,166,174,0.673,0.954
"7938","La Paz","Combaya","Unidad Educativa Huaycho",3,1,15,2,138,1,21,2,2,185,10,12,207,212,0.746,0.976
"7939","La Paz","Tipuani","U.E. Oscar Unzaga De La Vega",41,0,4,1,99,5,13,0,1,164,7,14,185,221,0.604,0.837
"7940","La Paz","Tipuani","U.E. Oscar Unzaga De La Vega",52,0,6,1,86,8,14,2,0,169,3,12,184,224,0.509,0.821
"7941","La Paz","Tipuani","U.E. Oscar Unzaga De La Vega",74,0,8,0,82,2,10,0,1,177,1,6,184,220,0.463,0.836
"7942","La Paz","Tipuani","U.E. Oscar Unzaga De La Vega",65,0,4,0,82,3,8,0,0,162,4,10,176,224,0.506,0.786
"7943","La Paz","Tipuani","U.E. Oscar Unzaga De La Vega",34,0,3,1,117,5,18,2,1,181,0,4,185,221,0.646,0.837
"7944","La Paz","Tipuani","U.E. Oscar Unzaga De La Vega",56,1,3,0,97,3,14,0,2,176,5,6,187,218,0.551,0.858
"7945","La Paz","Tipuani","U.E. Oscar Unzaga De La Vega",54,0,5,0,92,6,15,1,0,173,4,10,187,220,0.532,0.85
"7946","La Paz","Tipuani","U.E. Oscar Unzaga De La Vega",60,0,1,0,91,2,15,0,0,169,2,6,177,222,0.538,0.797
"7947","La Paz","Tipuani","Esc. Mixta German Busch",25,3,1,1,109,3,14,3,1,160,5,8,173,212,0.681,0.816
"7948","La Paz","Tipuani","Esc. 16 de Julio",25,1,0,1,120,4,10,1,1,163,3,8,174,220,0.736,0.791
"7949","La Paz","Tipuani","Esc. 16 de Julio",31,0,2,0,112,1,24,0,0,170,4,7,181,225,0.659,0.804
"7950","La Paz","Tipuani","Esc. 16 de Julio",45,0,3,2,107,1,8,1,0,167,5,5,177,218,0.641,0.812
"7951","La Paz","Tipuani","Unidad Educativa Pedro Domingo Murillo",39,0,3,1,118,2,12,0,1,176,1,5,182,214,0.67,0.85
"7952","La Paz","Tipuani","Escuela Chuquini",17,0,3,0,145,2,9,0,1,177,3,9,189,225,0.819,0.84
"7953","La Paz","Tipuani","Escuela Chuquini",21,0,4,1,136,3,11,0,1,177,1,6,184,226,0.768,0.814
"7954","La Paz","Tipuani","Escuela Chuquini",26,0,4,0,134,1,7,0,2,174,8,0,182,223,0.77,0.816
"7955","La Paz","Tipuani","Escuela Chuquini",32,1,7,1,109,0,10,0,1,161,2,1,164,209,0.677,0.785
"7956","La Paz","Mapiri","U. E. 16 de Julio de Mapiri",46,2,2,3,81,5,38,3,1,181,4,18,203,226,0.448,0.898
"7957","La Paz","Mapiri","U. E. 16 de Julio de Mapiri",55,6,7,1,91,2,32,0,1,195,7,5,207,231,0.467,0.896
"7958","La Paz","Mapiri","U. E. 16 de Julio de Mapiri",45,1,2,2,61,7,58,1,4,181,8,8,197,226,0.337,0.872
"7959","La Paz","Mapiri","U. E. 16 de Julio de Mapiri",40,2,8,0,80,3,46,2,1,182,7,5,194,226,0.44,0.858
"7960","La Paz","Mapiri","U. E. 16 de Julio de Mapiri",61,4,7,3,64,4,42,1,1,187,5,10,202,230,0.342,0.878
"7961","La Paz","Mapiri","U. E. 16 de Julio de Mapiri",58,2,10,1,82,6,40,0,1,200,1,8,209,233,0.41,0.897
"7962","La Paz","Mapiri","U. E. 16 de Julio de Mapiri",44,1,6,1,87,6,28,2,5,180,9,14,203,229,0.483,0.886
"7963","La Paz","Mapiri","U. E. 16 de Julio de Mapiri",42,1,3,2,76,8,50,0,4,186,9,14,209,231,0.409,0.905
"7964","La Paz","Mapiri","U. E. 16 de Julio de Mapiri",47,5,3,3,67,7,42,1,2,177,10,5,192,228,0.379,0.842
"7965","La Paz","Mapiri","U. E. 16 de Julio de Mapiri",38,1,3,0,83,4,47,1,5,182,11,8,201,231,0.456,0.87
"7966","La Paz","Mapiri","U. E. 16 de Julio de Mapiri",48,2,3,1,85,3,33,2,1,178,5,11,194,231,0.478,0.84
"7967","La Paz","Mapiri","U. E. 16 de Julio de Mapiri",31,2,3,2,85,7,41,0,5,176,9,11,196,226,0.483,0.867
"7968","La Paz","Mapiri","U.E. Juan José Torrez",18,2,2,5,104,4,31,1,0,167,9,23,199,234,0.623,0.85
"7969","La Paz","Mapiri","U.E. Juan José Torrez",18,4,1,1,119,5,40,1,0,189,6,12,207,234,0.63,0.885
"7970","La Paz","Mapiri","U. E. Vilaque Grande",26,2,7,3,121,3,19,0,0,181,6,8,195,225,0.669,0.867
"7971","La Paz","Mapiri","U. E. Chimate",10,1,6,0,153,2,12,0,0,184,6,7,197,218,0.832,0.904
"7972","La Paz","Mapiri","U. E. Santa Rosa",29,0,10,2,85,5,29,1,2,163,8,11,182,225,0.521,0.809
"7973","La Paz","Mapiri","U. E. Santa Rosa",32,0,12,3,118,2,24,1,3,195,1,6,202,234,0.605,0.863
"7974","La Paz","Mapiri","U. E. Santa Rosa",34,0,8,1,104,3,29,0,3,182,3,10,195,230,0.571,0.848
"7975","La Paz","Mapiri","U. E. Santa Rosa",43,0,9,2,95,5,25,0,1,180,5,8,193,229,0.528,0.843
"7976","La Paz","Mapiri","U. E. Santa Rosa",28,3,6,2,122,5,28,0,1,195,4,6,205,229,0.626,0.895
"7977","La Paz","Mapiri","U. E. Santa Rosa",38,1,6,0,95,5,31,0,6,182,3,9,194,225,0.522,0.862
"7978","La Paz","Mapiri","U. E. Santa Rosa",30,2,9,1,96,8,30,2,1,179,7,12,198,235,0.536,0.843
"7979","La Paz","Mapiri","U. E. Santa Rosa",32,1,4,2,108,8,34,0,3,192,3,8,203,225,0.562,0.902
"7980","La Paz","Mapiri","U. E. Santa Rosa",37,1,9,2,110,6,22,0,2,189,1,12,202,230,0.582,0.878
"7981","La Paz","Mapiri","U. E. 1ro de Mayo  de Charopampa",26,0,4,2,85,6,54,3,3,183,6,15,204,236,0.464,0.864
"7982","La Paz","Mapiri","U. E. 1ro de Mayo  de Charopampa",27,1,10,1,87,6,50,1,2,185,14,6,205,234,0.47,0.876
"7983","La Paz","Mapiri","U. E. 1ro de Mayo  de Charopampa",22,4,6,4,83,6,51,3,3,182,6,17,205,235,0.456,0.872
"7984","La Paz","Teoponte","Col. Nucleo Tajlihui",4,1,22,0,141,2,7,0,0,177,5,9,191,209,0.797,0.914
"7985","La Paz","Teoponte","Col. Nal. Mixto Teoponte",48,2,8,4,73,2,30,1,1,169,8,13,190,225,0.432,0.844
"7986","La Paz","Teoponte","Col. Nal. Mixto Teoponte",36,0,6,2,93,6,38,0,2,183,4,8,195,223,0.508,0.874
"7987","La Paz","Teoponte","Col. Nal. Mixto Teoponte",47,1,3,1,99,4,23,1,1,180,4,5,189,219,0.55,0.863
"7988","La Paz","Teoponte","Col. Nal. Mixto Teoponte",57,0,8,0,60,8,36,0,1,170,1,7,178,218,0.353,0.817
"7989","La Paz","Teoponte","Col. Nal. Mixto Teoponte",35,0,9,0,89,8,36,1,2,180,5,10,195,220,0.494,0.886
"7990","La Paz","Teoponte","Col. Nal. Mixto Teoponte",34,1,12,2,92,5,25,0,3,174,6,15,195,222,0.529,0.878
"7991","La Paz","Teoponte","Sede Social",26,2,12,0,115,3,24,1,2,185,4,1,190,232,0.622,0.819
"7992","La Paz","Teoponte","Sede Social",30,3,15,0,110,4,22,0,0,184,4,7,195,229,0.598,0.852
"7993","La Paz","Teoponte","Sede Social",21,1,15,4,123,1,23,0,2,190,4,6,200,232,0.647,0.862
"7994","La Paz","Teoponte","Sede Social",26,0,8,0,122,9,22,1,2,190,7,4,201,227,0.642,0.885
"7995","La Paz","Teoponte","Sede Social",26,3,12,0,119,6,22,0,0,188,6,7,201,232,0.633,0.866
"7996","La Paz","Teoponte","Sede Social",20,1,11,1,133,5,20,0,4,195,9,5,209,236,0.682,0.886
"7997","La Paz","Teoponte","Esc. Mixta Tomachi",36,0,9,1,116,2,19,0,0,183,1,10,194,224,0.634,0.866
"7998","La Paz","Teoponte","Esc. Nucleo Villa Aroma",18,0,21,0,140,2,28,0,1,210,5,10,225,232,0.667,0.97
"7999","La Paz","Apolo","U. E. Nazario Pardo Valle",41,2,11,2,70,0,27,1,0,154,11,12,177,228,0.455,0.776
"8000","La Paz","Apolo","U. E. Nazario Pardo Valle",80,1,10,2,53,2,16,1,1,166,9,14,189,229,0.319,0.825
"8001","La Paz","Apolo","U. E. Nazario Pardo Valle",76,0,7,1,55,4,25,1,2,171,5,14,190,227,0.322,0.837
"8002","La Paz","Apolo","U. E. Nazario Pardo Valle",48,3,8,3,70,4,22,0,1,159,11,9,179,225,0.44,0.796
"8003","La Paz","Apolo","U. E. Nazario Pardo Valle",55,3,6,0,81,6,17,0,1,169,10,14,193,232,0.479,0.832
"8004","La Paz","Apolo","U. E. Nazario Pardo Valle",53,2,9,1,67,6,32,1,2,173,4,15,192,226,0.387,0.85
"8005","La Paz","Apolo","U. E. Nazario Pardo Valle",75,2,3,2,70,9,15,0,0,176,10,9,195,229,0.398,0.852
"8006","La Paz","Apolo","U. E. Nazario Pardo Valle",95,1,1,1,61,4,22,1,1,187,7,14,208,225,0.326,0.924
"8007","La Paz","Apolo","U. E. Nazario Pardo Valle",85,0,4,1,61,8,16,0,1,176,3,13,192,222,0.347,0.865
"8008","La Paz","Apolo","U. E. Nazario Pardo Valle",59,2,6,3,61,6,28,0,1,166,10,16,192,226,0.367,0.85
"8009","La Paz","Apolo","U. E. Nazario Pardo Valle",48,1,10,0,85,6,19,3,0,172,8,13,193,229,0.494,0.843
"8010","La Paz","Apolo","U. E. Nazario Pardo Valle",75,0,6,1,54,4,31,0,0,171,6,14,191,226,0.316,0.845
"8011","La Paz","Apolo","U. E. Nazario Pardo Valle",62,0,4,2,68,4,27,0,1,168,7,7,182,225,0.405,0.809
"8012","La Paz","Apolo","U. E. Nazario Pardo Valle",77,2,11,0,46,7,18,2,0,163,10,17,190,225,0.282,0.844
"8013","La Paz","Apolo","U. E. Nazario Pardo Valle",58,1,9,2,62,1,20,2,1,156,14,18,188,223,0.397,0.843
"8014","La Paz","Apolo","U. E. Nazario Pardo Valle",74,3,8,2,66,3,16,1,1,174,6,10,190,223,0.379,0.852
"8015","La Paz","Apolo","U. E. Nazario Pardo Valle",63,0,5,1,68,4,19,0,1,161,5,17,183,222,0.422,0.824
"8016","La Paz","Apolo","U. E. Nazario Pardo Valle",85,1,6,1,59,6,19,1,1,179,5,15,199,224,0.33,0.888
"8017","La Paz","Apolo","U. E. Nazario Pardo Valle",62,4,8,1,67,5,20,1,2,170,6,19,195,224,0.394,0.871
"8018","La Paz","Apolo","U.E. Fátima",43,2,5,0,83,7,21,1,0,162,11,32,205,240,0.512,0.854
"8019","La Paz","Apolo","U.E. Fátima",45,1,8,0,104,9,33,0,1,201,9,10,220,239,0.517,0.921
"8020","La Paz","Apolo","U.E. Fátima",41,0,10,1,90,10,37,1,2,192,5,12,209,238,0.469,0.878
"8021","La Paz","Apolo","U. E. Inca",13,0,7,0,115,4,33,2,2,176,12,10,198,229,0.653,0.865
"8022","La Paz","Apolo","U. E. Santa Catalina",41,1,5,2,85,6,14,1,2,157,11,16,184,219,0.541,0.84
"8023","La Paz","Apolo","U. E. Santa Catalina",39,12,7,0,90,3,9,2,0,162,8,20,190,220,0.556,0.864
"8024","La Paz","Apolo","Colegio Santísima Trinidad",41,3,2,6,62,1,50,2,0,167,12,21,200,231,0.371,0.866
"8025","La Paz","Apolo","U. E. Puchahui",62,2,2,2,112,1,6,3,0,190,6,10,206,234,0.589,0.88
"8026","La Paz","Apolo","U. E. Puchahui",46,1,2,2,129,0,12,1,0,193,12,7,212,230,0.668,0.922
"8027","La Paz","Apolo","U. E. Correo",5,0,5,1,168,0,10,0,0,189,6,2,197,218,0.889,0.904
"8028","La Paz","Apolo","U. E. Munaypata",23,4,7,2,113,5,26,1,2,183,6,10,199,232,0.617,0.858
"8029","La Paz","Pelechuco","U. E. Nazario Pardo Valle",18,3,7,5,111,6,20,3,1,174,5,8,187,222,0.638,0.842
"8030","La Paz","Pelechuco","U. E. Nazario Pardo Valle",14,1,16,2,103,5,33,2,2,178,3,15,196,221,0.579,0.887
"8031","La Paz","Pelechuco","U.E. Hilo Hilo",17,4,4,0,95,4,44,2,3,173,3,18,194,222,0.549,0.874
"8032","La Paz","Pelechuco","U. E. Suches",41,3,9,1,68,5,70,1,0,198,3,6,207,225,0.343,0.92
"8033","La Paz","Pelechuco","U. E. Ulla Ulla",18,2,38,2,85,1,34,3,3,186,10,16,212,230,0.457,0.922
"8034","La Paz","Pelechuco","U. E. Ulla Ulla",7,2,20,4,94,6,34,1,0,168,11,11,190,216,0.56,0.88
"8035","La Paz","Pelechuco","U.E. Antaquilla",19,1,21,1,84,2,51,2,1,182,7,8,197,223,0.462,0.883
"8036","La Paz","Pelechuco","U. E. Litoral de Agua Blanca",8,2,18,2,87,1,36,2,1,157,3,7,167,179,0.554,0.933
"8037","La Paz","Pelechuco","U. E. Puyo Puyo",39,5,23,3,69,10,62,1,1,213,7,14,234,246,0.324,0.951
"8038","La Paz","Pelechuco","U. E. Central Hichocollo",10,1,24,3,94,1,46,2,0,181,12,11,204,220,0.519,0.927
"8039","La Paz","Viacha","Esc. Evaristo Valle",32,0,1,1,135,1,22,0,5,197,3,7,207,226,0.685,0.916
"8040","La Paz","Viacha","Esc. Evaristo Valle",27,2,5,1,123,1,17,0,3,179,1,16,196,223,0.687,0.879
"8041","La Paz","Viacha","Esc. Evaristo Valle",32,1,7,0,129,2,20,0,3,194,4,6,204,225,0.665,0.907
"8042","La Paz","Viacha","Esc. Evaristo Valle",30,1,6,0,122,2,14,1,3,179,4,6,189,215,0.682,0.879
"8043","La Paz","Viacha","Esc. Evaristo Valle",36,1,4,1,140,3,15,1,2,203,2,7,212,227,0.69,0.934
"8044","La Paz","Viacha","Esc. Evaristo Valle",36,0,10,1,130,2,21,0,4,204,0,8,212,230,0.637,0.922
"8045","La Paz","Viacha","Esc. Evaristo Valle",43,2,7,1,113,2,20,1,3,192,4,10,206,226,0.589,0.912
"8046","La Paz","Viacha","Esc. Evaristo Valle",44,1,6,1,114,1,27,0,1,195,1,10,206,226,0.585,0.912
"8047","La Paz","Viacha","Esc. Evaristo Valle",36,1,10,0,126,3,21,0,1,198,3,8,209,231,0.636,0.905
"8048","La Paz","Viacha","Esc. Evaristo Valle",49,0,2,2,119,1,22,1,1,197,0,4,201,231,0.604,0.87
"8049","La Paz","Viacha","Esc. Evaristo Valle",49,0,4,0,120,3,15,1,0,192,2,6,200,214,0.625,0.935
"8050","La Paz","Viacha","Esc. Evaristo Valle",39,0,8,1,118,4,22,0,3,195,3,8,206,225,0.605,0.916
"8051","La Paz","Viacha","Esc. Evaristo Valle",48,0,1,0,110,3,22,0,3,187,1,11,199,218,0.588,0.913
"8052","La Paz","Viacha","Esc. Evaristo Valle",37,1,3,1,120,4,17,1,2,186,0,14,200,224,0.645,0.893
"8053","La Paz","Viacha","Esc. Evaristo Valle",31,2,7,1,124,3,22,0,3,193,2,16,211,225,0.642,0.938
"8054","La Paz","Viacha","Esc. Evaristo Valle",28,3,6,1,122,3,25,0,0,188,2,4,194,221,0.649,0.878
"8055","La Paz","Viacha","Esc. Evaristo Valle",41,1,4,0,108,1,27,0,2,184,1,5,190,224,0.587,0.848
"8056","La Paz","Viacha","Esc. Evaristo Valle",35,2,4,3,123,5,18,1,2,193,2,10,205,221,0.637,0.928
"8057","La Paz","Viacha","Esc. Evaristo Valle",55,4,5,0,107,4,15,1,2,193,2,5,200,228,0.554,0.877
"8058","La Paz","Viacha","Esc. Evaristo Valle",35,0,7,0,120,1,17,1,0,181,2,12,195,220,0.663,0.886
"8059","La Paz","Viacha","Esc. Evaristo Valle",40,0,2,1,116,1,28,0,0,188,4,14,206,221,0.617,0.932
"8060","La Paz","Viacha","Esc. Evaristo Valle",27,0,6,1,129,2,21,0,2,188,4,7,199,214,0.686,0.93
"8061","La Paz","Viacha","Esc. Evaristo Valle",27,0,8,0,137,1,25,1,8,207,1,8,216,232,0.662,0.931
"8062","La Paz","Viacha","Esc. Evaristo Valle",41,4,6,0,114,3,24,0,0,192,3,14,209,224,0.594,0.933
"8063","La Paz","Viacha","Esc. Evaristo Valle",42,2,4,1,74,8,21,0,0,152,51,3,206,224,0.487,0.92
"8064","La Paz","Viacha","Esc. Evaristo Valle",47,1,2,0,132,1,12,1,2,198,1,7,206,229,0.667,0.9
"8065","La Paz","Viacha","Esc. Evaristo Valle",53,0,3,0,115,2,21,0,0,194,0,3,197,221,0.593,0.891
"8066","La Paz","Viacha","Esc. San Luis",50,1,9,0,108,3,27,1,0,199,1,9,209,223,0.543,0.937
"8067","La Paz","Viacha","Esc. San Luis",50,1,1,2,118,5,20,2,2,201,4,6,211,228,0.587,0.925
"8068","La Paz","Viacha","Esc. San Luis",33,3,3,0,115,1,23,0,1,179,3,12,194,216,0.642,0.898
"8069","La Paz","Viacha","Esc. San Luis",49,0,8,1,112,2,23,2,3,200,2,6,208,226,0.56,0.92
"8070","La Paz","Viacha","Esc. San Luis",32,0,6,0,129,4,24,0,0,195,5,6,206,232,0.662,0.888
"8071","La Paz","Viacha","Esc. San Luis",36,3,4,1,126,0,22,0,2,194,1,4,199,224,0.649,0.888
"8072","La Paz","Viacha","Esc. San Luis",46,1,3,0,118,3,17,0,2,190,4,10,204,230,0.621,0.887
"8073","La Paz","Viacha","Esc. San Luis",69,1,4,0,95,2,24,0,3,198,2,7,207,228,0.48,0.908
"8074","La Paz","Viacha","Esc. San Luis",58,0,5,2,117,2,16,0,4,204,0,6,210,226,0.574,0.929
"8075","La Paz","Viacha","Esc. San Luis",60,1,2,2,118,3,17,0,5,208,1,6,215,231,0.567,0.931
"8076","La Paz","Viacha","Esc. San Luis",37,0,5,1,124,3,22,1,1,194,3,10,207,234,0.639,0.885
"8077","La Paz","Viacha","Esc. San Luis",49,0,5,0,129,2,20,0,0,205,7,4,216,232,0.629,0.931
"8078","La Paz","Viacha","Esc. San Luis",48,2,4,1,116,0,26,0,0,197,2,6,205,223,0.589,0.919
"8079","La Paz","Viacha","Esc. San Luis",88,1,7,0,80,3,19,0,3,201,0,5,206,230,0.398,0.896
"8080","La Paz","Viacha","Esc. San Luis",51,1,4,1,123,3,16,0,2,201,1,6,208,228,0.612,0.912
"8081","La Paz","Viacha","Esc. San Luis",36,1,8,1,125,2,28,0,1,202,1,7,210,228,0.619,0.921
"8082","La Paz","Viacha","Esc. San Luis",51,0,6,0,130,4,21,0,1,213,0,8,221,231,0.61,0.957
"8083","La Paz","Viacha","Esc. San Luis",58,2,4,1,128,3,15,0,2,213,1,5,219,232,0.601,0.944
"8084","La Paz","Viacha","Esc. San Luis",68,2,3,1,104,4,18,0,3,203,0,4,207,230,0.512,0.9
"8085","La Paz","Viacha","Esc. San Luis",66,0,3,0,91,5,19,0,4,188,1,11,200,227,0.484,0.881
"8086","La Paz","Viacha","Esc. 18 de Noviembre",38,0,4,2,139,3,17,0,0,203,1,10,214,225,0.685,0.951
"8087","La Paz","Viacha","Esc. 18 de Noviembre",35,1,7,0,131,1,21,0,1,197,1,12,210,225,0.665,0.933
"8088","La Paz","Viacha","Esc. 18 de Noviembre",30,0,3,0,143,5,16,0,0,197,0,9,206,225,0.726,0.916
"8089","La Paz","Viacha","Esc. 18 de Noviembre",41,3,6,0,129,4,19,0,2,204,0,12,216,232,0.632,0.931
"8090","La Paz","Viacha","Esc. 18 de Noviembre",40,1,5,0,133,2,17,1,0,199,2,6,207,228,0.668,0.908
"8091","La Paz","Viacha","Esc. 18 de Noviembre",45,1,5,2,110,3,23,0,2,191,5,6,202,223,0.576,0.906
"8092","La Paz","Viacha","Esc. 18 de Noviembre",30,0,6,2,137,2,25,0,1,203,3,8,214,230,0.675,0.93
"8093","La Paz","Viacha","Esc. 18 de Noviembre",52,1,7,1,97,3,22,0,4,187,4,4,195,219,0.519,0.89
"8094","La Paz","Viacha","Esc. 18 de Noviembre",43,0,4,0,120,2,23,0,2,194,4,5,203,221,0.619,0.919
"8095","La Paz","Viacha","Esc. 18 de Noviembre",40,2,0,2,126,3,0,20,1,194,1,9,204,223,0.649,0.915
"8096","La Paz","Viacha","Esc. 18 de Noviembre",40,0,4,3,110,4,13,0,1,175,4,14,193,217,0.629,0.889
"8097","La Paz","Viacha","Esc. 18 de Noviembre",32,1,5,0,127,1,30,0,2,198,3,7,208,229,0.641,0.908
"8098","La Paz","Viacha","Esc. 18 de Noviembre",42,0,6,0,126,2,29,0,6,211,1,2,214,231,0.597,0.926
"8099","La Paz","Viacha","Esc. 18 de Noviembre",46,0,7,1,127,2,23,0,0,206,2,6,214,230,0.617,0.93
"8100","La Paz","Viacha","Esc. 18 de Noviembre",32,2,11,0,131,3,22,0,2,203,0,6,209,228,0.645,0.917
"8101","La Paz","Viacha","Esc. 18 de Noviembre",35,4,2,0,136,6,25,0,0,208,2,5,215,229,0.654,0.939
"8102","La Paz","Viacha","Esc. 18 de Noviembre",27,1,4,0,137,1,28,0,4,202,1,8,211,226,0.678,0.934
"8103","La Paz","Viacha","Esc. 18 de Noviembre",40,2,7,1,123,2,25,1,1,202,3,7,212,227,0.609,0.934
"8104","La Paz","Viacha","Esc. 18 de Noviembre",47,1,4,0,120,6,22,0,2,202,5,2,209,232,0.594,0.901
"8105","La Paz","Viacha","Esc. 18 de Noviembre",44,2,8,0,111,2,22,0,0,189,0,6,195,219,0.587,0.89
"8106","La Paz","Viacha","Esc. 18 de Noviembre",45,2,6,2,78,2,22,0,1,158,2,3,163,181,0.494,0.901
"8107","La Paz","Viacha","Colegio Ballivian",43,0,1,0,122,1,21,0,3,191,1,10,202,225,0.639,0.898
"8108","La Paz","Viacha","Colegio Ballivian",33,1,5,0,134,1,22,0,3,199,3,2,204,218,0.673,0.936
"8109","La Paz","Viacha","Colegio Ballivian",36,0,3,0,135,2,21,0,0,197,2,2,201,219,0.685,0.918
"8110","La Paz","Viacha","Colegio Ballivian",36,0,8,0,119,4,15,1,0,183,2,10,195,220,0.65,0.886
"8111","La Paz","Viacha","Colegio Ballivian",39,1,5,1,122,0,18,1,2,189,3,6,198,223,0.646,0.888
"8112","La Paz","Viacha","Colegio Ballivian",27,0,1,1,133,2,16,0,4,184,3,10,197,219,0.723,0.9
"8113","La Paz","Viacha","Colegio Ballivian",25,1,7,1,125,4,12,1,0,176,4,10,190,218,0.71,0.872
"8114","La Paz","Viacha","Colegio Ballivian",30,0,6,0,142,2,18,1,2,201,2,4,207,223,0.706,0.928
"8115","La Paz","Viacha","Colegio Ballivian",24,3,8,0,126,2,25,0,1,189,3,8,200,223,0.667,0.897
"8116","La Paz","Viacha","Colegio Ballivian",37,0,8,1,130,2,21,0,0,199,2,8,209,227,0.653,0.921
"8117","La Paz","Viacha","Colegio Ballivian",41,0,1,1,120,3,20,0,1,187,3,14,204,222,0.642,0.919
"8118","La Paz","Viacha","Colegio Ballivian",27,0,4,1,147,1,21,0,1,202,4,2,208,230,0.728,0.904
"8119","La Paz","Viacha","Colegio Ballivian",42,1,1,0,128,2,21,0,1,196,0,6,202,230,0.653,0.878
"8120","La Paz","Viacha","Colegio Ballivian",21,1,5,1,128,2,19,0,3,180,3,11,194,213,0.711,0.911
"8121","La Paz","Viacha","Colegio Ballivian",25,0,3,0,124,2,26,0,3,183,6,8,197,220,0.678,0.895
"8122","La Paz","Viacha","Colegio Ballivian",30,1,4,1,137,1,27,0,1,202,0,2,204,227,0.678,0.899
"8123","La Paz","Viacha","Colegio Ballivian",54,0,1,1,119,3,10,0,4,192,1,5,198,224,0.62,0.884
"8124","La Paz","Viacha","Colegio Ballivian",69,2,3,0,108,1,15,1,1,200,3,5,208,228,0.54,0.912
"8125","La Paz","Viacha","Colegio Ballivian",59,1,1,0,100,0,19,0,3,183,4,5,192,220,0.546,0.873
"8126","La Paz","Viacha","Colegio Ballivian",48,0,4,1,109,1,19,0,2,184,0,11,195,217,0.592,0.899
"8127","La Paz","Viacha","Colegio Ballivian",49,1,5,1,112,1,31,0,1,201,1,3,205,227,0.557,0.903
"8128","La Paz","Viacha","Colegio Ballivian",35,3,7,0,116,3,21,0,1,186,3,5,194,210,0.624,0.924
"8129","La Paz","Viacha","Colegio Ballivian",54,0,4,0,104,1,19,0,2,184,1,11,196,218,0.565,0.899
"8130","La Paz","Viacha","Colegio Ballivian",42,0,6,0,107,1,22,1,3,182,1,5,188,224,0.588,0.839
"8131","La Paz","Viacha","Colegio Ballivian",29,1,4,0,116,0,22,0,1,173,1,6,180,202,0.671,0.891
"8132","La Paz","Viacha","Colegio Ballivian",29,0,9,2,126,4,24,0,6,200,0,7,207,226,0.63,0.916
"8133","La Paz","Viacha","Colegio Ballivian",36,0,8,0,123,1,23,0,0,191,1,12,204,225,0.644,0.907
"8134","La Paz","Viacha","Colegio Ballivian",38,0,5,0,133,0,22,0,0,198,2,6,206,225,0.672,0.916
"8135","La Paz","Viacha","Colegio Ballivian",33,1,2,0,118,3,21,0,3,181,0,8,189,220,0.652,0.859
"8136","La Paz","Viacha","Colegio Ballivian",47,1,1,1,122,1,23,0,1,197,1,4,202,223,0.619,0.906
"8137","La Paz","Viacha","Colegio Ballivian",62,3,4,1,102,3,18,1,2,196,2,4,202,225,0.52,0.898
"8138","La Paz","Viacha","Colegio Ballivian",48,0,4,0,113,3,17,1,2,188,4,10,202,227,0.601,0.89
"8139","La Paz","Viacha","Colegio Ballivian",49,0,7,1,123,2,13,0,1,196,1,7,204,212,0.628,0.962
"8140","La Paz","Viacha","Colegio Ballivian",32,1,3,0,128,0,20,0,1,185,1,18,204,226,0.692,0.903
"8141","La Paz","Viacha","Colegio Ballivian",36,0,6,0,112,5,19,0,1,179,5,6,190,215,0.626,0.884
"8142","La Paz","Viacha","Colegio Ballivian",35,2,4,1,112,4,23,1,0,182,3,4,189,213,0.615,0.887
"8143","La Paz","Viacha","Colegio Ballivian",32,1,6,3,129,4,20,0,5,200,3,7,210,225,0.645,0.933
"8144","La Paz","Viacha","Colegio Ballivian",33,0,3,1,140,3,21,0,2,203,1,7,211,224,0.69,0.942
"8145","La Paz","Viacha","Colegio Ballivian",40,0,4,0,117,1,24,0,2,188,1,14,203,224,0.622,0.906
"8146","La Paz","Viacha","Colegio Ballivian",48,0,5,0,114,0,22,0,4,193,3,2,198,222,0.591,0.892
"8147","La Paz","Viacha","Colegio Ballivian",56,1,9,1,105,4,13,1,4,194,2,12,208,230,0.541,0.904
"8148","La Paz","Viacha","Colegio Ballivian",49,1,5,1,112,1,19,0,5,193,2,7,202,223,0.58,0.906
"8149","La Paz","Viacha","Colegio Ballivian",62,0,8,0,104,1,17,1,0,193,2,3,198,221,0.539,0.896
"8150","La Paz","Viacha","Colegio Ballivian",40,2,2,0,120,4,24,0,1,193,0,6,199,226,0.622,0.881
"8151","La Paz","Viacha","Colegio Ballivian",46,0,4,0,117,3,16,0,0,186,3,8,197,224,0.629,0.879
"8152","La Paz","Viacha","Colegio Ballivian",61,0,1,0,115,2,21,0,3,203,1,3,207,229,0.567,0.904
"8153","La Paz","Viacha","Esc. Viliroco",21,1,6,0,153,4,18,0,0,203,2,7,212,221,0.754,0.959
"8154","La Paz","Viacha","Esc. Viliroco",27,0,7,1,147,1,25,1,0,209,2,8,219,228,0.703,0.961
"8155","La Paz","Viacha","Esc. Viliroco",12,1,7,0,162,1,24,0,3,210,1,9,220,231,0.771,0.952
"8156","La Paz","Viacha","Esc. Viliroco",13,0,3,0,166,0,17,0,1,200,4,11,215,233,0.83,0.923
"8157","La Paz","Viacha","Esc. Viliroco",19,1,10,0,152,2,22,1,3,210,0,4,214,231,0.724,0.926
"8158","La Paz","Viacha","Esc. Viliroco",22,1,7,0,149,4,21,0,1,205,1,6,212,226,0.727,0.938
"8159","La Paz","Viacha","Esc. Viliroco",22,1,6,1,152,2,22,0,1,207,1,6,214,227,0.734,0.943
"8160","La Paz","Viacha","Esc. Viliroco",11,1,7,0,156,0,25,1,2,203,0,5,208,220,0.768,0.945
"8161","La Paz","Viacha","Esc. Viliroco",17,1,7,0,175,0,23,0,2,225,0,2,227,233,0.778,0.974
"8162","La Paz","Viacha","Esc. Viliroco",15,0,10,0,160,1,17,0,1,204,0,11,215,231,0.784,0.931
"8163","La Paz","Viacha","Esc. Viliroco",13,0,4,0,151,2,20,0,3,193,1,12,206,226,0.782,0.912
"8164","La Paz","Viacha","Esc. Viliroco",20,2,8,0,148,0,27,0,1,206,0,8,214,227,0.718,0.943
"8165","La Paz","Viacha","Esc. Viliroco",27,0,4,0,160,1,19,0,3,214,3,5,222,229,0.748,0.969
"8166","La Paz","Viacha","Esc. Viliroco",29,0,5,1,134,6,24,0,1,200,1,12,213,229,0.67,0.93
"8167","La Paz","Viacha","Esc. Viliroco",22,1,2,1,150,2,28,1,2,209,0,5,214,222,0.718,0.964
"8168","La Paz","Viacha","Esc. Viliroco",17,1,4,0,173,1,14,0,1,211,1,10,222,231,0.82,0.961
"8169","La Paz","Viacha","Esc. Viliroco",13,3,8,0,153,7,33,2,5,224,0,0,224,230,0.683,0.974
"8170","La Paz","Viacha","Esc. Viliroco",16,0,8,0,166,1,20,0,3,214,1,7,222,234,0.776,0.949
"8171","La Paz","Viacha","Esc. Viliroco",9,0,5,1,171,2,15,1,3,207,3,10,220,225,0.826,0.978
"8172","La Paz","Viacha","Esc. Viliroco",22,0,3,1,152,2,24,0,1,205,3,8,216,229,0.741,0.943
"8173","La Paz","Viacha","Col. Hacia El Mar",4,3,9,0,148,0,9,1,4,178,4,8,190,205,0.831,0.927
"8174","La Paz","Viacha","Col. Hacia El Mar",3,4,7,1,154,0,8,0,0,177,7,16,200,219,0.87,0.913
"8175","La Paz","Viacha","Col. Hacia El Mar",9,1,7,0,166,1,8,0,1,193,3,9,205,214,0.86,0.958
"8176","La Paz","Viacha","Col. Hacia El Mar",5,2,11,0,155,1,10,0,3,187,2,6,195,210,0.829,0.929
"8177","La Paz","Viacha","Colegio Jhonn F. Kennedi",13,3,11,1,141,2,13,0,0,184,4,10,198,214,0.766,0.925
"8178","La Paz","Viacha","Colegio Jhonn F. Kennedi",10,1,15,1,147,0,21,0,2,197,4,9,210,219,0.746,0.959
"8179","La Paz","Viacha","Colegio Jhonn F. Kennedi",17,2,9,2,134,1,18,0,1,184,4,11,199,214,0.728,0.93
"8180","La Paz","Viacha","Esc. Achica Arriba",11,3,8,1,150,2,14,1,0,190,3,8,201,212,0.789,0.948
"8181","La Paz","Viacha","Esc. Achica Arriba",8,0,3,0,151,4,25,0,1,192,3,13,208,222,0.786,0.937
"8182","La Paz","Viacha","Esc. Achica Arriba",6,0,5,0,143,0,17,1,3,175,7,6,188,205,0.817,0.917
"8183","La Paz","Viacha","Esc. Achica Arriba",8,0,7,0,153,3,19,2,1,193,4,6,203,218,0.793,0.931
"8184","La Paz","Viacha","Esc. Achica Arriba",11,1,10,1,157,4,17,0,0,201,3,13,217,228,0.781,0.952
"8185","La Paz","Viacha","U.E. Elizardo Pérez",7,0,9,2,148,1,5,1,0,173,8,6,187,206,0.855,0.908
"8186","La Paz","Viacha","Unidad Educativa Litoral",3,2,11,4,145,2,9,1,0,177,8,12,197,211,0.819,0.934
"8187","La Paz","Viacha","U.E. Hichuraya Baja",5,0,4,1,157,9,13,0,0,189,10,8,207,223,0.831,0.928
"8188","La Paz","Viacha","Col. Nal. Mixto Calama",5,3,2,1,154,4,5,1,2,177,3,10,190,198,0.87,0.96
"8189","La Paz","Viacha","U.E. José Ballivian de Hichuraya",2,1,11,0,146,1,11,1,0,173,3,12,188,199,0.844,0.945
"8190","La Paz","Viacha","Esc. Centro Tilata",17,2,7,0,155,2,15,0,2,200,4,4,208,230,0.775,0.904
"8191","La Paz","Viacha","Esc. Centro Tilata",37,1,6,0,139,0,25,0,0,208,0,5,213,235,0.668,0.906
"8192","La Paz","Viacha","Esc. Centro Tilata",31,0,2,0,151,4,26,0,4,218,3,4,225,238,0.693,0.945
"8193","La Paz","Viacha","Esc. Centro Tilata",22,2,9,1,141,2,25,0,2,204,1,6,211,233,0.691,0.906
"8194","La Paz","Viacha","Esc. Centro Tilata",34,1,6,0,142,1,21,1,1,207,3,6,216,232,0.686,0.931
"8195","La Paz","Viacha","Esc. Centro Tilata",23,1,5,0,134,0,22,0,2,187,1,7,195,225,0.717,0.867
"8196","La Paz","Viacha","Esc. Centro Tilata",25,2,10,0,133,3,28,2,2,205,1,15,221,235,0.649,0.94
"8197","La Paz","Viacha","Esc. Centro Tilata",29,1,6,0,132,4,22,0,1,195,4,10,209,231,0.677,0.905
"8198","La Paz","Viacha","Esc. Centro Tilata",18,1,10,1,156,1,20,0,3,210,3,5,218,230,0.743,0.948
"8199","La Paz","Viacha","Esc. Centro Tilata",30,3,4,1,135,3,29,0,0,205,1,11,217,229,0.659,0.948
"8200","La Paz","Viacha","Esc. Centro Tilata",20,2,6,0,145,0,23,2,2,200,0,8,208,230,0.725,0.904
"8201","La Paz","Viacha","Esc. Centro Tilata",35,0,8,0,131,5,25,0,4,208,1,7,216,226,0.63,0.956
"8202","La Paz","Viacha","Esc. Centro Tilata",22,0,8,0,143,2,19,0,2,196,2,15,213,227,0.73,0.938
"8203","La Paz","Viacha","Esc. Centro Tilata",24,1,3,1,149,3,16,1,1,199,2,10,211,229,0.749,0.921
"8204","La Paz","Viacha","Esc. Centro Tilata",21,0,12,1,139,1,28,0,3,205,2,7,214,232,0.678,0.922
"8205","La Paz","Viacha","Esc. Centro Tilata",23,1,8,0,146,2,21,0,1,202,4,4,210,230,0.723,0.913
"8206","La Paz","Viacha","Esc. Centro Tilata",21,2,9,2,141,1,26,0,2,204,1,8,213,232,0.691,0.918
"8207","La Paz","Viacha","Esc. Centro Tilata",31,2,1,0,135,1,24,0,1,195,2,13,210,227,0.692,0.925
"8208","La Paz","Viacha","Esc. Centro Tilata",17,2,4,1,156,1,21,2,2,206,0,7,213,229,0.757,0.93
"8209","La Paz","Viacha","Esc. Centro Tilata",23,0,4,1,142,0,29,0,3,202,0,11,213,231,0.703,0.922
"8210","La Paz","Viacha","Esc. Centro Tilata",22,0,13,0,137,4,23,0,2,201,2,8,211,230,0.682,0.917
"8211","La Paz","Viacha","Esc. Centro Tilata",27,1,7,1,131,1,28,0,3,199,3,7,209,230,0.658,0.909
"8212","La Paz","Viacha","Esc. Centro Tilata",29,4,8,0,138,2,16,0,0,197,0,11,208,231,0.701,0.9
"8213","La Paz","Viacha","Esc. Centro Tilata",26,0,7,0,143,3,21,1,1,202,6,8,216,232,0.708,0.931
"8214","La Paz","Viacha","Esc. Centro Tilata",29,1,3,1,138,3,26,0,1,202,8,6,216,226,0.683,0.956
"8215","La Paz","Viacha","Esc. Centro Tilata",24,1,8,1,145,2,25,0,1,207,0,9,216,234,0.7,0.923
"8216","La Paz","Viacha","Esc. Centro Tilata",24,2,4,1,141,2,16,0,2,192,2,8,202,226,0.734,0.894
"8217","La Paz","Viacha","Esc. Centro Tilata",23,1,5,2,132,3,34,1,4,205,3,5,213,227,0.644,0.938
"8218","La Paz","Viacha","Esc. Centro Tilata",28,0,7,1,127,4,30,0,1,198,4,9,211,229,0.641,0.921
"8219","La Paz","Viacha","Esc. Centro Tilata",26,0,11,0,137,0,28,0,1,203,3,11,217,232,0.675,0.935
"8220","La Paz","Viacha","Esc. Centro Tilata",23,2,4,0,145,2,30,0,0,206,4,8,218,238,0.704,0.916
"8221","La Paz","Viacha","Esc. Centro Tilata",32,0,6,0,124,6,23,0,0,191,2,9,202,227,0.649,0.89
"8222","La Paz","Viacha","Esc. Centro Tilata",16,1,7,0,147,0,26,0,3,200,2,7,209,229,0.735,0.913
"8223","La Paz","Viacha","Esc. Centro Tilata",21,2,7,1,128,2,36,2,1,200,3,7,210,226,0.64,0.929
"8224","La Paz","Viacha","Esc. Centro Tilata",29,0,8,1,128,2,22,0,4,194,1,10,205,231,0.66,0.887
"8225","La Paz","Viacha","Esc. Centro Tilata",27,1,7,0,128,2,26,0,3,194,0,6,200,223,0.66,0.897
"8226","La Paz","Viacha","Esc. Centro Tilata",15,1,9,0,152,1,17,1,1,197,2,11,210,233,0.772,0.901
"8227","La Paz","Viacha","Esc. Centro Tilata",23,1,7,1,143,2,29,0,2,208,1,8,217,229,0.688,0.948
"8228","La Paz","Viacha","Esc. Centro Tilata",27,0,6,0,147,2,22,1,3,208,1,6,215,230,0.707,0.935
"8229","La Paz","Viacha","Esc. Centro Tilata",22,1,7,1,146,2,21,0,2,202,3,5,210,228,0.723,0.921
"8230","La Paz","Viacha","Esc. Centro Tilata",29,7,7,1,149,0,20,0,1,214,3,1,218,232,0.696,0.94
"8231","La Paz","Viacha","Esc. Centro Tilata",29,0,7,1,139,2,22,0,1,201,2,8,211,228,0.692,0.925
"8232","La Paz","Viacha","Esc. Centro Tilata",17,0,8,0,154,1,27,1,2,210,4,5,219,233,0.733,0.94
"8233","La Paz","Viacha","Esc. Centro Tilata",26,0,7,0,135,3,28,0,2,201,0,2,203,228,0.672,0.89
"8234","La Paz","Viacha","Esc. Centro Tilata",17,2,6,0,147,3,23,0,2,200,1,9,210,233,0.735,0.901
"8235","La Paz","Viacha","Esc. Centro Tilata",31,1,6,1,139,2,26,0,1,207,4,3,214,233,0.671,0.918
"8236","La Paz","Viacha","Esc. Centro Tilata",34,2,4,1,144,2,23,1,2,213,0,1,214,229,0.676,0.934
"8237","La Paz","Viacha","Esc. Centro Tilata",31,1,3,0,150,2,18,0,0,205,0,9,214,229,0.732,0.934
"8238","La Paz","Viacha","Esc. Centro Tilata",30,0,13,1,132,2,26,0,1,205,3,6,214,232,0.644,0.922
"8239","La Paz","Viacha","Esc. Centro Tilata",24,4,6,0,137,0,13,0,4,188,2,10,200,225,0.729,0.889
"8240","La Paz","Viacha","Esc. Centro Tilata",30,1,8,2,127,1,28,1,3,201,2,8,211,230,0.632,0.917
"8241","La Paz","Viacha","Esc. Centro Tilata",17,0,15,1,149,0,18,0,3,203,1,6,210,226,0.734,0.929
"8242","La Paz","Viacha","Esc. Centro Tilata",25,0,8,0,138,5,25,0,1,202,1,5,208,230,0.683,0.904
"8243","La Paz","Viacha","Esc. Centro Tilata",21,2,5,1,141,2,13,2,0,187,2,6,195,221,0.754,0.882
"8244","La Paz","Viacha","Esc. Centro Tilata",27,9,0,0,136,0,27,0,0,199,0,9,208,231,0.683,0.9
"8245","La Paz","Viacha","Esc. Centro Tilata",18,0,7,0,146,2,24,0,2,199,1,10,210,227,0.734,0.925
"8246","La Paz","Viacha","Esc. Centro Tilata",26,0,10,0,141,2,25,1,3,208,1,6,215,232,0.678,0.927
"8247","La Paz","Viacha","Esc. Centro Tilata",24,1,4,0,146,0,25,0,4,204,0,9,213,231,0.716,0.922
"8248","La Paz","Viacha","Esc. Centro Tilata",35,0,8,0,137,2,14,0,3,199,1,8,208,228,0.688,0.912
"8249","La Paz","Viacha","Esc. Centro Tilata",24,2,6,0,132,2,22,0,1,189,3,6,198,221,0.698,0.896
"8250","La Paz","Viacha","Esc. Centro Tilata",40,0,6,0,141,1,21,1,1,211,1,5,217,235,0.668,0.923
"8251","La Paz","Viacha","Esc. Centro Tilata",21,0,7,2,136,3,27,0,3,199,5,7,211,229,0.683,0.921
"8252","La Paz","Viacha","Esc. Centro Tilata",22,0,10,0,139,4,32,0,1,208,2,7,217,234,0.668,0.927
"8253","La Paz","Viacha","Esc. Centro Tilata",26,0,3,0,149,1,25,0,3,207,0,6,213,232,0.72,0.918
"8254","La Paz","Viacha","Esc. Centro Tilata",34,0,6,1,132,2,27,0,2,204,1,5,210,229,0.647,0.917
"8255","La Paz","Viacha","Esc. Centro Tilata",25,1,9,2,128,1,24,0,3,193,2,6,201,225,0.663,0.893
"8256","La Paz","Viacha","Esc. Centro Tilata",30,0,5,0,138,1,28,0,4,206,0,11,217,234,0.67,0.927
"8257","La Paz","Viacha","Esc. Centro Tilata",31,1,5,0,143,1,18,0,0,199,2,9,210,236,0.719,0.89
"8258","La Paz","Viacha","Esc. Centro Tilata",36,0,10,0,130,7,18,0,2,203,4,6,213,231,0.64,0.922
"8259","La Paz","Viacha","Esc. Centro Tilata",32,0,6,3,136,2,22,0,0,201,2,8,211,229,0.677,0.921
"8260","La Paz","Viacha","Esc. Centro Tilata",26,1,14,0,141,2,25,1,0,210,2,5,217,232,0.671,0.935
"8261","La Paz","Viacha","U.E. 14 de Noviembre Paz y Unidad",31,1,7,0,158,0,21,0,1,219,2,6,227,237,0.721,0.958
"8262","La Paz","Viacha","U.E. 14 de Noviembre Paz y Unidad",30,0,10,0,148,5,30,0,3,226,4,3,233,238,0.655,0.979
"8263","La Paz","Viacha","U.E. 14 de Noviembre Paz y Unidad",22,1,6,0,149,2,40,0,0,220,2,5,227,240,0.677,0.946
"8264","La Paz","Viacha","U.E. 14 de Noviembre Paz y Unidad",20,1,5,0,157,2,29,0,1,215,1,13,229,240,0.73,0.954
"8265","La Paz","Viacha","U.E. 14 de Noviembre Paz y Unidad",31,0,6,2,147,1,29,2,1,219,1,8,228,240,0.671,0.95
"8266","La Paz","Viacha","U.E. 14 de Noviembre Paz y Unidad",22,0,11,3,153,1,20,0,0,210,0,8,218,238,0.729,0.916
"8267","La Paz","Viacha","U.E. 14 de Noviembre Paz y Unidad",22,0,7,0,162,1,25,0,1,218,1,11,230,240,0.743,0.958
"8268","La Paz","Viacha","U.E. 14 de Noviembre Paz y Unidad",27,1,6,2,156,8,21,0,5,226,2,5,233,238,0.69,0.979
"8269","La Paz","Viacha","U.E. 14 de Noviembre Paz y Unidad",29,0,6,0,155,1,26,2,1,220,0,10,230,240,0.705,0.958
"8270","La Paz","Viacha","U.E. 14 de Noviembre Paz y Unidad",29,1,7,0,165,3,30,0,1,236,1,4,241,249,0.699,0.968
"8271","La Paz","Viacha","U.E. República de Japón",32,1,1,1,154,1,24,0,1,215,2,7,224,237,0.716,0.945
"8272","La Paz","Viacha","U.E. República de Japón",23,0,2,0,157,2,36,0,1,221,1,5,227,239,0.71,0.95
"8273","La Paz","Viacha","U.E. República de Japón",28,1,7,2,147,3,26,1,2,217,1,5,223,239,0.677,0.933
"8274","La Paz","Viacha","U.E. República de Japón",17,1,5,0,152,5,27,0,4,211,5,5,221,237,0.72,0.932
"8275","La Paz","Viacha","U.E. República de Japón",20,0,6,1,159,3,28,2,3,222,1,5,228,240,0.716,0.95
"8276","La Paz","Viacha","U.E. República Islámica de Irán",43,1,6,1,126,3,36,0,1,217,1,5,223,236,0.581,0.945
"8277","La Paz","Viacha","U.E. República Islámica de Irán",32,1,10,0,146,4,30,1,3,227,1,6,234,240,0.643,0.975
"8278","La Paz","Viacha","Unidad Educativa Toncopujio",4,0,6,0,152,0,3,0,0,165,3,11,179,190,0.921,0.942
"8279","La Paz","Viacha","U.E. Bartolina Sisa",9,1,5,1,175,3,11,1,1,207,11,18,236,239,0.845,0.987
"8280","La Paz","Puerto Mayor de Guaqui","Colegio Daniel Sanchez Bustamante",12,0,4,2,112,4,14,1,2,151,5,16,172,202,0.742,0.851
"8281","La Paz","Puerto Mayor de Guaqui","Colegio Daniel Sanchez Bustamante",28,1,9,0,113,5,14,3,3,176,2,2,180,221,0.642,0.814
"8282","La Paz","Puerto Mayor de Guaqui","Colegio Daniel Sanchez Bustamante",17,2,4,2,124,1,12,1,4,167,6,9,182,210,0.743,0.867
"8283","La Paz","Puerto Mayor de Guaqui","Colegio Daniel Sanchez Bustamante",28,0,7,1,119,5,18,3,1,182,3,6,191,211,0.654,0.905
"8284","La Paz","Puerto Mayor de Guaqui","Col. Tomas Katari",7,1,14,0,138,2,23,1,0,186,3,5,194,217,0.742,0.894
"8285","La Paz","Puerto Mayor de Guaqui","Col. Tomas Katari",12,1,5,3,140,1,14,0,0,176,9,8,193,209,0.795,0.923
"8286","La Paz","Puerto Mayor de Guaqui","Col. Tomas Katari",4,2,9,1,160,3,12,0,1,192,5,9,206,221,0.833,0.932
"8287","La Paz","Puerto Mayor de Guaqui","Col. Tomas Katari",7,1,11,0,140,0,19,1,0,179,4,10,193,212,0.782,0.91
"8288","La Paz","Puerto Mayor de Guaqui","Col. Tomas Katari",13,3,5,0,129,0,31,1,2,184,5,16,205,220,0.701,0.932
"8289","La Paz","Puerto Mayor de Guaqui","Col. Tomas Katari",1,3,14,2,144,0,22,2,0,188,4,9,201,223,0.766,0.901
"8290","La Paz","Puerto Mayor de Guaqui","Col. Tomas Katari",3,0,10,1,153,3,18,1,2,191,7,5,203,217,0.801,0.935
"8291","La Paz","Puerto Mayor de Guaqui","Col. Tomas Katari",6,1,13,2,128,3,23,0,1,177,5,20,202,215,0.723,0.94
"8292","La Paz","Puerto Mayor de Guaqui","Esc. Ismael Montes",27,1,4,0,113,1,15,0,3,164,3,4,171,218,0.689,0.784
"8293","La Paz","Puerto Mayor de Guaqui","Esc. Ismael Montes",26,1,6,1,115,0,16,0,0,165,5,3,173,216,0.697,0.801
"8294","La Paz","Puerto Mayor de Guaqui","Esc. Ismael Montes",25,0,4,0,99,1,25,0,0,154,1,7,162,224,0.643,0.723
"8295","La Paz","Puerto Mayor de Guaqui","Esc. Ismael Montes",19,0,6,0,109,3,13,1,2,153,3,4,160,217,0.712,0.737
"8296","La Paz","Puerto Mayor de Guaqui","Unidad Educativa Wilacollo",5,1,12,1,145,3,11,0,3,181,6,9,196,216,0.801,0.907
"8297","La Paz","Tiahuanacu","Colegio Nacional Arturo Posnanski",23,2,8,1,118,6,19,0,2,179,7,9,195,206,0.659,0.947
"8298","La Paz","Tiahuanacu","Colegio Nacional Arturo Posnanski",18,2,9,1,131,2,17,1,0,181,7,8,196,213,0.724,0.92
"8299","La Paz","Tiahuanacu","Colegio Nacional Arturo Posnanski",16,2,6,2,131,0,17,0,3,177,8,4,189,204,0.74,0.926
"8300","La Paz","Tiahuanacu","Colegio Nacional Arturo Posnanski",13,3,8,0,148,1,19,0,0,192,2,6,200,221,0.771,0.905
"8301","La Paz","Tiahuanacu","Colegio Nacional Arturo Posnanski",15,1,5,1,138,1,19,2,2,184,4,11,199,213,0.75,0.934
"8302","La Paz","Tiahuanacu","Colegio Nacional Arturo Posnanski",11,0,13,1,121,1,27,0,0,174,2,16,192,212,0.695,0.906
"8303","La Paz","Tiahuanacu","Colegio Nacional Arturo Posnanski",19,1,9,0,129,4,19,1,1,183,5,11,199,210,0.705,0.948
"8304","La Paz","Tiahuanacu","Colegio Nacional Arturo Posnanski",13,3,12,0,134,2,16,0,0,180,9,10,199,213,0.744,0.934
"8305","La Paz","Tiahuanacu","Colegio Nacional Arturo Posnanski",20,1,9,1,131,5,18,1,1,187,5,6,198,213,0.701,0.93
"8306","La Paz","Tiahuanacu","Colegio Nacional Arturo Posnanski",13,0,14,2,137,1,22,2,1,192,5,7,204,221,0.714,0.923
"8307","La Paz","Tiahuanacu","Colegio Nacional Arturo Posnanski",20,0,9,0,128,1,18,1,2,179,7,11,197,213,0.715,0.925
"8308","La Paz","Tiahuanacu","Colegio Nacional Arturo Posnanski",18,2,12,1,131,4,30,1,1,200,4,9,213,218,0.655,0.977
"8309","La Paz","Tiahuanacu","Colegio Nacional Arturo Posnanski",11,1,6,1,134,1,14,1,0,169,8,15,192,211,0.793,0.91
"8310","La Paz","Tiahuanacu","Colegio Nacional Arturo Posnanski",10,1,9,0,158,2,12,0,2,194,1,8,203,221,0.814,0.919
"8311","La Paz","Tiahuanacu","Colegio Nacional Arturo Posnanski",4,2,11,0,148,0,22,0,1,188,6,11,205,220,0.787,0.932
"8312","La Paz","Tiahuanacu","Colegio Nacional Arturo Posnanski",15,1,10,2,134,3,15,1,2,183,2,9,194,212,0.732,0.915
"8313","La Paz","Tiahuanacu","Colegio Nacional Arturo Posnanski",6,0,6,0,158,1,11,1,2,185,4,13,202,215,0.854,0.94
"8314","La Paz","Tiahuanacu","Colegio Jose Ballivian",3,1,15,1,157,2,15,1,0,195,4,5,204,219,0.805,0.932
"8315","La Paz","Tiahuanacu","Colegio Jose Ballivian",6,1,12,3,153,3,19,1,2,200,2,2,204,216,0.765,0.944
"8316","La Paz","Tiahuanacu","Colegio Jose Ballivian",5,0,13,0,140,2,28,0,0,188,8,12,208,224,0.745,0.929
"8317","La Paz","Tiahuanacu","Colegio Jose Ballivian",2,0,10,0,162,0,12,1,0,187,5,6,198,214,0.866,0.925
"8318","La Paz","Tiahuanacu","Colegio Jose Ballivian",8,2,10,1,145,5,17,0,0,188,3,1,192,205,0.771,0.937
"8319","La Paz","Tiahuanacu","Colegio Jose Ballivian",7,2,20,0,128,3,30,0,0,190,4,11,205,222,0.674,0.923
"8320","La Paz","Tiahuanacu","Esc. Central Pillapi",7,0,4,0,169,4,15,0,0,199,7,6,212,226,0.849,0.938
"8321","La Paz","Tiahuanacu","Esc. Central Pillapi",9,1,6,1,162,3,13,0,0,195,8,8,211,225,0.831,0.938
"8322","La Paz","Tiahuanacu","Esc. Central Pillapi",5,0,8,1,144,4,18,0,1,181,6,10,197,210,0.796,0.938
"8323","La Paz","Tiahuanacu","Esc. Central Pillapi",6,0,3,2,160,3,15,1,1,191,3,8,202,214,0.838,0.944
"8324","La Paz","Tiahuanacu","Esc. Central Pillapi",3,1,8,0,140,3,15,0,2,172,6,6,184,192,0.814,0.958
"8325","La Paz","Desaguadero","Col. Batallon Colorados",49,0,12,0,100,3,27,1,1,193,2,11,206,218,0.518,0.945
"8326","La Paz","Desaguadero","Col. Batallon Colorados",44,0,8,1,86,4,44,2,1,190,2,6,198,217,0.453,0.912
"8327","La Paz","Desaguadero","Col. Batallon Colorados",74,3,8,1,74,1,39,1,0,201,1,4,206,221,0.368,0.932
"8328","La Paz","Desaguadero","Col. Batallon Colorados",42,0,14,2,91,2,35,0,0,186,3,11,200,224,0.489,0.893
"8329","La Paz","Desaguadero","Col. Batallon Colorados",65,1,8,0,76,2,29,3,3,187,5,7,199,220,0.406,0.905
"8330","La Paz","Desaguadero","Col. Batallon Colorados",46,3,27,0,68,2,10,1,2,159,6,15,180,212,0.428,0.849
"8331","La Paz","Desaguadero","Col. Batallon Colorados",59,3,16,0,76,3,38,1,0,196,3,9,208,225,0.388,0.924
"8332","La Paz","Desaguadero","Col. Batallon Colorados",42,1,13,1,84,4,32,1,2,180,4,17,201,225,0.467,0.893
"8333","La Paz","Desaguadero","Col. Batallon Colorados",59,1,12,2,78,4,36,0,5,197,6,6,209,227,0.396,0.921
"8334","La Paz","Desaguadero","Col. Batallon Colorados",53,1,17,1,93,1,24,0,0,190,5,11,206,220,0.489,0.936
"8335","La Paz","Desaguadero","Col. Batallon Colorados",42,1,22,0,84,7,38,3,1,198,6,11,215,229,0.424,0.939
"8336","La Paz","Desaguadero","Col. Batallon Colorados",47,2,17,2,88,5,23,1,1,186,4,8,198,227,0.473,0.872
"8337","La Paz","Desaguadero","Col. Batallon Colorados",54,1,12,2,70,5,33,0,4,181,1,21,203,219,0.387,0.927
"8338","La Paz","Desaguadero","Esc. Azafranal",8,2,14,1,132,1,18,2,0,178,4,3,185,204,0.742,0.907
"8339","La Paz","Desaguadero","Esc. Mcal. Andres De Santa Cruz",13,7,7,1,126,1,8,0,0,163,9,6,178,200,0.773,0.89
"8340","La Paz","Desaguadero","Esc. Mcal. Andres De Santa Cruz",15,3,4,4,124,1,10,1,0,162,6,11,179,204,0.765,0.877
"8341","La Paz","La (Marka) San Andrés de Machaca","Escuela de San Andres De Machaca",4,0,3,1,140,1,8,0,0,157,3,1,161,204,0.892,0.789
"8342","La Paz","La (Marka) San Andrés de Machaca","Escuela de San Andres De Machaca",14,1,6,0,124,2,14,1,1,163,1,6,170,210,0.761,0.81
"8343","La Paz","La (Marka) San Andrés de Machaca","Esc. Nucleo Laquinamaya",5,2,12,0,135,1,4,0,2,161,4,4,169,201,0.839,0.841
"8344","La Paz","La (Marka) San Andrés de Machaca","U.E. Alto de la Alianza",12,2,5,0,120,1,20,0,0,160,6,7,173,205,0.75,0.844
"8345","La Paz","La (Marka) San Andrés de Machaca","Colegio Tupak Katari De Conchacollo",3,2,18,0,137,1,13,0,2,176,5,15,196,210,0.778,0.933
"8346","La Paz","La (Marka) San Andrés de Machaca","Unidad Educativa Rosa Pata Erben Kalla",1,0,7,1,128,1,12,1,1,152,3,6,161,165,0.842,0.976
"8347","La Paz","Jesús de Machaka","U.E. Manuel Isidoro Belzu",6,4,23,1,132,0,16,0,2,184,5,7,196,215,0.717,0.912
"8348","La Paz","Jesús de Machaka","U.E. Manuel Isidoro Belzu",7,2,17,0,128,1,13,0,2,170,8,9,187,203,0.753,0.921
"8349","La Paz","Jesús de Machaka","Col. Rep. De Noruega",10,0,23,3,139,0,9,1,0,185,1,13,199,210,0.751,0.948
"8350","La Paz","Jesús de Machaka","Col. Rep. De Noruega",5,0,24,2,142,0,8,0,0,181,3,2,186,189,0.785,0.984
"8351","La Paz","Jesús de Machaka","U.E. Titicani Tucari",6,2,20,1,133,0,19,1,0,182,3,13,198,212,0.731,0.934
"8352","La Paz","Jesús de Machaka","Posta Sanitaria",7,0,11,0,149,0,9,0,2,178,7,3,188,209,0.837,0.9
"8353","La Paz","Jesús de Machaka","Colegio Chama",9,1,17,1,153,2,8,0,0,191,1,10,202,212,0.801,0.953
"8354","La Paz","Jesús de Machaka","U.E. Neptal Viris",11,0,21,2,129,1,25,0,0,189,4,6,199,208,0.683,0.957
"8355","La Paz","Jesús de Machaka","U.E. Neptal Viris",8,0,14,1,146,1,22,1,2,195,2,5,202,216,0.749,0.935
"8356","La Paz","Jesús de Machaka","Esc. San Felipe De Corpa",1,1,15,0,162,2,18,0,0,199,4,5,208,222,0.814,0.937
"8357","La Paz","Jesús de Machaka","Esc. San Felipe De Corpa",1,0,11,0,178,0,8,0,1,199,4,8,211,220,0.894,0.959
"8358","La Paz","Jesús de Machaka","Esc. San Felipe De Corpa",5,0,11,3,170,1,8,0,0,198,3,4,205,216,0.859,0.949
"8359","La Paz","Jesús de Machaka","Esc. San Felipe De Corpa",1,0,28,0,149,0,17,2,0,197,8,4,209,218,0.756,0.959
"8360","La Paz","Jesús de Machaka","Esc. San Felipe De Corpa",2,1,12,0,156,1,16,0,0,188,2,8,198,207,0.83,0.957
"8361","La Paz","Jesús de Machaka","Escuela German Busch",2,2,21,0,136,1,11,0,0,173,3,11,187,199,0.786,0.94
"8362","La Paz","Jesús de Machaka","U.E. José Carrasco",3,0,12,0,167,1,20,0,1,204,2,3,209,223,0.819,0.937
"8363","La Paz","Jesús de Machaka","Esc. Nucleo Cuipa Espana de Machaca",1,2,15,0,170,0,8,0,1,197,9,8,214,216,0.863,0.991
"8364","La Paz","Jesús de Machaka","Col. Mejillones",16,3,19,0,121,4,14,0,0,177,2,8,187,204,0.684,0.917
"8365","La Paz","Jesús de Machaka","Col. Holanda",6,2,27,1,119,0,10,0,1,166,2,12,180,196,0.717,0.918
"8366","La Paz","Jesús de Machaka","Col. Holanda",2,6,31,3,106,0,16,3,1,168,7,14,189,204,0.631,0.926
"8367","La Paz","Jesús de Machaka","Sede Social",5,2,19,3,134,2,10,0,1,176,7,3,186,198,0.761,0.939
"8368","La Paz","Taraco","Esc. Taraco",6,1,11,2,138,1,13,1,3,176,7,13,196,212,0.784,0.925
"8369","La Paz","Taraco","Esc. Taraco",12,2,10,1,130,1,21,0,0,177,3,7,187,208,0.734,0.899
"8370","La Paz","Taraco","Esc. Taraco",8,1,11,1,125,0,21,0,2,169,6,12,187,203,0.74,0.921
"8371","La Paz","Taraco","Esc. Taraco",7,2,11,2,147,4,13,0,0,186,5,8,199,210,0.79,0.948
"8372","La Paz","Taraco","Esc. Taraco",6,4,9,1,141,4,12,0,4,181,4,11,196,215,0.779,0.912
"8373","La Paz","Taraco","Esc. Taraco",13,3,16,4,130,2,17,1,3,189,3,9,201,214,0.688,0.939
"8374","La Paz","Taraco","Esc. Taraco",10,0,5,2,143,1,14,0,3,178,3,14,195,212,0.803,0.92
"8375","La Paz","Taraco","Col. Nucleo Fray Jose Zampa",7,1,10,2,153,2,12,0,1,188,6,7,201,210,0.814,0.957
"8376","La Paz","Taraco","Sede Social",5,1,16,1,137,3,9,0,1,173,6,10,189,213,0.792,0.887
"8377","La Paz","Taraco","Col. Ovando Candia",6,0,11,2,139,2,7,0,0,167,4,4,175,197,0.832,0.888
"8378","La Paz","Taraco","Col. Ovando Candia",7,0,14,2,134,1,13,0,1,172,8,9,189,203,0.779,0.931
"8379","La Paz","Luribay","Col. Rvdo. Victor Aruazo-Plaza Principal",27,1,7,1,131,0,16,0,1,184,3,5,192,218,0.712,0.881
"8380","La Paz","Luribay","Col. Rvdo. Victor Aruazo-Plaza Principal",8,0,11,0,162,0,17,0,1,199,0,3,202,219,0.814,0.922
"8381","La Paz","Luribay","Col. Rvdo. Victor Aruazo-Plaza Principal",14,0,7,1,144,1,13,1,0,181,1,3,185,211,0.796,0.877
"8382","La Paz","Luribay","Colegio Azambo",2,0,10,0,161,1,8,0,0,182,9,5,196,207,0.885,0.947
"8383","La Paz","Luribay","Colegio Azambo",6,1,20,0,176,0,23,0,0,226,3,4,233,238,0.779,0.979
"8384","La Paz","Luribay","Escuela Anquimoa",4,0,2,0,182,0,10,0,0,198,0,5,203,220,0.919,0.923
"8385","La Paz","Luribay","Escuela Anquimoa",5,3,8,0,164,1,5,0,1,187,7,8,202,217,0.877,0.931
"8386","La Paz","Luribay","Colegio Villa Litoral",7,1,3,1,179,0,5,0,1,197,2,4,203,220,0.909,0.923
"8387","La Paz","Luribay","Colegio Villa Litoral",6,0,6,0,186,0,8,0,0,206,0,2,208,220,0.903,0.945
"8388","La Paz","Luribay","Escuela El Porvenir",15,1,11,1,144,0,13,0,0,185,3,4,192,210,0.778,0.914
"8389","La Paz","Luribay","Escuela El Porvenir",13,1,7,0,167,2,8,0,0,198,0,4,202,215,0.843,0.94
"8390","La Paz","Luribay","Unidad Educativa Pedro Domingo Murillo",5,1,3,1,168,1,12,1,0,192,4,4,200,215,0.875,0.93
"8391","La Paz","Luribay","Unidad Educativa Pedro Domingo Murillo",12,2,5,1,156,1,18,1,0,196,1,2,199,221,0.796,0.9
"8392","La Paz","Luribay","Unidad Educativa Pedro Domingo Murillo",11,0,7,0,151,1,13,0,0,183,6,13,202,225,0.825,0.898
"8393","La Paz","Luribay","U.E. Simón Bolívar",6,1,4,1,164,1,12,0,1,190,2,2,194,212,0.863,0.915
"8394","La Paz","Luribay","U.E. Simón Bolívar",8,0,12,1,154,1,12,0,2,190,1,5,196,212,0.811,0.925
"8395","La Paz","Luribay","Unidad Educativa Colliri",3,1,10,1,169,2,9,0,0,195,1,2,198,223,0.867,0.888
"8396","La Paz","Luribay","Unidad Educativa Poroma",6,0,6,0,162,3,8,1,0,186,0,2,188,204,0.871,0.922
"8397","La Paz","Luribay","U.E. Anchallani República Venezuela",3,2,7,1,166,0,4,1,0,184,0,12,196,210,0.902,0.933
"8398","La Paz","Luribay","U.E. Anchallani República Venezuela",5,0,7,1,191,0,2,0,0,206,0,8,214,228,0.927,0.939
"8399","La Paz","Luribay","Escuela Murmuntani",1,1,4,0,161,0,8,1,0,176,5,3,184,201,0.915,0.915
"8400","La Paz","Luribay","Esc. Unidad Educativa Bravo",4,0,17,0,173,3,11,1,0,209,1,6,216,236,0.828,0.915
"8401","La Paz","Luribay","U.E. Eduardo Abaroa",8,0,3,0,202,0,7,0,0,220,8,5,233,240,0.918,0.971
"8402","La Paz","Sapahaqui","Unidad Educativa Sapahaqui",13,2,5,0,161,1,13,2,0,197,5,8,210,224,0.817,0.938
"8403","La Paz","Sapahaqui","Unidad Educativa Sapahaqui",12,1,8,2,150,3,24,0,0,200,5,1,206,220,0.75,0.936
"8404","La Paz","Sapahaqui","Unidad Educativa Sapahaqui",9,2,8,2,138,1,17,0,1,178,8,13,199,216,0.775,0.921
"8405","La Paz","Sapahaqui","Unidad Educativa Sapahaqui",9,2,11,1,143,1,22,1,2,192,6,6,204,221,0.745,0.923
"8406","La Paz","Sapahaqui","Unidad Educativa Sapahaqui",9,2,11,0,145,1,16,0,0,184,6,5,195,216,0.788,0.903
"8407","La Paz","Sapahaqui","Unidad Educativa Sapahaqui",8,1,7,1,140,2,24,1,0,184,10,10,204,228,0.761,0.895
"8408","La Paz","Sapahaqui","Unidad Educativa Sapahaqui",18,1,7,0,146,0,10,1,0,183,3,9,195,218,0.798,0.894
"8409","La Paz","Sapahaqui","Unidad Educativa Sapahaqui",11,3,6,1,140,3,22,0,0,186,9,8,203,225,0.753,0.902
"8410","La Paz","Sapahaqui","U.E. Huancane",16,0,11,1,174,0,7,1,3,213,2,3,218,221,0.817,0.986
"8411","La Paz","Sapahaqui","U.E. Huancane",1,0,10,1,134,0,6,0,0,152,3,0,155,159,0.882,0.975
"8412","La Paz","Sapahaqui","Unidad Educativa Chivisivi",9,1,3,1,161,1,9,1,0,186,7,4,197,214,0.866,0.921
"8413","La Paz","Sapahaqui","Unidad Educativa Chivisivi",8,1,4,1,151,1,18,1,0,185,7,6,198,213,0.816,0.93
"8414","La Paz","Sapahaqui","Unidad Educativa Chivisivi",7,0,7,0,147,1,18,0,0,180,6,8,194,214,0.817,0.907
"8415","La Paz","Sapahaqui","Unidad Educativa Tacobamba",8,0,2,0,146,0,16,0,0,172,9,10,191,213,0.849,0.897
"8416","La Paz","Sapahaqui","Unidad Educativa Tacobamba",9,0,2,1,155,1,10,0,1,179,4,11,194,212,0.866,0.915
"8417","La Paz","Sapahaqui","Unidad Educativa Tacobamba",10,1,3,0,151,0,14,1,0,180,6,13,199,213,0.839,0.934
"8418","La Paz","Sapahaqui","Unidad Educativa San Marcos",10,0,11,0,165,3,3,2,0,194,7,4,205,219,0.851,0.936
"8419","La Paz","Sapahaqui","Unidad Educativa San Marcos",7,1,8,0,157,0,8,0,0,181,4,5,190,215,0.867,0.884
"8420","La Paz","Sapahaqui","Unidad Educativa San Marcos",3,1,12,1,167,0,10,0,0,194,3,11,208,227,0.861,0.916
"8421","La Paz","Sapahaqui","Unidad Educativa San Marcos",5,0,4,0,176,3,9,0,1,198,3,7,208,224,0.889,0.929
"8422","La Paz","Sapahaqui","Unidad Educativa San Marcos",8,1,9,0,162,0,13,0,1,194,3,4,201,219,0.835,0.918
"8423","La Paz","Sapahaqui","Unidad Educativa San Marcos",1,1,4,1,169,2,7,0,0,185,5,7,197,222,0.914,0.887
"8424","La Paz","Sapahaqui","Unidad Educativa Ocuiri",2,0,4,0,188,1,5,0,0,200,2,6,208,226,0.94,0.92
"8425","La Paz","Sapahaqui","Muruhuta",5,4,9,1,173,2,13,0,0,207,2,2,211,222,0.836,0.95
"8426","La Paz","Sapahaqui","Muruhuta",5,0,9,1,177,0,9,1,0,202,5,4,211,223,0.876,0.946
"8427","La Paz","Sapahaqui","Escuela Sixilla Baja",2,2,21,1,158,1,9,0,0,194,2,8,204,221,0.814,0.923
"8428","La Paz","Sapahaqui","Escuela Eduardo Avaroa",3,0,1,0,198,0,2,1,0,205,1,12,218,227,0.966,0.96
"8429","La Paz","Sapahaqui","Escuela Eduardo Avaroa",10,1,4,0,183,0,10,0,0,208,4,3,215,229,0.88,0.939
"8430","La Paz","Yaco","Unidad Educativa Yaco",18,1,2,1,122,0,13,0,1,158,5,9,172,209,0.772,0.823
"8431","La Paz","Yaco","Unidad Educativa Yaco",11,1,3,0,140,1,15,0,0,171,4,6,181,200,0.819,0.905
"8432","La Paz","Yaco","Escuela Challoma",2,1,1,1,187,0,10,1,0,203,5,1,209,220,0.921,0.95
"8433","La Paz","Yaco","U.E. Germán Busch de Tablachaca",5,1,6,0,158,5,14,0,0,189,7,6,202,221,0.836,0.914
"8434","La Paz","Yaco","U.E. Germán Busch de Tablachaca",4,4,9,0,142,2,13,1,1,176,3,16,195,212,0.807,0.92
"8435","La Paz","Yaco","Unidad Educativa Chucamarca",0,0,5,0,159,1,19,0,0,184,8,6,198,220,0.864,0.9
"8436","La Paz","Yaco","Colegio Republica Venezuela",3,4,13,0,152,0,15,0,0,187,2,13,202,216,0.813,0.935
"8437","La Paz","Yaco","Colegio Republica Venezuela",4,4,14,2,155,2,10,0,2,193,2,7,202,219,0.803,0.922
"8438","La Paz","Yaco","Colegio Republica Venezuela",5,0,17,3,135,1,11,1,1,174,3,10,187,200,0.776,0.935
"8439","La Paz","Yaco","Unidad Educativa Daniel Gomez Garcia",5,2,2,2,162,0,8,1,0,182,9,11,202,218,0.89,0.927
"8440","La Paz","Yaco","Unidad Educativa Hurnuni",7,3,19,2,153,3,8,0,0,195,5,8,208,220,0.785,0.945
"8441","La Paz","Malla","U.E. Malla",5,1,1,0,180,0,19,0,0,206,3,3,212,219,0.874,0.968
"8442","La Paz","Malla","U.E. Malla",11,3,7,1,158,1,19,1,0,201,2,9,212,214,0.786,0.991
"8443","La Paz","Malla","U. E. Jachapampa",8,1,10,0,151,6,6,0,0,182,10,5,197,212,0.83,0.929
"8444","La Paz","Cairoma","Colegio German Busch",9,0,12,1,157,0,9,2,0,190,5,3,198,219,0.826,0.904
"8445","La Paz","Cairoma","Colegio German Busch",6,2,7,0,142,0,17,1,0,175,12,6,193,220,0.811,0.877
"8446","La Paz","Cairoma","Colegio German Busch",4,1,8,2,157,1,8,0,0,181,3,8,192,213,0.867,0.901
"8447","La Paz","Cairoma","Colegio German Busch",2,0,14,2,150,14,0,0,0,182,10,7,199,217,0.824,0.917
"8448","La Paz","Cairoma","Colegio German Busch",11,0,20,1,138,2,10,0,0,182,11,8,201,217,0.758,0.926
"8449","La Paz","Cairoma","Unidad Educativa Bolivar",8,0,14,0,153,0,16,0,0,191,6,5,202,227,0.801,0.89
"8450","La Paz","Cairoma","Unidad Educativa Bolivar",8,0,9,0,149,1,19,0,0,186,4,12,202,219,0.801,0.922
"8451","La Paz","Cairoma","Unidad Educativa Libertad",12,0,11,0,165,4,8,0,0,200,5,5,210,227,0.825,0.925
"8452","La Paz","Cairoma","Unidad Educativa Libertad",12,3,18,0,150,2,11,0,1,197,5,14,216,233,0.761,0.927
"8453","La Paz","Cairoma","Colegio Luis Espinal",10,3,11,2,128,3,16,0,0,173,9,6,188,204,0.74,0.922
"8454","La Paz","Cairoma","Unidad Educativa Sacani",7,2,5,0,153,1,8,1,0,177,11,4,192,218,0.864,0.881
"8455","La Paz","Cairoma","Unidad Educativa Sacani",2,1,10,1,139,1,7,0,0,161,9,7,177,198,0.863,0.894
"8456","La Paz","Cairoma","U.E. La Lloja",8,0,7,0,185,1,6,0,0,207,0,0,207,228,0.894,0.908
"8457","La Paz","Cairoma","Unidad Educativa Bolivia-Viloco",62,1,12,0,85,0,23,1,2,186,3,11,200,221,0.457,0.905
"8458","La Paz","Cairoma","Unidad Educativa Bolivia-Viloco",72,2,9,0,73,5,25,0,1,187,0,9,196,218,0.39,0.899
"8459","La Paz","Cairoma","Unidad Educativa Bolivia-Viloco",63,1,9,0,79,4,27,0,2,185,4,10,199,227,0.427,0.877
"8460","La Paz","Cairoma","U.E. Araca Torre Pampa",9,3,20,1,139,2,7,0,0,181,6,10,197,220,0.768,0.895
"8461","La Paz","Cairoma","U.E. Araca Torre Pampa",5,1,24,1,136,3,14,1,0,185,4,24,213,231,0.735,0.922
"8462","La Paz","Inquisivi","Escuela Eliodoro Camacho",37,1,5,1,114,3,9,0,0,170,7,10,187,216,0.671,0.866
"8463","La Paz","Inquisivi","Escuela Eliodoro Camacho",35,1,6,2,112,1,18,1,0,176,6,12,194,224,0.636,0.866
"8464","La Paz","Inquisivi","Escuela Eliodoro Camacho",15,1,6,2,127,2,22,1,0,176,5,15,196,214,0.722,0.916
"8465","La Paz","Inquisivi","Escuela Eliodoro Camacho",25,0,7,3,114,2,20,0,0,171,1,11,183,210,0.667,0.871
"8466","La Paz","Inquisivi","Esc. Pedro Domingo Murillo",3,1,1,0,166,1,11,1,0,184,0,10,194,218,0.902,0.89
"8467","La Paz","Inquisivi","Esc. Pedro Domingo Murillo",8,2,0,2,139,0,3,0,0,154,3,4,161,171,0.903,0.942
"8468","La Paz","Inquisivi","Unidad Educativa Tupak Katari",6,4,16,2,117,1,7,2,0,155,15,17,187,212,0.755,0.882
"8469","La Paz","Inquisivi","Unidad Educativa Tupak Katari",3,2,8,1,147,2,7,2,0,172,9,11,192,212,0.855,0.906
"8470","La Paz","Inquisivi","Esc. Central Cavari",11,3,10,2,137,0,2,0,0,165,8,23,196,222,0.83,0.883
"8471","La Paz","Inquisivi","Esc. Central Cavari",6,4,12,2,136,0,2,1,1,164,11,13,188,226,0.829,0.832
"8472","La Paz","Inquisivi","Unidad Educativa Escola",15,1,2,0,152,4,7,0,0,181,3,12,196,217,0.84,0.903
"8473","La Paz","Inquisivi","Plaza Principal 16 de Julio",10,2,2,6,171,1,9,0,0,201,5,5,211,230,0.851,0.917
"8474","La Paz","Inquisivi","Plaza Principal 16 de Julio",5,1,6,3,170,3,11,1,2,202,2,7,211,230,0.842,0.917
"8475","La Paz","Inquisivi","Plaza Principal 16 de Julio",10,2,4,2,155,1,11,0,0,185,6,8,199,229,0.838,0.869
"8476","La Paz","Inquisivi","Plaza Principal 16 de Julio",5,0,9,1,158,2,9,1,0,185,2,5,192,208,0.854,0.923
"8477","La Paz","Inquisivi","Plaza Principal",12,4,8,2,162,1,4,1,1,195,6,1,202,224,0.831,0.902
"8478","La Paz","Inquisivi","Plaza Principal",3,1,7,0,182,1,2,0,1,197,3,0,200,222,0.924,0.901
"8479","La Paz","Inquisivi","Plaza Principal",7,4,2,2,179,0,4,0,1,199,3,11,213,230,0.899,0.926
"8480","La Paz","Inquisivi","Unidad Educativa Siguas",3,1,9,2,141,2,25,1,2,186,7,11,204,219,0.758,0.932
"8481","La Paz","Inquisivi","Escuela Simon Bolivar",7,2,1,0,166,1,4,0,0,181,3,7,191,222,0.917,0.86
"8482","La Paz","Inquisivi","Esc. Eduardo Avaroa",15,8,3,1,140,1,7,1,2,178,6,13,197,236,0.787,0.835
"8483","La Paz","Inquisivi","Esc. Eduardo Avaroa",5,1,6,2,169,2,3,0,3,191,8,9,208,230,0.885,0.904
"8484","La Paz","Inquisivi","Sede Social",5,0,9,2,154,0,10,0,1,181,12,13,206,221,0.851,0.932
"8485","La Paz","Inquisivi","Unidad Educativa Mariscal Sucre",8,2,6,2,132,0,4,0,2,156,1,9,166,171,0.846,0.971
"8486","La Paz","Inquisivi","Unidad Educativa Kanamarca",43,1,6,2,130,7,9,0,0,198,5,8,211,227,0.657,0.93
"8487","La Paz","Quime","Esc. Teodomiro Urquiola",31,0,1,3,118,1,21,2,0,177,5,14,196,211,0.667,0.929
"8488","La Paz","Quime","Esc. Teodomiro Urquiola",50,0,4,1,112,3,9,1,3,183,5,7,195,212,0.612,0.92
"8489","La Paz","Quime","Esc. Teodomiro Urquiola",18,0,9,1,147,1,17,2,1,196,8,5,209,222,0.75,0.941
"8490","La Paz","Quime","Esc. Teodomiro Urquiola",38,2,10,1,115,3,12,2,0,183,7,11,201,214,0.628,0.939
"8491","La Paz","Quime","Esc. Teodomiro Urquiola",36,0,9,1,103,6,18,0,0,173,6,9,188,209,0.595,0.9
"8492","La Paz","Quime","Esc. Teodomiro Urquiola",25,1,5,2,127,5,26,1,0,192,3,9,204,221,0.661,0.923
"8493","La Paz","Quime","Esc. Teodomiro Urquiola",17,2,9,0,130,4,18,0,1,181,9,11,201,220,0.718,0.914
"8494","La Paz","Quime","Esc. Teodomiro Urquiola",19,0,8,1,124,1,18,0,1,172,3,15,190,210,0.721,0.905
"8495","La Paz","Quime","Esc. Teodomiro Urquiola",26,0,15,1,113,3,28,0,2,188,2,10,200,219,0.601,0.913
"8496","La Paz","Quime","Esc. Teodomiro Urquiola",21,3,10,3,115,0,16,1,3,172,3,15,190,216,0.669,0.88
"8497","La Paz","Quime","Esc. Teodomiro Urquiola",24,4,6,0,115,1,22,0,3,175,7,10,192,220,0.657,0.873
"8498","La Paz","Quime","Esc. Teodomiro Urquiola",39,0,1,2,115,4,19,1,1,182,5,10,197,219,0.632,0.9
"8499","La Paz","Quime","Esc. Pongo B2",29,1,4,0,141,3,12,2,2,194,4,9,207,219,0.727,0.945
"8500","La Paz","Quime","Unidad Educativa Choquetanga",42,2,4,0,105,5,20,2,1,181,12,7,200,219,0.58,0.913
"8501","La Paz","Quime","Unidad Educativa Choquetanga",28,2,2,0,126,2,25,2,1,188,2,6,196,221,0.67,0.887
"8502","La Paz","Quime","Escuela Simon Bolivar",0,0,0,0,203,0,0,0,0,203,0,0,203,205,1,0.99
"8503","La Paz","Cajuata","U. E. Cajuata",43,3,6,1,110,5,18,0,2,188,6,14,208,223,0.585,0.933
"8504","La Paz","Cajuata","U. E. Cajuata",50,5,8,2,99,3,22,0,0,189,5,12,206,227,0.524,0.907
"8505","La Paz","Cajuata","U. E. Cajuata",48,4,9,3,100,6,23,2,0,195,2,12,209,227,0.513,0.921
"8506","La Paz","Cajuata","U. E. Cajuata",39,5,4,2,110,6,21,1,2,190,8,10,208,227,0.579,0.916
"8507","La Paz","Cajuata","U. E. Cajuata",52,0,6,2,90,8,24,0,1,183,3,16,202,224,0.492,0.902
"8508","La Paz","Cajuata","U. E. Cajuata",32,0,4,1,119,4,17,1,1,179,11,17,207,226,0.665,0.916
"8509","La Paz","Cajuata","U. E. Cajuata",43,1,2,1,102,1,33,1,0,184,2,20,206,226,0.554,0.912
"8510","La Paz","Cajuata","U. E. Cajuata",45,2,3,2,100,2,18,2,0,174,9,16,199,227,0.575,0.877
"8511","La Paz","Cajuata","U. E. Cajuata",50,2,6,3,92,3,14,0,3,173,8,12,193,219,0.532,0.881
"8512","La Paz","Cajuata","U. E. Cajuata",29,2,5,1,110,4,21,1,3,176,13,11,200,214,0.625,0.935
"8513","La Paz","Cajuata","U. E. Circuata I",30,4,3,0,132,3,14,0,2,188,8,8,204,223,0.702,0.915
"8514","La Paz","Cajuata","U. E. Circuata I",43,2,0,6,131,4,13,0,0,199,7,4,210,223,0.658,0.942
"8515","La Paz","Cajuata","U. E. Circuata I",20,5,3,0,143,1,21,0,0,193,7,13,213,225,0.741,0.947
"8516","La Paz","Cajuata","U. E. Circuata I",39,1,2,1,138,0,15,1,1,198,2,8,208,224,0.697,0.929
"8517","La Paz","Cajuata","U. E. Circuata I",14,4,3,1,116,4,9,0,1,152,7,12,171,187,0.763,0.914
"8518","La Paz","Cajuata","U. E. Simon Bolivar",58,0,2,1,122,0,10,1,1,195,2,8,205,220,0.626,0.932
"8519","La Paz","Cajuata","U. E. Simon Bolivar",54,0,7,1,115,3,13,1,0,194,9,7,210,228,0.593,0.921
"8520","La Paz","Cajuata","Casa de Gobierno",32,0,1,1,170,1,8,1,0,214,3,5,222,237,0.794,0.937
"8521","La Paz","Cajuata","Casa de Gobierno",31,0,4,0,164,1,6,0,0,206,3,7,216,229,0.796,0.943
"8522","La Paz","Cajuata","Casa de Gobierno",14,0,1,1,178,1,6,0,0,201,6,7,214,230,0.886,0.93
"8523","La Paz","Cajuata","Casa de Gobierno",34,0,0,1,165,2,9,0,1,212,4,7,223,229,0.778,0.974
"8524","La Paz","Cajuata","Casa de Gobierno",25,1,2,1,143,2,14,2,0,190,7,11,208,229,0.753,0.908
"8525","La Paz","Cajuata","U. E. Huaritolo",31,3,5,1,125,0,16,0,1,182,4,14,200,215,0.687,0.93
"8526","La Paz","Cajuata","U. E. Huaritolo",18,0,6,0,135,0,7,2,0,168,4,18,190,218,0.804,0.872
"8527","La Paz","Cajuata","Casa de Gobierno",10,0,2,2,152,2,10,1,1,180,3,9,192,216,0.844,0.889
"8528","La Paz","Cajuata","U. E. Miguillas",44,0,2,1,157,0,5,0,2,211,2,3,216,231,0.744,0.935
"8529","La Paz","Cajuata","U. E. Miguillas",24,1,3,0,157,1,4,1,0,191,5,10,206,221,0.822,0.932
"8530","La Paz","Colquiri","Ladislao Cabrera",24,1,4,0,123,1,42,2,1,198,5,7,210,231,0.621,0.909
"8531","La Paz","Colquiri","Ladislao Cabrera",29,1,3,0,113,0,51,0,1,198,7,18,223,229,0.571,0.974
"8532","La Paz","Colquiri","Ladislao Cabrera",34,0,4,2,112,1,45,0,1,199,3,17,219,228,0.563,0.961
"8533","La Paz","Colquiri","Ladislao Cabrera",35,0,9,3,114,1,33,0,0,195,5,9,209,227,0.585,0.921
"8534","La Paz","Colquiri","Ladislao Cabrera",33,0,4,1,108,3,37,1,3,190,5,10,205,223,0.568,0.919
"8535","La Paz","Colquiri","Ladislao Cabrera",27,1,5,1,122,2,37,0,5,200,3,12,215,226,0.61,0.951
"8536","La Paz","Colquiri","Ladislao Cabrera",34,1,8,2,122,3,30,0,0,200,4,7,211,227,0.61,0.93
"8537","La Paz","Colquiri","Ladislao Cabrera",21,1,7,1,108,1,35,1,0,175,7,23,205,226,0.617,0.907
"8538","La Paz","Colquiri","Ladislao Cabrera",28,0,14,0,126,2,34,0,2,206,6,10,222,233,0.612,0.953
"8539","La Paz","Colquiri","Ladislao Cabrera",34,1,5,0,120,2,38,1,4,205,3,7,215,228,0.585,0.943
"8540","La Paz","Colquiri","Ladislao Cabrera",7,0,11,1,118,3,45,2,3,190,8,8,206,225,0.621,0.916
"8541","La Paz","Colquiri","Ladislao Cabrera",26,1,12,0,121,0,22,0,7,189,5,9,203,227,0.64,0.894
"8542","La Paz","Colquiri","Ladislao Cabrera",35,0,10,0,119,2,36,0,0,202,6,9,217,233,0.589,0.931
"8543","La Paz","Colquiri","Ladislao Cabrera",28,1,8,0,111,2,42,2,3,197,5,12,214,228,0.563,0.939
"8544","La Paz","Colquiri","U.E. Mariscal De Zepita",17,1,7,1,117,2,45,1,2,193,4,17,214,223,0.606,0.96
"8545","La Paz","Colquiri","U.E. Mariscal De Zepita",28,0,4,0,129,3,34,1,1,200,7,27,234,234,0.645,1
"8546","La Paz","Colquiri","U.E. Mariscal De Zepita",28,0,10,2,109,4,38,1,2,194,8,12,214,225,0.562,0.951
"8547","La Paz","Colquiri","U.E. Mariscal De Zepita",20,3,2,1,134,3,30,0,2,195,8,10,213,230,0.687,0.926
"8548","La Paz","Colquiri","U.E. Mariscal De Zepita",25,1,4,0,110,3,42,0,0,185,3,16,204,224,0.595,0.911
"8549","La Paz","Colquiri","U.E. Mariscal De Zepita",19,0,7,0,109,6,38,0,1,180,3,20,203,229,0.606,0.886
"8550","La Paz","Colquiri","U.E. Mariscal De Zepita",27,0,11,0,119,2,31,2,2,194,8,10,212,228,0.613,0.93
"8551","La Paz","Colquiri","U.E. Mariscal De Zepita",29,0,8,0,110,1,49,0,1,198,5,13,216,227,0.556,0.952
"8552","La Paz","Colquiri","Colegio Simon Bolivar",13,3,2,0,140,1,20,0,0,179,8,17,204,220,0.782,0.927
"8553","La Paz","Colquiri","Colegio Simon Bolivar",3,2,6,1,143,0,24,1,1,181,8,10,199,224,0.79,0.888
"8554","La Paz","Colquiri","Escuela Aniceto Arce",12,3,3,1,122,5,17,0,1,164,13,9,186,199,0.744,0.935
"8555","La Paz","Colquiri","Escuela Jose Miguel Lanza",5,2,3,2,154,2,17,4,0,189,4,9,202,218,0.815,0.927
"8556","La Paz","Colquiri","Escuela Jose Miguel Lanza",8,2,2,1,154,1,8,1,0,177,3,16,196,219,0.87,0.895
"8557","La Paz","Colquiri","Casa de Gobierno",3,0,2,1,171,4,12,0,0,193,4,5,202,227,0.886,0.89
"8558","La Paz","Colquiri","Escuela Caquena Entre Rios",4,1,1,0,175,2,9,1,1,194,0,2,196,233,0.902,0.841
"8559","La Paz","Colquiri","Escuela Central Uyuni",10,2,4,2,120,2,25,3,0,168,8,12,188,212,0.714,0.887
"8560","La Paz","Colquiri","Escuela Pipini",6,3,2,2,137,1,36,1,0,188,10,14,212,228,0.729,0.93
"8561","La Paz","Colquiri","Casa de Gobierno",12,2,5,0,132,0,31,0,2,184,6,24,214,226,0.717,0.947
"8562","La Paz","Colquiri","Casa de Gobierno",8,1,5,0,144,0,30,0,0,188,3,10,201,214,0.766,0.939
"8563","La Paz","Colquiri","Colegio Alto De La Alianza",9,3,3,2,130,3,29,2,1,182,15,15,212,223,0.714,0.951
"8564","La Paz","Colquiri","Esc. Simon Bolivar",4,0,8,1,130,1,16,0,0,160,0,6,166,175,0.812,0.949
"8565","La Paz","Colquiri","Unidad Educativa Marquirivi",7,1,3,1,130,3,28,1,0,174,3,5,182,204,0.747,0.892
"8566","La Paz","Colquiri","U.E. Llanquera",13,0,3,0,148,4,21,0,0,189,7,10,206,211,0.783,0.976
"8567","La Paz","Ichoca","Unidad Educativa",9,2,4,1,141,1,12,1,1,172,6,9,187,216,0.82,0.866
"8568","La Paz","Ichoca","Unidad Educativa",10,0,9,0,152,1,11,0,0,183,2,7,192,220,0.831,0.873
"8569","La Paz","Ichoca","Unidad Educativa",7,1,8,0,158,5,13,3,0,195,1,6,202,229,0.81,0.882
"8570","La Paz","Ichoca","Unidad Educativa German Busch",5,2,8,4,104,2,26,1,0,152,7,17,176,188,0.684,0.936
"8571","La Paz","Ichoca","Escuela Jose Antonio De Sucre",2,0,6,1,167,2,16,0,1,195,2,7,204,212,0.856,0.962
"8572","La Paz","Ichoca","Escuela Pedro Domingo Murillo",4,7,1,2,151,2,6,2,0,175,6,10,191,213,0.863,0.897
"8573","La Paz","Ichoca","Esc. Central Luruta",5,1,8,1,122,2,12,1,1,153,3,8,164,181,0.797,0.906
"8574","La Paz","Villa Libertad Licoma","Escuela Eliodoro Camacho",19,2,1,1,143,3,7,0,1,177,5,10,192,218,0.808,0.881
"8575","La Paz","Villa Libertad Licoma","Escuela Eliodoro Camacho",18,0,3,0,154,0,12,0,1,188,7,7,202,224,0.819,0.902
"8576","La Paz","Villa Libertad Licoma","Escuela Eliodoro Camacho",14,1,2,1,146,3,9,1,0,177,5,16,198,216,0.825,0.917
"8577","La Paz","Villa Libertad Licoma","Escuela Eliodoro Camacho",24,1,1,2,145,2,14,1,0,190,4,7,201,223,0.763,0.901
"8578","La Paz","Villa Libertad Licoma","Escuela Eliodoro Camacho",10,2,4,0,154,2,7,0,0,179,4,6,189,216,0.86,0.875
"8579","La Paz","Villa Libertad Licoma","Escuela Mixta Charapaxi",6,1,1,0,161,0,1,0,0,170,5,6,181,208,0.947,0.87
"8580","La Paz","Chulumani","Colegio Agustin Aspiazu",105,1,4,0,61,2,6,0,0,179,3,12,194,230,0.341,0.843
"8581","La Paz","Chulumani","Colegio Agustin Aspiazu",113,0,5,0,64,0,10,1,1,194,4,14,212,228,0.33,0.93
"8582","La Paz","Chulumani","Colegio Agustin Aspiazu",111,0,3,4,67,4,6,0,0,195,4,6,205,221,0.344,0.928
"8583","La Paz","Chulumani","Colegio Agustin Aspiazu",89,1,5,0,55,1,18,2,0,171,7,11,189,219,0.322,0.863
"8584","La Paz","Chulumani","Colegio Agustin Aspiazu",99,2,4,2,62,0,8,0,2,179,4,12,195,218,0.346,0.894
"8585","La Paz","Chulumani","Colegio Agustin Aspiazu",119,0,3,2,43,2,11,0,0,180,7,9,196,223,0.239,0.879
"8586","La Paz","Chulumani","Colegio Agustin Aspiazu",106,3,5,2,56,3,15,0,1,191,4,11,206,222,0.293,0.928
"8587","La Paz","Chulumani","Colegio Agustin Aspiazu",106,2,2,0,58,1,13,4,0,186,4,6,196,220,0.312,0.891
"8588","La Paz","Chulumani","Colegio Agustin Aspiazu",105,0,2,1,64,1,6,0,1,180,3,8,191,217,0.356,0.88
"8589","La Paz","Chulumani","Colegio Agustin Aspiazu",107,0,2,2,62,2,20,0,0,195,1,7,203,223,0.318,0.91
"8590","La Paz","Chulumani","Colegio Agustin Aspiazu",122,0,6,0,44,1,11,1,0,185,3,8,196,220,0.238,0.891
"8591","La Paz","Chulumani","Colegio Agustin Aspiazu",112,0,3,0,64,1,9,0,1,190,3,6,199,221,0.337,0.9
"8592","La Paz","Chulumani","Colegio Agustin Aspiazu",103,0,4,0,53,2,12,0,1,175,4,7,186,221,0.303,0.842
"8593","La Paz","Chulumani","Colegio Agustin Aspiazu",101,0,7,3,54,0,14,0,1,180,3,10,193,218,0.3,0.885
"8594","La Paz","Chulumani","Colegio Agustin Aspiazu",125,0,1,2,56,0,13,1,0,198,1,6,205,227,0.283,0.903
"8595","La Paz","Chulumani","Colegio Agustin Aspiazu",126,1,1,0,42,2,8,1,0,181,0,13,194,220,0.232,0.882
"8596","La Paz","Chulumani","Colegio Agustin Aspiazu",95,3,3,1,60,1,13,0,2,178,1,6,185,212,0.337,0.873
"8597","La Paz","Chulumani","Colegio Agustin Aspiazu",128,0,1,0,50,0,8,1,0,188,2,10,200,222,0.266,0.901
"8598","La Paz","Chulumani","Colegio Agustin Aspiazu",102,0,2,1,69,2,10,0,0,186,3,4,193,219,0.371,0.881
"8599","La Paz","Chulumani","Colegio Agustin Aspiazu",99,0,2,0,65,1,15,0,0,182,2,9,193,222,0.357,0.869
"8600","La Paz","Chulumani","Colegio Agustin Aspiazu",103,1,3,0,73,0,11,0,0,191,3,10,204,220,0.382,0.927
"8601","La Paz","Chulumani","Colegio Agustin Aspiazu",129,1,3,0,48,1,16,0,2,200,3,4,207,221,0.24,0.937
"8602","La Paz","Chulumani","Colegio Agustin Aspiazu",115,0,2,2,52,2,9,1,1,184,3,4,191,222,0.283,0.86
"8603","La Paz","Chulumani","Colegio Agustin Aspiazu",102,0,4,0,57,2,8,0,1,174,5,8,187,217,0.328,0.862
"8604","La Paz","Chulumani","Colegio Juan Ramos de Tagma",130,0,3,1,59,0,8,0,0,201,1,8,210,223,0.294,0.942
"8605","La Paz","Chulumani","Colegio Juan Ramos de Tagma",105,0,3,2,65,3,4,0,2,184,5,6,195,220,0.353,0.886
"8606","La Paz","Chulumani","Colegio Juan Ramos de Tagma",106,2,8,2,63,2,6,0,1,190,1,9,200,222,0.332,0.901
"8607","La Paz","Chulumani","Colegio Juan Ramos de Tagma",114,2,4,1,62,0,8,0,2,193,3,4,200,222,0.321,0.901
"8608","La Paz","Chulumani","U.E. Técnico Humanístico Pasto Pata",138,1,7,1,39,4,8,2,1,201,4,7,212,226,0.194,0.938
"8609","La Paz","Chulumani","U.E. Técnico Humanístico Pasto Pata",151,1,3,0,25,4,7,1,0,192,3,9,204,225,0.13,0.907
"8610","La Paz","Chulumani","U.E. Técnico Humanístico Pasto Pata",148,0,6,2,36,1,9,0,2,204,2,7,213,224,0.176,0.951
"8611","La Paz","Chulumani","U.E. Técnico Humanístico Pasto Pata",117,0,5,0,44,1,10,1,1,179,0,7,186,205,0.246,0.907
"8612","La Paz","Chulumani","Casa de Gobierno",112,4,1,2,60,5,5,0,0,189,2,6,197,211,0.317,0.934
"8613","La Paz","Chulumani","Casa de Gobierno",122,0,1,1,59,0,6,1,0,190,2,7,199,220,0.311,0.905
"8614","La Paz","Chulumani","Casa de Gobierno",125,1,3,2,48,5,8,0,0,192,5,3,200,217,0.25,0.922
"8615","La Paz","Chulumani","Unidad Educativa Huancane",89,2,1,1,100,1,1,1,1,197,3,7,207,215,0.508,0.963
"8616","La Paz","Chulumani","Unidad Educativa Huancane",88,0,2,2,84,1,7,0,0,184,5,11,200,224,0.457,0.893
"8617","La Paz","Chulumani","Unidad Educativa Huancane",77,2,4,1,101,1,4,0,1,191,3,10,204,222,0.529,0.919
"8618","La Paz","Chulumani","Unidad Educativa Huancane",81,1,1,3,78,0,7,1,0,172,8,11,191,217,0.453,0.88
"8619","La Paz","Chulumani","Unidad Educativa Huancane",87,1,0,2,92,0,4,0,0,186,1,5,192,215,0.495,0.893
"8620","La Paz","Chulumani","Unidad Educativa Huancane",92,3,2,0,82,0,3,1,1,184,2,4,190,223,0.446,0.852
"8621","La Paz","Chulumani","Unidad Educativa Huancane",93,0,4,1,69,1,8,2,0,178,1,6,185,208,0.388,0.889
"8622","La Paz","Chulumani","Unidad Educativa Huancane",94,0,4,1,85,1,7,1,0,193,2,3,198,219,0.44,0.904
"8623","La Paz","Chulumani","Colegio Gral. Armando Escobar Uria",137,0,3,0,33,0,8,0,0,181,4,4,189,215,0.182,0.879
"8624","La Paz","Chulumani","Colegio Gral. Armando Escobar Uria",147,0,2,1,33,2,2,0,1,188,2,5,195,214,0.176,0.911
"8625","La Paz","Chulumani","Colegio Gral. Armando Escobar Uria",129,2,8,0,46,0,7,0,0,192,3,1,196,218,0.24,0.899
"8626","La Paz","Chulumani","Plaza Principal",82,2,3,0,90,2,19,1,0,199,3,1,203,219,0.452,0.927
"8627","La Paz","Chulumani","Plaza Principal",83,1,0,2,101,3,4,0,0,194,2,3,199,219,0.521,0.909
"8628","La Paz","Chulumani","Esc. Colopampa",95,1,0,1,53,0,5,0,0,155,3,2,160,175,0.342,0.914
"8629","La Paz","Irupana","U. E. Agustin Aspiazu",81,1,6,1,72,1,15,0,0,177,1,15,193,218,0.407,0.885
"8630","La Paz","Irupana","U. E. Agustin Aspiazu",90,1,2,0,66,1,4,1,0,165,6,12,183,220,0.4,0.832
"8631","La Paz","Irupana","U. E. Agustin Aspiazu",85,1,2,0,87,1,8,1,1,186,5,4,195,217,0.468,0.899
"8632","La Paz","Irupana","U. E. Agustin Aspiazu",89,0,4,2,82,1,13,1,2,194,6,10,210,228,0.423,0.921
"8633","La Paz","Irupana","U. E. Agustin Aspiazu",97,1,2,0,67,0,15,1,0,183,3,9,195,219,0.366,0.89
"8634","La Paz","Irupana","U. E. Agustin Aspiazu",98,1,2,2,60,1,9,0,0,173,4,10,187,223,0.347,0.839
"8635","La Paz","Irupana","U. E. Agustin Aspiazu",67,0,3,1,85,5,13,0,1,175,6,11,192,216,0.486,0.889
"8636","La Paz","Irupana","U. E. Agustin Aspiazu",109,0,2,2,65,1,6,0,0,185,2,9,196,220,0.351,0.891
"8637","La Paz","Irupana","U. E. Agustin Aspiazu",92,2,3,2,78,0,8,0,1,186,2,6,194,222,0.419,0.874
"8638","La Paz","Irupana","U. E. Agustin Aspiazu",79,1,5,2,101,0,5,0,0,193,6,10,209,229,0.523,0.913
"8639","La Paz","Irupana","U. E. Agustin Aspiazu",80,1,1,1,82,1,12,1,0,179,4,9,192,216,0.458,0.889
"8640","La Paz","Irupana","U. E. Agustin Aspiazu",89,1,2,1,67,4,15,1,0,180,1,7,188,218,0.372,0.862
"8641","La Paz","Irupana","U. E. Agustin Aspiazu",90,1,2,0,69,0,5,0,2,169,1,14,184,209,0.408,0.88
"8642","La Paz","Irupana","U. E. Agustin Aspiazu",95,0,4,0,74,0,9,3,0,185,2,7,194,213,0.4,0.911
"8643","La Paz","Irupana","U. E. Agustin Aspiazu",98,0,0,2,73,3,3,0,2,181,3,9,193,218,0.403,0.885
"8644","La Paz","Irupana","U. E. Agustin Aspiazu",99,0,1,2,73,0,9,0,1,185,1,5,191,214,0.395,0.893
"8645","La Paz","Irupana","U. E. Agustin Aspiazu",96,1,3,1,72,1,5,0,2,181,5,9,195,219,0.398,0.89
"8646","La Paz","Irupana","Esc. Central La Plazuela",72,0,2,2,95,1,11,1,0,184,3,11,198,225,0.516,0.88
"8647","La Paz","Irupana","Esc. T.C. Rafael Pabon",25,2,25,0,124,2,11,0,0,189,4,8,201,236,0.656,0.852
"8648","La Paz","Irupana","U.E. Chicaloma",129,1,1,1,44,0,5,0,0,181,7,6,194,218,0.243,0.89
"8649","La Paz","Irupana","U.E. Chicaloma",125,0,1,1,57,0,5,0,1,190,6,12,208,229,0.3,0.908
"8650","La Paz","Irupana","U.E. Chicaloma",116,3,6,3,51,1,10,1,0,191,5,6,202,221,0.267,0.914
"8651","La Paz","Irupana","U.E. Chicaloma",111,2,5,0,48,0,2,1,0,169,6,6,181,196,0.284,0.923
"8652","La Paz","Irupana","Plaza 25 de Julio",9,0,9,2,154,2,14,0,2,192,6,3,201,219,0.802,0.918
"8653","La Paz","Irupana","Plaza 25 de Julio",8,1,6,0,162,1,13,0,1,192,2,1,195,217,0.844,0.899
"8654","La Paz","Irupana","Colegio Tte.Cnl. Rafael Pabon",46,3,16,3,110,4,24,0,1,207,1,7,215,226,0.531,0.951
"8655","La Paz","Irupana","Colegio Tte.Cnl. Rafael Pabon",23,2,18,0,122,2,29,0,3,199,3,10,212,225,0.613,0.942
"8656","La Paz","Irupana","Colegio Tte.Cnl. Rafael Pabon",40,1,9,1,111,1,22,1,4,190,3,7,200,216,0.584,0.926
"8657","La Paz","Irupana","Colegio Tte.Cnl. Rafael Pabon",27,2,15,0,108,3,21,0,1,177,7,16,200,216,0.61,0.926
"8658","La Paz","Irupana","Colegio Tte.Cnl. Rafael Pabon",32,0,11,1,113,3,29,0,1,190,4,8,202,216,0.595,0.935
"8659","La Paz","Irupana","Col. Nucleo Rosario",22,1,6,1,167,1,14,0,0,212,6,3,221,236,0.788,0.936
"8660","La Paz","Irupana","Esc. Victor Centellas",76,2,1,1,70,2,13,0,3,168,11,9,188,214,0.417,0.879
"8661","La Paz","Irupana","Unidad Educativa Taca",10,2,6,0,163,1,7,1,0,190,6,12,208,218,0.858,0.954
"8662","La Paz","Irupana","Esc. Victorio Lanza",84,0,6,1,83,5,23,0,1,203,3,3,209,233,0.409,0.897
"8663","La Paz","Irupana","Esc. Victorio Lanza",64,1,4,0,96,0,23,1,0,189,4,9,202,223,0.508,0.906
"8664","La Paz","Irupana","Cancha de Union Huiri",90,2,7,1,109,1,8,0,0,218,4,10,232,235,0.5,0.987
"8665","La Paz","Irupana","Cancha de Union Huiri",75,2,12,2,108,3,10,0,0,212,6,5,223,235,0.509,0.949
"8666","La Paz","Irupana","Cancha de Union Huiri",61,2,9,2,99,1,11,0,2,187,2,7,196,201,0.529,0.975
"8667","La Paz","Irupana","U.E. Nucleo Alejandro Perez",30,0,2,0,129,1,4,2,1,169,3,11,183,200,0.763,0.915
"8668","La Paz","Irupana","U.E. Lejna",123,0,2,2,47,0,10,0,1,185,3,3,191,197,0.254,0.97
"8669","La Paz","Irupana","U.E. Totoral",31,3,13,0,113,3,63,0,2,228,3,7,238,240,0.496,0.992
"8670","La Paz","Irupana","U.E. Totoral",34,3,23,0,108,2,51,1,5,227,2,4,233,238,0.476,0.979
"8671","La Paz","Yanacachi","Unidad Educ. Felix Ernesto Moscoso",39,1,2,1,111,4,25,1,1,185,5,9,199,218,0.6,0.913
"8672","La Paz","Yanacachi","Unidad Educ. Felix Ernesto Moscoso",52,0,4,0,95,3,18,0,0,172,3,14,189,214,0.552,0.883
"8673","La Paz","Yanacachi","Unidad Educ. Felix Ernesto Moscoso",44,1,4,0,119,1,14,0,1,184,1,8,193,217,0.647,0.889
"8674","La Paz","Yanacachi","Unidad Educ. Felix Ernesto Moscoso",34,3,3,0,121,2,22,1,0,186,4,5,195,222,0.651,0.878
"8675","La Paz","Yanacachi","Esc. Eduardo Avaroa",36,2,5,1,110,2,35,1,4,196,2,3,201,217,0.561,0.926
"8676","La Paz","Yanacachi","Esc. Eduardo Avaroa",38,1,7,1,119,1,28,0,1,196,0,7,203,224,0.607,0.906
"8677","La Paz","Yanacachi","Esc. Eduardo Avaroa",40,2,3,1,103,3,44,1,1,198,5,4,207,225,0.52,0.92
"8678","La Paz","Yanacachi","Agencia Cantonal",65,4,2,1,102,1,16,0,1,192,2,4,198,230,0.531,0.861
"8679","La Paz","Yanacachi","Escuela Puente Villa",64,2,7,0,90,3,20,0,1,187,3,1,191,220,0.481,0.868
"8680","La Paz","Yanacachi","Escuela Puente Villa",52,0,4,0,101,1,20,0,1,179,4,6,189,209,0.564,0.904
"8681","La Paz","Yanacachi","Escuela Puente Villa",61,2,2,0,84,3,21,1,6,180,12,6,198,220,0.467,0.9
"8682","La Paz","Palos Blancos","Esc. Unid Edu. Palos Blancos",41,2,5,2,111,2,30,1,3,197,2,5,204,230,0.563,0.887
"8683","La Paz","Palos Blancos","Esc. Unid Edu. Palos Blancos",39,1,4,3,111,4,22,1,2,187,6,9,202,226,0.594,0.894
"8684","La Paz","Palos Blancos","Esc. Unid Edu. Palos Blancos",32,2,2,0,107,0,25,0,2,170,3,10,183,219,0.629,0.836
"8685","La Paz","Palos Blancos","Esc. Unid Edu. Palos Blancos",26,1,3,1,118,3,33,1,1,187,4,8,199,228,0.631,0.873
"8686","La Paz","Palos Blancos","Esc. Unid Edu. Palos Blancos",33,3,5,0,131,2,28,1,0,203,2,6,211,231,0.645,0.913
"8687","La Paz","Palos Blancos","Esc. Unid Edu. Palos Blancos",29,2,3,0,131,1,21,0,3,190,5,7,202,228,0.689,0.886
"8688","La Paz","Palos Blancos","Esc. Unid Edu. Palos Blancos",40,0,5,0,124,1,15,3,1,189,6,7,202,232,0.656,0.871
"8689","La Paz","Palos Blancos","Esc. Unid Edu. Palos Blancos",38,1,6,1,107,4,28,0,1,186,6,12,204,233,0.575,0.876
"8690","La Paz","Palos Blancos","Esc. Unid Edu. Palos Blancos",42,1,6,0,104,3,24,0,1,181,4,5,190,219,0.575,0.868
"8691","La Paz","Palos Blancos","Esc. Unid Edu. Palos Blancos",33,1,6,0,109,4,24,2,2,181,4,4,189,223,0.602,0.848
"8692","La Paz","Palos Blancos","Esc. Unid Edu. Palos Blancos",36,2,5,0,107,2,25,0,3,180,3,11,194,225,0.594,0.862
"8693","La Paz","Palos Blancos","Esc. Unid Edu. Palos Blancos",30,0,4,1,122,1,25,1,4,188,2,8,198,228,0.649,0.868
"8694","La Paz","Palos Blancos","Esc. Unid Edu. Palos Blancos",37,0,7,0,106,3,29,1,4,187,4,6,197,228,0.567,0.864
"8695","La Paz","Palos Blancos","Esc. Unid Edu. Palos Blancos",32,0,14,0,120,2,20,0,1,189,3,10,202,226,0.635,0.894
"8696","La Paz","Palos Blancos","Esc. Unid Edu. Palos Blancos",47,3,5,0,98,3,37,1,4,198,0,6,204,226,0.495,0.903
"8697","La Paz","Palos Blancos","Esc. Unid Edu. Palos Blancos",33,0,8,0,108,5,30,0,3,187,1,9,197,231,0.578,0.853
"8698","La Paz","Palos Blancos","Esc. Unid Edu. Palos Blancos",27,2,13,1,109,4,37,0,0,193,7,7,207,226,0.565,0.916
"8699","La Paz","Palos Blancos","Esc. Unid Edu. Palos Blancos",25,1,5,0,128,2,31,0,2,194,2,8,204,231,0.66,0.883
"8700","La Paz","Palos Blancos","Esc. Unid Edu. Palos Blancos",48,1,7,1,83,5,35,1,1,182,2,6,190,223,0.456,0.852
"8701","La Paz","Palos Blancos","Esc. Unid Edu. Palos Blancos",41,0,8,0,110,3,23,0,0,185,4,7,196,227,0.595,0.863
"8702","La Paz","Palos Blancos","Esc. Unid Edu. Palos Blancos",43,5,5,0,107,6,24,3,1,194,2,6,202,225,0.552,0.898
"8703","La Paz","Palos Blancos","Esc. Unid Edu. Palos Blancos",37,1,10,1,107,1,34,0,1,192,1,6,199,224,0.557,0.888
"8704","La Paz","Palos Blancos","Escuela Unidad Educativa Popoy",12,2,4,0,148,3,22,0,0,191,3,8,202,223,0.775,0.906
"8705","La Paz","Palos Blancos","Escuela Unidad Educativa Popoy",31,0,0,0,150,4,13,0,2,200,1,4,205,231,0.75,0.887
"8706","La Paz","Palos Blancos","Escuela Unidad Educativa Popoy",14,4,4,0,120,2,20,0,1,165,2,5,172,190,0.727,0.905
"8707","La Paz","Palos Blancos","Esc. San Miguel de Huachi",23,2,6,1,126,1,27,1,0,187,1,5,193,220,0.674,0.877
"8708","La Paz","Palos Blancos","Esc. San Miguel de Huachi",19,2,6,1,123,1,23,1,4,180,5,6,191,229,0.683,0.834
"8709","La Paz","Palos Blancos","Esc. San Miguel de Huachi",18,1,5,0,110,2,41,1,1,179,3,5,187,220,0.615,0.85
"8710","La Paz","Palos Blancos","Esc. Franz Tamayo",8,1,12,1,141,3,17,0,2,185,6,10,201,229,0.762,0.878
"8711","La Paz","Palos Blancos","Esc. Franz Tamayo",11,4,13,0,129,10,16,0,3,186,5,8,199,225,0.694,0.884
"8712","La Paz","Palos Blancos","Esc. Franz Tamayo",6,2,8,3,152,5,9,1,1,187,15,7,209,232,0.813,0.901
"8713","La Paz","Palos Blancos","Esc. Remolinos",11,2,1,1,155,0,17,0,2,189,6,4,199,215,0.82,0.926
"8714","La Paz","Palos Blancos","Esc. Central Sapecho",17,0,4,0,145,1,22,0,2,191,3,7,201,227,0.759,0.885
"8715","La Paz","Palos Blancos","Esc. Central Sapecho",24,0,8,0,132,1,23,2,2,192,4,5,201,224,0.688,0.897
"8716","La Paz","Palos Blancos","Esc. Central Sapecho",26,1,4,1,124,3,26,0,2,187,6,7,200,229,0.663,0.873
"8717","La Paz","Palos Blancos","Esc. Central Sapecho",28,0,5,0,128,2,35,0,0,198,0,6,204,230,0.646,0.887
"8718","La Paz","Palos Blancos","Esc. Central Sapecho",24,0,6,0,124,1,18,0,1,174,2,9,185,215,0.713,0.86
"8719","La Paz","Palos Blancos","Esc. Santa Ana De Mosetenes",10,1,0,0,166,0,11,1,1,190,19,3,212,233,0.874,0.91
"8720","La Paz","Palos Blancos","Esc. Santa Ana De Mosetenes",15,1,6,1,174,2,12,0,0,211,7,5,223,234,0.825,0.953
"8721","La Paz","Palos Blancos","Esc. Santa Ana De Mosetenes",6,0,7,0,164,1,18,0,1,197,6,2,205,229,0.832,0.895
"8722","La Paz","Palos Blancos","U.E. Tucupi",5,0,5,0,144,2,26,0,0,182,3,6,191,226,0.791,0.845
"8723","La Paz","Palos Blancos","U.E. Tucupi",12,1,5,1,125,0,29,0,2,175,3,5,183,203,0.714,0.901
"8724","La Paz","Palos Blancos","Colegio Gral. Juan Jose Torrez",9,3,6,0,166,4,14,0,1,203,2,11,216,235,0.818,0.919
"8725","La Paz","Palos Blancos","Colegio Gral. Juan Jose Torrez",14,0,5,0,155,6,17,0,1,198,3,6,207,226,0.783,0.916
"8726","La Paz","Palos Blancos","Esc. Secc. Puerto Carmen",9,0,8,0,153,0,33,0,0,203,2,10,215,232,0.754,0.927
"8727","La Paz","Palos Blancos","Esc. Secc. Puerto Carmen",10,1,4,0,164,0,25,0,2,206,0,5,211,231,0.796,0.913
"8728","La Paz","Palos Blancos","Colegio Inicua Alto",13,3,6,0,139,3,17,0,0,181,4,10,195,235,0.768,0.83
"8729","La Paz","Palos Blancos","Colegio Inicua Alto",5,1,10,0,153,1,18,0,2,190,5,11,206,233,0.805,0.884
"8730","La Paz","Palos Blancos","Colegio Inicua Alto",4,2,8,0,157,0,28,0,0,199,5,6,210,234,0.789,0.897
"8731","La Paz","Palos Blancos","Colegio Inicua Alto",5,1,11,0,146,1,23,1,0,188,6,11,205,229,0.777,0.895
"8732","La Paz","Palos Blancos","Colegio Inicua Alto",4,1,8,0,167,2,14,0,2,198,4,6,208,230,0.843,0.904
"8733","La Paz","Palos Blancos","Colegio Inicua Alto",8,1,6,0,149,2,25,0,0,191,3,11,205,228,0.78,0.899
"8734","La Paz","Palos Blancos","Colegio Inicua Alto",8,0,9,0,159,3,24,0,1,204,5,4,213,233,0.779,0.914
"8735","La Paz","Palos Blancos","Escuela Cocochi",5,0,2,0,176,0,20,0,0,203,2,5,210,236,0.867,0.89
"8736","La Paz","Palos Blancos","Escuela Cocochi",1,2,1,0,182,1,14,0,0,201,1,12,214,232,0.905,0.922
"8737","La Paz","Palos Blancos","Escuela Cocochi",5,1,7,0,185,0,15,0,0,213,3,3,219,233,0.869,0.94
"8738","La Paz","La Asunta","Esc. Rene Barrientos Ortuno",68,0,7,0,94,2,18,1,0,190,1,7,198,221,0.495,0.896
"8739","La Paz","La Asunta","Esc. Rene Barrientos Ortuno",86,0,9,0,98,0,11,0,0,204,2,3,209,229,0.48,0.913
"8740","La Paz","La Asunta","Esc. Rene Barrientos Ortuno",79,0,3,1,90,1,16,1,0,191,3,4,198,222,0.471,0.892
"8741","La Paz","La Asunta","Esc. Rene Barrientos Ortuno",90,2,6,2,92,3,8,0,0,203,3,2,208,229,0.453,0.908
"8742","La Paz","La Asunta","Esc. Rene Barrientos Ortuno",72,2,6,2,110,6,8,0,1,207,1,4,212,231,0.531,0.918
"8743","La Paz","La Asunta","Esc. Rene Barrientos Ortuno",66,1,4,0,93,2,9,0,0,175,7,25,207,227,0.531,0.912
"8744","La Paz","La Asunta","Esc. Rene Barrientos Ortuno",70,1,8,1,99,1,12,0,2,194,4,8,206,233,0.51,0.884
"8745","La Paz","La Asunta","Esc. Rene Barrientos Ortuno",84,0,5,2,85,3,20,0,0,199,5,6,210,230,0.427,0.913
"8746","La Paz","La Asunta","Esc. Rene Barrientos Ortuno",87,1,6,0,86,4,14,1,1,200,3,10,213,231,0.43,0.922
"8747","La Paz","La Asunta","Esc. Rene Barrientos Ortuno",81,0,5,0,88,2,10,1,0,187,2,6,195,228,0.471,0.855
"8748","La Paz","La Asunta","Esc. Rene Barrientos Ortuno",84,0,10,0,86,2,18,1,0,201,2,9,212,233,0.428,0.91
"8749","La Paz","La Asunta","Esc. Rene Barrientos Ortuno",81,0,2,0,97,2,14,1,0,197,2,7,206,226,0.492,0.912
"8750","La Paz","La Asunta","Esc. Rene Barrientos Ortuno",71,1,4,1,97,3,16,1,0,194,0,10,204,229,0.5,0.891
"8751","La Paz","La Asunta","Esc. Rene Barrientos Ortuno",117,2,5,3,66,0,8,0,1,202,4,5,211,234,0.327,0.902
"8752","La Paz","La Asunta","Esc. Rene Barrientos Ortuno",79,0,8,1,90,5,12,1,0,196,0,7,203,220,0.459,0.923
"8753","La Paz","La Asunta","Esc. Rene Barrientos Ortuno",68,1,8,0,101,1,17,0,1,197,1,12,210,228,0.513,0.921
"8754","La Paz","La Asunta","Esc. Rene Barrientos Ortuno",87,2,5,2,76,2,12,0,2,188,7,10,205,225,0.404,0.911
"8755","La Paz","La Asunta","Esc. Rene Barrientos Ortuno",95,0,9,0,83,4,6,0,0,197,2,4,203,230,0.421,0.883
"8756","La Paz","La Asunta","Esc. Rene Barrientos Ortuno",80,1,10,0,88,4,10,0,0,193,4,3,200,226,0.456,0.885
"8757","La Paz","La Asunta","Esc. Rene Barrientos Ortuno",95,0,4,0,90,1,15,0,0,205,1,7,213,228,0.439,0.934
"8758","La Paz","La Asunta","Esc. Rene Barrientos Ortuno",102,0,7,3,68,3,14,0,0,197,5,9,211,234,0.345,0.902
"8759","La Paz","La Asunta","Esc. Rene Barrientos Ortuno",79,0,8,3,94,2,14,0,0,200,3,4,207,227,0.47,0.912
"8760","La Paz","La Asunta","Esc. Rene Barrientos Ortuno",72,1,4,1,108,2,0,17,0,205,3,6,214,234,0.527,0.915
"8761","La Paz","La Asunta","Esc. Rene Barrientos Ortuno",83,0,2,0,88,3,12,2,1,191,3,5,199,230,0.461,0.865
"8762","La Paz","La Asunta","Esc. Rene Barrientos Ortuno",71,0,9,1,108,3,10,1,0,203,3,6,212,231,0.532,0.918
"8763","La Paz","La Asunta","Esc. Rene Barrientos Ortuno",73,0,14,1,105,3,12,0,0,208,0,5,213,226,0.505,0.942
"8764","La Paz","La Asunta","Unidad Educativa Central Quinuni",84,3,14,0,79,4,17,0,1,202,1,10,213,229,0.391,0.93
"8765","La Paz","La Asunta","Unidad Educativa Central Quinuni",96,1,18,1,71,2,13,0,0,202,4,9,215,232,0.351,0.927
"8766","La Paz","La Asunta","Unidad Educativa Central Quinuni",108,2,10,1,64,2,13,0,1,201,5,7,213,227,0.318,0.938
"8767","La Paz","La Asunta","Unidad Educativa Central Quinuni",94,3,19,1,65,1,13,0,0,196,6,9,211,228,0.332,0.925
"8768","La Paz","La Asunta","Unidad Educativa Central Quinuni",106,1,12,1,78,1,9,0,0,208,4,10,222,233,0.375,0.953
"8769","La Paz","La Asunta","Unidad Educativa Central Quinuni",78,0,13,0,81,2,30,1,1,206,3,8,217,233,0.393,0.931
"8770","La Paz","La Asunta","Unidad Educativa Central Quinuni",75,2,7,2,90,5,15,1,0,197,5,18,220,236,0.457,0.932
"8771","La Paz","La Asunta","Colegio Las Mercedes",109,1,3,0,89,3,6,1,0,212,4,3,219,232,0.42,0.944
"8772","La Paz","La Asunta","Colegio Las Mercedes",93,3,7,2,84,4,16,0,0,209,4,4,217,230,0.402,0.943
"8773","La Paz","La Asunta","Colegio Las Mercedes",104,1,3,1,76,3,12,0,0,200,5,8,213,225,0.38,0.947
"8774","La Paz","La Asunta","Colegio Las Mercedes",106,1,4,2,84,2,8,1,0,208,3,6,217,230,0.404,0.943
"8775","La Paz","La Asunta","Colegio Las Mercedes",128,1,2,1,72,3,4,1,0,212,0,3,215,226,0.34,0.951
"8776","La Paz","La Asunta","Colegio Las Mercedes",99,3,8,2,78,4,10,2,0,206,8,8,222,236,0.379,0.941
"8777","La Paz","La Asunta","Escuela Puerto Rico",82,1,6,3,98,2,10,0,2,204,3,7,214,236,0.48,0.907
"8778","La Paz","La Asunta","Escuela Puerto Rico",61,1,4,1,118,1,15,0,0,201,5,6,212,232,0.587,0.914
"8779","La Paz","La Asunta","Escuela Puerto Rico",66,1,2,7,106,1,17,1,0,201,4,8,213,233,0.527,0.914
"8780","La Paz","La Asunta","Escuela Puerto Rico",76,2,9,0,95,1,7,0,2,192,2,11,205,228,0.495,0.899
"8781","La Paz","La Asunta","Escuela Puerto Rico",56,1,2,0,86,0,8,1,1,155,2,9,166,182,0.555,0.912
"8782","La Paz","La Asunta","Plaza 5 de Agosto",128,0,8,2,46,2,8,1,1,196,3,9,208,228,0.235,0.912
"8783","La Paz","La Asunta","Plaza 5 de Agosto",117,0,5,2,58,1,5,0,0,188,5,14,207,224,0.309,0.924
"8784","La Paz","La Asunta","Plaza 5 de Agosto",122,2,6,4,54,5,10,1,2,206,4,4,214,231,0.262,0.926
"8785","La Paz","La Asunta","Plaza 5 de Agosto",106,0,2,0,51,0,5,0,0,164,0,5,169,178,0.311,0.949
"8786","La Paz","La Asunta","Esc. Batallon Colorados",101,2,11,0,70,1,5,0,0,190,1,9,200,223,0.368,0.897
"8787","La Paz","La Asunta","Esc. Batallon Colorados",87,0,10,0,81,1,6,0,0,185,2,9,196,229,0.438,0.856
"8788","La Paz","La Asunta","Esc. Yanamayu",84,0,9,3,91,3,9,2,0,201,3,4,208,228,0.453,0.912
"8789","La Paz","La Asunta","Esc. Yanamayu",90,1,6,1,92,1,7,0,0,198,2,8,208,226,0.465,0.92
"8790","La Paz","La Asunta","Sede Social - Esc. Fiscal Calizaya",101,1,16,0,74,2,8,0,0,202,2,9,213,230,0.366,0.926
"8791","La Paz","La Asunta","Sede Social - Esc. Fiscal Calizaya",91,0,19,2,78,4,10,1,1,206,5,2,213,226,0.379,0.942
"8792","La Paz","La Asunta","Sede Social - Esc. Fiscal Calizaya",90,2,17,1,68,1,22,0,1,202,5,4,211,228,0.337,0.925
"8793","La Paz","La Asunta","Sede Social - Esc. Fiscal Calizaya",83,3,16,3,88,3,11,1,0,208,2,3,213,230,0.423,0.926
"8794","La Paz","La Asunta","Sede Social - Esc. Fiscal Calizaya",109,1,11,2,76,2,14,0,0,215,1,3,219,233,0.353,0.94
"8795","La Paz","La Asunta","Sede Social Charia",59,0,11,0,95,4,25,0,2,196,4,11,211,227,0.485,0.93
"8796","La Paz","La Asunta","Sede Social Charia",68,2,15,1,93,4,18,0,0,201,3,6,210,226,0.463,0.929
"8797","La Paz","La Asunta","Sede Social Charia",70,5,5,1,100,2,21,1,3,208,9,2,219,236,0.481,0.928
"8798","La Paz","La Asunta","Plaza Principal Pichari",108,0,3,2,66,5,8,1,1,194,1,8,203,227,0.34,0.894
"8799","La Paz","La Asunta","Casa de Gobierno",105,0,10,2,58,4,9,1,0,189,2,10,201,229,0.307,0.878
"8800","La Paz","La Asunta","Casa de Gobierno",87,3,15,1,72,5,11,3,0,197,6,5,208,224,0.365,0.929
"8801","La Paz","La Asunta","Colegio Pedro Domingo Murillo",94,3,10,2,60,3,18,0,1,191,5,13,209,226,0.314,0.925
"8802","La Paz","La Asunta","Colegio Pedro Domingo Murillo",83,1,11,2,85,3,8,1,1,195,3,8,206,228,0.436,0.904
"8803","La Paz","La Asunta","Colegio Pedro Domingo Murillo",78,1,11,2,84,6,16,1,0,199,4,8,211,232,0.422,0.909
"8804","La Paz","La Asunta","Colegio Pedro Domingo Murillo",116,3,9,1,59,3,12,1,1,205,2,5,212,233,0.288,0.91
"8805","La Paz","La Asunta","Colegio Pedro Domingo Murillo",110,0,4,2,73,2,12,0,0,203,4,7,214,227,0.36,0.943
"8806","La Paz","La Asunta","Colegio Pedro Domingo Murillo",92,0,11,1,72,5,16,0,1,198,4,8,210,229,0.364,0.917
"8807","La Paz","La Asunta","Plaza Principal",26,2,15,0,156,0,11,0,0,210,2,5,217,225,0.743,0.964
"8808","La Paz","La Asunta","Plaza Principal",20,0,12,1,166,0,11,0,1,211,4,10,225,228,0.787,0.987
"8809","La Paz","La Asunta","Sede Social 16 de Julio",35,1,8,0,152,1,8,0,0,205,1,7,213,228,0.741,0.934
"8810","La Paz","La Asunta","Sede Social 16 de Julio",41,2,6,2,149,7,3,0,0,210,3,9,222,233,0.71,0.953
"8811","La Paz","La Asunta","Sede Social 16 de Julio",45,2,9,1,143,1,6,1,0,208,4,7,219,234,0.688,0.936
"8812","La Paz","La Asunta","Esc. Pedro Domingo Murillo",69,0,31,2,84,4,18,0,0,208,4,5,217,230,0.404,0.943
"8813","La Paz","La Asunta","Esc. Pedro Domingo Murillo",72,2,23,1,63,5,27,1,1,195,10,6,211,228,0.323,0.925
"8814","La Paz","La Asunta","Esc. Pedro Domingo Murillo",59,2,25,1,88,4,20,2,3,204,5,6,215,226,0.431,0.951
"8815","La Paz","La Asunta","Unidad Educativa Nuevos Horizontes",47,1,10,2,124,2,11,0,1,198,4,9,211,231,0.626,0.913
"8816","La Paz","La Asunta","Unidad Educativa Nuevos Horizontes",63,2,17,0,97,3,28,2,0,212,3,9,224,250,0.458,0.896
"8817","La Paz","La Asunta","Unidad Educativa Siguani Grande",67,2,5,1,98,5,10,0,1,189,2,13,204,230,0.519,0.887
"8818","La Paz","La Asunta","Unidad Educativa Siguani Grande",47,0,6,0,151,3,6,1,0,214,3,5,222,231,0.706,0.961
"8819","La Paz","La Asunta","Unidad Educativa Siguani Grande",57,0,4,3,119,5,19,0,1,208,2,7,217,235,0.572,0.923
"8820","La Paz","La Asunta","Unidad Educativa Siguani Grande",75,1,12,1,101,4,10,0,1,205,3,8,216,234,0.493,0.923
"8821","La Paz","La Asunta","Unidad Educativa Siguani Grande",70,1,3,0,120,2,9,0,1,206,3,5,214,234,0.583,0.915
"8822","La Paz","La Asunta","U.E. Santa Rosa",12,0,6,1,182,2,7,0,1,211,2,3,216,229,0.863,0.943
"8823","La Paz","La Asunta","U.E. Santa Rosa",14,0,8,2,188,0,3,0,1,216,2,6,224,237,0.87,0.945
"8824","La Paz","La Asunta","U.E. Luis Ramos",44,0,7,2,137,2,13,0,0,205,2,15,222,239,0.668,0.929
"8825","La Paz","La Asunta","U.E. Luis Ramos",56,1,9,0,128,0,10,0,0,204,3,17,224,236,0.627,0.949
"8826","La Paz","La Asunta","U.E. Luis Ramos",62,0,7,3,110,1,13,1,0,197,5,12,214,221,0.558,0.968
"8827","La Paz","Pucarani","Esc. Jose Salmon Ballivian",6,3,16,0,117,1,36,1,0,180,11,18,209,220,0.65,0.95
"8828","La Paz","Pucarani","Esc. Jose Salmon Ballivian",24,3,11,1,116,3,25,2,2,187,4,11,202,209,0.62,0.967
"8829","La Paz","Pucarani","Esc. Jose Salmon Ballivian",13,0,17,0,126,1,28,3,0,188,6,17,211,223,0.67,0.946
"8830","La Paz","Pucarani","Esc. Jose Salmon Ballivian",13,1,16,0,112,1,32,1,3,179,3,16,198,211,0.626,0.938
"8831","La Paz","Pucarani","Esc. Jose Salmon Ballivian",23,0,8,0,96,3,23,0,6,159,12,28,199,213,0.604,0.934
"8832","La Paz","Pucarani","Esc. Jose Salmon Ballivian",12,2,6,0,122,3,32,1,1,179,5,19,203,223,0.682,0.91
"8833","La Paz","Pucarani","Esc. Jose Salmon Ballivian",26,1,13,0,120,0,18,1,4,183,3,7,193,210,0.656,0.919
"8834","La Paz","Pucarani","Esc. Jose Salmon Ballivian",24,0,12,1,110,2,25,1,3,178,10,13,201,217,0.618,0.926
"8835","La Paz","Pucarani","Esc. Jose Salmon Ballivian",16,2,10,0,133,1,16,1,3,182,7,11,200,221,0.731,0.905
"8836","La Paz","Pucarani","Esc. Jose Salmon Ballivian",13,0,14,0,122,0,20,1,3,173,7,14,194,210,0.705,0.924
"8837","La Paz","Pucarani","Esc. Jose Salmon Ballivian",18,1,15,1,107,2,23,1,2,170,2,17,189,209,0.629,0.904
"8838","La Paz","Pucarani","Esc. Jose Salmon Ballivian",10,0,3,1,131,0,26,0,0,171,5,20,196,215,0.766,0.912
"8839","La Paz","Pucarani","Esc. Jose Salmon Ballivian",17,1,6,0,137,2,31,0,0,194,3,11,208,219,0.706,0.95
"8840","La Paz","Pucarani","Esc. Jose Salmon Ballivian",35,0,13,0,116,1,12,2,0,179,8,17,204,217,0.648,0.94
"8841","La Paz","Pucarani","Esc. Jose Salmon Ballivian",13,2,21,2,127,2,16,0,2,185,15,13,213,225,0.686,0.947
"8842","La Paz","Pucarani","Colegio Cohana",2,2,17,0,170,0,9,0,0,200,6,4,210,225,0.85,0.933
"8843","La Paz","Pucarani","Colegio Cohana",3,1,16,0,171,0,11,0,1,203,2,5,210,219,0.842,0.959
"8844","La Paz","Pucarani","Colegio Cohana",2,0,6,1,160,1,13,0,2,185,9,6,200,217,0.865,0.922
"8845","La Paz","Pucarani","Colegio San Salvador",4,1,14,3,122,4,31,0,0,179,9,20,208,217,0.682,0.959
"8846","La Paz","Pucarani","Colegio San Salvador",5,2,17,2,137,2,26,0,0,191,7,6,204,215,0.717,0.949
"8847","La Paz","Pucarani","Colegio San Salvador",6,1,14,1,134,4,27,1,2,190,6,13,209,221,0.705,0.946
"8848","La Paz","Pucarani","Colegio San Salvador",9,0,14,0,131,2,21,0,1,178,11,14,203,221,0.736,0.919
"8849","La Paz","Pucarani","Colegio San Salvador",11,0,4,0,121,3,26,0,2,167,10,17,194,214,0.725,0.907
"8850","La Paz","Pucarani","Colegio San Salvador",7,1,14,1,137,1,18,0,2,181,5,11,197,218,0.757,0.904
"8851","La Paz","Pucarani","Colegio San Salvador",0,2,10,0,147,3,19,1,1,183,14,10,207,217,0.803,0.954
"8852","La Paz","Pucarani","Colegio San Salvador",3,2,14,0,138,3,16,0,1,177,16,11,204,214,0.78,0.953
"8853","La Paz","Pucarani","Colegio San Salvador",13,2,17,1,127,2,25,2,3,192,9,11,212,223,0.661,0.951
"8854","La Paz","Pucarani","Colegio Mario Gutierrez",14,10,7,1,95,2,24,2,0,155,15,17,187,204,0.613,0.917
"8855","La Paz","Pucarani","Colegio Mario Gutierrez",6,3,12,5,118,3,24,0,2,173,19,15,207,215,0.682,0.963
"8856","La Paz","Pucarani","Colegio Mario Gutierrez",4,2,12,2,119,3,20,0,0,162,16,18,196,213,0.735,0.92
"8857","La Paz","Pucarani","Colegio Mario Gutierrez",7,3,10,0,116,2,26,0,0,164,19,27,210,219,0.707,0.959
"8858","La Paz","Pucarani","Escuela Chojasivi",6,2,13,1,132,2,40,0,1,197,5,5,207,215,0.67,0.963
"8859","La Paz","Pucarani","Escuela Chojasivi",6,1,15,1,132,4,40,1,0,200,12,6,218,218,0.66,1
"8860","La Paz","Pucarani","Escuela Chojasivi",6,0,13,0,133,4,24,0,1,181,14,12,207,217,0.735,0.954
"8861","La Paz","Pucarani","U.E. Mariscal de Ayacucho",5,1,17,3,156,1,14,0,1,198,7,2,207,216,0.788,0.958
"8862","La Paz","Pucarani","U.E. Mariscal de Ayacucho",2,1,19,1,139,0,11,1,0,174,10,7,191,202,0.799,0.946
"8863","La Paz","Pucarani","U.E. Mariscal de Ayacucho",8,1,17,1,136,0,17,1,1,182,21,7,210,214,0.747,0.981
"8864","La Paz","Pucarani","U.E. Mariscal de Ayacucho",4,2,13,0,147,0,16,0,1,183,17,6,206,219,0.803,0.941
"8865","La Paz","Pucarani","Colegio Chiarpata",9,2,10,0,149,2,9,1,1,183,5,14,202,210,0.814,0.962
"8866","La Paz","Pucarani","Colegio Chiarpata",4,3,13,1,138,0,8,2,1,170,4,18,192,200,0.812,0.96
"8867","La Paz","Pucarani","Escuela Catavi",8,0,10,0,163,0,12,2,1,196,6,7,209,220,0.832,0.95
"8868","La Paz","Pucarani","Escuela Catavi",25,3,4,1,125,3,24,0,2,187,8,10,205,217,0.668,0.945
"8869","La Paz","Pucarani","Escuela Catavi",5,2,14,0,141,1,17,1,0,181,3,12,196,208,0.779,0.942
"8870","La Paz","Pucarani","Escuela Catavi",12,2,13,2,121,3,31,0,1,185,8,11,204,218,0.654,0.936
"8871","La Paz","Pucarani","Esc. Central Chipamaya",17,3,17,2,134,4,8,1,5,191,10,6,207,214,0.702,0.967
"8872","La Paz","Pucarani","Esc. Central Chipamaya",8,2,16,1,143,1,6,3,0,180,9,15,204,214,0.794,0.953
"8873","La Paz","Pucarani","U.E. Corapata",15,1,17,1,120,2,33,0,1,190,5,13,208,216,0.632,0.963
"8874","La Paz","Pucarani","U.E. Corapata",8,1,22,1,106,4,27,0,4,173,4,19,196,210,0.613,0.933
"8875","La Paz","Pucarani","U.E. Corapata",9,0,12,1,125,5,37,0,3,192,10,17,219,227,0.651,0.965
"8876","La Paz","Pucarani","U.E. Corapata",11,3,15,2,106,3,36,1,2,179,7,27,213,223,0.592,0.955
"8877","La Paz","Pucarani","U.E. Corapata",4,2,16,0,116,2,32,2,1,175,10,13,198,205,0.663,0.966
"8878","La Paz","Pucarani","Col. Nal.Chojña Collo",4,4,11,5,138,5,23,1,0,191,10,11,212,218,0.723,0.972
"8879","La Paz","Pucarani","Col. Nal.Chojña Collo",6,3,16,1,137,2,28,1,4,198,15,14,227,235,0.692,0.966
"8880","La Paz","Pucarani","Escuela Antofagasta",5,4,13,3,121,3,40,2,3,194,12,14,220,231,0.624,0.952
"8881","La Paz","Pucarani","Escuela Antofagasta",8,2,20,1,110,4,30,3,0,178,14,18,210,219,0.618,0.959
"8882","La Paz","Pucarani","Escuela Antofagasta",13,2,12,3,123,4,38,0,3,198,6,12,216,227,0.621,0.952
"8883","La Paz","Pucarani","Escuela Antofagasta",5,1,16,3,115,1,28,1,0,170,12,36,218,228,0.676,0.956
"8884","La Paz","Pucarani","Escuela Antofagasta",2,3,12,1,118,2,35,2,1,176,9,29,214,222,0.67,0.964
"8885","La Paz","Pucarani","Escuela Antofagasta",8,1,13,1,113,4,32,2,0,174,12,23,209,222,0.649,0.941
"8886","La Paz","Pucarani","Escuela Antofagasta",16,3,11,0,102,4,52,0,0,188,16,15,219,229,0.543,0.956
"8887","La Paz","Pucarani","Escuela Antofagasta",9,3,9,2,111,2,45,1,1,183,12,19,214,225,0.607,0.951
"8888","La Paz","Pucarani","Escuela Antofagasta",10,2,10,2,131,1,31,0,2,189,9,17,215,226,0.693,0.951
"8889","La Paz","Pucarani","U.E. Boliviano Japones",10,0,6,1,136,1,27,1,0,182,8,9,199,217,0.747,0.917
"8890","La Paz","Pucarani","U.E. Boliviano Japones",4,1,15,1,128,3,18,2,2,174,1,17,192,208,0.736,0.923
"8891","La Paz","Pucarani","U.E. Boliviano Japones",4,0,11,0,162,1,17,0,1,196,7,8,211,221,0.827,0.955
"8892","La Paz","Pucarani","U.E. Boliviano Japones",7,0,7,0,148,3,27,1,0,193,3,8,204,214,0.767,0.953
"8893","La Paz","Pucarani","U.E. Boliviano Japones",5,0,12,0,141,4,20,3,1,186,4,14,204,215,0.758,0.949
"8894","La Paz","Pucarani","U.E. Boliviano Japones",2,0,11,0,167,0,20,0,1,201,2,8,211,229,0.831,0.921
"8895","La Paz","Pucarani","U.E. Boliviano Japones",11,1,10,1,150,1,14,1,2,191,3,16,210,224,0.785,0.938
"8896","La Paz","Pucarani","U.E. Boliviano Japones",3,1,9,0,138,1,19,1,1,173,3,6,182,192,0.798,0.948
"8897","La Paz","Pucarani","Esc. Gualberto Villarroel",8,2,12,2,125,3,28,0,0,180,9,4,193,208,0.694,0.928
"8898","La Paz","Pucarani","Esc. Gualberto Villarroel",8,3,22,1,131,2,18,0,0,185,14,13,212,219,0.708,0.968
"8899","La Paz","Pucarani","Esc. Gualberto Villarroel",7,3,18,0,120,2,18,2,0,170,8,12,190,208,0.706,0.913
"8900","La Paz","Laja","U. E. Pedro Domingo Murillo",16,2,11,1,147,1,14,0,1,193,4,6,203,219,0.762,0.927
"8901","La Paz","Laja","U. E. Pedro Domingo Murillo",22,4,10,1,123,1,31,2,1,195,6,6,207,222,0.631,0.932
"8902","La Paz","Laja","U. E. Pedro Domingo Murillo",12,0,11,0,147,1,10,0,0,181,2,12,195,211,0.812,0.924
"8903","La Paz","Laja","U. E. Pedro Domingo Murillo",11,0,4,0,156,1,16,1,3,192,9,7,208,219,0.812,0.95
"8904","La Paz","Laja","U. E. Pedro Domingo Murillo",14,1,6,2,135,1,27,0,6,192,7,13,212,220,0.703,0.964
"8905","La Paz","Laja","U. E. Pedro Domingo Murillo",8,1,10,1,140,0,15,0,1,176,10,14,200,213,0.795,0.939
"8906","La Paz","Laja","U. E. Pedro Domingo Murillo",12,4,5,0,138,1,17,0,3,180,7,7,194,210,0.767,0.924
"8907","La Paz","Laja","U. E. Pedro Domingo Murillo",4,1,12,0,161,0,10,1,1,190,9,10,209,215,0.847,0.972
"8908","La Paz","Laja","U. E. Pedro Domingo Murillo",13,1,8,0,133,0,21,0,0,176,13,19,208,225,0.756,0.924
"8909","La Paz","Laja","U. E. Pedro Domingo Murillo",5,1,5,1,139,1,13,0,1,166,14,11,191,208,0.837,0.918
"8910","La Paz","Laja","U. E. Pedro Domingo Murillo",11,0,12,1,165,0,18,0,2,209,0,10,219,230,0.789,0.952
"8911","La Paz","Laja","U. E. Pedro Domingo Murillo",11,0,14,0,151,1,15,2,3,197,2,14,213,224,0.766,0.951
"8912","La Paz","Laja","U. E. Pedro Domingo Murillo",8,1,19,1,148,0,13,0,1,191,7,8,206,223,0.775,0.924
"8913","La Paz","Laja","U. E. Pedro Domingo Murillo",10,1,9,0,141,0,20,0,0,181,5,17,203,222,0.779,0.914
"8914","La Paz","Laja","U. E. Pedro Domingo Murillo",15,1,7,1,152,3,14,0,1,194,6,6,206,216,0.784,0.954
"8915","La Paz","Laja","U. E. Pedro Domingo Murillo",5,0,9,1,136,2,20,1,0,174,4,29,207,223,0.782,0.928
"8916","La Paz","Laja","U. E. Pedro Domingo Murillo",12,3,4,1,156,0,19,1,0,196,3,8,207,215,0.796,0.963
"8917","La Paz","Laja","U. E. Pedro Domingo Murillo",4,0,7,1,160,2,15,1,2,192,4,12,208,216,0.833,0.963
"8918","La Paz","Laja","U. E. Pedro Domingo Murillo",12,3,11,0,147,0,13,0,2,188,5,6,199,215,0.782,0.926
"8919","La Paz","Laja","U. E. Kentupata",7,1,10,1,141,1,2,0,1,164,2,6,172,177,0.86,0.972
"8920","La Paz","Laja","U. E. Técnico Humanístico Tambillo",33,2,8,0,134,1,14,1,0,193,4,7,204,222,0.694,0.919
"8921","La Paz","Laja","U. E. Técnico Humanístico Tambillo",18,2,7,0,137,1,10,0,2,177,11,13,201,214,0.774,0.939
"8922","La Paz","Laja","Mercado San Juan",3,1,12,2,145,0,6,4,2,175,7,13,195,206,0.829,0.947
"8923","La Paz","Laja","Mercado San Juan",7,3,3,0,151,3,5,1,1,174,10,7,191,207,0.868,0.923
"8924","La Paz","Laja","U. E. Curva Pucara",0,0,5,1,166,4,15,0,1,192,5,3,200,207,0.865,0.966
"8925","La Paz","Laja","U. E. Curva Pucara",3,1,5,1,152,0,22,0,1,185,5,13,203,214,0.822,0.949
"8926","La Paz","Laja","U. E. Curva Pucara",3,1,8,1,166,1,17,2,1,200,6,5,211,218,0.83,0.968
"8927","La Paz","Laja","U.E. Collo Collo",2,1,8,0,177,1,12,2,2,205,6,3,214,219,0.863,0.977
"8928","La Paz","Laja","U. E. René Barrientos Ortuño",10,0,13,0,146,1,21,0,0,191,5,14,210,219,0.764,0.959
"8929","La Paz","Laja","U. E. René Barrientos Ortuño",8,0,11,1,139,0,11,1,0,171,6,5,182,190,0.813,0.958
"8930","La Paz","Laja","U. E. Cantapa",8,1,9,1,159,2,22,0,0,202,4,10,216,222,0.787,0.973
"8931","La Paz","Laja","U. E. Cantapa",2,3,11,0,167,0,9,0,0,192,14,10,216,219,0.87,0.986
"8932","La Paz","Laja","U. E. Copajira",4,2,5,0,154,3,23,0,0,191,10,8,209,221,0.806,0.946
"8933","La Paz","Laja","U. E. Copajira",3,0,7,0,168,1,12,1,0,192,8,8,208,215,0.875,0.967
"8934","La Paz","Laja","U. E. Copajira",10,1,13,1,158,2,10,1,1,197,8,12,217,228,0.802,0.952
"8935","La Paz","Laja","U. E. Republica de Iran",11,2,8,0,133,3,22,0,2,181,5,8,194,213,0.735,0.911
"8936","La Paz","Laja","U. E. Republica de Iran",5,2,8,1,149,1,21,0,0,187,7,9,203,217,0.797,0.935
"8937","La Paz","Laja","U. E. Republica de Iran",2,3,6,1,135,1,17,1,0,166,7,16,189,208,0.813,0.909
"8938","La Paz","Laja","U. E. Republica de Iran",14,0,8,0,135,2,23,0,0,182,4,14,200,218,0.742,0.917
"8939","La Paz","Laja","U.E. Callamarca",8,3,3,0,159,0,24,1,4,202,8,16,226,228,0.787,0.991
"8940","La Paz","Laja","U.E. Callamarca",5,2,10,0,122,1,17,1,0,158,3,7,168,169,0.772,0.994
"8941","La Paz","Laja","U.E. Gualberto Villarroel de Sacacani",3,0,12,1,174,1,10,0,0,201,6,10,217,217,0.866,1
"8942","La Paz","Laja","U.E. República Bolivariana de Venezuela",31,0,9,1,148,2,28,1,2,222,1,7,230,236,0.667,0.975
"8943","La Paz","Laja","U.E. República Bolivariana de Venezuela",26,3,5,0,150,1,35,0,4,224,3,7,234,240,0.67,0.975
"8944","La Paz","Laja","U.E. República Bolivariana de Venezuela",34,0,10,0,145,2,31,0,2,224,1,7,232,239,0.647,0.971
"8945","La Paz","Laja","U.E. República Bolivariana de Venezuela",29,2,6,0,153,1,28,0,4,223,2,10,235,239,0.686,0.983
"8946","La Paz","Laja","U.E. República Bolivariana de Venezuela",21,1,4,0,160,1,29,0,5,221,2,5,228,236,0.724,0.966
"8947","La Paz","Laja","U.E. República Bolivariana de Venezuela",24,3,6,1,159,0,23,1,1,218,3,11,232,240,0.729,0.967
"8948","La Paz","Laja","U.E. República Bolivariana de Venezuela",34,2,10,1,134,0,40,0,3,224,2,6,232,237,0.598,0.979
"8949","La Paz","Laja","U.E. República Bolivariana de Venezuela",20,0,9,0,111,1,18,0,3,162,2,11,175,181,0.685,0.967
"8950","La Paz","Batallas","Escuela Genoveva Rios",13,2,16,0,139,3,23,0,3,199,3,5,207,221,0.698,0.937
"8951","La Paz","Batallas","Escuela Genoveva Rios",25,3,8,1,101,11,37,0,2,188,5,9,202,217,0.537,0.931
"8952","La Paz","Batallas","Escuela Genoveva Rios",17,2,12,0,122,2,30,0,1,186,5,8,199,215,0.656,0.926
"8953","La Paz","Batallas","Escuela Genoveva Rios",9,1,12,1,112,2,24,0,1,162,7,17,186,209,0.691,0.89
"8954","La Paz","Batallas","Escuela Genoveva Rios",17,2,7,0,121,1,34,0,2,184,3,17,204,221,0.658,0.923
"8955","La Paz","Batallas","Escuela Genoveva Rios",16,3,7,1,104,4,44,0,1,180,5,13,198,222,0.578,0.892
"8956","La Paz","Batallas","Escuela Genoveva Rios",14,0,13,0,134,3,27,0,2,193,5,5,203,216,0.694,0.94
"8957","La Paz","Batallas","Escuela Genoveva Rios",5,0,16,1,104,6,26,1,2,161,14,13,188,206,0.646,0.913
"8958","La Paz","Batallas","Escuela Genoveva Rios",15,0,16,1,111,1,29,0,2,175,7,13,195,214,0.634,0.911
"8959","La Paz","Batallas","Escuela Genoveva Rios",12,2,11,0,121,4,29,0,3,182,3,9,194,210,0.665,0.924
"8960","La Paz","Batallas","Escuela Genoveva Rios",13,1,14,0,127,5,23,0,0,183,10,10,203,212,0.694,0.958
"8961","La Paz","Batallas","Escuela Genoveva Rios",27,0,15,0,123,3,42,0,1,211,2,8,221,231,0.583,0.957
"8962","La Paz","Batallas","Escuela Genoveva Rios",6,0,25,0,110,1,30,1,0,173,10,12,195,210,0.636,0.929
"8963","La Paz","Batallas","Escuela Genoveva Rios",7,3,13,2,134,2,23,0,1,185,6,11,202,216,0.724,0.935
"8964","La Paz","Batallas","Escuela Genoveva Rios",10,1,3,0,121,5,30,1,0,171,12,13,196,212,0.708,0.925
"8965","La Paz","Batallas","Escuela Genoveva Rios",10,0,9,0,114,1,27,0,1,162,5,9,176,187,0.704,0.941
"8966","La Paz","Batallas","U.E. Villa Asunción De Caluyo",8,1,12,0,159,3,28,0,1,212,4,5,221,231,0.75,0.957
"8967","La Paz","Batallas","Col. Fiscal Boliviano Cubano",13,0,4,3,120,2,38,0,2,182,4,11,197,212,0.659,0.929
"8968","La Paz","Batallas","Col. Fiscal Boliviano Cubano",9,1,12,3,148,3,21,0,1,198,5,5,208,216,0.747,0.963
"8969","La Paz","Batallas","Col. Fiscal Boliviano Cubano",11,0,11,1,113,4,50,0,0,190,6,11,207,224,0.595,0.924
"8970","La Paz","Batallas","U.E. Calasaya",12,4,16,0,138,4,19,0,1,194,3,11,208,226,0.711,0.92
"8971","La Paz","Batallas","U.E. Calasaya",5,2,13,1,136,4,22,0,0,183,8,9,200,212,0.743,0.943
"8972","La Paz","Batallas","U.E. Calasaya",6,1,8,0,128,4,29,1,0,177,0,3,180,187,0.723,0.963
"8973","La Paz","Batallas","Colegio Don Bosco",8,2,11,0,147,0,25,1,0,194,5,5,204,216,0.758,0.944
"8974","La Paz","Batallas","Colegio Don Bosco",8,0,5,1,153,4,19,1,2,193,9,6,208,222,0.793,0.937
"8975","La Paz","Batallas","Colegio Don Bosco",12,1,7,0,154,2,12,1,0,189,2,9,200,214,0.815,0.935
"8976","La Paz","Batallas","Colegio Don Bosco",10,3,2,0,147,2,18,0,1,183,8,7,198,212,0.803,0.934
"8977","La Paz","Batallas","U.E. Huancane",18,0,8,1,130,2,25,0,1,185,3,8,196,209,0.703,0.938
"8978","La Paz","Batallas","U.E. Julián Túpac Katari",7,3,30,2,137,4,10,1,0,194,12,3,209,218,0.706,0.959
"8979","La Paz","Batallas","U.E. Julián Túpac Katari",3,0,20,0,124,1,10,0,1,159,13,11,183,205,0.78,0.893
"8980","La Paz","Batallas","U.E. Julián Túpac Katari",4,1,24,1,134,1,6,3,0,174,8,11,193,210,0.77,0.919
"8981","La Paz","Batallas","Col. Pedro Domingo Murillo",7,0,25,1,109,3,15,1,1,162,4,24,190,204,0.673,0.931
"8982","La Paz","Batallas","Col. Pedro Domingo Murillo",9,3,34,2,89,0,12,1,2,152,16,13,181,196,0.586,0.923
"8983","La Paz","Batallas","Col. Pedro Domingo Murillo",3,0,29,2,99,2,18,1,1,155,9,7,171,187,0.639,0.914
"8984","La Paz","Batallas","U.E. Fray Jose Antonio  Zampa",4,2,18,1,120,3,17,1,6,172,4,29,205,217,0.698,0.945
"8985","La Paz","Batallas","U.E. Fray Jose Antonio  Zampa",6,2,13,0,122,0,26,0,2,171,4,15,190,204,0.713,0.931
"8986","La Paz","Batallas","U.E. Fray Jose Antonio  Zampa",11,4,20,0,125,0,19,5,3,187,2,7,196,212,0.668,0.925
"8987","La Paz","Batallas","U.E. Franz Tamayo de Chachacomani",6,2,29,1,101,1,17,1,0,158,8,30,196,219,0.639,0.895
"8988","La Paz","Batallas","U.E. Franz Tamayo de Chachacomani",11,3,30,2,98,5,20,2,1,172,5,12,189,208,0.57,0.909
"8989","La Paz","Batallas","U.E. Franz Tamayo de Chachacomani",12,0,33,3,98,6,28,0,0,180,6,15,201,214,0.544,0.939
"8990","La Paz","Batallas","U.E. Libertador Simón Bolívar",3,2,14,1,146,5,16,1,0,188,2,20,210,219,0.777,0.959
"8991","La Paz","Batallas","U.E. Libertador Simón Bolívar",8,1,12,1,141,0,20,2,0,185,7,9,201,214,0.762,0.939
"8992","La Paz","Batallas","U.E. Libertador Simón Bolívar",3,4,10,1,118,2,23,0,0,161,4,42,207,219,0.733,0.945
"8993","La Paz","Batallas","Colegio Técnico Humanístico Chirapaca",25,0,14,0,119,0,34,1,2,195,4,13,212,218,0.61,0.972
"8994","La Paz","Batallas","Colegio Técnico Humanístico Chirapaca",28,0,23,0,116,2,26,2,3,200,5,3,208,214,0.58,0.972
"8995","La Paz","Puerto Pérez","Escuela Puerto Perez",14,3,15,0,133,4,17,0,1,187,5,8,200,210,0.711,0.952
"8996","La Paz","Puerto Pérez","Escuela Puerto Perez",8,3,18,2,135,3,15,0,1,185,7,4,196,206,0.73,0.951
"8997","La Paz","Puerto Pérez","Escuela Puerto Perez",4,3,12,1,157,7,16,0,2,202,1,9,212,219,0.777,0.968
"8998","La Paz","Puerto Pérez","Escuela Puerto Perez",9,2,4,0,150,1,19,1,4,190,6,12,208,218,0.789,0.954
"8999","La Paz","Puerto Pérez","Escuela Puerto Perez",5,1,14,0,150,2,18,1,0,191,5,7,203,215,0.785,0.944
"9000","La Paz","Puerto Pérez","Esc. Mixto 16 De Julio",3,3,7,0,173,1,21,1,0,209,3,7,219,226,0.828,0.969
"9001","La Paz","Puerto Pérez","Esc. Mixto 16 De Julio",4,1,6,0,164,2,11,1,0,189,9,6,204,209,0.868,0.976
"9002","La Paz","Puerto Pérez","Esc. Mixto 16 De Julio",7,2,9,0,177,2,10,0,1,208,4,7,219,225,0.851,0.973
"9003","La Paz","Puerto Pérez","Escuela Central Cascachi",4,1,9,0,139,1,8,0,1,163,7,8,178,190,0.853,0.937
"9004","La Paz","Puerto Pérez","Escuela Central Cascachi",0,0,10,1,138,1,6,0,0,156,9,12,177,196,0.885,0.903
"9005","La Paz","Puerto Pérez","Escuelas Populares Don Bosco",2,1,23,1,133,2,19,1,0,182,9,5,196,214,0.731,0.916
"9006","La Paz","Puerto Pérez","Unidad Educativa Cumana",7,0,12,1,150,1,14,2,0,187,6,8,201,216,0.802,0.931
"9007","La Paz","Sicasica","Col. Nal. Sica Sica",32,1,13,1,109,3,25,1,1,186,6,4,196,217,0.586,0.903
"9008","La Paz","Sicasica","Col. Nal. Sica Sica",23,1,8,1,112,3,35,1,0,184,7,8,199,220,0.609,0.905
"9009","La Paz","Sicasica","Col. Nal. Sica Sica",22,1,15,0,124,0,16,0,0,178,4,8,190,209,0.697,0.909
"9010","La Paz","Sicasica","Col. Nal. Sica Sica",17,2,16,0,125,2,13,1,2,178,5,5,188,210,0.702,0.895
"9011","La Paz","Sicasica","Col. Nal. Sica Sica",18,1,12,0,127,2,24,0,0,184,6,11,201,218,0.69,0.922
"9012","La Paz","Sicasica","Col. Nal. Sica Sica",21,1,10,1,119,5,18,0,0,175,2,6,183,209,0.68,0.876
"9013","La Paz","Sicasica","Col. Nal. Sica Sica",29,1,7,3,111,2,30,1,1,185,0,12,197,219,0.6,0.9
"9014","La Paz","Sicasica","U.E Integral Ayamaya",6,1,11,0,172,3,7,1,0,201,4,3,208,221,0.856,0.941
"9015","La Paz","Sicasica","Casa de Gobierno",27,5,5,0,136,1,12,1,0,187,6,10,203,218,0.727,0.931
"9016","La Paz","Sicasica","Casa de Gobierno",19,1,3,3,161,1,5,0,1,194,1,5,200,211,0.83,0.948
"9017","La Paz","Sicasica","U.E. Santiago de Laurani",6,0,14,0,158,1,6,0,1,186,0,2,188,203,0.849,0.926
"9018","La Paz","Sicasica","Escuela Eden",11,0,13,0,144,1,20,0,0,189,7,5,201,219,0.762,0.918
"9019","La Paz","Sicasica","Escuela Eden",12,0,19,1,136,1,22,0,1,192,3,7,202,222,0.708,0.91
"9020","La Paz","Sicasica","Escuela Eden",21,1,13,1,132,1,18,1,2,190,2,9,201,221,0.695,0.91
"9021","La Paz","Sicasica","Escuela Eden",12,2,21,0,137,1,18,0,1,192,4,7,203,225,0.714,0.902
"9022","La Paz","Sicasica","Escuela Eden",10,1,12,0,151,2,17,0,2,195,5,4,204,222,0.774,0.919
"9023","La Paz","Sicasica","Escuela Eden",15,0,23,0,130,3,22,0,1,194,3,7,204,220,0.67,0.927
"9024","La Paz","Sicasica","Escuela Eden",15,0,8,1,140,0,20,0,0,184,3,13,200,216,0.761,0.926
"9025","La Paz","Sicasica","Escuela Eden",11,0,11,0,145,1,21,0,0,189,3,8,200,216,0.767,0.926
"9026","La Paz","Sicasica","Escuela Eden",10,1,11,1,152,1,12,1,1,190,5,8,203,217,0.8,0.935
"9027","La Paz","Sicasica","Escuela Eden",11,1,11,1,153,0,18,0,0,195,4,8,207,218,0.785,0.95
"9028","La Paz","Sicasica","Escuela Eden",15,0,10,0,154,2,15,0,0,196,3,5,204,218,0.786,0.936
"9029","La Paz","Sicasica","Escuela Eden",12,0,9,1,148,2,30,0,1,203,3,3,209,225,0.729,0.929
"9030","La Paz","Sicasica","Escuela Eden",7,1,8,2,160,0,15,0,1,194,2,9,205,221,0.825,0.928
"9031","La Paz","Sicasica","Colegio Tawantinsuyo",10,2,13,0,148,0,11,0,1,185,1,11,197,214,0.8,0.921
"9032","La Paz","Sicasica","Colegio Tawantinsuyo",4,1,18,1,130,3,20,1,2,180,1,7,188,204,0.722,0.922
"9033","La Paz","Sicasica","Escuela Simon Bolivar",11,0,14,0,160,1,7,0,0,193,2,1,196,214,0.829,0.916
"9034","La Paz","Sicasica","Escuela Simon Bolivar",6,0,13,1,165,0,4,0,0,189,2,2,193,211,0.873,0.915
"9035","La Paz","Sicasica","Unidad Educativa Conani",9,3,15,0,132,2,30,1,0,192,4,5,201,216,0.688,0.931
"9036","La Paz","Sicasica","Unidad Educativa Conani",22,0,7,0,152,2,10,1,1,195,3,8,206,223,0.779,0.924
"9037","La Paz","Sicasica","Unidad Educativa Conani",7,0,16,3,147,2,12,0,4,191,5,3,199,217,0.77,0.917
"9038","La Paz","Sicasica","Unidad Educativa Conani",10,1,15,1,131,3,29,0,0,190,6,4,200,217,0.689,0.922
"9039","La Paz","Sicasica","Unidad Educativa Conani",1,1,13,0,165,1,7,1,1,190,5,7,202,217,0.868,0.931
"9040","La Paz","Sicasica","Unidad Educativa Conani",11,3,22,0,132,2,16,1,1,188,3,3,194,210,0.702,0.924
"9041","La Paz","Sicasica","Unidad Educativa Conani",11,1,15,0,135,1,20,0,1,184,4,11,199,209,0.734,0.952
"9042","La Paz","Sicasica","Unidad Educativa Conani",1,0,12,1,156,2,15,1,2,190,4,7,201,216,0.821,0.931
"9043","La Paz","Sicasica","Unidad Educativa Conani",4,0,14,2,144,3,17,1,0,185,4,6,195,208,0.778,0.938
"9044","La Paz","Sicasica","Col. Tomas Katari",0,0,8,0,177,0,9,0,1,195,6,6,207,220,0.908,0.941
"9045","La Paz","Sicasica","Esc. Jose M. Pando",21,0,2,0,168,1,11,0,1,204,3,2,209,225,0.824,0.929
"9046","La Paz","Sicasica","Esc. Jose M. Pando",5,0,5,1,184,1,8,1,0,205,2,2,209,227,0.898,0.921
"9047","La Paz","Sicasica","Unidad Educativa Chuacollo Grande",3,0,6,0,142,3,5,0,0,159,6,5,170,180,0.893,0.944
"9048","La Paz","Sicasica","U.E. Hurinzaya",9,0,14,0,143,2,7,0,0,175,12,16,203,215,0.817,0.944
"9049","La Paz","Sicasica","U.E. Hurinzaya",12,1,13,3,150,2,6,0,1,188,6,2,196,217,0.798,0.903
"9050","La Paz","Sicasica","U.E. Jaruma ´B´",4,1,6,1,159,0,3,1,0,175,1,10,186,211,0.909,0.882
"9051","La Paz","Sicasica","U.E. Jaruma ´B´",3,2,8,1,167,0,5,1,0,187,1,0,188,205,0.893,0.917
"9052","La Paz","Sicasica","U.E. Jaruma ´B´",2,0,7,0,172,0,6,0,0,187,0,1,188,206,0.92,0.913
"9053","La Paz","Sicasica","Unidad Educativa Pedro Domingo Murillo",9,0,16,0,140,1,32,0,2,200,2,7,209,219,0.7,0.954
"9054","La Paz","Sicasica","Unidad Educativa Pedro Domingo Murillo",13,0,18,0,147,3,23,0,0,204,4,12,220,223,0.721,0.987
"9055","La Paz","Sicasica","Unidad Educativa Pedro Domingo Murillo",8,0,16,2,143,4,28,1,1,203,3,6,212,221,0.704,0.959
"9056","La Paz","Sicasica","Unidad Educativa Bartolina Sisa A",3,0,6,1,201,1,6,0,1,219,0,2,221,228,0.918,0.969
"9057","La Paz","Umala","U.E. Gral. Demetrio Ramos",15,2,10,2,127,3,10,0,0,169,4,7,180,202,0.751,0.891
"9058","La Paz","Umala","U.E. Gral. Demetrio Ramos",17,0,20,1,117,1,9,0,0,165,6,13,184,205,0.709,0.898
"9059","La Paz","Umala","Casa de Gobierno",22,0,17,3,112,2,15,1,2,174,7,5,186,209,0.644,0.89
"9060","La Paz","Umala","Casa de Gobierno",19,0,12,3,114,1,18,0,0,167,3,7,177,198,0.683,0.894
"9061","La Paz","Umala","Col. De Ventilla",6,2,20,2,148,4,5,1,1,189,0,9,198,211,0.783,0.938
"9062","La Paz","Umala","Escuela San Miguel de Copani",6,2,16,1,119,2,10,1,1,158,6,12,176,192,0.753,0.917
"9063","La Paz","Umala","Unidad Educativa Llanga Belen",13,2,11,0,132,1,21,2,1,183,10,2,195,211,0.721,0.924
"9064","La Paz","Umala","U.E. Huari Belen ´B´",10,1,4,0,157,0,9,0,0,181,7,3,191,208,0.867,0.918
"9065","La Paz","Umala","U.E. Huari Belen ´B´",16,0,7,0,146,0,11,0,1,181,1,3,185,213,0.807,0.869
"9066","La Paz","Umala","U.E. Jaime Mendoza",8,1,12,0,145,1,7,0,0,174,9,7,190,208,0.833,0.913
"9067","La Paz","Umala","Casa de Gobierno",7,1,21,2,130,1,14,1,0,177,15,3,195,214,0.734,0.911
"9068","La Paz","Umala","Casa de Gobierno",19,2,20,1,129,1,14,2,2,190,5,5,200,213,0.679,0.939
"9069","La Paz","Umala","U.E. Asunción de Huancarama",9,0,15,0,133,0,8,3,1,169,5,5,179,196,0.787,0.913
"9070","La Paz","Umala","Col. Nal. Mixto San Jose",10,3,10,1,131,2,27,1,1,186,4,6,196,213,0.704,0.92
"9071","La Paz","Umala","U.E. Kellhuiri",8,5,12,0,130,1,15,1,0,172,6,11,189,205,0.756,0.922
"9072","La Paz","Ayo Ayo","Col. Ayo Ayo",5,1,15,0,159,3,14,2,0,199,2,7,208,221,0.799,0.941
"9073","La Paz","Ayo Ayo","Col. Ayo Ayo",4,2,11,1,151,2,10,0,0,181,4,9,194,217,0.834,0.894
"9074","La Paz","Ayo Ayo","Col. Ayo Ayo",4,1,14,0,152,2,16,1,0,190,7,6,203,217,0.8,0.935
"9075","La Paz","Ayo Ayo","Col. Ayo Ayo",12,0,10,0,162,0,5,0,0,189,8,10,207,219,0.857,0.945
"9076","La Paz","Ayo Ayo","Col. Ayo Ayo",4,1,28,2,153,0,3,0,0,191,3,4,198,213,0.801,0.93
"9077","La Paz","Ayo Ayo","Col. Ayo Ayo",3,1,13,1,162,1,11,0,0,192,3,8,203,224,0.844,0.906
"9078","La Paz","Ayo Ayo","Col. Ayo Ayo",7,1,26,0,137,1,11,1,0,184,6,6,196,215,0.745,0.912
"9079","La Paz","Ayo Ayo","Col. Ayo Ayo",9,0,23,0,155,1,5,1,1,195,6,3,204,221,0.795,0.923
"9080","La Paz","Ayo Ayo","Col. Ayo Ayo",6,0,29,1,130,0,19,0,0,185,4,6,195,212,0.703,0.92
"9081","La Paz","Ayo Ayo","Esc. Calacachi",10,2,34,1,122,1,12,0,0,182,11,19,212,227,0.67,0.934
"9082","La Paz","Ayo Ayo","Esc. Calacachi",11,0,50,0,116,1,7,3,0,188,6,7,201,220,0.617,0.914
"9083","La Paz","Ayo Ayo","Esc. Sta. Rosa de Lima",3,2,20,1,146,1,1,0,0,174,4,7,185,204,0.839,0.907
"9084","La Paz","Ayo Ayo","Esc. Franz Tamayo",12,0,15,1,146,1,17,1,0,193,7,9,209,222,0.756,0.941
"9085","La Paz","Ayo Ayo","Esc. Franz Tamayo",7,2,27,0,150,0,13,0,0,199,6,7,212,225,0.754,0.942
"9086","La Paz","Ayo Ayo","Esc. Franz Tamayo",12,1,23,2,141,2,7,0,0,188,5,12,205,225,0.75,0.911
"9087","La Paz","Ayo Ayo","Esc. Franz Tamayo",12,1,18,1,148,3,10,0,0,193,12,4,209,225,0.767,0.929
"9088","La Paz","Ayo Ayo","Colegio José Ballivián",3,0,10,3,138,1,7,0,0,162,7,9,178,185,0.852,0.962
"9089","La Paz","Calamarca","U.E. Rosa Kroeber Vda. de Carpio",23,0,22,1,119,0,16,0,0,181,5,7,193,213,0.657,0.906
"9090","La Paz","Calamarca","U.E. Rosa Kroeber Vda. de Carpio",12,2,54,0,103,3,10,0,1,185,9,14,208,223,0.557,0.933
"9091","La Paz","Calamarca","U.E. Rosa Kroeber Vda. de Carpio",9,4,55,0,107,3,13,0,4,195,5,4,204,225,0.549,0.907
"9092","La Paz","Calamarca","U.E. Rosa Kroeber Vda. de Carpio",10,1,45,0,110,0,11,0,1,178,5,13,196,224,0.618,0.875
"9093","La Paz","Calamarca","U.E. Rosa Kroeber Vda. de Carpio",15,1,29,2,130,1,16,0,2,196,2,9,207,224,0.663,0.924
"9094","La Paz","Calamarca","U.E. Rosa Kroeber Vda. de Carpio",17,1,55,0,101,0,9,0,1,184,6,12,202,219,0.549,0.922
"9095","La Paz","Calamarca","U.E. Rosa Kroeber Vda. de Carpio",18,2,32,3,113,1,14,0,0,183,3,13,199,217,0.617,0.917
"9096","La Paz","Calamarca","Unidad Educativa Sucanavi",7,3,26,1,104,1,18,0,0,160,4,9,173,184,0.65,0.94
"9097","La Paz","Calamarca","Casa de Gobierno",7,4,14,1,137,5,10,1,0,179,2,20,201,218,0.765,0.922
"9098","La Paz","Calamarca","Casa de Gobierno",2,1,18,2,132,3,10,0,0,168,6,18,192,198,0.786,0.97
"9099","La Paz","Calamarca","Casa de Gobierno",13,0,14,0,116,3,11,0,2,159,2,22,183,196,0.73,0.934
"9100","La Paz","Calamarca","U.E. German Busch de Sivicani",3,1,31,0,142,0,12,1,0,190,7,12,209,223,0.747,0.937
"9101","La Paz","Calamarca","U.E. German Busch de Sivicani",6,2,35,0,123,0,20,0,0,186,10,7,203,209,0.661,0.971
"9102","La Paz","Calamarca","U.E. Venezuela de Totorani",7,0,20,0,132,3,11,1,0,174,4,8,186,205,0.759,0.907
"9103","La Paz","Calamarca","U.E. Venezuela de Totorani",14,2,17,1,129,1,7,0,0,171,5,7,183,206,0.754,0.888
"9104","La Paz","Calamarca","U.E. San Antonio",8,4,11,0,151,1,13,1,0,189,3,19,211,224,0.799,0.942
"9105","La Paz","Calamarca","U.E. San Antonio",10,1,14,0,142,2,20,2,2,193,5,7,205,219,0.736,0.936
"9106","La Paz","Calamarca","U.E. San Antonio",5,2,13,0,158,1,11,0,1,191,8,11,210,218,0.827,0.963
"9107","La Paz","Calamarca","U.E. San Antonio",5,1,19,1,163,2,13,0,1,205,1,8,214,223,0.795,0.96
"9108","La Paz","Calamarca","U.E. San Antonio",6,1,25,0,150,2,12,2,0,198,5,7,210,221,0.758,0.95
"9109","La Paz","Calamarca","U.E. San Antonio",10,0,14,0,156,2,15,0,0,197,8,10,215,220,0.792,0.977
"9110","La Paz","Calamarca","Casa de Gobierno",9,0,30,3,136,2,14,0,3,197,2,12,211,220,0.69,0.959
"9111","La Paz","Calamarca","U.E. Germán Busch de Caluyo",8,2,34,0,136,1,3,1,0,185,6,14,205,216,0.735,0.949
"9112","La Paz","Calamarca","U.E. Germán Busch de Caluyo",16,1,39,0,120,1,8,0,0,185,5,11,201,217,0.649,0.926
"9113","La Paz","Calamarca","Esc. Central Choritotora",4,1,16,1,160,0,3,1,0,186,4,10,200,215,0.86,0.93
"9114","La Paz","Calamarca","Esc. Central Choritotora",0,2,14,3,166,0,3,0,0,188,5,5,198,211,0.883,0.938
"9115","La Paz","Calamarca","Escuela Eduardo Avaroa",10,2,13,1,150,2,16,0,0,194,3,3,200,217,0.773,0.922
"9116","La Paz","Calamarca","Escuela Eduardo Avaroa",4,6,18,1,153,1,18,0,1,202,1,9,212,223,0.757,0.951
"9117","La Paz","Calamarca","Escuela Eduardo Avaroa",5,0,14,1,141,0,15,0,0,176,2,6,184,201,0.801,0.915
"9118","La Paz","Calamarca","Unidad Educativa Franz Tamayo",1,1,12,1,165,1,9,1,1,192,4,9,205,220,0.859,0.932
"9119","La Paz","Calamarca","Unidad Educativa Franz Tamayo",4,2,13,0,166,1,10,0,0,196,1,11,208,218,0.847,0.954
"9120","La Paz","Calamarca","U.E. Juan José Torrez",3,0,19,2,152,0,20,1,0,197,8,17,222,231,0.772,0.961
"9121","La Paz","Calamarca","U.E. Juan José Torrez",4,1,18,0,169,0,8,0,1,201,3,17,221,230,0.841,0.961
"9122","La Paz","Calamarca","U.E. Porvenir de Cañuma",10,1,26,1,169,1,16,1,0,225,6,6,237,240,0.751,0.988
"9123","La Paz","Patacamaya","Esc. Roberto Pabon",38,0,9,0,118,1,28,2,2,198,1,4,203,224,0.596,0.906
"9124","La Paz","Patacamaya","Esc. Roberto Pabon",24,0,19,0,118,1,30,0,1,193,5,10,208,227,0.611,0.916
"9125","La Paz","Patacamaya","Esc. Roberto Pabon",35,0,3,1,110,1,30,0,1,181,1,4,186,220,0.608,0.845
"9126","La Paz","Patacamaya","Esc. Roberto Pabon",22,0,7,0,118,4,30,0,0,181,2,6,189,218,0.652,0.867
"9127","La Paz","Patacamaya","Esc. Roberto Pabon",24,0,14,0,115,2,30,0,1,186,5,9,200,223,0.618,0.897
"9128","La Paz","Patacamaya","Esc. Roberto Pabon",27,0,8,0,109,1,32,0,0,177,3,9,189,217,0.616,0.871
"9129","La Paz","Patacamaya","Esc. Roberto Pabon",31,1,12,1,115,2,38,0,0,200,4,5,209,229,0.575,0.913
"9130","La Paz","Patacamaya","Esc. Roberto Pabon",32,2,12,1,95,5,46,0,1,194,4,4,202,225,0.49,0.898
"9131","La Paz","Patacamaya","Esc. Roberto Pabon",18,1,11,0,110,2,34,0,2,178,1,15,194,220,0.618,0.882
"9132","La Paz","Patacamaya","Esc. Roberto Pabon",30,0,11,0,126,2,24,0,2,195,4,7,206,226,0.646,0.912
"9133","La Paz","Patacamaya","Esc. Roberto Pabon",26,0,7,0,117,4,32,1,2,189,3,4,196,220,0.619,0.891
"9134","La Paz","Patacamaya","Esc. Roberto Pabon",25,0,6,0,108,0,37,0,1,177,3,5,185,219,0.61,0.845
"9135","La Paz","Patacamaya","Esc. Roberto Pabon",8,0,7,1,139,2,26,2,0,185,7,9,201,221,0.751,0.91
"9136","La Paz","Patacamaya","Esc. Roberto Pabon",29,0,5,0,123,3,24,0,1,185,1,8,194,223,0.665,0.87
"9137","La Paz","Patacamaya","Esc. Roberto Pabon",18,0,7,1,132,0,29,1,0,188,1,5,194,228,0.702,0.851
"9138","La Paz","Patacamaya","Esc. Roberto Pabon",15,2,8,0,120,1,29,0,4,179,3,7,189,223,0.67,0.848
"9139","La Paz","Patacamaya","Esc. Roberto Pabon",19,0,5,1,137,0,29,1,1,193,3,7,203,216,0.71,0.94
"9140","La Paz","Patacamaya","Esc. Roberto Pabon",23,0,7,0,124,2,24,1,0,181,2,3,186,217,0.685,0.857
"9141","La Paz","Patacamaya","Esc. Roberto Pabon",32,1,11,1,120,3,25,0,1,194,1,3,198,218,0.619,0.908
"9142","La Paz","Patacamaya","Esc. Roberto Pabon",19,0,11,1,119,4,26,0,1,181,6,9,196,228,0.657,0.86
"9143","La Paz","Patacamaya","Esc. Roberto Pabon",14,0,9,0,109,2,38,0,2,174,4,9,187,221,0.626,0.846
"9144","La Paz","Patacamaya","Esc. Roberto Pabon",27,1,6,1,110,1,34,1,0,181,3,6,190,225,0.608,0.844
"9145","La Paz","Patacamaya","Esc. Roberto Pabon",30,0,10,0,109,2,33,0,0,184,1,9,194,223,0.592,0.87
"9146","La Paz","Patacamaya","Esc. Roberto Pabon",21,2,9,2,114,2,39,1,2,192,5,4,201,221,0.594,0.91
"9147","La Paz","Patacamaya","Esc. Roberto Pabon",39,0,13,2,102,0,33,0,1,190,2,3,195,226,0.537,0.863
"9148","La Paz","Patacamaya","Esc. Roberto Pabon",21,1,15,0,111,0,28,0,2,178,3,7,188,218,0.624,0.862
"9149","La Paz","Patacamaya","Esc. Roberto Pabon",28,1,7,0,132,0,26,1,1,196,3,5,204,231,0.673,0.883
"9150","La Paz","Patacamaya","Esc. Roberto Pabon",39,0,12,0,94,0,35,3,1,184,1,11,196,226,0.511,0.867
"9151","La Paz","Patacamaya","Esc. Roberto Pabon",33,1,5,1,109,3,29,1,1,183,4,5,192,223,0.596,0.861
"9152","La Paz","Patacamaya","Esc. Roberto Pabon",34,0,8,2,107,3,31,1,3,189,2,7,198,227,0.566,0.872
"9153","La Paz","Patacamaya","Esc. Roberto Pabon",21,0,6,0,121,0,38,1,0,187,2,5,194,224,0.647,0.866
"9154","La Paz","Patacamaya","U.E. German Busch",41,0,6,1,117,1,35,1,2,204,2,6,212,239,0.574,0.887
"9155","La Paz","Patacamaya","U.E. German Busch",49,1,9,0,92,2,43,0,1,197,1,5,203,235,0.467,0.864
"9156","La Paz","Patacamaya","U.E. German Busch",30,0,7,0,121,1,43,0,2,204,1,6,211,232,0.593,0.909
"9157","La Paz","Patacamaya","U.E. German Busch",37,0,5,1,117,1,34,1,3,199,1,8,208,234,0.588,0.889
"9158","La Paz","Patacamaya","U.E. German Busch",30,2,3,0,97,2,29,0,0,163,1,7,171,200,0.595,0.855
"9159","La Paz","Patacamaya","U.E. Chiarumani",14,0,4,1,163,1,20,0,3,206,3,1,210,219,0.791,0.959
"9160","La Paz","Patacamaya","U.E. Chiarumani",12,1,13,2,146,1,22,0,0,197,4,8,209,220,0.741,0.95
"9161","La Paz","Patacamaya","Escuela Colchani",7,2,13,1,159,2,20,0,0,204,6,5,215,224,0.779,0.96
"9162","La Paz","Patacamaya","Escuela Colchani",2,2,9,0,157,0,25,1,0,196,4,6,206,215,0.801,0.958
"9163","La Paz","Patacamaya","Unidad Educativa Viscachani",8,2,6,0,163,0,21,0,0,200,6,3,209,223,0.815,0.937
"9164","La Paz","Patacamaya","Unidad Educativa Viscachani",6,0,7,0,157,3,25,0,1,199,6,3,208,222,0.789,0.937
"9165","La Paz","Patacamaya","Unidad Educativa Viscachani",6,0,13,0,150,3,19,0,1,192,2,5,199,221,0.781,0.9
"9166","La Paz","Patacamaya","Escuela Calama",14,2,21,0,99,0,22,0,0,158,0,4,162,222,0.627,0.73
"9167","La Paz","Patacamaya","U.E. Nacional de Ayacucho",2,1,6,0,179,0,22,0,1,211,1,7,219,224,0.848,0.978
"9168","La Paz","Patacamaya","Esc. Taypillanga",6,0,3,0,172,2,12,0,0,195,3,12,210,217,0.882,0.968
"9169","La Paz","Patacamaya","Esc. Taypillanga",7,0,6,0,167,1,9,0,1,191,4,2,197,215,0.874,0.916
"9170","La Paz","Patacamaya","Casa de Gobierno",5,0,14,0,164,1,11,0,1,196,4,5,205,218,0.837,0.94
"9171","La Paz","Patacamaya","Colegio Franz Tamayo",7,0,10,0,153,2,6,2,1,181,5,8,194,207,0.845,0.937
"9172","La Paz","Patacamaya","Colegio Franz Tamayo",3,0,9,0,158,1,8,0,0,179,2,9,190,212,0.883,0.896
"9173","La Paz","Patacamaya","Colegio Franz Tamayo",7,1,7,3,159,0,11,0,0,188,4,5,197,211,0.846,0.934
"9174","La Paz","Patacamaya","Colegio 23 de Marzo",5,2,8,0,159,2,16,1,0,193,7,5,205,217,0.824,0.945
"9175","La Paz","Patacamaya","Colegio 23 de Marzo",17,0,3,1,157,6,13,0,0,197,4,4,205,214,0.797,0.958
"9176","La Paz","Patacamaya","Nucleo Educativo Belen Iquiaca",6,0,6,0,157,3,18,0,1,191,6,5,202,222,0.822,0.91
"9177","La Paz","Patacamaya","Unidad Educativa Cauchi - Titiri",14,3,14,0,134,6,15,0,1,187,4,11,202,217,0.717,0.931
"9178","La Paz","Colquencha","U.E. Nacional Litoral",9,0,26,1,147,2,16,1,1,203,3,6,212,224,0.724,0.946
"9179","La Paz","Colquencha","U.E. Nacional Litoral",11,1,32,2,142,1,23,0,0,212,1,8,221,228,0.67,0.969
"9180","La Paz","Colquencha","U.E. Nacional Litoral",11,0,22,0,142,1,23,0,0,199,4,10,213,223,0.714,0.955
"9181","La Paz","Colquencha","U.E. Nacional Litoral",11,1,35,1,122,2,25,1,0,198,1,6,205,220,0.616,0.932
"9182","La Paz","Colquencha","U.E. Nacional Litoral",12,1,35,0,113,2,28,0,0,191,5,7,203,217,0.592,0.935
"9183","La Paz","Colquencha","U.E. Nacional Litoral",7,0,39,0,131,1,26,0,1,205,4,12,221,232,0.639,0.953
"9184","La Paz","Colquencha","U.E. Nacional Litoral",16,2,41,0,126,2,20,0,1,208,3,7,218,230,0.606,0.948
"9185","La Paz","Colquencha","U.E. Nacional Litoral",8,0,23,0,142,0,22,0,0,195,3,13,211,223,0.728,0.946
"9186","La Paz","Colquencha","U.E. Nacional Litoral",20,1,24,1,111,7,24,0,2,190,3,12,205,219,0.584,0.936
"9187","La Paz","Colquencha","Escuela Litoral",1,0,15,1,175,0,9,0,1,202,2,5,209,215,0.866,0.972
"9188","La Paz","Colquencha","U.E. Tte. Cnel. Max Toledo",9,1,40,1,148,1,7,0,0,207,0,10,217,224,0.715,0.969
"9189","La Paz","Colquencha","U.E. Tte. Cnel. Max Toledo",6,0,47,2,134,1,12,0,0,202,6,10,218,227,0.663,0.96
"9190","La Paz","Colquencha","U.E. Tte. Cnel. Max Toledo",10,0,43,2,126,1,27,1,1,211,1,3,215,225,0.597,0.956
"9191","La Paz","Colquencha","U.E. Tte. Cnel. Max Toledo",14,0,48,0,134,2,9,0,1,208,1,9,218,223,0.644,0.978
"9192","La Paz","Colquencha","Esc. Ladislao Cabrera",14,0,44,0,120,0,10,0,0,188,1,13,202,216,0.638,0.935
"9193","La Paz","Colquencha","Esc. Ladislao Cabrera",9,0,31,2,137,2,8,0,1,190,5,4,199,219,0.721,0.909
"9194","La Paz","Colquencha","Esc. Ladislao Cabrera",11,0,43,1,132,0,5,0,0,192,2,9,203,216,0.688,0.94
"9195","La Paz","Colquencha","Esc. Ladislao Cabrera",5,2,50,0,133,1,7,0,1,199,1,7,207,227,0.668,0.912
"9196","La Paz","Collana","U.E. Túpac Katari",49,1,18,1,105,1,14,0,0,189,9,8,206,219,0.556,0.941
"9197","La Paz","Collana","U.E. Túpac Katari",40,4,19,0,122,1,16,0,0,202,3,8,213,224,0.604,0.951
"9198","La Paz","Collana","U.E. Túpac Katari",42,2,28,1,93,4,13,0,1,184,10,11,205,218,0.505,0.94
"9199","La Paz","Collana","U.E. Túpac Katari",23,2,22,0,118,5,7,1,1,179,3,8,190,217,0.659,0.876
"9200","La Paz","Collana","U.E. Túpac Katari",31,0,18,2,110,4,16,0,3,184,3,6,193,218,0.598,0.885
"9201","La Paz","Collana","U.E. Túpac Katari",39,1,14,2,95,5,11,1,4,172,4,14,190,209,0.552,0.909
"9202","La Paz","Collana","U.E. Túpac Katari",41,0,26,0,105,4,15,0,0,191,2,9,202,221,0.55,0.914
"9203","La Paz","Collana","U.E. Pedro Domingo Murillo ´B´",20,1,13,0,128,0,19,0,0,181,0,7,188,205,0.707,0.917
"9204","La Paz","Collana","Casa Social",5,0,13,0,152,1,6,0,0,177,3,11,191,204,0.859,0.936
"9205","La Paz","Coroico","Esc. Felix Reyes Ortiz",65,1,5,0,94,4,14,0,0,183,7,4,194,232,0.514,0.836
"9206","La Paz","Coroico","Esc. Felix Reyes Ortiz",62,1,11,0,93,2,26,0,1,196,3,7,206,235,0.474,0.877
"9207","La Paz","Coroico","Esc. Felix Reyes Ortiz",68,0,5,0,102,1,18,1,3,198,0,9,207,233,0.515,0.888
"9208","La Paz","Coroico","Esc. Felix Reyes Ortiz",51,2,6,0,91,2,24,0,3,179,4,13,196,227,0.508,0.863
"9209","La Paz","Coroico","Esc. Felix Reyes Ortiz",59,1,5,0,104,0,10,1,1,181,1,5,187,216,0.575,0.866
"9210","La Paz","Coroico","Esc. Felix Reyes Ortiz",56,2,1,1,89,5,22,0,2,178,4,7,189,217,0.5,0.871
"9211","La Paz","Coroico","Esc. Felix Reyes Ortiz",73,3,5,4,69,4,12,0,0,170,2,5,177,213,0.406,0.831
"9212","La Paz","Coroico","Esc. Felix Reyes Ortiz",66,1,8,2,90,6,7,0,2,182,2,9,193,216,0.495,0.894
"9213","La Paz","Coroico","Esc. Felix Reyes Ortiz",72,0,6,2,70,7,10,0,0,167,6,8,181,217,0.419,0.834
"9214","La Paz","Coroico","Esc. Felix Reyes Ortiz",62,3,4,2,98,5,13,0,0,187,2,12,201,228,0.524,0.882
"9215","La Paz","Coroico","Esc. Felix Reyes Ortiz",64,1,7,2,95,6,13,0,1,189,4,8,201,227,0.503,0.885
"9216","La Paz","Coroico","Unidad Educ. San Pedro",78,0,5,3,72,6,12,2,3,181,2,4,187,215,0.398,0.87
"9217","La Paz","Coroico","Unidad Educ. San Pedro",74,2,5,1,81,3,13,1,0,180,2,12,194,216,0.45,0.898
"9218","La Paz","Coroico","Unidad Educ. San Pedro",72,0,6,3,85,2,14,1,0,183,3,9,195,217,0.464,0.899
"9219","La Paz","Coroico","Unidad Educ. San Pedro",45,0,5,4,111,6,14,1,0,186,3,12,201,228,0.597,0.882
"9220","La Paz","Coroico","Unidad Educ. San Pedro",66,2,7,0,79,4,14,1,0,173,10,6,189,217,0.457,0.871
"9221","La Paz","Coroico","Unidad Educ. San Pedro",73,2,4,2,88,2,6,1,1,179,5,7,191,214,0.492,0.893
"9222","La Paz","Coroico","Unidad Educ. San Pedro",72,1,6,1,85,5,13,1,3,187,6,5,198,214,0.455,0.925
"9223","La Paz","Coroico","Unidad Educ. San Pedro",46,1,4,0,92,4,17,0,3,167,3,10,180,216,0.551,0.833
"9224","La Paz","Coroico","Unidad Educ. San Pedro",51,3,11,1,87,1,15,0,0,169,6,7,182,217,0.515,0.839
"9225","La Paz","Coroico","Unidad Educ. San Pedro",62,0,3,2,102,3,20,1,0,193,3,13,209,227,0.528,0.921
"9226","La Paz","Coroico","Unidad Educ. San Pedro",79,3,5,2,95,2,18,0,0,204,3,4,211,234,0.466,0.902
"9227","La Paz","Coroico","Unidad Educ. San Pedro",58,3,5,0,67,2,18,2,0,155,6,1,162,181,0.432,0.895
"9228","La Paz","Coroico","U.E. Yolosa",74,3,6,2,85,6,12,1,2,191,3,8,202,222,0.445,0.91
"9229","La Paz","Coroico","U.E. Yolosa",64,2,6,1,99,3,18,2,0,195,5,7,207,226,0.508,0.916
"9230","La Paz","Coroico","Col. Tec. Hum. Cruz Loma",71,4,5,4,98,0,9,0,1,192,2,8,202,224,0.51,0.902
"9231","La Paz","Coroico","Col. Tec. Hum. Cruz Loma",81,2,7,1,85,3,12,1,3,195,2,13,210,221,0.436,0.95
"9232","La Paz","Coroico","Col. Tec. Hum. Cruz Loma",61,2,2,1,113,2,5,2,0,188,6,6,200,219,0.601,0.913
"9233","La Paz","Coroico","Col. Tec. Hum. Cruz Loma",65,4,5,0,99,4,16,1,1,195,1,7,203,223,0.508,0.91
"9234","La Paz","Coroico","Escuela Jhon F. Kennedy",33,2,10,0,132,5,21,0,0,203,3,6,212,229,0.65,0.926
"9235","La Paz","Coroico","Escuela Jhon F. Kennedy",36,3,11,1,132,1,12,0,1,197,5,9,211,228,0.67,0.925
"9236","La Paz","Coroico","Escuela Jhon F. Kennedy",32,3,5,0,114,2,12,0,0,168,7,6,181,196,0.679,0.923
"9237","La Paz","Coroico","Escuela Franz Tamayo",64,5,12,0,76,7,10,0,3,177,5,11,193,218,0.429,0.885
"9238","La Paz","Coroico","Escuela Franz Tamayo",67,3,10,2,98,4,10,1,0,195,4,6,205,221,0.503,0.928
"9239","La Paz","Coroico","Escuela Franz Tamayo",60,1,13,2,93,3,12,0,1,185,4,7,196,220,0.503,0.891
"9240","La Paz","Coroico","Escuela Santa Rosa de Quilo Quilo",36,0,9,0,145,2,9,0,0,201,7,8,216,232,0.721,0.931
"9241","La Paz","Coroico","Escuela Santa Rosa de Quilo Quilo",40,1,2,0,135,0,11,0,1,190,5,15,210,227,0.711,0.925
"9242","La Paz","Coroico","Escuela Santa Rosa de Quilo Quilo",34,1,5,1,138,2,12,0,0,193,0,17,210,223,0.715,0.942
"9243","La Paz","Coroico","Escuela Santa Rosa de Quilo Quilo",40,2,2,0,127,4,9,1,0,185,1,9,195,207,0.686,0.942
"9244","La Paz","Coroico","Casa de Gobierno",80,1,5,0,77,2,17,3,1,186,7,14,207,232,0.414,0.892
"9245","La Paz","Coroico","Casa de Gobierno",77,3,8,1,92,2,9,0,2,194,6,6,206,220,0.474,0.936
"9246","La Paz","Coroico","Casa de Gobierno",58,3,9,1,73,0,11,1,0,156,8,4,168,185,0.468,0.908
"9247","La Paz","Coroico","Escuela Pacollo",42,1,8,0,124,0,8,2,1,186,5,6,197,223,0.667,0.883
"9248","La Paz","Coroico","Escuela Pacollo",49,5,5,0,115,1,14,1,0,190,2,6,198,222,0.605,0.892
"9249","La Paz","Coroico","Escuela Pacollo",39,3,8,1,115,2,24,0,1,193,2,8,203,220,0.596,0.923
"9250","La Paz","Coroico","Unidad Educativa Puente Armas",23,2,6,1,153,5,7,0,0,197,2,7,206,226,0.777,0.912
"9251","La Paz","Coroico","Unidad Educativa Puente Armas",22,3,3,1,159,4,9,0,0,201,2,3,206,228,0.791,0.904
"9252","La Paz","Coripata","Escuela Capitan Luis Revero Sanchez",95,2,1,0,70,2,10,1,0,181,0,4,185,219,0.387,0.845
"9253","La Paz","Coripata","Escuela Capitan Luis Revero Sanchez",91,1,1,0,83,0,7,0,1,184,2,6,192,214,0.451,0.897
"9254","La Paz","Coripata","Escuela Capitan Luis Revero Sanchez",98,1,5,0,81,0,9,0,1,195,2,5,202,226,0.415,0.894
"9255","La Paz","Coripata","Escuela Capitan Luis Revero Sanchez",88,0,3,2,78,3,6,2,0,182,4,7,193,217,0.429,0.889
"9256","La Paz","Coripata","Escuela Capitan Luis Revero Sanchez",91,0,4,0,74,0,14,1,0,184,2,4,190,214,0.402,0.888
"9257","La Paz","Coripata","Escuela Capitan Luis Revero Sanchez",87,1,4,1,83,0,5,0,2,183,4,3,190,216,0.454,0.88
"9258","La Paz","Coripata","Escuela Capitan Luis Revero Sanchez",80,0,2,0,94,0,17,0,0,193,1,5,199,221,0.487,0.9
"9259","La Paz","Coripata","Escuela Capitan Luis Revero Sanchez",90,2,1,1,87,1,4,0,0,186,3,10,199,220,0.468,0.905
"9260","La Paz","Coripata","Escuela Capitan Luis Revero Sanchez",92,1,2,0,93,0,5,0,0,193,4,5,202,226,0.482,0.894
"9261","La Paz","Coripata","Escuela Capitan Luis Revero Sanchez",81,4,0,1,86,2,6,0,2,182,6,9,197,223,0.473,0.883
"9262","La Paz","Coripata","Escuela Capitan Luis Revero Sanchez",75,2,2,1,90,1,15,0,0,186,2,3,191,209,0.484,0.914
"9263","La Paz","Coripata","Escuela Capitan Luis Revero Sanchez",103,0,0,1,76,0,3,0,1,184,3,3,190,214,0.413,0.888
"9264","La Paz","Coripata","Escuela Capitan Luis Revero Sanchez",91,1,3,1,87,0,5,0,0,188,1,8,197,221,0.463,0.891
"9265","La Paz","Coripata","Escuela Capitan Luis Revero Sanchez",101,1,1,0,83,0,8,0,0,194,1,4,199,223,0.428,0.892
"9266","La Paz","Coripata","Escuela Capitan Luis Revero Sanchez",96,1,0,0,76,2,6,0,1,182,2,7,191,215,0.418,0.888
"9267","La Paz","Coripata","Escuela Capitan Luis Revero Sanchez",98,1,0,0,89,2,7,0,0,197,2,0,199,218,0.452,0.913
"9268","La Paz","Coripata","Escuela Capitan Luis Revero Sanchez",74,0,2,1,93,0,11,0,2,183,6,10,199,210,0.508,0.948
"9269","La Paz","Coripata","Escuela Capitan Luis Revero Sanchez",89,1,8,0,84,0,5,0,1,188,2,5,195,211,0.447,0.924
"9270","La Paz","Coripata","Escuela Capitan Luis Revero Sanchez",109,1,1,0,80,1,4,1,0,197,4,3,204,218,0.406,0.936
"9271","La Paz","Coripata","Escuela Capitan Luis Revero Sanchez",89,0,3,0,76,1,10,0,0,179,5,8,192,214,0.425,0.897
"9272","La Paz","Coripata","Escuela Capitan Luis Revero Sanchez",93,0,4,1,66,1,12,1,0,178,3,15,196,221,0.371,0.887
"9273","La Paz","Coripata","Escuela Capitan Luis Revero Sanchez",76,0,4,0,93,1,10,0,0,184,4,8,196,218,0.505,0.899
"9274","La Paz","Coripata","Escuela Capitan Luis Revero Sanchez",91,0,4,1,78,1,13,0,1,189,0,7,196,228,0.413,0.86
"9275","La Paz","Coripata","Casa Cultural San Juan de Coripata",66,0,13,0,120,1,11,1,2,214,1,6,221,232,0.561,0.953
"9276","La Paz","Coripata","Casa Cultural San Juan de Coripata",56,0,14,2,112,2,12,0,0,198,6,6,210,221,0.566,0.95
"9277","La Paz","Coripata","Casa Cultural San Juan de Coripata",68,2,9,3,120,2,9,0,0,213,1,3,217,233,0.563,0.931
"9278","La Paz","Coripata","Colegio Andres de Santa Cruz",94,0,4,1,89,2,5,0,0,195,3,13,211,226,0.456,0.934
"9279","La Paz","Coripata","Colegio Andres de Santa Cruz",98,0,2,2,83,2,9,0,0,196,2,8,206,222,0.423,0.928
"9280","La Paz","Coripata","Colegio Andres de Santa Cruz",85,0,4,2,86,1,8,1,1,188,1,7,196,223,0.457,0.879
"9281","La Paz","Coripata","Colegio Andres de Santa Cruz",69,0,3,1,110,0,9,0,0,192,1,8,201,227,0.573,0.885
"9282","La Paz","Coripata","Colegio Andres de Santa Cruz",67,1,3,4,105,1,7,0,0,188,4,11,203,221,0.559,0.919
"9283","La Paz","Coripata","Colegio Andres de Santa Cruz",78,0,2,1,101,1,3,1,0,187,4,10,201,221,0.54,0.91
"9284","La Paz","Coripata","Colegio Andres de Santa Cruz",82,0,3,1,118,0,9,0,0,213,0,8,221,224,0.554,0.987
"9285","La Paz","Coripata","Colegio Andres de Santa Cruz",83,2,5,0,109,1,10,0,0,210,6,10,226,229,0.519,0.987
"9286","La Paz","Coripata","Colegio Andres de Santa Cruz",87,1,1,0,98,2,5,1,0,195,0,12,207,230,0.503,0.9
"9287","La Paz","Coripata","Colegio Andres de Santa Cruz",62,3,2,3,112,1,8,0,1,192,5,6,203,222,0.583,0.914
"9288","La Paz","Coripata","Colegio Andres de Santa Cruz",66,0,7,1,105,2,11,1,0,193,3,9,205,225,0.544,0.911
"9289","La Paz","Coripata","Colegio Santiago Tocoroni",75,0,6,2,112,1,13,0,0,209,1,9,219,228,0.536,0.961
"9290","La Paz","Coripata","Colegio Santiago Tocoroni",66,0,7,1,112,2,8,0,1,197,5,10,212,227,0.569,0.934
"9291","La Paz","Coripata","Colegio Santiago Tocoroni",61,2,11,2,126,1,12,0,1,216,2,4,222,232,0.583,0.957
"9292","La Paz","Coripata","Colegio Santiago Tocoroni",70,3,10,2,95,3,23,0,0,206,5,6,217,227,0.461,0.956
"9293","La Paz","Coripata","Colegio Santiago Tocoroni",80,1,7,0,100,0,9,0,1,198,2,12,212,229,0.505,0.926
"9294","La Paz","Coripata","Colegio Fraz Tamayo Fe y Alegria",131,2,8,1,43,1,12,0,0,198,6,8,212,223,0.217,0.951
"9295","La Paz","Coripata","Colegio Fraz Tamayo Fe y Alegria",109,0,9,2,51,3,7,1,0,182,3,15,200,220,0.28,0.909
"9296","La Paz","Coripata","Colegio Fraz Tamayo Fe y Alegria",127,0,5,1,49,2,11,0,2,197,3,5,205,226,0.249,0.907
"9297","La Paz","Coripata","Colegio Fraz Tamayo Fe y Alegria",121,0,8,1,50,1,19,0,0,200,3,7,210,220,0.25,0.955
"9298","La Paz","Coripata","Colegio Fraz Tamayo Fe y Alegria",107,1,8,2,54,1,15,0,1,189,6,9,204,226,0.286,0.903
"9299","La Paz","Coripata","Escuela Milluhuaya Alto",73,1,2,0,103,2,9,0,0,190,6,8,204,225,0.542,0.907
"9300","La Paz","Coripata","Escuela Milluhuaya Alto",82,1,2,1,110,1,10,0,0,207,5,4,216,228,0.531,0.947
"9301","La Paz","Coripata","Escuela Milluhuaya Alto",67,1,2,1,121,3,7,1,0,203,6,3,212,224,0.596,0.946
"9302","La Paz","Ixiamas","Esc. German Busch",69,2,0,0,66,16,13,1,0,167,5,16,188,232,0.395,0.81
"9303","La Paz","Ixiamas","Esc. German Busch",48,1,6,2,86,5,16,2,2,168,4,13,185,225,0.512,0.822
"9304","La Paz","Ixiamas","Esc. German Busch",34,1,3,1,102,9,15,0,3,168,7,11,186,227,0.607,0.819
"9305","La Paz","Ixiamas","Esc. German Busch",54,1,2,1,89,4,18,4,1,174,0,15,189,227,0.511,0.833
"9306","La Paz","Ixiamas","Esc. German Busch",71,0,5,1,83,8,12,1,1,182,6,14,202,227,0.456,0.89
"9307","La Paz","Ixiamas","Esc. German Busch",99,1,2,1,54,11,14,1,0,183,4,11,198,230,0.295,0.861
"9308","La Paz","Ixiamas","Esc. German Busch",51,2,3,1,115,8,14,0,1,195,3,3,201,234,0.59,0.859
"9309","La Paz","Ixiamas","Esc. German Busch",43,3,4,3,105,4,22,0,1,185,6,6,197,234,0.568,0.842
"9310","La Paz","Ixiamas","Esc. German Busch",35,1,4,1,86,8,26,2,0,163,9,15,187,229,0.528,0.817
"9311","La Paz","Ixiamas","Esc. German Busch",52,1,0,2,82,12,13,1,0,163,7,14,184,228,0.503,0.807
"9312","La Paz","Ixiamas","Esc. German Busch",61,2,1,1,81,7,9,1,1,164,6,11,181,232,0.494,0.78
"9313","La Paz","Ixiamas","Esc. German Busch",79,2,4,2,56,2,24,2,0,171,6,13,190,228,0.327,0.833
"9314","La Paz","Ixiamas","Esc. German Busch",53,2,4,0,90,8,17,3,0,177,4,10,191,229,0.508,0.834
"9315","La Paz","Ixiamas","Escuela Puerto Perez",87,2,22,4,24,23,12,6,1,181,8,6,195,237,0.133,0.823
"9316","La Paz","Ixiamas","U.E. Manurimi",32,3,7,5,95,15,8,6,1,172,4,5,181,252,0.552,0.718
"9317","La Paz","San Buenaventura","Escuela Jose Manuel Pando",56,0,2,0,100,11,15,2,0,186,3,8,197,237,0.538,0.831
"9318","La Paz","San Buenaventura","Escuela Jose Manuel Pando",60,1,3,0,96,14,15,2,0,191,7,7,205,236,0.503,0.869
"9319","La Paz","San Buenaventura","Escuela Jose Manuel Pando",40,3,3,3,78,21,27,0,1,176,4,13,193,225,0.443,0.858
"9320","La Paz","San Buenaventura","Escuela Jose Manuel Pando",37,0,3,0,120,8,23,1,0,192,4,5,201,231,0.625,0.87
"9321","La Paz","San Buenaventura","Escuela Jose Manuel Pando",48,2,2,0,86,9,25,0,0,172,9,8,189,228,0.5,0.829
"9322","La Paz","San Buenaventura","Escuela Jose Manuel Pando",64,2,0,1,63,6,15,1,0,152,1,46,199,227,0.414,0.877
"9323","La Paz","San Buenaventura","Escuela Jose Manuel Pando",64,1,2,2,82,11,22,1,0,185,3,10,198,227,0.443,0.872
"9324","La Paz","San Buenaventura","Escuela Jose Manuel Pando",48,1,6,2,98,10,23,3,0,191,1,7,199,231,0.513,0.861
"9325","La Paz","San Buenaventura","Escuela Jose Manuel Pando",56,0,1,1,100,14,19,1,2,194,5,5,204,228,0.515,0.895
"9326","La Paz","San Buenaventura","Escuela Jose Manuel Pando",52,1,2,1,84,8,16,0,0,164,1,36,201,228,0.512,0.882
"9327","La Paz","San Buenaventura","Escuela Jose Manuel Pando",44,1,5,1,96,1,25,1,1,175,7,5,187,224,0.549,0.835
"9328","La Paz","San Buenaventura","Escuela Jose Manuel Pando",70,1,2,1,72,13,11,0,2,172,9,12,193,230,0.419,0.839
"9329","La Paz","San Buenaventura","Escuela Jose Manuel Pando",44,2,1,2,85,21,26,1,1,183,1,13,197,229,0.464,0.86
"9330","La Paz","San Buenaventura","Col. Tumupasa B",54,1,2,0,94,12,15,1,2,181,10,11,202,226,0.519,0.894
"9331","La Paz","San Buenaventura","Col. Tumupasa B",48,1,2,3,105,11,28,1,1,200,8,3,211,236,0.525,0.894
"9332","La Paz","San Buenaventura","Col. Tumupasa B",31,1,0,2,100,13,32,1,3,183,8,9,200,233,0.546,0.858
"9333","La Paz","San Buenaventura","Col. Tumupasa B",34,2,2,1,84,22,18,2,3,168,14,15,197,227,0.5,0.868
"9334","La Paz","San Buenaventura","Col. Tumupasa B",45,0,2,0,104,14,34,2,1,202,9,7,218,243,0.515,0.897
"9335","La Paz","San Buenaventura","Unidad Educativa Central Buena Vista",30,0,1,3,88,11,43,3,2,181,14,12,207,233,0.486,0.888
"9336","La Paz","Charazani","Escuela Charazani",18,2,17,1,106,4,16,3,0,167,11,11,189,210,0.635,0.9
"9337","La Paz","Charazani","Escuela Charazani",16,2,11,2,117,1,10,2,2,163,17,12,192,210,0.718,0.914
"9338","La Paz","Charazani","Escuela Charazani",15,3,11,1,113,2,6,0,3,154,13,13,180,208,0.734,0.865
"9339","La Paz","Charazani","U. E. Isqani 2",10,1,16,0,125,0,8,0,0,160,19,11,190,208,0.781,0.913
"9340","La Paz","Charazani","U. E. Isqani 2",7,1,33,0,119,1,2,0,0,163,10,11,184,201,0.73,0.915
"9341","La Paz","Charazani","U. E. Isqani 2",7,0,27,0,127,2,10,0,0,173,14,11,198,214,0.734,0.925
"9342","La Paz","Charazani","U. E. Isqani 2",8,3,35,2,113,0,5,1,0,167,10,4,181,209,0.677,0.866
"9343","La Paz","Charazani","U. E. Isqani 2",9,1,37,1,110,1,7,0,0,166,13,6,185,206,0.663,0.898
"9344","La Paz","Charazani","U. E. Chullina",4,1,22,1,125,0,11,2,0,166,22,10,198,237,0.753,0.835
"9345","La Paz","Charazani","U. E. Yawar Mallku",5,0,15,1,121,2,16,0,0,160,14,16,190,211,0.756,0.9
"9346","La Paz","Charazani","Unidad Educativa Apacheta",3,0,39,1,100,2,18,2,0,165,9,4,178,198,0.606,0.899
"9347","La Paz","Charazani","U.E. Soto Pata",25,0,15,0,154,0,10,0,0,204,4,6,214,233,0.755,0.918
"9348","La Paz","Charazani","U. E. Llachuani",8,1,17,3,130,0,25,1,0,185,8,4,197,223,0.703,0.883
"9349","La Paz","Charazani","Unidad Educativa Kallurhuaya",20,1,29,2,98,3,18,0,0,171,4,16,191,211,0.573,0.905
"9350","La Paz","Curva","Recinto Taipi Canuma",2,3,7,0,135,0,40,0,0,187,1,2,190,212,0.722,0.896
"9351","La Paz","Copacabana","Col. Nacional Mixto Copacabana",32,1,3,1,132,4,14,2,1,190,4,6,200,222,0.695,0.901
"9352","La Paz","Copacabana","Col. Nacional Mixto Copacabana",31,0,2,1,124,3,29,0,1,191,1,4,196,216,0.649,0.907
"9353","La Paz","Copacabana","Col. Nacional Mixto Copacabana",30,1,3,0,114,1,30,1,2,182,2,13,197,213,0.626,0.925
"9354","La Paz","Copacabana","Col. Nacional Mixto Copacabana",20,1,8,1,139,0,17,0,1,187,4,6,197,217,0.743,0.908
"9355","La Paz","Copacabana","Col. Nacional Mixto Copacabana",11,2,0,0,147,2,29,1,0,192,3,13,208,229,0.766,0.908
"9356","La Paz","Copacabana","Col. Nacional Mixto Copacabana",24,1,4,0,144,1,27,0,0,201,2,10,213,224,0.716,0.951
"9357","La Paz","Copacabana","Col. Nacional Mixto Copacabana",45,1,4,0,108,1,29,1,1,190,4,9,203,222,0.568,0.914
"9358","La Paz","Copacabana","Col. Nacional Mixto Copacabana",30,0,2,0,117,6,24,0,0,179,3,10,192,217,0.654,0.885
"9359","La Paz","Copacabana","Col. Nacional Mixto Copacabana",33,1,10,0,125,0,17,0,4,190,4,7,201,220,0.658,0.914
"9360","La Paz","Copacabana","Col. Nacional Mixto Copacabana",16,0,3,0,132,2,16,1,3,173,3,16,192,221,0.763,0.869
"9361","La Paz","Copacabana","Col. Nacional Mixto Copacabana",12,0,1,0,131,1,30,1,1,177,4,11,192,218,0.74,0.881
"9362","La Paz","Copacabana","Col. Nacional Mixto Copacabana",26,1,10,1,127,0,20,1,2,188,7,6,201,225,0.676,0.893
"9363","La Paz","Copacabana","Col. Nacional Mixto Copacabana",40,1,5,3,124,1,20,1,0,195,5,6,206,219,0.636,0.941
"9364","La Paz","Copacabana","Col. Nacional Mixto Copacabana",28,0,3,0,120,1,30,0,3,185,1,18,204,221,0.649,0.923
"9365","La Paz","Copacabana","Col. Nacional Mixto Copacabana",23,0,5,0,140,2,22,1,1,194,3,4,201,224,0.722,0.897
"9366","La Paz","Copacabana","Col. Nacional Mixto Copacabana",23,1,1,0,135,0,26,1,1,188,2,13,203,215,0.718,0.944
"9367","La Paz","Copacabana","Col. Nacional Mixto Copacabana",25,1,3,1,131,1,22,0,3,187,3,15,205,222,0.701,0.923
"9368","La Paz","Copacabana","Col. Nacional Mixto Copacabana",16,0,11,0,132,1,20,1,3,184,2,14,200,218,0.717,0.917
"9369","La Paz","Copacabana","Col. Nacional Mixto Copacabana",21,1,2,0,132,3,35,1,1,196,1,9,206,224,0.673,0.92
"9370","La Paz","Copacabana","Col. Nacional Mixto Copacabana",46,1,4,1,101,2,17,1,2,175,1,10,186,209,0.577,0.89
"9371","La Paz","Copacabana","Col. Nacional Mixto Copacabana",27,0,5,1,148,2,21,0,2,206,2,2,210,224,0.718,0.938
"9372","La Paz","Copacabana","Col. Nacional Mixto Copacabana",43,0,3,0,109,3,29,0,1,188,3,5,196,217,0.58,0.903
"9373","La Paz","Copacabana","Esc. Col. Tec. Humanistico Huacuyo",4,0,10,0,158,1,12,0,2,187,7,4,198,216,0.845,0.917
"9374","La Paz","Copacabana","Esc. Col. Tec. Humanistico Huacuyo",2,1,5,0,159,1,11,0,0,179,7,9,195,226,0.888,0.863
"9375","La Paz","Copacabana","Esc. 16 de Julio",8,1,3,1,132,0,14,0,1,160,2,19,181,206,0.825,0.879
"9376","La Paz","Copacabana","Esc. 16 de Julio",13,2,5,1,124,8,24,1,1,179,8,15,202,217,0.693,0.931
"9377","La Paz","Copacabana","Esc. 16 de Julio",17,1,8,2,137,1,18,0,3,187,3,12,202,218,0.733,0.927
"9378","La Paz","Copacabana","Esc. 16 de Julio",13,1,3,0,148,2,20,1,3,191,3,6,200,213,0.775,0.939
"9379","La Paz","Copacabana","Esc. 16 de Julio",16,0,4,0,116,2,24,1,0,163,5,13,181,197,0.712,0.919
"9380","La Paz","Copacabana","Escuela Seccional Sampaya",6,7,7,1,147,1,10,1,0,180,2,4,186,203,0.817,0.916
"9381","La Paz","Copacabana","Colegio Challa",3,2,3,2,181,0,4,0,0,195,0,3,198,212,0.928,0.934
"9382","La Paz","Copacabana","Colegio Challa",7,1,2,1,163,2,12,1,0,189,6,5,200,214,0.862,0.935
"9383","La Paz","Copacabana","Colegio Challa",4,2,3,1,177,0,4,0,0,191,6,3,200,216,0.927,0.926
"9384","La Paz","Copacabana","Colegio Challa",4,0,2,0,182,1,15,0,0,204,2,3,209,220,0.892,0.95
"9385","La Paz","Copacabana","Centro de Salud Siripaca",0,0,7,0,164,2,11,0,0,184,4,7,195,217,0.891,0.899
"9386","La Paz","Copacabana","Escuela Villa Rosario",1,3,10,1,141,4,18,0,0,178,7,5,190,202,0.792,0.941
"9387","La Paz","Copacabana","U.E. Challapampa",17,2,9,0,177,5,11,1,3,225,1,8,234,240,0.787,0.975
"9388","La Paz","San Pedro de Tiquina","Col. Simon Bolivar",28,0,5,1,113,4,14,0,0,165,9,7,181,210,0.685,0.862
"9389","La Paz","San Pedro de Tiquina","Col. Simon Bolivar",26,2,4,0,126,3,14,1,0,176,4,8,188,216,0.716,0.87
"9390","La Paz","San Pedro de Tiquina","Col. Simon Bolivar",21,1,3,2,113,4,25,1,0,170,2,8,180,208,0.665,0.865
"9391","La Paz","San Pedro de Tiquina","Col. Simon Bolivar",23,1,3,0,111,7,26,1,2,174,2,14,190,214,0.638,0.888
"9392","La Paz","San Pedro de Tiquina","Col. Simon Bolivar",29,4,4,0,117,3,20,0,0,177,3,10,190,219,0.661,0.868
"9393","La Paz","San Pedro de Tiquina","Col. Simon Bolivar",15,2,3,0,130,3,18,0,0,171,2,8,181,213,0.76,0.85
"9394","La Paz","San Pedro de Tiquina","Esc. Mixta San Pablo De Tiquina",25,4,11,2,97,2,42,1,1,185,6,8,199,215,0.524,0.926
"9395","La Paz","San Pedro de Tiquina","Esc. Mixta San Pablo De Tiquina",20,3,16,1,125,3,22,2,1,193,2,2,197,209,0.648,0.943
"9396","La Paz","San Pedro de Tiquina","Esc. Mixta San Pablo De Tiquina",24,0,10,132,0,0,21,1,0,188,3,4,195,214,0,0.911
"9397","La Paz","San Pedro de Tiquina","U.E. Santiago de Ojje",29,3,4,0,106,3,7,2,3,157,6,8,171,199,0.675,0.859
"9398","La Paz","San Pedro de Tiquina","Colegio Villa Amacari",10,0,6,3,129,4,23,0,1,176,3,6,185,200,0.733,0.925
"9399","La Paz","Tito Yupanqui","Colegio Nacional Mixto Tito Yupanqui",22,2,10,1,94,6,25,1,1,162,1,12,175,204,0.58,0.858
"9400","La Paz","Tito Yupanqui","Colegio Nacional Mixto Tito Yupanqui",26,0,5,0,105,5,29,0,1,171,5,9,185,217,0.614,0.853
"9401","La Paz","Tito Yupanqui","Colegio Nacional Mixto Tito Yupanqui",17,1,7,0,131,4,21,0,1,182,4,5,191,213,0.72,0.897
"9402","La Paz","Tito Yupanqui","Escuela Huatapampa",11,3,4,0,106,5,20,0,2,151,7,11,169,182,0.702,0.929
"9403","La Paz","San Pedro de Curahuara","U.E. Mcal. Sucre",4,0,14,0,150,1,3,0,0,172,3,2,177,201,0.872,0.881
"9404","La Paz","San Pedro de Curahuara","U.E. Mcal. Sucre",9,0,13,0,146,1,6,0,0,175,4,5,184,208,0.834,0.885
"9405","La Paz","San Pedro de Curahuara","Colegio Hernando Siles",10,0,7,0,153,1,1,0,0,172,7,5,184,211,0.89,0.872
"9406","La Paz","San Pedro de Curahuara","Colegio Hernando Siles",2,2,9,1,156,1,3,0,1,175,5,6,186,219,0.891,0.849
"9407","La Paz","San Pedro de Curahuara","U.E. Chojña",8,0,26,0,167,0,4,0,0,205,1,4,210,218,0.815,0.963
"9408","La Paz","San Pedro de Curahuara","U.E. Chojña",13,0,13,0,143,1,1,0,0,171,2,5,178,184,0.836,0.967
"9409","La Paz","San Pedro de Curahuara","Colegio Luis Espinal",5,2,4,0,172,0,4,0,0,187,0,9,196,223,0.92,0.879
"9410","La Paz","San Pedro de Curahuara","Colegio Luis Espinal",4,0,7,0,178,0,4,0,0,193,1,5,199,217,0.922,0.917
"9411","La Paz","San Pedro de Curahuara","U.E. Janko Marca",1,0,4,0,213,0,4,0,0,222,1,0,223,223,0.959,1
"9412","La Paz","San Pedro de Curahuara","U.E. Janko Marca",1,0,0,1,151,0,1,0,0,154,0,0,154,156,0.981,0.987
"9413","La Paz","San Pedro de Curahuara","Colegio Wisco Kari",11,1,8,0,186,0,7,0,0,213,0,0,213,220,0.873,0.968
"9414","La Paz","San Pedro de Curahuara","Colegio Wisco Kari",2,1,7,0,197,0,8,0,1,216,1,2,219,224,0.912,0.978
"9415","La Paz","San Pedro de Curahuara","U.E. Jalsuri",4,0,7,0,166,0,8,0,0,185,0,2,187,209,0.897,0.895
"9416","La Paz","Papel Pampa","Casa de Gobierno",7,1,13,0,159,0,10,1,0,191,1,10,202,215,0.832,0.94
"9417","La Paz","Papel Pampa","Casa de Gobierno",9,1,27,1,161,1,6,0,0,206,3,4,213,221,0.782,0.964
"9418","La Paz","Papel Pampa","U.E. Santos Marca Thola",10,1,5,0,139,0,7,1,1,164,3,2,169,211,0.848,0.801
"9419","La Paz","Papel Pampa","U.E. Santos Marca Thola",10,0,4,0,143,0,4,0,0,161,4,2,167,206,0.888,0.811
"9420","La Paz","Papel Pampa","U.E. Santos Marca Thola",4,0,6,0,175,2,8,0,1,196,1,3,200,222,0.893,0.901
"9421","La Paz","Papel Pampa","U.E. Gualberto Villarroel",4,0,13,0,176,0,5,0,0,198,3,3,204,218,0.889,0.936
"9422","La Paz","Papel Pampa","U.E. Gualberto Villarroel",5,1,20,0,142,0,7,1,6,182,6,7,195,211,0.78,0.924
"9423","La Paz","Papel Pampa","U.E. Rivera Alta",23,3,24,2,150,1,13,2,0,218,4,3,225,229,0.688,0.983
"9424","La Paz","Papel Pampa","Casa de Gobierno",4,2,16,0,147,1,8,0,0,178,3,5,186,213,0.826,0.873
"9425","La Paz","Papel Pampa","Unidad Educativa San Jose",11,1,21,0,136,0,20,0,0,189,6,5,200,217,0.72,0.922
"9426","La Paz","Papel Pampa","Escuela Colque Amaya Alta",2,1,7,0,173,0,13,0,0,196,4,6,206,219,0.883,0.941
"9427","La Paz","Chacarilla","U.E. Chacarilla",2,0,20,0,140,0,16,0,1,179,3,1,183,211,0.782,0.867
"9428","La Paz","Chacarilla","U.E. Rosapata",3,1,10,1,147,0,6,0,0,168,6,19,193,216,0.875,0.894
"9429","La Paz","Chacarilla","Esc. Puerto Aroma",6,2,19,0,159,2,14,0,0,202,1,3,206,217,0.787,0.949
"9430","La Paz","Santiago de Machaca","Escuela Santiago de Machaca",9,1,2,0,138,0,23,0,1,174,1,10,185,206,0.793,0.898
"9431","La Paz","Santiago de Machaca","Escuela Santiago de Machaca",14,2,5,0,134,3,13,0,0,171,3,5,179,207,0.784,0.865
"9432","La Paz","Santiago de Machaca","Escuela Santiago de Machaca",12,0,2,0,144,1,10,0,0,169,2,5,176,204,0.852,0.863
"9433","La Paz","Santiago de Machaca","Escuela Santiago de Machaca",7,1,7,0,151,0,11,2,0,179,2,3,184,208,0.844,0.885
"9434","La Paz","Santiago de Machaca","Escuela Santiago de Machaca",3,1,10,1,134,1,14,1,0,165,2,7,174,201,0.812,0.866
"9435","La Paz","Santiago de Machaca","Escuela Santiago de Machaca",5,1,3,0,147,1,21,1,0,179,3,6,188,218,0.821,0.862
"9436","La Paz","Santiago de Machaca","Escuela Santiago de Machaca",5,3,6,1,134,2,15,0,1,167,3,8,178,207,0.802,0.86
"9437","La Paz","Catacora","Nucleo Escolar Catacora",6,4,8,0,159,1,21,2,0,201,1,1,203,217,0.791,0.935
"9438","La Paz","Caranavi","Col. Madre Maria Federica",52,1,2,0,94,6,23,3,1,182,2,6,190,223,0.516,0.852
"9439","La Paz","Caranavi","Col. Madre Maria Federica",58,0,3,0,87,2,31,0,1,182,5,7,194,225,0.478,0.862
"9440","La Paz","Caranavi","Col. Madre Maria Federica",39,0,7,0,109,2,32,1,4,194,2,6,202,223,0.562,0.906
"9441","La Paz","Caranavi","Col. Madre Maria Federica",41,0,6,1,100,3,33,1,2,187,6,8,201,225,0.535,0.893
"9442","La Paz","Caranavi","Col. Madre Maria Federica",29,3,8,0,93,1,36,0,2,172,3,7,182,217,0.541,0.839
"9443","La Paz","Caranavi","Col. Madre Maria Federica",71,1,4,0,64,8,28,0,5,181,5,7,193,218,0.354,0.885
"9444","La Paz","Caranavi","Col. Madre Maria Federica",41,0,4,1,86,2,38,2,3,177,3,7,187,218,0.486,0.858
"9445","La Paz","Caranavi","Col. Madre Maria Federica",30,1,4,0,99,0,37,0,4,175,4,17,196,219,0.566,0.895
"9446","La Paz","Caranavi","Col. Madre Maria Federica",56,1,6,1,75,4,36,0,4,183,3,7,193,221,0.41,0.873
"9447","La Paz","Caranavi","Col. Madre Maria Federica",24,1,11,0,100,2,39,0,1,178,4,7,189,216,0.562,0.875
"9448","La Paz","Caranavi","Col. Madre Maria Federica",32,0,15,2,103,3,34,0,1,190,2,7,199,224,0.542,0.888
"9449","La Paz","Caranavi","Col. Madre Maria Federica",54,1,10,0,86,6,37,0,1,195,3,5,203,225,0.441,0.902
"9450","La Paz","Caranavi","Col. Madre Maria Federica",46,1,5,0,93,1,27,1,1,175,1,10,186,221,0.531,0.842
"9451","La Paz","Caranavi","Col. Madre Maria Federica",47,0,6,0,77,4,34,0,1,169,1,9,179,216,0.456,0.829
"9452","La Paz","Caranavi","Col. Madre Maria Federica",33,1,11,2,100,2,27,0,1,177,4,7,188,221,0.565,0.851
"9453","La Paz","Caranavi","Col. Madre Maria Federica",64,2,8,0,77,3,25,1,4,184,1,7,192,220,0.418,0.873
"9454","La Paz","Caranavi","Col. Madre Maria Federica",59,0,9,1,76,1,38,1,0,185,2,8,195,222,0.411,0.878
"9455","La Paz","Caranavi","Col. Madre Maria Federica",55,0,6,0,85,2,23,0,2,173,2,1,176,218,0.491,0.807
"9456","La Paz","Caranavi","Unidad Educativa Simon Bolivar",33,0,5,0,101,3,42,1,4,189,3,4,196,230,0.534,0.852
"9457","La Paz","Caranavi","Unidad Educativa Simon Bolivar",30,1,5,0,105,2,37,0,3,183,2,8,193,222,0.574,0.869
"9458","La Paz","Caranavi","Unidad Educativa Simon Bolivar",40,2,3,1,100,1,34,2,3,186,7,10,203,227,0.538,0.894
"9459","La Paz","Caranavi","Unidad Educativa Simon Bolivar",22,0,6,0,103,1,41,0,2,175,3,11,189,225,0.589,0.84
"9460","La Paz","Caranavi","Unidad Educativa Simon Bolivar",27,0,9,0,105,2,40,1,3,187,3,6,196,233,0.561,0.841
"9461","La Paz","Caranavi","Unidad Educativa Simon Bolivar",19,1,5,0,95,0,40,0,2,162,5,9,176,221,0.586,0.796
"9462","La Paz","Caranavi","Unidad Educativa Simon Bolivar",19,3,5,0,102,2,36,0,2,169,1,8,178,217,0.604,0.82
"9463","La Paz","Caranavi","Unidad Educativa Simon Bolivar",25,0,9,1,108,2,33,0,1,179,4,10,193,227,0.603,0.85
"9464","La Paz","Caranavi","Unidad Educativa Simon Bolivar",37,3,2,0,101,2,33,0,0,178,5,6,189,226,0.567,0.836
"9465","La Paz","Caranavi","Unidad Educativa Simon Bolivar",45,3,3,1,91,5,35,0,0,183,7,5,195,220,0.497,0.886
"9466","La Paz","Caranavi","Unidad Educativa Simon Bolivar",26,0,7,1,117,3,32,0,1,187,1,8,196,221,0.626,0.887
"9467","La Paz","Caranavi","Unidad Educativa Simon Bolivar",19,1,4,0,117,1,29,0,7,178,6,5,189,222,0.657,0.851
"9468","La Paz","Caranavi","Unidad Educativa Simon Bolivar",45,1,5,1,85,2,22,2,5,168,3,12,183,217,0.506,0.843
"9469","La Paz","Caranavi","Unidad Educativa Simon Bolivar",42,0,6,0,106,2,29,1,2,188,3,6,197,227,0.564,0.868
"9470","La Paz","Caranavi","Unidad Educativa Simon Bolivar",28,0,3,0,92,6,25,0,1,155,1,5,161,193,0.594,0.834
"9471","La Paz","Caranavi","Col. Jhon F. Keneddy",41,0,13,1,86,5,35,1,0,182,5,6,193,229,0.473,0.843
"9472","La Paz","Caranavi","Col. Jhon F. Keneddy",48,2,8,0,90,0,41,0,0,189,0,5,194,229,0.476,0.847
"9473","La Paz","Caranavi","Col. Jhon F. Keneddy",43,0,9,0,87,2,42,0,2,185,2,5,192,229,0.47,0.838
"9474","La Paz","Caranavi","Col. Jhon F. Keneddy",31,2,2,0,108,3,34,2,3,185,1,6,192,230,0.584,0.835
"9475","La Paz","Caranavi","Col. Jhon F. Keneddy",31,0,4,0,110,2,28,1,2,178,3,8,189,224,0.618,0.844
"9476","La Paz","Caranavi","Col. Jhon F. Keneddy",24,1,9,0,108,5,36,0,1,184,1,6,191,229,0.587,0.834
"9477","La Paz","Caranavi","Col. Jhon F. Keneddy",46,1,12,0,86,2,40,2,1,190,1,11,202,233,0.453,0.867
"9478","La Paz","Caranavi","Col. Jhon F. Keneddy",30,0,15,1,99,2,46,0,4,197,1,9,207,236,0.503,0.877
"9479","La Paz","Caranavi","Col. Jhon F. Keneddy",43,1,6,0,91,10,34,0,2,187,2,4,193,231,0.487,0.835
"9480","La Paz","Caranavi","Col. Jhon F. Keneddy",41,1,4,0,98,4,34,1,3,186,2,3,191,228,0.527,0.838
"9481","La Paz","Caranavi","Col. Jhon F. Keneddy",38,1,9,0,80,1,42,0,4,175,4,7,186,225,0.457,0.827
"9482","La Paz","Caranavi","Col. Jhon F. Keneddy",34,0,6,0,102,4,34,0,3,183,3,10,196,232,0.557,0.845
"9483","La Paz","Caranavi","Col. Jhon F. Keneddy",31,1,7,0,97,2,43,0,0,181,2,7,190,226,0.536,0.841
"9484","La Paz","Caranavi","Col. Jhon F. Keneddy",39,1,7,0,107,0,32,0,3,189,3,6,198,226,0.566,0.876
"9485","La Paz","Caranavi","Col. Jhon F. Keneddy",26,2,10,0,114,1,32,0,2,187,0,3,190,226,0.61,0.841
"9486","La Paz","Caranavi","Col. Jhon F. Keneddy",16,1,5,0,120,3,42,0,2,189,1,3,193,234,0.635,0.825
"9487","La Paz","Caranavi","Col. Jhon F. Keneddy",48,0,5,2,81,4,38,0,3,181,1,7,189,230,0.448,0.822
"9488","La Paz","Caranavi","Col. Jhon F. Keneddy",31,0,4,0,94,5,40,0,1,175,3,7,185,228,0.537,0.811
"9489","La Paz","Caranavi","Col. Jhon F. Keneddy",30,0,4,0,127,2,32,0,1,196,1,5,202,230,0.648,0.878
"9490","La Paz","Caranavi","Col. Jhon F. Keneddy",40,1,5,0,103,2,33,0,6,190,4,4,198,228,0.542,0.868
"9491","La Paz","Caranavi","Col. Jhon F. Keneddy",30,1,4,0,103,0,42,0,1,181,5,11,197,226,0.569,0.872
"9492","La Paz","Caranavi","Col. Jhon F. Keneddy",25,0,10,0,118,1,31,0,4,189,0,11,200,228,0.624,0.877
"9493","La Paz","Caranavi","Col. Jhon F. Keneddy",38,1,8,0,92,1,41,2,2,185,3,8,196,221,0.497,0.887
"9494","La Paz","Caranavi","Col. Jhon F. Keneddy",45,0,7,0,72,6,37,0,4,171,1,8,180,227,0.421,0.793
"9495","La Paz","Caranavi","Col. Jhon F. Keneddy",39,3,9,1,85,6,40,0,3,186,0,3,189,230,0.457,0.822
"9496","La Paz","Caranavi","Col. Jhon F. Keneddy",35,2,3,1,96,2,43,0,4,186,4,7,197,229,0.516,0.86
"9497","La Paz","Caranavi","Col. Jhon F. Keneddy",31,0,5,1,96,3,38,0,2,176,7,13,196,228,0.545,0.86
"9498","La Paz","Caranavi","U.E. Suazo",33,0,8,0,109,0,55,0,3,208,1,5,214,237,0.524,0.903
"9499","La Paz","Caranavi","Instituto Americano",50,1,5,0,100,4,52,0,2,214,1,8,223,236,0.467,0.945
"9500","La Paz","Caranavi","Instituto Americano",47,1,7,0,89,2,61,0,3,210,2,13,225,240,0.424,0.938
"9501","La Paz","Caranavi","Instituto Americano",43,0,9,0,89,4,41,0,0,186,1,7,194,219,0.478,0.886
"9502","La Paz","Caranavi","U.E. Venezuela",21,0,3,0,92,2,31,1,2,152,4,64,220,239,0.605,0.921
"9503","La Paz","Caranavi","U.E. Venezuela",28,0,6,0,132,1,29,0,1,197,3,15,215,238,0.67,0.903
"9504","La Paz","Caranavi","U.E. Venezuela",31,0,7,1,127,5,34,1,3,209,2,9,220,237,0.608,0.928
"9505","La Paz","Caranavi","Col. San Lorenzo",5,1,3,0,186,1,4,1,0,201,4,3,208,221,0.925,0.941
"9506","La Paz","Caranavi","Col. San Lorenzo",10,1,5,0,163,1,19,1,0,200,3,4,207,222,0.815,0.932
"9507","La Paz","Caranavi","Col. San Lorenzo",4,1,7,2,168,2,15,0,1,200,8,6,214,226,0.84,0.947
"9508","La Paz","Caranavi","Col. San Lorenzo",3,1,5,0,175,1,11,0,0,196,3,6,205,219,0.893,0.936
"9509","La Paz","Caranavi","Esc. N. Choro",7,0,5,0,138,2,10,0,0,162,4,2,168,190,0.852,0.884
"9510","La Paz","Caranavi","Esc. P. Domingo Murillo",15,2,9,0,157,4,12,1,1,201,5,7,213,230,0.781,0.926
"9511","La Paz","Caranavi","Esc. P. Domingo Murillo",11,0,11,0,149,1,22,0,1,195,5,10,210,225,0.764,0.933
"9512","La Paz","Caranavi","Esc. P. Domingo Murillo",12,0,8,0,141,1,20,0,0,182,5,13,200,221,0.775,0.905
"9513","La Paz","Caranavi","Esc. P. Domingo Murillo",6,0,9,1,166,1,12,0,1,196,3,9,208,223,0.847,0.933
"9514","La Paz","Caranavi","Esc. P. Domingo Murillo",8,1,8,0,154,1,15,0,1,188,4,11,203,223,0.819,0.91
"9515","La Paz","Caranavi","Esc. P. Domingo Murillo",7,0,8,0,155,1,16,0,1,188,4,4,196,223,0.824,0.879
"9516","La Paz","Caranavi","Esc. P. Domingo Murillo",16,0,15,1,131,5,16,0,0,184,1,12,197,224,0.712,0.879
"9517","La Paz","Caranavi","Esc. P. Domingo Murillo",9,2,7,0,152,4,13,1,0,188,4,8,200,219,0.809,0.913
"9518","La Paz","Caranavi","Escuela Simon Bolivar de Santa Fe",26,0,16,0,132,3,16,0,0,193,6,6,205,226,0.684,0.907
"9519","La Paz","Caranavi","Escuela Simon Bolivar de Santa Fe",19,1,18,0,127,4,19,0,1,189,6,12,207,227,0.672,0.912
"9520","La Paz","Caranavi","U.E. Germán Busch",25,1,7,0,132,6,9,0,2,182,2,10,194,221,0.725,0.878
"9521","La Paz","Caranavi","U.E. Germán Busch",29,0,12,1,117,3,18,0,0,180,6,12,198,224,0.65,0.884
"9522","La Paz","Caranavi","U.E. Germán Busch",14,1,7,0,150,6,11,0,2,191,2,5,198,219,0.785,0.904
"9523","La Paz","Caranavi","U. E. Villa Elevación",10,1,15,0,137,4,13,1,3,184,9,7,200,226,0.745,0.885
"9524","La Paz","Caranavi","U. E. Villa Elevación",12,2,15,0,126,9,10,1,1,176,7,10,193,220,0.716,0.877
"9525","La Paz","Caranavi","Esc. Uyunense",8,0,14,2,157,1,14,0,0,196,8,4,208,223,0.801,0.933
"9526","La Paz","Caranavi","Esc. Uyunense",8,2,13,0,149,2,13,1,0,188,2,13,203,221,0.793,0.919
"9527","La Paz","Caranavi","Centro de Salud Santa Ana",6,0,5,0,157,2,18,0,2,190,23,4,217,217,0.826,1
"9528","La Paz","Caranavi","Centro de Salud Santa Ana",17,1,5,0,140,0,16,0,4,183,26,10,219,219,0.765,1
"9529","La Paz","Caranavi","U. E. Rene Zenon Portillo Chavarria",6,0,10,0,151,2,16,1,1,187,4,8,199,225,0.807,0.884
"9530","La Paz","Caranavi","Esc. C. de Chojna",17,1,5,0,140,1,19,0,4,187,6,9,202,223,0.749,0.906
"9531","La Paz","Caranavi","Col. Guillermo Molina",5,0,11,0,161,2,9,0,0,188,5,4,197,219,0.856,0.9
"9532","La Paz","Caranavi","Col. Guillermo Molina",4,0,8,1,160,2,14,0,0,189,5,6,200,222,0.847,0.901
"9533","La Paz","Caranavi","Col. Guillermo Molina",9,1,6,1,154,1,16,1,2,191,4,8,203,230,0.806,0.883
"9534","La Paz","Caranavi","Col. Guillermo Molina",10,0,8,0,156,0,13,0,1,188,0,5,193,223,0.83,0.865
"9535","La Paz","Caranavi","Esc. Tupac Katari",4,0,12,0,171,0,11,0,2,200,9,4,213,229,0.855,0.93
"9536","La Paz","Caranavi","Esc. Tupac Katari",6,1,8,0,177,2,14,1,0,209,5,5,219,227,0.847,0.965
"9537","La Paz","Caranavi","Esc. Simon Bolivar",10,2,6,2,135,4,29,1,1,190,7,6,203,222,0.711,0.914
"9538","La Paz","Caranavi","Esc. Simon Bolivar",11,1,16,1,146,2,22,0,1,200,6,6,212,227,0.73,0.934
"9539","La Paz","Caranavi","Esc. Simon Bolivar",11,1,12,2,141,0,34,0,0,201,0,6,207,229,0.701,0.904
"9540","La Paz","Caranavi","Esc. Carrasco La Reserva",6,0,3,0,159,1,19,1,0,189,4,9,202,222,0.841,0.91
"9541","La Paz","Caranavi","Esc. Carrasco La Reserva",7,0,5,0,167,0,15,0,1,195,5,3,203,225,0.856,0.902
"9542","La Paz","Caranavi","Esc. Carrasco La Reserva",5,1,3,0,179,0,9,1,0,198,3,2,203,221,0.904,0.919
"9543","La Paz","Caranavi","Esc. Carrasco La Reserva",6,0,5,0,171,0,13,0,1,196,2,4,202,221,0.872,0.914
"9544","La Paz","Caranavi","Esc. Carrasco La Reserva",9,2,3,0,150,2,22,0,1,189,6,11,206,224,0.794,0.92
"9545","La Paz","Caranavi","Esc. Carrasco La Reserva",4,2,3,0,171,0,17,0,1,198,4,4,206,228,0.864,0.904
"9546","La Paz","Caranavi","Esc. Carrasco La Reserva",4,0,0,1,178,0,4,1,1,189,7,13,209,226,0.942,0.925
"9547","La Paz","Caranavi","Esc. Mscal. Santa Cruz",13,1,7,0,156,0,11,0,1,189,4,8,201,221,0.825,0.91
"9548","La Paz","Caranavi","Esc. Mscal. Santa Cruz",6,0,3,0,157,0,8,0,0,174,3,12,189,215,0.902,0.879
"9549","La Paz","Caranavi","Col. Los Andes",10,0,7,0,164,0,15,1,1,198,0,6,204,224,0.828,0.911
"9550","La Paz","Caranavi","Col. Los Andes",6,0,13,0,187,0,6,0,1,213,1,7,221,229,0.878,0.965
"9551","La Paz","Caranavi","Escuela Central Villamontes",6,0,15,0,156,1,24,0,1,203,5,3,211,236,0.768,0.894
"9552","La Paz","Caranavi","Unidad Educativa Nueva Llusta 2da",0,1,4,0,176,1,6,0,1,189,3,8,200,228,0.931,0.877
"9553","La Paz","Alto Beni","U. E. Sararia",23,0,6,0,126,4,15,0,6,180,6,5,191,225,0.7,0.849
"9554","La Paz","Alto Beni","U. E. Sararia",18,0,9,1,141,2,23,0,2,196,7,6,209,229,0.719,0.913
"9555","La Paz","Alto Beni","U.E. Palmar Suapi",19,0,6,0,134,2,10,1,1,173,7,8,188,218,0.775,0.862
"9556","La Paz","Alto Beni","U.E. Palmar Suapi",13,0,9,2,143,2,10,0,0,179,3,7,189,216,0.799,0.875
"9557","La Paz","Alto Beni","U. E. Bella Vista II",15,1,8,0,140,1,19,0,0,184,1,13,198,223,0.761,0.888
"9558","La Paz","Alto Beni","U. E. Bella Vista II",13,2,9,0,146,1,8,0,1,180,5,8,193,214,0.811,0.902
"9559","La Paz","Alto Beni","U.E. Santa Rosa I",25,3,6,0,121,0,15,0,3,173,9,9,191,214,0.699,0.893
"9560","La Paz","Alto Beni","U. E. San Antonio",21,0,9,0,137,2,26,0,5,200,2,5,207,225,0.685,0.92
"9561","La Paz","Alto Beni","U. E. San Antonio",12,0,6,0,154,0,18,0,1,191,7,2,200,223,0.806,0.897
"9562","La Paz","Alto Beni","U. E. San Antonio",12,0,2,0,156,0,21,0,4,195,4,3,202,225,0.8,0.898
"9563","La Paz","Alto Beni","U. E. San Antonio",12,0,6,0,152,2,20,0,0,192,3,4,199,226,0.792,0.881
"9564","La Paz","Alto Beni","U. E. San Antonio",14,0,4,0,125,1,18,1,1,164,3,3,170,186,0.762,0.914
"9565","La Paz","Alto Beni","U. E. Villa Camacho",19,1,5,1,156,1,15,0,0,198,1,10,209,225,0.788,0.929
"9566","La Paz","Alto Beni","U. E. Villa Camacho",17,0,3,0,149,3,19,1,0,192,0,8,200,220,0.776,0.909
"9567","La Paz","Alto Beni","U. E. Villa Camacho",11,2,8,0,151,0,21,0,0,193,4,4,201,230,0.782,0.874
"9568","La Paz","Alto Beni","U. E. Caserio Nueve",20,2,4,0,150,1,15,0,3,195,2,5,202,231,0.769,0.874
"9569","La Paz","Alto Beni","U. E. Villa Litoral",9,0,2,0,177,0,21,0,0,209,3,7,219,239,0.847,0.916
"9570","La Paz","Alto Beni","U. E. Villa El Porvenir",10,1,2,0,178,2,16,1,0,210,1,8,219,234,0.848,0.936
"9571","La Paz","Alto Beni","U. E. Puente Alto Beni",4,0,12,0,112,1,23,1,2,155,4,5,164,182,0.723,0.901
"9572","Cochabamba","Cochabamba","Unidad Educativa Club De Leones",129,2,0,0,50,3,12,0,1,197,3,4,204,229,0.254,0.891
"9573","Cochabamba","Cochabamba","Unidad Educativa Club De Leones",119,0,1,0,52,6,6,1,0,185,0,7,192,220,0.281,0.873
"9574","Cochabamba","Cochabamba","Unidad Educativa Club De Leones",141,0,0,1,40,3,6,0,1,192,2,4,198,228,0.208,0.868
"9575","Cochabamba","Cochabamba","Unidad Educativa Club De Leones",118,0,1,1,48,1,13,1,0,183,1,9,193,225,0.262,0.858
"9576","Cochabamba","Cochabamba","Unidad Educativa Club De Leones",136,0,0,1,45,4,4,0,2,192,1,8,201,227,0.234,0.885
"9577","Cochabamba","Cochabamba","Unidad Educativa Club De Leones",139,0,3,0,43,6,7,2,0,200,1,5,206,232,0.215,0.888
"9578","Cochabamba","Cochabamba","Unidad Educativa Club De Leones",133,0,0,0,58,4,9,1,1,206,2,2,210,224,0.282,0.938
"9579","Cochabamba","Cochabamba","Unidad Educativa Club De Leones",107,0,0,0,64,3,13,0,2,189,0,5,194,225,0.339,0.862
"9580","Cochabamba","Cochabamba","Unidad Educativa Club De Leones",141,0,0,0,41,4,6,1,1,194,1,3,198,227,0.211,0.872
"9581","Cochabamba","Cochabamba","Unidad Educativa Club De Leones",144,1,1,1,36,2,6,0,0,191,0,8,199,224,0.188,0.888
"9582","Cochabamba","Cochabamba","Unidad Educativa Club De Leones",136,0,0,0,36,0,6,0,1,179,1,10,190,225,0.201,0.844
"9583","Cochabamba","Cochabamba","Unidad Educativa Club De Leones",137,0,1,1,39,2,7,1,0,188,0,0,188,216,0.207,0.87
"9584","Cochabamba","Cochabamba","Unidad Educativa Club De Leones",139,0,0,1,43,3,5,1,1,193,1,6,200,226,0.223,0.885
"9585","Cochabamba","Cochabamba","Unidad Educativa Club De Leones",134,1,0,0,48,3,5,0,0,191,2,7,200,229,0.251,0.873
"9586","Cochabamba","Cochabamba","Unidad Educativa Club De Leones",143,0,0,0,45,2,6,0,1,197,1,2,200,227,0.228,0.881
"9587","Cochabamba","Cochabamba","Escuela Mixta Fiscal Temporal A",95,0,1,1,74,2,6,1,2,182,1,11,194,225,0.407,0.862
"9588","Cochabamba","Cochabamba","Escuela Mixta Fiscal Temporal A",114,0,0,0,63,2,14,0,0,193,1,3,197,225,0.326,0.876
"9589","Cochabamba","Cochabamba","Escuela Mixta Fiscal Temporal A",127,0,1,0,50,2,14,1,1,196,2,3,201,222,0.255,0.905
"9590","Cochabamba","Cochabamba","Escuela Mixta Fiscal Temporal A",128,0,3,0,50,5,4,1,0,191,0,6,197,225,0.262,0.876
"9591","Cochabamba","Cochabamba","Escuela Mixta Fiscal Temporal A",89,0,1,1,84,2,13,0,1,191,1,3,195,221,0.44,0.882
"9592","Cochabamba","Cochabamba","Escuela Mixta Fiscal Temporal A",111,0,2,1,65,7,11,0,1,198,2,5,205,229,0.328,0.895
"9593","Cochabamba","Cochabamba","Escuela Mixta Fiscal Temporal A",98,0,0,2,68,10,5,0,1,184,1,11,196,224,0.37,0.875
"9594","Cochabamba","Cochabamba","Escuela Mixta Fiscal Temporal A",126,0,0,0,59,1,10,0,2,198,1,5,204,232,0.298,0.879
"9595","Cochabamba","Cochabamba","Escuela Mixta Fiscal Temporal A",98,0,0,1,69,3,13,0,0,184,1,8,193,216,0.375,0.894
"9596","Cochabamba","Cochabamba","Escuela Mixta Fiscal Temporal A",98,0,0,1,62,4,15,0,0,180,2,3,185,220,0.344,0.841
"9597","Cochabamba","Cochabamba","Escuela Mixta Fiscal Temporal A",102,0,1,1,83,4,7,1,0,199,1,4,204,227,0.417,0.899
"9598","Cochabamba","Cochabamba","Escuela Mixta Fiscal Temporal A",121,1,0,0,45,6,9,0,0,182,1,7,190,219,0.247,0.868
"9599","Cochabamba","Cochabamba","Escuela Mixta Fiscal Temporal A",126,0,0,1,51,7,4,0,1,190,2,5,197,227,0.268,0.868
"9600","Cochabamba","Cochabamba","Escuela Mixta Fiscal Temporal A",119,0,0,0,58,4,17,0,1,199,0,5,204,221,0.291,0.923
"9601","Cochabamba","Cochabamba","Escuela Mixta Fiscal Temporal A",102,1,0,0,67,1,9,1,1,182,1,8,191,217,0.368,0.88
"9602","Cochabamba","Cochabamba","Escuela Mixta Fiscal Temporal A",124,0,0,0,56,5,10,0,2,197,0,2,199,227,0.284,0.877
"9603","Cochabamba","Cochabamba","Escuela Mixta Fiscal Temporal A",115,0,0,1,56,5,3,0,0,180,1,5,186,228,0.311,0.816
"9604","Cochabamba","Cochabamba","Escuela Mixta Fiscal Temporal A",121,0,0,1,63,2,9,0,1,197,1,5,203,223,0.32,0.91
"9605","Cochabamba","Cochabamba","Escuela Mixta Fiscal Temporal A",121,0,0,1,54,2,7,0,2,187,1,11,199,219,0.289,0.909
"9606","Cochabamba","Cochabamba","Escuela Mixta Fiscal Temporal A",128,1,0,1,56,4,15,0,4,209,1,6,216,232,0.268,0.931
"9607","Cochabamba","Cochabamba","Escuela Mixta Fiscal Temporal A",104,1,1,0,71,3,14,0,0,194,0,3,197,225,0.366,0.876
"9608","Cochabamba","Cochabamba","Colegio Marista",135,0,1,0,51,4,3,0,0,194,4,12,210,235,0.263,0.894
"9609","Cochabamba","Cochabamba","Colegio Marista",144,0,0,0,51,1,4,1,0,201,2,4,207,224,0.254,0.924
"9610","Cochabamba","Cochabamba","Colegio Marista",142,0,1,0,41,3,8,0,0,195,2,4,201,231,0.21,0.87
"9611","Cochabamba","Cochabamba","Colegio Marista",143,0,0,0,41,3,7,2,1,197,0,4,201,225,0.208,0.893
"9612","Cochabamba","Cochabamba","Colegio Marista",150,1,1,1,41,5,1,0,0,200,1,7,208,230,0.205,0.904
"9613","Cochabamba","Cochabamba","Colegio Marista",124,1,1,0,58,3,15,0,1,203,0,3,206,230,0.286,0.896
"9614","Cochabamba","Cochabamba","Colegio Marista",124,0,0,0,57,6,14,0,1,202,2,2,206,230,0.282,0.896
"9615","Cochabamba","Cochabamba","Colegio Marista",146,0,1,0,30,4,13,0,1,195,2,8,205,228,0.154,0.899
"9616","Cochabamba","Cochabamba","Colegio Marista",134,0,1,0,52,4,11,0,1,203,0,3,206,228,0.256,0.904
"9617","Cochabamba","Cochabamba","Colegio Marista",148,0,1,1,48,2,4,1,1,206,1,6,213,228,0.233,0.934
"9618","Cochabamba","Cochabamba","Colegio Marista",129,0,1,0,50,3,9,0,0,192,1,1,194,222,0.26,0.874
"9619","Cochabamba","Cochabamba","Colegio Marista",142,0,1,0,49,4,5,1,1,203,0,6,209,229,0.241,0.913
"9620","Cochabamba","Cochabamba","Colegio Marista",131,0,1,1,56,7,14,3,0,213,0,3,216,232,0.263,0.931
"9621","Cochabamba","Cochabamba","Colegio Marista",139,1,0,0,54,6,11,0,0,211,0,1,212,229,0.256,0.926
"9622","Cochabamba","Cochabamba","Colegio Marista",149,0,1,0,38,6,7,1,1,203,0,7,210,230,0.187,0.913
"9623","Cochabamba","Cochabamba","Colegio Marista",142,0,1,0,43,3,8,0,1,198,1,8,207,230,0.217,0.9
"9624","Cochabamba","Cochabamba","Colegio Marista",145,0,2,0,39,5,8,0,1,200,0,0,200,224,0.195,0.893
"9625","Cochabamba","Cochabamba","Colegio Marista",150,1,0,0,37,3,11,1,2,205,0,10,215,233,0.18,0.923
"9626","Cochabamba","Cochabamba","Colegio Marista",153,1,0,0,39,3,7,1,1,205,1,2,208,229,0.19,0.908
"9627","Cochabamba","Cochabamba","Colegio Marista",134,1,0,0,53,3,10,0,0,201,0,8,209,226,0.264,0.925
"9628","Cochabamba","Cochabamba","Colegio Marista",139,0,0,2,51,4,7,0,1,204,1,5,210,230,0.25,0.913
"9629","Cochabamba","Cochabamba","Colegio Marista",131,0,3,0,43,7,5,0,0,189,1,9,199,226,0.228,0.881
"9630","Cochabamba","Cochabamba","Colegio Marista",134,0,1,1,51,4,12,1,1,205,0,2,207,231,0.249,0.896
"9631","Cochabamba","Cochabamba","Colegio Marista",144,0,1,3,44,4,7,1,0,204,1,5,210,229,0.216,0.917
"9632","Cochabamba","Cochabamba","Liceo Elena Arze De Arze",158,1,0,0,29,4,2,1,0,195,0,4,199,221,0.149,0.9
"9633","Cochabamba","Cochabamba","Liceo Elena Arze De Arze",151,0,0,0,49,1,3,0,1,205,0,2,207,230,0.239,0.9
"9634","Cochabamba","Cochabamba","Liceo Elena Arze De Arze",145,0,0,1,34,0,4,0,0,184,0,1,185,220,0.185,0.841
"9635","Cochabamba","Cochabamba","Liceo Elena Arze De Arze",167,0,0,0,25,1,2,1,1,197,1,1,199,229,0.127,0.869
"9636","Cochabamba","Cochabamba","Liceo Elena Arze De Arze",163,0,0,0,23,3,5,1,1,196,1,5,202,227,0.117,0.89
"9637","Cochabamba","Cochabamba","Liceo Elena Arze De Arze",136,1,1,2,40,6,5,0,1,192,0,7,199,231,0.208,0.861
"9638","Cochabamba","Cochabamba","Liceo Elena Arze De Arze",145,0,0,0,23,3,4,2,1,178,1,1,180,211,0.129,0.853
"9639","Cochabamba","Cochabamba","Liceo Elena Arze De Arze",164,0,0,1,31,2,5,0,1,204,0,8,212,232,0.152,0.914
"9640","Cochabamba","Cochabamba","Liceo Elena Arze De Arze",160,0,0,0,28,1,6,0,0,195,0,3,198,226,0.144,0.876
"9641","Cochabamba","Cochabamba","Liceo Elena Arze De Arze",164,0,0,0,24,1,5,0,0,194,0,5,199,225,0.124,0.884
"9642","Cochabamba","Cochabamba","Liceo Elena Arze De Arze",160,0,0,1,26,1,3,1,1,193,2,6,201,228,0.135,0.882
"9643","Cochabamba","Cochabamba","Liceo Elena Arze De Arze",143,0,0,1,27,2,11,1,4,189,0,5,194,227,0.143,0.855
"9644","Cochabamba","Cochabamba","Liceo Elena Arze De Arze",129,0,0,1,47,5,7,0,2,191,3,2,196,227,0.246,0.863
"9645","Cochabamba","Cochabamba","Liceo Elena Arze De Arze",145,0,1,2,36,3,7,0,0,194,2,1,197,230,0.186,0.857
"9646","Cochabamba","Cochabamba","Liceo Elena Arze De Arze",150,0,0,0,35,1,6,0,1,193,1,4,198,227,0.181,0.872
"9647","Cochabamba","Cochabamba","Liceo Elena Arze De Arze",159,0,0,0,32,1,6,0,0,198,0,3,201,221,0.162,0.91
"9648","Cochabamba","Cochabamba","Liceo Elena Arze De Arze",151,0,0,0,38,6,1,0,1,197,0,4,201,228,0.193,0.882
"9649","Cochabamba","Cochabamba","Liceo Elena Arze De Arze",160,0,0,1,21,5,5,0,0,192,0,2,194,227,0.109,0.855
"9650","Cochabamba","Cochabamba","Liceo Elena Arze De Arze",152,0,0,0,33,2,5,1,0,193,0,2,195,229,0.171,0.852
"9651","Cochabamba","Cochabamba","Liceo Elena Arze De Arze",153,0,0,0,27,1,1,1,0,183,0,5,188,224,0.148,0.839
"9652","Cochabamba","Cochabamba","Liceo Elena Arze De Arze",160,0,0,0,26,3,1,1,0,191,1,5,197,227,0.136,0.868
"9653","Cochabamba","Cochabamba","Liceo Elena Arze De Arze",143,0,1,0,35,3,2,0,0,184,1,4,189,226,0.19,0.836
"9654","Cochabamba","Cochabamba","Liceo Elena Arze De Arze",150,0,1,1,31,3,8,2,0,196,0,0,196,231,0.158,0.848
"9655","Cochabamba","Cochabamba","Liceo Elena Arze De Arze",158,0,0,1,28,4,9,0,0,200,0,3,203,225,0.14,0.902
"9656","Cochabamba","Cochabamba","Instituto Eduardo Laredo",155,2,0,0,26,2,4,2,0,191,0,1,192,222,0.136,0.865
"9657","Cochabamba","Cochabamba","Instituto Eduardo Laredo",148,0,0,0,29,2,5,0,0,184,0,3,187,213,0.158,0.878
"9658","Cochabamba","Cochabamba","Instituto Eduardo Laredo",148,0,1,0,25,4,3,0,0,181,3,4,188,224,0.138,0.839
"9659","Cochabamba","Cochabamba","Instituto Eduardo Laredo",142,0,1,0,31,5,3,1,0,183,1,9,193,225,0.169,0.858
"9660","Cochabamba","Cochabamba","Instituto Eduardo Laredo",147,0,0,0,26,4,6,0,0,183,0,6,189,220,0.142,0.859
"9661","Cochabamba","Cochabamba","Instituto Eduardo Laredo",126,0,1,0,37,4,8,2,0,178,1,5,184,223,0.208,0.825
"9662","Cochabamba","Cochabamba","Instituto Eduardo Laredo",151,1,0,0,29,1,1,0,0,183,2,2,187,227,0.158,0.824
"9663","Cochabamba","Cochabamba","Instituto Eduardo Laredo",152,1,0,1,27,2,6,0,0,189,0,4,193,215,0.143,0.898
"9664","Cochabamba","Cochabamba","Instituto Eduardo Laredo",141,1,0,1,30,4,4,0,0,181,2,1,184,221,0.166,0.833
"9665","Cochabamba","Cochabamba","Instituto Eduardo Laredo",149,0,0,0,31,9,5,1,0,195,0,3,198,229,0.159,0.865
"9666","Cochabamba","Cochabamba","Instituto Eduardo Laredo",127,0,0,0,37,2,3,1,0,170,2,8,180,222,0.218,0.811
"9667","Cochabamba","Cochabamba","Instituto Eduardo Laredo",147,0,0,4,31,4,3,0,0,189,1,3,193,222,0.164,0.869
"9668","Cochabamba","Cochabamba","Colegio La Salle",145,0,0,0,22,8,7,0,0,182,0,2,184,213,0.121,0.864
"9669","Cochabamba","Cochabamba","Colegio La Salle",145,0,0,0,24,4,4,0,0,177,0,1,178,217,0.136,0.82
"9670","Cochabamba","Cochabamba","Colegio La Salle",121,0,0,0,30,7,5,0,1,164,0,1,165,209,0.183,0.789
"9671","Cochabamba","Cochabamba","Colegio La Salle",135,0,0,0,27,1,4,0,0,167,2,5,174,202,0.162,0.861
"9672","Cochabamba","Cochabamba","Colegio La Salle",138,0,0,2,25,1,4,0,1,171,2,3,176,208,0.146,0.846
"9673","Cochabamba","Cochabamba","Colegio La Salle",126,0,1,2,32,2,5,0,0,168,0,1,169,212,0.19,0.797
"9674","Cochabamba","Cochabamba","Colegio La Salle",137,0,0,1,28,4,5,0,0,175,2,2,179,213,0.16,0.84
"9675","Cochabamba","Cochabamba","Colegio La Salle",132,0,1,1,28,3,2,0,0,167,1,1,169,197,0.168,0.858
"9676","Cochabamba","Cochabamba","Colegio La Salle",131,0,0,1,25,3,7,0,0,167,1,2,170,202,0.15,0.842
"9677","Cochabamba","Cochabamba","Colegio La Salle",140,0,0,1,21,4,0,1,0,167,0,6,173,207,0.126,0.836
"9678","Cochabamba","Cochabamba","Colegio La Salle",127,0,0,0,21,3,5,3,0,159,1,3,163,207,0.132,0.787
"9679","Cochabamba","Cochabamba","Colegio La Salle",144,0,0,0,29,4,3,2,0,182,0,3,185,213,0.159,0.869
"9680","Cochabamba","Cochabamba","Colegio La Salle",125,0,0,0,29,3,5,0,0,162,0,5,167,202,0.179,0.827
"9681","Cochabamba","Cochabamba","Colegio La Salle",146,0,0,0,17,0,3,0,0,166,0,4,170,207,0.102,0.821
"9682","Cochabamba","Cochabamba","Colegio La Salle",130,0,0,0,25,7,5,1,0,168,1,3,172,205,0.149,0.839
"9683","Cochabamba","Cochabamba","Colegio La Salle",150,1,0,0,19,2,0,1,2,175,0,3,178,218,0.109,0.817
"9684","Cochabamba","Cochabamba","Colegio La Salle",146,0,1,1,25,1,1,0,0,175,0,1,176,214,0.143,0.822
"9685","Cochabamba","Cochabamba","Colegio Boliviano Argentino",142,0,1,1,27,3,9,1,1,185,0,6,191,225,0.146,0.849
"9686","Cochabamba","Cochabamba","Colegio Boliviano Argentino",143,2,0,0,29,2,9,0,4,189,0,5,194,222,0.153,0.874
"9687","Cochabamba","Cochabamba","Colegio Boliviano Argentino",137,0,0,0,40,4,13,0,1,195,0,6,201,230,0.205,0.874
"9688","Cochabamba","Cochabamba","Colegio Boliviano Argentino",161,1,0,1,24,1,3,2,3,196,0,3,199,222,0.122,0.896
"9689","Cochabamba","Cochabamba","Colegio Boliviano Argentino",129,0,0,0,38,3,8,0,2,180,0,3,183,202,0.211,0.906
"9690","Cochabamba","Cochabamba","Unidad Educativa Daniel Salamanca (Ex Colegio Nal. Mixto 6 De Agosto)",145,1,1,0,37,3,2,1,0,190,0,3,193,224,0.195,0.862
"9691","Cochabamba","Cochabamba","Unidad Educativa Daniel Salamanca (Ex Colegio Nal. Mixto 6 De Agosto)",132,0,0,0,46,4,8,0,1,191,1,5,197,221,0.241,0.891
"9692","Cochabamba","Cochabamba","Unidad Educativa Daniel Salamanca (Ex Colegio Nal. Mixto 6 De Agosto)",148,0,0,0,31,3,2,0,1,185,1,4,190,216,0.168,0.88
"9693","Cochabamba","Cochabamba","U. E. 8 de Mayo",152,1,2,0,49,4,10,0,3,221,2,3,226,239,0.222,0.946
"9694","Cochabamba","Cochabamba","U. E. 8 de Mayo",157,0,0,1,35,1,5,1,0,200,1,6,207,214,0.175,0.967
"9695","Cochabamba","Cochabamba","Colegio Aleman Santa Maria",139,0,0,0,42,2,6,0,1,190,0,6,196,227,0.221,0.863
"9696","Cochabamba","Cochabamba","Colegio Aleman Santa Maria",144,0,0,0,24,2,7,0,0,177,0,9,186,218,0.136,0.853
"9697","Cochabamba","Cochabamba","Colegio Aleman Santa Maria",143,0,0,0,30,3,6,0,1,183,2,4,189,223,0.164,0.848
"9698","Cochabamba","Cochabamba","Colegio Aleman Santa Maria",144,0,0,1,34,4,4,1,1,189,2,3,194,222,0.18,0.874
"9699","Cochabamba","Cochabamba","Colegio Aleman Santa Maria",154,0,0,0,36,1,3,2,1,197,0,0,197,225,0.183,0.876
"9700","Cochabamba","Cochabamba","Colegio Aleman Santa Maria",135,1,0,0,32,8,3,1,0,180,1,5,186,220,0.178,0.845
"9701","Cochabamba","Cochabamba","Colegio Aleman Santa Maria",142,0,0,0,34,2,5,0,2,185,0,6,191,223,0.184,0.857
"9702","Cochabamba","Cochabamba","Colegio Aleman Santa Maria",150,1,0,0,21,2,9,2,1,186,3,3,192,220,0.113,0.873
"9703","Cochabamba","Cochabamba","Colegio Aleman Santa Maria",154,0,1,0,21,4,7,0,1,188,0,4,192,220,0.112,0.873
"9704","Cochabamba","Cochabamba","Colegio Aleman Santa Maria",150,2,0,0,28,0,3,2,0,185,2,5,192,220,0.151,0.873
"9705","Cochabamba","Cochabamba","Colegio Aleman Santa Maria",168,0,0,0,20,5,3,1,3,200,0,3,203,229,0.1,0.886
"9706","Cochabamba","Cochabamba","Escuela Wilge Rodriguez",136,0,1,1,43,3,7,1,0,192,0,6,198,222,0.224,0.892
"9707","Cochabamba","Cochabamba","Escuela Wilge Rodriguez",141,0,2,0,38,4,5,0,0,190,1,7,198,228,0.2,0.868
"9708","Cochabamba","Cochabamba","Escuela Wilge Rodriguez",135,0,0,0,54,3,8,1,0,201,1,4,206,228,0.269,0.904
"9709","Cochabamba","Cochabamba","Escuela Wilge Rodriguez",137,0,1,0,39,4,9,0,0,190,0,7,197,224,0.205,0.879
"9710","Cochabamba","Cochabamba","Escuela Wilge Rodriguez",132,1,1,1,35,2,7,0,0,179,1,7,187,220,0.196,0.85
"9711","Cochabamba","Cochabamba","Colegio Hispano Boliviano",123,0,0,1,49,3,7,0,2,185,2,7,194,229,0.265,0.847
"9712","Cochabamba","Cochabamba","Colegio Hispano Boliviano",131,2,0,1,34,6,10,2,0,186,1,2,189,219,0.183,0.863
"9713","Cochabamba","Cochabamba","Colegio Hispano Boliviano",116,1,1,2,52,3,10,0,2,187,0,4,191,220,0.278,0.868
"9714","Cochabamba","Cochabamba","Colegio Hispano Boliviano",126,1,1,2,51,3,7,1,1,193,1,6,200,229,0.264,0.873
"9715","Cochabamba","Cochabamba","Colegio Hispano Boliviano",119,1,3,0,47,1,8,0,0,179,0,8,187,222,0.263,0.842
"9716","Cochabamba","Cochabamba","Colegio Hispano Boliviano",129,0,1,0,48,1,8,0,2,189,1,6,196,222,0.254,0.883
"9717","Cochabamba","Cochabamba","Colegio Hispano Boliviano",130,2,0,0,39,4,9,1,1,186,1,6,193,224,0.21,0.862
"9718","Cochabamba","Cochabamba","Colegio Hispano Boliviano",116,0,0,0,58,6,11,1,1,193,0,1,194,224,0.301,0.866
"9719","Cochabamba","Cochabamba","Colegio Hispano Boliviano",152,0,0,1,39,4,9,0,1,206,0,1,207,231,0.189,0.896
"9720","Cochabamba","Cochabamba","Colegio Hispano Boliviano",129,0,0,0,45,3,8,0,1,186,0,3,189,222,0.242,0.851
"9721","Cochabamba","Cochabamba","Colegio Hispano Boliviano",125,0,1,1,41,3,17,0,2,190,1,6,197,224,0.216,0.879
"9722","Cochabamba","Cochabamba","Colegio Hispano Boliviano",139,0,0,1,41,3,7,0,1,192,0,4,196,231,0.214,0.848
"9723","Cochabamba","Cochabamba","Colegio Hispano Boliviano",129,1,0,0,43,3,9,2,0,187,0,4,191,226,0.23,0.845
"9724","Cochabamba","Cochabamba","Colegio Hispano Boliviano",119,0,0,1,50,7,7,0,2,186,2,5,193,227,0.269,0.85
"9725","Cochabamba","Cochabamba","Colegio Abaroa",131,2,1,0,33,0,5,0,0,172,0,3,175,209,0.192,0.837
"9726","Cochabamba","Cochabamba","Colegio Abaroa",131,0,0,0,33,1,8,0,0,173,0,3,176,214,0.191,0.822
"9727","Cochabamba","Cochabamba","Colegio Abaroa",134,0,1,1,37,2,12,0,2,189,0,6,195,228,0.196,0.855
"9728","Cochabamba","Cochabamba","Colegio Abaroa",131,3,0,0,48,3,5,1,0,191,2,3,196,222,0.251,0.883
"9729","Cochabamba","Cochabamba","Colegio Abaroa",132,0,1,0,39,1,3,0,0,176,0,6,182,217,0.222,0.839
"9730","Cochabamba","Cochabamba","Colegio Abaroa",130,1,1,0,32,7,9,0,1,181,3,6,190,219,0.177,0.868
"9731","Cochabamba","Cochabamba","Colegio Abaroa",116,1,1,1,39,4,9,1,1,173,2,5,180,216,0.225,0.833
"9732","Cochabamba","Cochabamba","Colegio Abaroa",127,1,0,0,43,7,7,0,4,189,0,1,190,223,0.228,0.852
"9733","Cochabamba","Cochabamba","Colegio Abaroa",132,0,0,0,44,3,7,0,0,186,0,3,189,226,0.237,0.836
"9734","Cochabamba","Cochabamba","Colegio Abaroa",133,1,0,2,38,6,9,2,1,192,0,5,197,221,0.198,0.891
"9735","Cochabamba","Cochabamba","Colegio Abaroa",108,1,0,0,46,5,9,0,2,171,2,6,179,215,0.269,0.833
"9736","Cochabamba","Cochabamba","Colegio Abaroa",124,0,0,0,36,2,6,2,2,172,0,7,179,222,0.209,0.806
"9737","Cochabamba","Cochabamba","Colegio Abaroa",135,1,0,0,32,3,8,1,1,181,1,4,186,218,0.177,0.853
"9738","Cochabamba","Cochabamba","Colegio Abaroa",133,0,0,0,34,4,7,0,1,179,1,1,181,213,0.19,0.85
"9739","Cochabamba","Cochabamba","Colegio Bolivar",133,0,0,0,43,3,9,1,1,190,2,4,196,224,0.226,0.875
"9740","Cochabamba","Cochabamba","Colegio Bolivar",111,0,0,2,39,3,22,1,0,178,2,2,182,226,0.219,0.805
"9741","Cochabamba","Cochabamba","Colegio Bolivar",112,1,0,0,61,2,13,0,1,190,2,4,196,228,0.321,0.86
"9742","Cochabamba","Cochabamba","Colegio Bolivar",117,0,1,1,50,3,11,0,0,183,1,2,186,219,0.273,0.849
"9743","Cochabamba","Cochabamba","Colegio Bolivar",115,0,2,0,58,4,8,1,0,188,2,2,192,222,0.309,0.865
"9744","Cochabamba","Cochabamba","Colegio Bolivar",115,1,0,0,52,5,13,1,2,189,1,5,195,227,0.275,0.859
"9745","Cochabamba","Cochabamba","Colegio Bolivar",142,1,2,2,28,3,10,1,1,190,3,1,194,223,0.147,0.87
"9746","Cochabamba","Cochabamba","Colegio Bolivar",122,0,0,0,36,2,20,2,1,183,1,7,191,227,0.197,0.841
"9747","Cochabamba","Cochabamba","Colegio Bolivar",125,0,0,1,38,3,6,0,2,175,0,2,177,204,0.217,0.868
"9748","Cochabamba","Cochabamba","(Cárcel) Penitenciaria San Sebastian  Varones",31,0,0,1,105,5,12,0,0,154,3,7,164,229,0.682,0.716
"9749","Cochabamba","Cochabamba","Centro Kanata",110,0,1,0,66,6,12,2,1,198,1,8,207,231,0.333,0.896
"9750","Cochabamba","Cochabamba","Centro Kanata",120,0,1,0,63,4,7,0,1,196,2,9,207,232,0.321,0.892
"9751","Cochabamba","Cochabamba","Centro Kanata",105,0,0,0,68,9,11,0,2,195,0,2,197,228,0.349,0.864
"9752","Cochabamba","Cochabamba","Centro Kanata",103,1,0,1,71,5,9,1,1,192,1,4,197,221,0.37,0.891
"9753","Cochabamba","Cochabamba","Colegio Yugoslavia ( Ex Mariscal Santa Cruz)",120,1,0,1,59,1,8,0,1,191,1,7,199,223,0.309,0.892
"9754","Cochabamba","Cochabamba","Colegio Yugoslavia ( Ex Mariscal Santa Cruz)",134,0,0,1,54,6,6,0,0,201,1,7,209,229,0.269,0.913
"9755","Cochabamba","Cochabamba","Colegio Yugoslavia ( Ex Mariscal Santa Cruz)",104,1,0,0,67,1,15,0,1,189,0,6,195,219,0.354,0.89
"9756","Cochabamba","Cochabamba","Colegio Yugoslavia ( Ex Mariscal Santa Cruz)",111,0,3,1,54,3,12,0,1,185,1,4,190,224,0.292,0.848
"9757","Cochabamba","Cochabamba","Colegio Yugoslavia ( Ex Mariscal Santa Cruz)",117,0,1,1,49,7,11,0,0,186,0,3,189,217,0.263,0.871
"9758","Cochabamba","Cochabamba","Colegio Yugoslavia ( Ex Mariscal Santa Cruz)",123,0,2,0,51,0,11,0,0,187,1,1,189,222,0.273,0.851
"9759","Cochabamba","Cochabamba","Colegio Yugoslavia ( Ex Mariscal Santa Cruz)",117,0,0,0,61,3,6,1,2,190,1,4,195,221,0.321,0.882
"9760","Cochabamba","Cochabamba","Colegio Yugoslavia ( Ex Mariscal Santa Cruz)",139,0,0,2,43,7,3,0,1,195,3,4,202,227,0.221,0.89
"9761","Cochabamba","Cochabamba","Colegio Yugoslavia ( Ex Mariscal Santa Cruz)",110,0,0,1,57,3,10,2,0,183,1,7,191,219,0.311,0.872
"9762","Cochabamba","Cochabamba","Colegio Yugoslavia ( Ex Mariscal Santa Cruz)",132,0,0,1,50,1,7,1,2,194,2,3,199,221,0.258,0.9
"9763","Cochabamba","Cochabamba","Colegio Yugoslavia ( Ex Mariscal Santa Cruz)",112,0,0,1,61,4,6,0,1,185,1,8,194,219,0.33,0.886
"9764","Cochabamba","Cochabamba","Colegio Yugoslavia ( Ex Mariscal Santa Cruz)",131,0,0,0,57,1,4,0,0,193,1,5,199,225,0.295,0.884
"9765","Cochabamba","Cochabamba","Unidad Educativa Estados Unidos",106,0,2,2,65,8,14,0,1,198,0,4,202,224,0.328,0.902
"9766","Cochabamba","Cochabamba","Unidad Educativa Estados Unidos",93,1,0,2,85,4,7,0,1,193,0,5,198,225,0.44,0.88
"9767","Cochabamba","Cochabamba","Unidad Educativa Estados Unidos",119,0,0,0,62,2,7,0,0,190,3,6,199,222,0.326,0.896
"9768","Cochabamba","Cochabamba","Unidad Educativa Estados Unidos",106,1,1,0,67,2,7,1,3,188,1,6,195,226,0.356,0.863
"9769","Cochabamba","Cochabamba","Unidad Educativa Estados Unidos",113,0,1,0,61,3,13,0,0,191,2,9,202,220,0.319,0.918
"9770","Cochabamba","Cochabamba","Unidad Educativa Estados Unidos",98,0,1,1,71,3,11,0,3,188,1,6,195,224,0.378,0.871
"9771","Cochabamba","Cochabamba","Unidad Educativa Estados Unidos",133,0,0,0,48,5,6,0,1,193,0,9,202,222,0.249,0.91
"9772","Cochabamba","Cochabamba","Unidad Educativa Estados Unidos",113,0,2,1,60,4,12,0,2,194,2,4,200,219,0.309,0.913
"9773","Cochabamba","Cochabamba","Colegio Sergio Almaraz Paz",99,1,2,2,72,5,2,0,0,183,2,5,190,221,0.393,0.86
"9774","Cochabamba","Cochabamba","Colegio Sergio Almaraz Paz",122,0,0,2,51,5,11,1,2,194,0,1,195,221,0.263,0.882
"9775","Cochabamba","Cochabamba","Colegio Sergio Almaraz Paz",109,0,1,2,72,6,7,1,0,198,0,4,202,219,0.364,0.922
"9776","Cochabamba","Cochabamba","Colegio Sergio Almaraz Paz",117,0,0,0,60,3,7,1,1,189,1,8,198,224,0.317,0.884
"9777","Cochabamba","Cochabamba","Colegio Sergio Almaraz Paz",104,1,1,1,62,0,17,0,1,187,1,15,203,225,0.332,0.902
"9778","Cochabamba","Cochabamba","Colegio Sergio Almaraz Paz",104,0,1,0,64,3,13,0,3,188,0,9,197,222,0.34,0.887
"9779","Cochabamba","Cochabamba","Colegio Sergio Almaraz Paz",108,0,1,0,64,3,13,0,1,190,0,5,195,223,0.337,0.874
"9780","Cochabamba","Cochabamba","Colegio Sergio Almaraz Paz",114,1,0,0,60,8,13,0,0,196,0,4,200,219,0.306,0.913
"9781","Cochabamba","Cochabamba","Colegio Sergio Almaraz Paz",117,0,0,0,55,6,14,1,1,194,1,2,197,224,0.284,0.879
"9782","Cochabamba","Cochabamba","Colegio Sergio Almaraz Paz",108,0,0,1,67,4,8,1,1,190,2,4,196,220,0.353,0.891
"9783","Cochabamba","Cochabamba","Colegio Sergio Almaraz Paz",91,0,0,2,74,1,14,0,0,182,0,8,190,223,0.407,0.852
"9784","Cochabamba","Cochabamba","Colegio Sergio Almaraz Paz",107,0,1,1,70,4,9,0,0,192,0,8,200,226,0.365,0.885
"9785","Cochabamba","Cochabamba","Colegio Sergio Almaraz Paz",99,1,2,0,81,3,11,1,2,200,0,4,204,224,0.405,0.911
"9786","Cochabamba","Cochabamba","Colegio Sergio Almaraz Paz",114,0,0,0,59,4,14,0,2,193,1,3,197,227,0.306,0.868
"9787","Cochabamba","Cochabamba","Colegio Sergio Almaraz Paz",118,0,0,1,47,2,8,2,3,181,0,8,189,216,0.26,0.875
"9788","Cochabamba","Cochabamba","Colegio Sergio Almaraz Paz",106,1,1,1,59,2,6,0,2,178,2,7,187,215,0.331,0.87
"9789","Cochabamba","Cochabamba","Colegio Sergio Almaraz Paz",118,0,1,0,57,1,10,1,1,189,1,3,193,223,0.302,0.865
"9790","Cochabamba","Cochabamba","Colegio Sergio Almaraz Paz",102,0,0,1,77,5,13,0,0,198,5,7,210,225,0.389,0.933
"9791","Cochabamba","Cochabamba","Colegio Sergio Almaraz Paz",101,0,1,0,83,4,9,0,2,200,0,8,208,228,0.415,0.912
"9792","Cochabamba","Cochabamba","Colegio Sergio Almaraz Paz",116,0,0,0,65,4,5,1,0,191,0,3,194,221,0.34,0.878
"9793","Cochabamba","Cochabamba","Colegio Sergio Almaraz Paz",121,0,1,0,68,6,8,0,0,204,0,9,213,230,0.333,0.926
"9794","Cochabamba","Cochabamba","Colegio Sergio Almaraz Paz",118,0,0,0,61,4,7,1,1,192,1,6,199,221,0.318,0.9
"9795","Cochabamba","Cochabamba","Colegio Sergio Almaraz Paz",108,0,2,0,61,2,15,0,0,188,3,6,197,224,0.324,0.879
"9796","Cochabamba","Cochabamba","Colegio Sergio Almaraz Paz",101,0,1,0,72,4,11,0,2,191,1,8,200,224,0.377,0.893
"9797","Cochabamba","Cochabamba","Colegio Sergio Almaraz Paz",112,0,2,0,64,1,10,0,2,191,0,6,197,226,0.335,0.872
"9798","Cochabamba","Cochabamba","Colegio Santo Domingo Savio",132,0,0,0,61,4,21,0,0,218,0,5,223,238,0.28,0.937
"9799","Cochabamba","Cochabamba","Colegio Santo Domingo Savio",120,0,1,1,59,6,16,1,1,205,1,4,210,235,0.288,0.894
"9800","Cochabamba","Cochabamba","Colegio Santo Domingo Savio",116,0,1,1,67,5,14,0,1,205,2,4,211,237,0.327,0.89
"9801","Cochabamba","Cochabamba","Colegio Santo Domingo Savio",100,0,0,0,78,5,17,1,3,204,0,4,208,236,0.382,0.881
"9802","Cochabamba","Cochabamba","Colegio Santo Domingo Savio",132,1,1,0,58,0,15,0,1,208,0,6,214,237,0.279,0.903
"9803","Cochabamba","Cochabamba","Colegio Santo Domingo Savio",123,0,1,0,58,4,21,0,1,208,0,5,213,237,0.279,0.899
"9804","Cochabamba","Cochabamba","Colegio Santo Domingo Savio",107,0,0,0,81,7,10,0,1,206,1,6,213,238,0.393,0.895
"9805","Cochabamba","Cochabamba","Colegio Santo Domingo Savio",102,1,2,1,77,8,12,1,1,205,0,4,209,235,0.376,0.889
"9806","Cochabamba","Cochabamba","Colegio Santo Domingo Savio",117,1,0,0,56,6,11,0,3,194,1,7,202,233,0.289,0.867
"9807","Cochabamba","Cochabamba","Colegio Santo Domingo Savio",125,0,0,0,64,3,8,0,1,201,2,5,208,239,0.318,0.87
"9808","Cochabamba","Cochabamba","Colegio Santo Domingo Savio",135,0,2,1,47,3,12,0,2,202,0,3,205,238,0.233,0.861
"9809","Cochabamba","Cochabamba","Colegio Santo Domingo Savio",124,0,1,0,72,4,10,0,1,212,2,2,216,234,0.34,0.923
"9810","Cochabamba","Cochabamba","Colegio Santo Domingo Savio",122,0,1,0,56,6,22,1,3,211,0,9,220,235,0.265,0.936
"9811","Cochabamba","Cochabamba","Colegio Santo Domingo Savio",120,1,0,0,66,4,16,0,3,210,2,5,217,238,0.314,0.912
"9812","Cochabamba","Cochabamba","Colegio Santo Domingo Savio",109,1,0,0,49,0,17,1,1,178,1,4,183,211,0.275,0.867
"9813","Cochabamba","Cochabamba","Colegio Don Bosco",141,0,0,0,20,7,11,1,1,181,1,2,184,219,0.11,0.84
"9814","Cochabamba","Cochabamba","Colegio Don Bosco",161,0,0,0,27,3,3,0,0,194,0,7,201,229,0.139,0.878
"9815","Cochabamba","Cochabamba","Colegio Don Bosco",153,1,0,0,22,2,2,0,1,181,0,1,182,224,0.122,0.812
"9816","Cochabamba","Cochabamba","Colegio Don Bosco",148,0,0,0,32,6,8,1,0,195,1,1,197,226,0.164,0.872
"9817","Cochabamba","Cochabamba","Colegio Don Bosco",140,0,0,1,27,9,3,1,3,184,1,9,194,227,0.147,0.855
"9818","Cochabamba","Cochabamba","Colegio Don Bosco",151,0,0,1,34,3,5,1,1,196,0,5,201,225,0.173,0.893
"9819","Cochabamba","Cochabamba","Colegio Don Bosco",141,0,1,0,34,7,4,0,2,189,1,3,193,225,0.18,0.858
"9820","Cochabamba","Cochabamba","Colegio Don Bosco",148,0,1,1,27,2,5,1,0,185,0,1,186,221,0.146,0.842
"9821","Cochabamba","Cochabamba","Colegio Don Bosco",137,0,0,1,35,5,3,0,0,181,0,3,184,221,0.193,0.833
"9822","Cochabamba","Cochabamba","Colegio Don Bosco",148,0,0,0,30,5,6,0,0,189,0,3,192,225,0.159,0.853
"9823","Cochabamba","Cochabamba","Colegio Don Bosco",132,0,0,1,35,3,13,0,0,184,2,6,192,218,0.19,0.881
"9824","Cochabamba","Cochabamba","Colegio Don Bosco",139,0,0,0,36,1,5,0,0,181,2,5,188,222,0.199,0.847
"9825","Cochabamba","Cochabamba","Colegio Don Bosco",151,0,0,0,27,3,5,0,0,186,1,5,192,218,0.145,0.881
"9826","Cochabamba","Cochabamba","Colegio Don Bosco",164,0,0,3,22,3,5,0,0,197,0,2,199,225,0.112,0.884
"9827","Cochabamba","Cochabamba","Colegio Don Bosco",150,0,0,0,27,1,2,1,0,181,1,4,186,220,0.149,0.845
"9828","Cochabamba","Cochabamba","Colegio Don Bosco",152,0,0,0,27,3,5,1,0,188,0,5,193,225,0.144,0.858
"9829","Cochabamba","Cochabamba","Colegio Don Bosco",146,0,0,0,34,3,2,1,0,186,3,4,193,224,0.183,0.862
"9830","Cochabamba","Cochabamba","Colegio Don Bosco",146,0,0,0,33,3,2,0,1,185,1,1,187,223,0.178,0.839
"9831","Cochabamba","Cochabamba","Colegio Don Bosco",149,0,0,0,27,2,2,2,0,182,2,3,187,222,0.148,0.842
"9832","Cochabamba","Cochabamba","Colegio Don Bosco",154,0,0,0,25,3,3,0,0,185,3,4,192,226,0.135,0.85
"9833","Cochabamba","Cochabamba","Colegio Don Bosco",152,0,0,0,26,4,5,1,0,188,0,2,190,228,0.138,0.833
"9834","Cochabamba","Cochabamba","Colegio Don Bosco",159,0,1,0,22,3,4,0,1,190,1,2,193,217,0.116,0.889
"9835","Cochabamba","Cochabamba","Unidad Educativa Domingo Savio (Ex Lorenzo Filho)",151,0,1,0,29,1,2,0,1,185,1,5,191,224,0.157,0.853
"9836","Cochabamba","Cochabamba","Unidad Educativa Domingo Savio (Ex Lorenzo Filho)",133,1,0,0,42,4,7,0,1,188,1,2,191,227,0.223,0.841
"9837","Cochabamba","Cochabamba","Unidad Educativa Domingo Savio (Ex Lorenzo Filho)",139,0,0,0,40,5,6,0,1,191,0,7,198,218,0.209,0.908
"9838","Cochabamba","Cochabamba","Unidad Educativa Domingo Savio (Ex Lorenzo Filho)",143,0,1,0,44,2,6,0,0,196,0,3,199,220,0.224,0.905
"9839","Cochabamba","Cochabamba","Unidad Educativa Domingo Savio (Ex Lorenzo Filho)",141,1,0,0,37,3,5,1,0,188,2,2,192,223,0.197,0.861
"9840","Cochabamba","Cochabamba","Unidad Educativa Domingo Savio (Ex Lorenzo Filho)",136,2,0,1,37,2,7,2,0,187,1,2,190,221,0.198,0.86
"9841","Cochabamba","Cochabamba","Unidad Educativa Domingo Savio (Ex Lorenzo Filho)",156,0,0,0,33,0,9,0,1,199,2,3,204,228,0.166,0.895
"9842","Cochabamba","Cochabamba","Colegio Loyola",150,0,1,2,24,4,1,0,1,183,0,5,188,222,0.131,0.847
"9843","Cochabamba","Cochabamba","Colegio Loyola",158,0,0,0,32,1,2,0,0,193,0,2,195,222,0.166,0.878
"9844","Cochabamba","Cochabamba","Colegio Loyola",149,1,1,0,25,1,8,2,0,187,0,3,190,224,0.134,0.848
"9845","Cochabamba","Cochabamba","Colegio Loyola",147,0,1,0,32,4,6,1,0,191,1,2,194,218,0.168,0.89
"9846","Cochabamba","Cochabamba","Colegio Loyola",140,1,0,0,38,2,8,1,1,191,0,5,196,229,0.199,0.856
"9847","Cochabamba","Cochabamba","Colegio Loyola",145,0,0,1,29,2,2,0,1,180,1,7,188,214,0.161,0.879
"9848","Cochabamba","Cochabamba","Colegio Loyola",158,1,2,0,24,1,8,1,1,196,0,4,200,228,0.122,0.877
"9849","Cochabamba","Cochabamba","Colegio Loyola",141,0,0,1,26,6,7,0,0,181,1,7,189,216,0.144,0.875
"9850","Cochabamba","Cochabamba","Colegio Loyola",137,0,0,0,32,3,4,0,0,176,1,7,184,218,0.182,0.844
"9851","Cochabamba","Cochabamba","Colegio Loyola",126,1,0,0,31,0,7,0,0,165,1,7,173,207,0.188,0.836
"9852","Cochabamba","Cochabamba","Escuela Gualberto Villarroel",146,0,0,0,39,2,6,1,0,194,0,6,200,228,0.201,0.877
"9853","Cochabamba","Cochabamba","Escuela Gualberto Villarroel",153,0,0,0,30,1,10,3,0,197,1,3,201,226,0.152,0.889
"9854","Cochabamba","Cochabamba","Escuela Gualberto Villarroel",127,0,1,0,33,0,11,1,2,175,0,8,183,215,0.189,0.851
"9855","Cochabamba","Cochabamba","Escuela Gualberto Villarroel",146,0,0,0,43,5,6,1,0,201,0,2,203,218,0.214,0.931
"9856","Cochabamba","Cochabamba","Escuela Gualberto Villarroel",155,0,2,0,28,3,8,0,1,197,1,2,200,220,0.142,0.909
"9857","Cochabamba","Cochabamba","Escuela Gualberto Villarroel",136,0,0,0,37,5,10,0,0,188,0,7,195,217,0.197,0.899
"9858","Cochabamba","Cochabamba","Escuela Gualberto Villarroel",132,0,2,1,46,2,7,0,0,190,0,2,192,218,0.242,0.881
"9859","Cochabamba","Cochabamba","Escuela Gualberto Villarroel",143,0,0,0,39,3,6,0,2,193,1,3,197,224,0.202,0.879
"9860","Cochabamba","Cochabamba","Escuela Gualberto Villarroel",159,0,1,0,38,2,6,1,0,207,0,2,209,226,0.184,0.925
"9861","Cochabamba","Cochabamba","Escuela Gualberto Villarroel",146,0,3,0,31,1,9,0,0,190,2,4,196,219,0.163,0.895
"9862","Cochabamba","Cochabamba","Colegio Albert Einstein",149,0,0,1,41,5,5,2,1,204,2,2,208,227,0.201,0.916
"9863","Cochabamba","Cochabamba","Colegio Albert Einstein",157,0,0,1,36,3,5,1,0,203,0,6,209,228,0.177,0.917
"9864","Cochabamba","Cochabamba","Colegio Albert Einstein",150,0,1,1,30,2,6,1,0,191,0,7,198,219,0.157,0.904
"9865","Cochabamba","Cochabamba","Colegio Albert Einstein",134,1,0,1,54,2,4,0,1,197,0,9,206,223,0.274,0.924
"9866","Cochabamba","Cochabamba","Colegio Albert Einstein",137,0,1,2,43,2,3,2,1,191,2,10,203,219,0.225,0.927
"9867","Cochabamba","Cochabamba","Colegio Albert Einstein",134,0,1,0,48,4,5,1,0,193,0,3,196,226,0.249,0.867
"9868","Cochabamba","Cochabamba","Colegio Albert Einstein",141,0,0,1,32,4,4,3,0,185,0,8,193,224,0.173,0.862
"9869","Cochabamba","Cochabamba","Colegio Albert Einstein",156,0,0,0,20,5,6,0,1,188,0,1,189,219,0.106,0.863
"9870","Cochabamba","Cochabamba","Colegio Albert Einstein",142,1,0,0,29,1,5,0,0,178,0,7,185,216,0.163,0.856
"9871","Cochabamba","Cochabamba","Colegio Albert Einstein",145,0,0,0,38,4,3,0,1,191,0,7,198,219,0.199,0.904
"9872","Cochabamba","Cochabamba","Colegio Albert Einstein",163,0,0,1,28,1,2,0,3,198,0,4,202,230,0.141,0.878
"9873","Cochabamba","Cochabamba","Colegio Albert Einstein",148,1,0,0,35,2,2,0,2,190,0,6,196,214,0.184,0.916
"9874","Cochabamba","Cochabamba","Colegio Albert Einstein",142,0,0,0,35,2,6,1,1,187,0,11,198,222,0.187,0.892
"9875","Cochabamba","Cochabamba","Colegio Albert Einstein",144,1,0,0,37,3,5,1,0,191,1,7,199,228,0.194,0.873
"9876","Cochabamba","Cochabamba","Escuela Jose Gabriel De Gumucio",146,0,0,0,39,3,6,1,0,195,0,6,201,219,0.2,0.918
"9877","Cochabamba","Cochabamba","Escuela Jose Gabriel De Gumucio",143,0,1,1,45,1,2,1,0,194,1,5,200,219,0.232,0.913
"9878","Cochabamba","Cochabamba","Escuela Jose Gabriel De Gumucio",145,0,0,1,26,3,6,0,0,181,2,2,185,213,0.144,0.869
"9879","Cochabamba","Cochabamba","Escuela Jose Gabriel De Gumucio",151,0,0,0,23,3,2,1,0,180,0,2,182,213,0.128,0.854
"9880","Cochabamba","Cochabamba","Escuela Jose Gabriel De Gumucio",156,0,1,1,24,2,5,0,0,189,0,2,191,218,0.127,0.876
"9881","Cochabamba","Cochabamba","Escuela Jose Gabriel De Gumucio",142,0,0,1,36,4,7,2,0,192,0,6,198,221,0.188,0.896
"9882","Cochabamba","Cochabamba","Escuela Jose Gabriel De Gumucio",151,0,1,0,33,3,2,1,0,191,0,5,196,227,0.173,0.863
"9883","Cochabamba","Cochabamba","Escuela Jose Gabriel De Gumucio",156,1,0,0,12,4,5,0,0,178,0,4,182,212,0.067,0.858
"9884","Cochabamba","Cochabamba","Escuela Jose Gabriel De Gumucio",143,1,1,0,38,2,2,2,1,190,0,6,196,219,0.2,0.895
"9885","Cochabamba","Cochabamba","Colegio Cristo Rey",134,0,1,1,38,2,0,1,0,177,0,5,182,215,0.215,0.847
"9886","Cochabamba","Cochabamba","Colegio Cristo Rey",133,0,1,3,42,6,6,0,2,193,1,2,196,228,0.218,0.86
"9887","Cochabamba","Cochabamba","Colegio Cristo Rey",154,1,0,0,27,4,5,0,1,192,0,3,195,218,0.141,0.894
"9888","Cochabamba","Cochabamba","Colegio Cristo Rey",156,0,1,0,30,7,0,0,1,195,0,3,198,225,0.154,0.88
"9889","Cochabamba","Cochabamba","Colegio Cristo Rey",144,1,1,1,44,1,2,3,0,197,0,5,202,219,0.223,0.922
"9890","Cochabamba","Cochabamba","Colegio Cristo Rey",130,3,0,0,40,5,11,1,2,192,0,5,197,228,0.208,0.864
"9891","Cochabamba","Cochabamba","Colegio Cristo Rey",148,0,0,1,40,5,2,0,0,196,1,2,199,219,0.204,0.909
"9892","Cochabamba","Cochabamba","Colegio Cristo Rey",144,1,2,2,42,3,3,1,0,198,0,8,206,232,0.212,0.888
"9893","Cochabamba","Cochabamba","Colegio Cristo Rey",131,0,0,1,38,2,7,0,1,180,1,6,187,215,0.211,0.87
"9894","Cochabamba","Cochabamba","Colegio Cristo Rey",140,1,1,1,36,2,9,1,0,191,0,4,195,223,0.188,0.874
"9895","Cochabamba","Cochabamba","Colegio Cristo Rey",149,0,0,0,30,3,6,1,0,189,1,5,195,218,0.159,0.894
"9896","Cochabamba","Cochabamba","Colegio Cristo Rey",149,2,0,1,39,2,3,0,1,197,1,3,201,227,0.198,0.885
"9897","Cochabamba","Cochabamba","Colegio Cristo Rey",144,0,0,0,39,1,4,1,0,189,1,3,193,221,0.206,0.873
"9898","Cochabamba","Cochabamba","Colegio Cristo Rey",147,0,0,0,31,7,7,2,1,195,2,3,200,221,0.159,0.905
"9899","Cochabamba","Cochabamba","Colegio Cristo Rey",138,0,0,1,28,2,8,2,1,180,0,9,189,218,0.156,0.867
"9900","Cochabamba","Cochabamba","Colegio Cristo Rey",136,0,0,2,31,4,9,1,0,183,1,10,194,217,0.169,0.894
"9901","Cochabamba","Cochabamba","Colegio Cristo Rey",161,0,0,0,27,2,1,1,0,192,0,5,197,226,0.141,0.872
"9902","Cochabamba","Cochabamba","Colegio Cristo Rey",161,1,2,0,32,2,3,0,1,202,1,8,211,227,0.158,0.93
"9903","Cochabamba","Cochabamba","Colegio Cristo Rey",138,1,0,1,45,3,2,0,0,190,0,5,195,216,0.237,0.903
"9904","Cochabamba","Cochabamba","Colegio Cristo Rey",131,1,0,1,56,2,4,0,1,196,2,3,201,225,0.286,0.893
"9905","Cochabamba","Cochabamba","Colegio Cristo Rey",145,0,1,1,48,4,4,0,1,204,0,3,207,228,0.235,0.908
"9906","Cochabamba","Cochabamba","Colegio Cristo Rey",158,0,1,0,32,2,4,0,2,199,2,5,206,223,0.161,0.924
"9907","Cochabamba","Cochabamba","Colegio Paulo VI",151,0,0,0,29,1,5,0,0,186,1,13,200,223,0.156,0.897
"9908","Cochabamba","Cochabamba","Colegio Paulo VI",146,0,0,0,33,3,3,0,1,186,0,2,188,215,0.177,0.874
"9909","Cochabamba","Cochabamba","Colegio Paulo VI",146,0,0,0,30,2,0,1,0,179,2,4,185,217,0.168,0.853
"9910","Cochabamba","Cochabamba","Colegio Paulo VI",148,0,1,1,30,2,4,0,1,187,4,1,192,223,0.16,0.861
"9911","Cochabamba","Cochabamba","Colegio Paulo VI",136,0,1,0,35,3,2,1,1,179,1,8,188,216,0.196,0.87
"9912","Cochabamba","Cochabamba","Colegio Paulo VI",143,0,0,2,26,2,3,0,1,177,0,9,186,210,0.147,0.886
"9913","Cochabamba","Cochabamba","Colegio Paulo VI",149,0,0,2,31,1,2,0,1,186,0,5,191,222,0.167,0.86
"9914","Cochabamba","Cochabamba","Colegio Paulo VI",137,0,0,3,30,6,6,0,0,182,3,5,190,214,0.165,0.888
"9915","Cochabamba","Cochabamba","Colegio Paulo VI",138,0,0,3,34,4,6,1,1,187,1,2,190,221,0.182,0.86
"9916","Cochabamba","Cochabamba","Colegio Paulo VI",150,0,0,0,33,5,4,1,1,194,1,0,195,219,0.17,0.89
"9917","Cochabamba","Cochabamba","Colegio Paulo VI",152,0,0,0,38,1,2,2,0,195,0,4,199,222,0.195,0.896
"9918","Cochabamba","Cochabamba","Colegio Paulo VI",153,0,0,0,38,3,4,0,1,199,0,4,203,223,0.191,0.91
"9919","Cochabamba","Cochabamba","U. E. España",170,0,1,1,37,2,10,1,3,225,0,4,229,239,0.164,0.958
"9920","Cochabamba","Cochabamba","U. E. España",162,0,0,1,46,4,11,2,1,227,1,4,232,239,0.203,0.971
"9921","Cochabamba","Cochabamba","U. E. España",159,0,0,0,50,3,8,1,0,221,1,8,230,233,0.226,0.987
"9922","Cochabamba","Cochabamba","U. E. El Principito",177,1,0,0,32,5,3,0,2,220,1,8,229,239,0.145,0.958
"9923","Cochabamba","Cochabamba","U. E. El Principito",136,0,0,0,27,2,3,0,0,168,1,12,181,187,0.161,0.968
"9924","Cochabamba","Cochabamba","Instituto Americano",146,0,1,1,33,2,4,1,1,189,1,6,196,233,0.175,0.841
"9925","Cochabamba","Cochabamba","Instituto Americano",139,0,0,1,40,3,5,0,0,188,0,9,197,221,0.213,0.891
"9926","Cochabamba","Cochabamba","Instituto Americano",162,0,0,0,39,2,3,0,0,206,1,4,211,233,0.189,0.906
"9927","Cochabamba","Cochabamba","Instituto Americano",141,0,3,0,31,4,8,1,0,188,1,4,193,220,0.165,0.877
"9928","Cochabamba","Cochabamba","Instituto Americano",131,0,1,1,40,5,8,1,0,187,4,4,195,228,0.214,0.855
"9929","Cochabamba","Cochabamba","Instituto Americano",143,1,0,1,40,1,8,3,1,198,1,7,206,229,0.202,0.9
"9930","Cochabamba","Cochabamba","Instituto Americano",132,0,1,0,44,4,5,1,1,188,1,6,195,225,0.234,0.867
"9931","Cochabamba","Cochabamba","Instituto Americano",142,0,1,0,54,4,3,1,2,207,1,6,214,233,0.261,0.918
"9932","Cochabamba","Cochabamba","Instituto Americano",124,0,0,0,48,5,11,1,1,190,2,5,197,228,0.253,0.864
"9933","Cochabamba","Cochabamba","Instituto Americano",144,0,1,1,38,2,2,0,3,191,1,8,200,229,0.199,0.873
"9934","Cochabamba","Cochabamba","Instituto Americano",138,0,0,0,37,1,4,2,1,183,0,7,190,221,0.202,0.86
"9935","Cochabamba","Cochabamba","Instituto Americano",144,0,0,0,37,2,9,0,1,193,1,5,199,232,0.192,0.858
"9936","Cochabamba","Cochabamba","Instituto Americano",154,1,0,2,34,3,5,0,1,200,0,3,203,227,0.17,0.894
"9937","Cochabamba","Cochabamba","Instituto Americano",141,0,0,0,36,4,1,0,0,182,1,6,189,227,0.198,0.833
"9938","Cochabamba","Cochabamba","Instituto Americano",132,0,0,0,46,3,7,0,0,188,2,2,192,225,0.245,0.853
"9939","Cochabamba","Cochabamba","Instituto Americano",151,0,0,0,30,1,6,1,0,189,0,4,193,222,0.159,0.869
"9940","Cochabamba","Cochabamba","Instituto Americano",151,0,1,0,35,4,7,0,1,199,1,3,203,231,0.176,0.879
"9941","Cochabamba","Cochabamba","Instituto Americano",130,0,0,1,58,2,10,0,0,201,0,5,206,233,0.289,0.884
"9942","Cochabamba","Cochabamba","Instituto Americano",164,0,0,1,26,3,3,0,0,197,0,2,199,230,0.132,0.865
"9943","Cochabamba","Cochabamba","Instituto Americano",144,0,1,0,46,4,8,0,0,203,1,6,210,230,0.227,0.913
"9944","Cochabamba","Cochabamba","Instituto Americano",155,0,0,0,27,1,4,1,0,188,0,4,192,226,0.144,0.85
"9945","Cochabamba","Cochabamba","Instituto Americano",156,0,0,0,31,2,3,0,0,192,0,7,199,229,0.161,0.869
"9946","Cochabamba","Cochabamba","Instituto Americano",148,0,1,0,24,3,1,1,4,182,1,3,186,223,0.132,0.834
"9947","Cochabamba","Cochabamba","Instituto Americano",138,0,1,1,41,6,10,1,1,199,2,1,202,229,0.206,0.882
"9948","Cochabamba","Cochabamba","Instituto Americano",153,0,1,0,37,1,3,0,1,196,0,2,198,224,0.189,0.884
"9949","Cochabamba","Cochabamba","Instituto Americano",147,0,0,0,44,1,4,1,0,197,1,4,202,231,0.223,0.874
"9950","Cochabamba","Cochabamba","Instituto Americano",152,0,0,1,32,3,9,0,0,197,0,5,202,230,0.162,0.878
"9951","Cochabamba","Cochabamba","Instituto Americano",152,0,0,1,29,3,6,0,1,192,2,8,202,229,0.151,0.882
"9952","Cochabamba","Cochabamba","Instituto Americano",167,0,0,0,18,4,6,0,1,196,0,5,201,231,0.092,0.87
"9953","Cochabamba","Cochabamba","Instituto Americano",144,1,1,0,38,4,7,0,0,195,2,6,203,228,0.195,0.89
"9954","Cochabamba","Cochabamba","Instituto Americano",151,0,0,0,35,4,3,3,0,196,1,1,198,225,0.179,0.88
"9955","Cochabamba","Cochabamba","Instituto Americano",142,0,0,0,50,6,3,0,1,202,1,8,211,228,0.248,0.925
"9956","Cochabamba","Cochabamba","Instituto Americano",164,0,0,0,21,1,5,0,0,191,0,4,195,225,0.11,0.867
"9957","Cochabamba","Cochabamba","Colegio Jaime Escalante",148,0,1,0,42,1,1,0,0,193,1,3,197,219,0.218,0.9
"9958","Cochabamba","Cochabamba","Colegio Jaime Escalante",137,0,1,0,37,5,7,1,2,190,2,6,198,223,0.195,0.888
"9959","Cochabamba","Cochabamba","Colegio Jaime Escalante",151,0,2,0,27,4,3,0,0,187,1,5,193,228,0.144,0.846
"9960","Cochabamba","Cochabamba","Colegio Jaime Escalante",147,0,0,1,37,1,6,1,0,193,0,4,197,217,0.192,0.908
"9961","Cochabamba","Cochabamba","Colegio Jaime Escalante",146,0,1,0,37,0,5,1,0,190,1,2,193,221,0.195,0.873
"9962","Cochabamba","Cochabamba","Colegio Jaime Escalante",150,0,0,1,27,4,2,1,0,185,1,4,190,221,0.146,0.86
"9963","Cochabamba","Cochabamba","Colegio Jaime Escalante",165,0,0,1,19,0,1,1,0,187,3,3,193,229,0.102,0.843
"9964","Cochabamba","Cochabamba","Escuela Maryknoll",165,0,0,1,24,3,5,0,0,198,0,1,199,226,0.121,0.881
"9965","Cochabamba","Cochabamba","Escuela Maryknoll",165,0,0,1,19,1,1,1,0,188,2,2,192,227,0.101,0.846
"9966","Cochabamba","Cochabamba","Escuela Maryknoll",171,0,0,1,13,1,5,0,0,191,0,5,196,221,0.068,0.887
"9967","Cochabamba","Cochabamba","Escuela Maryknoll",151,0,0,1,26,2,4,1,1,186,1,1,188,216,0.14,0.87
"9968","Cochabamba","Cochabamba","Escuela Maryknoll",156,0,0,0,27,2,7,0,0,192,0,5,197,226,0.141,0.872
"9969","Cochabamba","Cochabamba","Escuela Maryknoll",164,0,0,0,20,2,3,2,0,191,1,2,194,221,0.105,0.878
"9970","Cochabamba","Cochabamba","Escuela Maryknoll",168,0,0,0,20,4,6,0,1,199,4,4,207,225,0.101,0.92
"9971","Cochabamba","Cochabamba","Centro Inmaculada Concepcion",153,2,1,2,17,1,4,0,0,180,2,5,187,221,0.094,0.846
"9972","Cochabamba","Cochabamba","Centro Inmaculada Concepcion",141,0,0,1,24,2,2,0,1,171,1,7,179,212,0.14,0.844
"9973","Cochabamba","Cochabamba","Centro Inmaculada Concepcion",150,0,0,1,12,2,1,0,0,166,0,6,172,220,0.072,0.782
"9974","Cochabamba","Cochabamba","Centro Inmaculada Concepcion",152,0,0,0,16,7,1,1,0,177,0,1,178,215,0.09,0.828
"9975","Cochabamba","Cochabamba","Centro Inmaculada Concepcion",139,0,0,0,23,0,1,0,0,163,0,3,166,214,0.141,0.776
"9976","Cochabamba","Cochabamba","Centro Inmaculada Concepcion",152,0,0,0,18,0,0,1,1,172,0,2,174,215,0.105,0.809
"9977","Cochabamba","Cochabamba","Centro Inmaculada Concepcion",154,0,0,0,20,3,4,0,0,181,1,2,184,213,0.11,0.864
"9978","Cochabamba","Cochabamba","Centro Inmaculada Concepcion",154,0,2,1,20,2,2,1,1,183,1,3,187,212,0.109,0.882
"9979","Cochabamba","Cochabamba","Centro Inmaculada Concepcion",144,0,0,0,25,0,2,1,0,172,0,3,175,211,0.145,0.829
"9980","Cochabamba","Cochabamba","Centro Inmaculada Concepcion",159,0,0,1,18,2,1,0,0,181,0,3,184,216,0.099,0.852
"9981","Cochabamba","Cochabamba","Centro Inmaculada Concepcion",143,0,0,0,18,5,3,1,1,171,2,7,180,214,0.105,0.841
"9982","Cochabamba","Cochabamba","Centro Inmaculada Concepcion",155,0,0,1,19,0,2,0,0,177,0,2,179,211,0.107,0.848
"9983","Cochabamba","Cochabamba","U. E. Isaac Attie",189,1,0,1,29,2,1,0,0,223,0,2,225,239,0.13,0.941
"9984","Cochabamba","Cochabamba","U. E. Oscar Alfaro",141,0,0,0,67,0,5,0,1,214,0,6,220,235,0.313,0.936
"9985","Cochabamba","Cochabamba","U. E. Oscar Alfaro",149,2,0,0,58,8,21,1,1,240,2,3,245,257,0.242,0.953
"9986","Cochabamba","Cochabamba","U.E. Genoveva Ríos",121,0,0,0,82,5,17,0,0,225,1,5,231,240,0.364,0.963
"9987","Cochabamba","Cochabamba","U.E. Genoveva Ríos",111,0,1,0,92,8,13,0,2,227,2,2,231,238,0.405,0.971
"9988","Cochabamba","Cochabamba","U.E. Genoveva Ríos",137,0,3,0,72,4,10,0,1,227,1,7,235,240,0.317,0.979
"9989","Cochabamba","Cochabamba","Unidad Educativa San Miguel",71,0,0,0,97,6,13,1,2,190,1,8,199,229,0.511,0.869
"9990","Cochabamba","Cochabamba","Unidad Educativa San Miguel",69,1,2,1,110,5,10,1,3,202,1,3,206,226,0.545,0.912
"9991","Cochabamba","Cochabamba","Unidad Educativa San Miguel",57,0,1,0,114,2,18,0,0,192,0,4,196,230,0.594,0.852
"9992","Cochabamba","Cochabamba","Unidad Educativa San Miguel",44,0,0,1,122,5,19,0,1,192,0,9,201,227,0.635,0.885
"9993","Cochabamba","Cochabamba","Unidad Educativa San Miguel",74,0,1,0,89,2,15,0,0,181,3,12,196,224,0.492,0.875
"9994","Cochabamba","Cochabamba","Unidad Educativa San Miguel",69,0,0,3,104,3,6,0,0,185,2,7,194,225,0.562,0.862
"9995","Cochabamba","Cochabamba","Unidad Educativa San Miguel",57,1,1,0,110,1,14,0,2,186,3,9,198,224,0.591,0.884
"9996","Cochabamba","Cochabamba","Unidad Educativa San Miguel",64,0,2,1,109,4,10,0,2,192,1,5,198,228,0.568,0.868
"9997","Cochabamba","Cochabamba","Unidad Educativa San Miguel",54,0,1,1,121,2,10,0,2,191,2,5,198,225,0.634,0.88
"9998","Cochabamba","Cochabamba","Unidad Educativa San Miguel",56,0,0,0,102,6,15,3,3,185,2,9,196,228,0.551,0.86
"9999","Cochabamba","Cochabamba","Unidad Educativa San Miguel",80,2,0,3,80,6,17,0,0,188,2,9,199,226,0.426,0.881
"10000","Cochabamba","Cochabamba","Unidad Educativa San Miguel",67,0,1,0,97,3,12,0,0,180,2,5,187,218,0.539,0.858
"10001","Cochabamba","Cochabamba","Unidad Educativa San Miguel",67,3,1,0,114,6,5,0,3,199,1,5,205,231,0.573,0.887
"10002","Cochabamba","Cochabamba","Escuela Walter Vallejo",130,0,0,1,52,3,9,0,0,195,1,5,201,231,0.267,0.87
"10003","Cochabamba","Cochabamba","Escuela Walter Vallejo",108,1,2,0,68,1,9,2,3,194,4,9,207,224,0.351,0.924
"10004","Cochabamba","Cochabamba","Escuela Walter Vallejo",94,0,0,0,75,5,11,2,2,189,1,3,193,229,0.397,0.843
"10005","Cochabamba","Cochabamba","Escuela Walter Vallejo",89,0,0,0,76,3,16,1,1,186,3,10,199,231,0.409,0.861
"10006","Cochabamba","Cochabamba","Escuela Walter Vallejo",111,2,0,3,61,2,8,2,2,191,2,5,198,228,0.319,0.868
"10007","Cochabamba","Cochabamba","Escuela Walter Vallejo",115,0,1,1,55,1,8,0,1,182,3,3,188,222,0.302,0.847
"10008","Cochabamba","Cochabamba","Escuela Walter Vallejo",118,1,0,0,62,1,5,2,1,190,5,7,202,225,0.326,0.898
"10009","Cochabamba","Cochabamba","Colegio Amor de Dios",97,0,6,0,84,4,3,0,1,195,2,6,203,228,0.431,0.89
"10010","Cochabamba","Cochabamba","Colegio Amor de Dios",105,1,0,0,67,4,6,0,4,187,0,4,191,221,0.358,0.864
"10011","Cochabamba","Cochabamba","Colegio Amor de Dios",111,1,1,0,68,2,12,0,1,196,3,6,205,229,0.347,0.895
"10012","Cochabamba","Cochabamba","Colegio Amor de Dios",88,0,2,1,70,3,13,2,1,180,2,4,186,221,0.389,0.842
"10013","Cochabamba","Cochabamba","Colegio Amor de Dios",91,2,0,0,74,7,10,1,3,188,0,4,192,219,0.394,0.877
"10014","Cochabamba","Cochabamba","Colegio Amor de Dios",85,0,1,0,82,4,13,1,3,189,1,2,192,226,0.434,0.85
"10015","Cochabamba","Cochabamba","Colegio Amor de Dios",71,0,3,1,88,7,17,1,2,190,0,1,191,219,0.463,0.872
"10016","Cochabamba","Cochabamba","Colegio Amor de Dios",89,1,0,0,85,3,14,0,1,193,1,5,199,223,0.44,0.892
"10017","Cochabamba","Cochabamba","Colegio Amor de Dios",90,0,0,1,79,5,5,1,0,181,3,6,190,219,0.436,0.868
"10018","Cochabamba","Cochabamba","Colegio Amor de Dios",96,2,1,0,74,1,9,0,1,184,1,5,190,224,0.402,0.848
"10019","Cochabamba","Cochabamba","Colegio Amor de Dios",114,2,1,2,60,3,6,0,1,189,2,6,197,224,0.317,0.879
"10020","Cochabamba","Cochabamba","Colegio Amor de Dios",129,0,1,0,49,4,9,0,1,193,0,9,202,228,0.254,0.886
"10021","Cochabamba","Cochabamba","Colegio Amor de Dios",98,1,0,0,66,1,8,2,1,177,0,4,181,213,0.373,0.85
"10022","Cochabamba","Cochabamba","Colegio Amor de Dios",93,2,1,0,87,1,14,1,0,199,0,4,203,229,0.437,0.886
"10023","Cochabamba","Cochabamba","Colegio Amor de Dios",91,1,2,0,80,0,7,1,2,184,0,10,194,226,0.435,0.858
"10024","Cochabamba","Cochabamba","Colegio Amor de Dios",103,0,1,0,67,4,9,2,0,186,4,1,191,224,0.36,0.853
"10025","Cochabamba","Cochabamba","Colegio Amor de Dios",71,2,0,0,96,4,10,1,2,186,1,5,192,224,0.516,0.857
"10026","Cochabamba","Cochabamba","Colegio Amor de Dios",105,0,1,0,68,2,9,1,1,187,0,7,194,226,0.364,0.858
"10027","Cochabamba","Cochabamba","Colegio Amor de Dios",103,2,1,2,68,5,9,0,0,190,2,5,197,223,0.358,0.883
"10028","Cochabamba","Cochabamba","Colegio Amor de Dios",103,0,0,1,78,2,4,0,3,191,0,2,193,229,0.408,0.843
"10029","Cochabamba","Cochabamba","Colegio Amor de Dios",109,1,0,1,64,4,9,1,0,189,0,6,195,226,0.339,0.863
"10030","Cochabamba","Cochabamba","Colegio Amor de Dios",81,0,1,0,85,2,13,1,2,185,2,4,191,219,0.459,0.872
"10031","Cochabamba","Cochabamba","Colegio Amor de Dios",105,1,0,0,62,6,11,0,3,188,1,4,193,222,0.33,0.869
"10032","Cochabamba","Cochabamba","Colegio Amor de Dios",110,1,1,0,54,10,11,0,0,187,3,6,196,224,0.289,0.875
"10033","Cochabamba","Cochabamba","Colegio Amor de Dios",113,1,2,0,53,3,10,0,0,182,0,8,190,222,0.291,0.856
"10034","Cochabamba","Cochabamba","Colegio Amor de Dios",107,1,4,1,62,2,7,1,0,185,3,4,192,213,0.335,0.901
"10035","Cochabamba","Cochabamba","Colegio Amor de Dios",101,0,1,0,72,4,6,2,1,187,0,4,191,222,0.385,0.86
"10036","Cochabamba","Cochabamba","Colegio Amor de Dios",106,0,0,0,66,1,11,0,1,185,1,5,191,221,0.357,0.864
"10037","Cochabamba","Cochabamba","Colegio Amor de Dios",101,0,2,0,59,4,13,0,0,179,1,6,186,217,0.33,0.857
"10038","Cochabamba","Cochabamba","Colegio Amor de Dios",120,0,1,0,56,5,7,1,1,191,0,4,195,215,0.293,0.907
"10039","Cochabamba","Cochabamba","Colegio Amor de Dios",92,0,2,0,75,5,13,1,3,191,4,8,203,233,0.393,0.871
"10040","Cochabamba","Cochabamba","Escuela Camara Junior",84,1,0,1,73,3,17,0,1,180,1,9,190,227,0.406,0.837
"10041","Cochabamba","Cochabamba","Escuela Camara Junior",100,1,0,3,76,5,12,0,1,198,1,6,205,228,0.384,0.899
"10042","Cochabamba","Cochabamba","Escuela Camara Junior",82,1,0,0,85,6,12,1,1,188,3,4,195,227,0.452,0.859
"10043","Cochabamba","Cochabamba","Escuela Camara Junior",73,0,0,2,94,3,14,2,3,191,3,2,196,229,0.492,0.856
"10044","Cochabamba","Cochabamba","Escuela Camara Junior",70,2,1,0,85,5,15,0,4,182,1,19,202,230,0.467,0.878
"10045","Cochabamba","Cochabamba","Escuela Camara Junior",88,0,0,0,85,2,16,1,0,192,1,7,200,231,0.443,0.866
"10046","Cochabamba","Cochabamba","Escuela Camara Junior",95,1,1,0,75,4,15,2,1,194,1,6,201,229,0.387,0.878
"10047","Cochabamba","Cochabamba","Escuela Camara Junior",93,0,0,1,62,4,18,1,4,183,4,8,195,226,0.339,0.863
"10048","Cochabamba","Cochabamba","Escuela Camara Junior",100,0,0,0,81,6,15,0,0,202,0,8,210,228,0.401,0.921
"10049","Cochabamba","Cochabamba","Escuela Camara Junior",88,0,0,0,77,12,18,0,4,199,2,5,206,227,0.387,0.907
"10050","Cochabamba","Cochabamba","Unidad Educativa Prof. Oscar Rojas Caballero",77,1,2,0,90,5,25,2,2,204,1,8,213,238,0.441,0.895
"10051","Cochabamba","Cochabamba","Unidad Educativa Prof. Oscar Rojas Caballero",87,1,2,0,89,2,26,0,1,208,1,6,215,238,0.428,0.903
"10052","Cochabamba","Cochabamba","U.E. Madre De La Divina Providencia",77,0,0,0,100,3,20,0,3,203,3,15,221,239,0.493,0.925
"10053","Cochabamba","Cochabamba","U.E. Madre De La Divina Providencia",91,0,1,0,111,2,11,0,1,217,1,5,223,237,0.512,0.941
"10054","Cochabamba","Cochabamba","U.E. Madre De La Divina Providencia",101,0,0,1,93,4,20,0,1,220,0,6,226,242,0.423,0.934
"10055","Cochabamba","Cochabamba","Centro Educativo P.  Maria Auxiliadora",101,1,0,1,77,3,24,0,1,208,0,5,213,228,0.37,0.934
"10056","Cochabamba","Cochabamba","Centro Educativo P.  Maria Auxiliadora",90,1,0,2,82,5,16,0,0,196,2,5,203,227,0.418,0.894
"10057","Cochabamba","Cochabamba","Centro Educativo P.  Maria Auxiliadora",85,1,2,0,79,4,15,0,3,189,1,10,200,226,0.418,0.885
"10058","Cochabamba","Cochabamba","Centro Educativo P.  Maria Auxiliadora",85,0,1,1,82,4,19,0,0,192,0,7,199,224,0.427,0.888
"10059","Cochabamba","Cochabamba","Centro Educativo P.  Maria Auxiliadora",65,1,1,2,92,4,22,1,1,189,2,8,199,226,0.487,0.881
"10060","Cochabamba","Cochabamba","Centro Educativo P.  Maria Auxiliadora",72,0,4,0,97,6,13,0,1,193,4,7,204,233,0.503,0.876
"10061","Cochabamba","Cochabamba","Centro Educativo P.  Maria Auxiliadora",87,0,0,1,88,6,16,1,2,201,0,2,203,219,0.438,0.927
"10062","Cochabamba","Cochabamba","Centro Educativo P.  Maria Auxiliadora",91,0,2,0,80,2,15,0,0,190,1,5,196,225,0.421,0.871
"10063","Cochabamba","Cochabamba","Centro Educativo P.  Maria Auxiliadora",93,0,0,2,80,1,9,1,2,188,0,4,192,224,0.426,0.857
"10064","Cochabamba","Cochabamba","Centro Educativo P.  Maria Auxiliadora",90,1,0,2,77,9,12,0,0,191,2,7,200,224,0.403,0.893
"10065","Cochabamba","Cochabamba","Centro Educativo P.  Maria Auxiliadora",72,0,2,2,97,10,13,0,1,197,0,10,207,229,0.492,0.904
"10066","Cochabamba","Cochabamba","Centro Educativo P.  Maria Auxiliadora",84,0,0,0,83,2,11,1,2,183,2,6,191,226,0.454,0.845
"10067","Cochabamba","Cochabamba","Centro Educativo P.  Maria Auxiliadora",62,3,2,3,92,5,25,0,2,194,0,6,200,228,0.474,0.877
"10068","Cochabamba","Cochabamba","Centro Educativo P.  Maria Auxiliadora",68,0,0,1,101,5,21,0,2,198,1,10,209,228,0.51,0.917
"10069","Cochabamba","Cochabamba","Centro Educativo P.  Maria Auxiliadora",73,0,1,0,98,1,15,0,1,189,0,3,192,221,0.519,0.869
"10070","Cochabamba","Cochabamba","Centro Educativo P.  Maria Auxiliadora",87,0,0,1,85,5,18,1,3,200,0,6,206,227,0.425,0.907
"10071","Cochabamba","Cochabamba","Centro Educativo P.  Maria Auxiliadora",91,0,2,2,75,0,24,0,1,195,1,5,201,230,0.385,0.874
"10072","Cochabamba","Cochabamba","Centro Educativo P.  Maria Auxiliadora",86,1,0,1,69,6,21,0,3,187,1,6,194,221,0.369,0.878
"10073","Cochabamba","Cochabamba","Centro Educativo P.  Maria Auxiliadora",102,0,1,0,83,4,5,0,2,197,2,4,203,229,0.421,0.886
"10074","Cochabamba","Cochabamba","Centro Educativo P.  Maria Auxiliadora",80,0,1,1,79,8,15,0,2,186,0,14,200,228,0.425,0.877
"10075","Cochabamba","Cochabamba","Centro Educativo P.  Maria Auxiliadora",109,1,0,1,65,9,9,0,1,195,1,7,203,229,0.333,0.886
"10076","Cochabamba","Cochabamba","Centro Educativo P.  Maria Auxiliadora",77,1,0,1,91,8,14,1,1,194,1,6,201,227,0.469,0.885
"10077","Cochabamba","Cochabamba","Centro Educativo P.  Maria Auxiliadora",90,0,0,0,84,4,24,0,1,203,1,4,208,231,0.414,0.9
"10078","Cochabamba","Cochabamba","Centro Educativo P.  Maria Auxiliadora",87,0,2,1,86,4,10,0,3,193,1,4,198,224,0.446,0.884
"10079","Cochabamba","Cochabamba","Centro Educativo P.  Maria Auxiliadora",81,2,0,0,84,4,17,1,1,190,3,5,198,226,0.442,0.876
"10080","Cochabamba","Cochabamba","Colegio San Francisco de Asis",89,0,0,0,90,4,21,1,4,209,1,4,214,230,0.431,0.93
"10081","Cochabamba","Cochabamba","Colegio San Francisco de Asis",104,0,1,0,70,6,10,3,0,194,0,5,199,229,0.361,0.869
"10082","Cochabamba","Cochabamba","Colegio San Francisco de Asis",98,1,3,1,74,5,21,0,1,204,1,3,208,227,0.363,0.916
"10083","Cochabamba","Cochabamba","Colegio San Francisco de Asis",109,0,0,0,69,3,13,0,0,194,1,11,206,228,0.356,0.904
"10084","Cochabamba","Cochabamba","Colegio San Francisco de Asis",84,0,2,1,87,8,17,0,0,199,1,7,207,229,0.437,0.904
"10085","Cochabamba","Cochabamba","Colegio San Francisco de Asis",91,1,1,0,89,4,11,2,2,201,2,4,207,228,0.443,0.908
"10086","Cochabamba","Cochabamba","Colegio San Francisco de Asis",80,1,1,1,99,1,12,0,2,197,0,6,203,226,0.503,0.898
"10087","Cochabamba","Cochabamba","Colegio San Francisco de Asis",81,0,1,0,98,6,20,3,0,209,1,4,214,233,0.469,0.918
"10088","Cochabamba","Cochabamba","Colegio San Francisco de Asis",86,0,1,0,87,2,17,0,2,195,0,3,198,228,0.446,0.868
"10089","Cochabamba","Cochabamba","Colegio San Francisco de Asis",90,0,0,0,72,7,17,2,1,189,0,9,198,226,0.381,0.876
"10090","Cochabamba","Cochabamba","Colegio San Francisco de Asis",96,1,2,0,87,2,11,1,1,201,2,2,205,226,0.433,0.907
"10091","Cochabamba","Cochabamba","Colegio San Francisco de Asis",110,1,1,1,67,3,9,0,2,194,1,5,200,232,0.345,0.862
"10092","Cochabamba","Cochabamba","Colegio San Francisco de Asis",99,0,0,0,83,3,23,0,0,208,3,3,214,233,0.399,0.918
"10093","Cochabamba","Cochabamba","Colegio San Francisco de Asis",95,0,2,1,82,2,14,0,0,196,0,5,201,231,0.418,0.87
"10094","Cochabamba","Cochabamba","Colegio San Francisco de Asis",95,0,0,0,69,8,18,1,4,195,2,2,199,222,0.354,0.896
"10095","Cochabamba","Cochabamba","Colegio San Francisco de Asis",86,0,0,0,82,6,19,1,1,195,2,6,203,227,0.421,0.894
"10096","Cochabamba","Cochabamba","Colegio San Francisco de Asis",79,0,1,2,87,5,18,0,2,194,1,8,203,229,0.448,0.886
"10097","Cochabamba","Cochabamba","Colegio San Francisco de Asis",89,0,1,0,79,6,13,0,1,189,2,8,199,227,0.418,0.877
"10098","Cochabamba","Cochabamba","Colegio San Francisco de Asis",108,0,0,0,66,6,14,2,1,197,1,2,200,230,0.335,0.87
"10099","Cochabamba","Cochabamba","Colegio San Francisco de Asis",95,0,1,0,74,4,23,0,2,199,1,14,214,227,0.372,0.943
"10100","Cochabamba","Cochabamba","Colegio San Francisco de Asis",111,0,0,0,70,2,12,0,3,198,2,6,206,229,0.354,0.9
"10101","Cochabamba","Cochabamba","Colegio San Francisco de Asis",103,0,0,0,79,7,11,0,2,202,0,3,205,223,0.391,0.919
"10102","Cochabamba","Cochabamba","Colegio San Francisco de Asis",100,0,1,0,78,7,12,0,1,199,0,8,207,230,0.392,0.9
"10103","Cochabamba","Cochabamba","Colegio San Francisco de Asis",92,0,0,2,102,3,12,0,0,211,0,5,216,234,0.483,0.923
"10104","Cochabamba","Cochabamba","Colegio San Francisco de Asis",105,0,0,0,73,4,16,0,2,200,1,4,205,228,0.365,0.899
"10105","Cochabamba","Cochabamba","Colegio San Francisco de Asis",102,0,0,1,67,4,7,0,3,184,2,10,196,229,0.364,0.856
"10106","Cochabamba","Cochabamba","Colegio San Francisco de Asis",116,0,0,0,68,3,10,1,0,198,1,3,202,225,0.343,0.898
"10107","Cochabamba","Cochabamba","Colegio San Francisco de Asis",101,1,0,0,74,4,16,2,1,199,2,3,204,227,0.372,0.899
"10108","Cochabamba","Cochabamba","Colegio San Francisco de Asis",77,1,0,0,88,7,21,3,0,197,0,5,202,220,0.447,0.918
"10109","Cochabamba","Cochabamba","Colegio San Francisco de Asis",106,0,0,1,71,5,9,1,3,196,0,8,204,219,0.362,0.932
"10110","Cochabamba","Cochabamba","Colegio San Francisco de Asis",100,1,0,0,82,1,15,0,0,199,1,5,205,223,0.412,0.919
"10111","Cochabamba","Cochabamba","Colegio San Francisco de Asis",90,0,0,0,87,1,15,0,1,194,3,5,202,227,0.448,0.89
"10112","Cochabamba","Cochabamba","U. E. Bolivia Japón Tarde",88,0,0,0,72,2,19,2,0,183,0,2,185,195,0.393,0.949
"10113","Cochabamba","Cochabamba","Centro Educativo San Francisco De Asis",136,0,0,0,59,2,7,0,2,206,1,4,211,238,0.286,0.887
"10114","Cochabamba","Cochabamba","Centro Educativo San Francisco De Asis",105,0,0,0,72,7,15,1,1,201,1,6,208,233,0.358,0.893
"10115","Cochabamba","Cochabamba","Centro Educativo San Francisco De Asis",137,0,0,1,66,1,9,0,1,215,1,7,223,235,0.307,0.949
"10116","Cochabamba","Cochabamba","Centro Educativo San Francisco De Asis",115,1,1,1,75,5,8,1,1,208,0,4,212,237,0.361,0.895
"10117","Cochabamba","Cochabamba","Centro Educativo San Francisco De Asis",117,0,1,0,71,2,9,1,0,201,1,5,207,237,0.353,0.873
"10118","Cochabamba","Cochabamba","Centro Educativo San Francisco De Asis",125,0,0,0,53,5,8,0,1,192,0,6,198,231,0.276,0.857
"10119","Cochabamba","Cochabamba","Centro Educativo San Francisco De Asis",129,0,1,0,67,2,6,0,0,205,1,5,211,236,0.327,0.894
"10120","Cochabamba","Cochabamba","Centro Educativo San Francisco De Asis",128,0,1,2,73,5,7,1,0,217,0,4,221,243,0.336,0.909
"10121","Cochabamba","Cochabamba","Esc. Republica Del Peru O I. Vasquez",105,1,2,0,68,2,2,1,1,182,1,8,191,216,0.374,0.884
"10122","Cochabamba","Cochabamba","Esc. Republica Del Peru O I. Vasquez",100,0,0,1,67,6,7,1,0,182,1,7,190,220,0.368,0.864
"10123","Cochabamba","Cochabamba","Esc. Republica Del Peru O I. Vasquez",123,0,0,1,52,7,4,0,1,188,2,3,193,213,0.277,0.906
"10124","Cochabamba","Cochabamba","Esc. Republica Del Peru O I. Vasquez",109,0,1,0,65,3,12,1,0,191,0,8,199,216,0.34,0.921
"10125","Cochabamba","Cochabamba","Esc. Republica Del Peru O I. Vasquez",120,2,1,2,62,3,4,0,1,195,1,4,200,221,0.318,0.905
"10126","Cochabamba","Cochabamba","Esc. Republica Del Peru O I. Vasquez",97,0,1,1,76,8,7,0,3,193,2,1,196,217,0.394,0.903
"10127","Cochabamba","Cochabamba","Esc. Republica Del Peru O I. Vasquez",100,0,0,0,65,2,9,2,3,181,0,3,184,219,0.359,0.84
"10128","Cochabamba","Cochabamba","Esc. Republica Del Peru O I. Vasquez",96,0,1,3,89,2,10,1,0,202,0,2,204,226,0.441,0.903
"10129","Cochabamba","Cochabamba","Esc. Republica Del Peru O I. Vasquez",115,0,2,0,66,5,11,0,0,199,0,4,203,219,0.332,0.927
"10130","Cochabamba","Cochabamba","Esc. Republica Del Peru O I. Vasquez",113,0,0,3,63,6,5,0,0,190,0,3,193,222,0.332,0.869
"10131","Cochabamba","Cochabamba","Esc. Republica Del Peru O I. Vasquez",118,0,1,0,54,3,15,0,0,191,0,3,194,223,0.283,0.87
"10132","Cochabamba","Cochabamba","Esc. Republica Del Peru O I. Vasquez",109,1,0,1,61,8,7,1,1,189,0,5,194,216,0.323,0.898
"10133","Cochabamba","Cochabamba","Esc. Republica Del Peru O I. Vasquez",116,0,0,1,49,5,9,0,0,180,1,6,187,218,0.272,0.858
"10134","Cochabamba","Cochabamba","Esc. Republica Del Peru O I. Vasquez",109,0,0,0,61,6,11,0,1,188,1,5,194,227,0.324,0.855
"10135","Cochabamba","Cochabamba","Esc. Republica Del Peru O I. Vasquez",115,0,1,1,53,5,16,0,0,191,1,5,197,220,0.277,0.895
"10136","Cochabamba","Cochabamba","Esc. Republica Del Peru O I. Vasquez",117,0,0,0,50,3,12,0,3,185,3,7,195,220,0.27,0.886
"10137","Cochabamba","Cochabamba","Esc. Republica Del Peru O I. Vasquez",102,0,0,0,58,7,14,0,1,182,2,5,189,216,0.319,0.875
"10138","Cochabamba","Cochabamba","Esc. Republica Del Peru O I. Vasquez",86,1,0,0,84,6,14,0,3,194,2,5,201,224,0.433,0.897
"10139","Cochabamba","Cochabamba","Esc. Republica Del Peru O I. Vasquez",117,0,1,0,64,4,6,0,1,193,0,2,195,218,0.332,0.894
"10140","Cochabamba","Cochabamba","Esc. Republica Del Peru O I. Vasquez",122,0,1,0,45,4,2,0,2,176,1,8,185,212,0.256,0.873
"10141","Cochabamba","Cochabamba","Esc. Republica Del Peru O I. Vasquez",124,0,0,0,55,6,3,1,2,191,1,5,197,225,0.288,0.876
"10142","Cochabamba","Cochabamba","Esc. Republica Del Peru O I. Vasquez",110,1,0,0,71,5,8,0,1,196,0,5,201,222,0.362,0.905
"10143","Cochabamba","Cochabamba","Esc. Republica Del Peru O I. Vasquez",125,0,0,1,66,2,8,0,1,203,0,2,205,225,0.325,0.911
"10144","Cochabamba","Cochabamba","Esc. Republica Del Peru O I. Vasquez",123,0,0,1,64,4,7,0,0,199,1,4,204,220,0.322,0.927
"10145","Cochabamba","Cochabamba","Esc. Republica Del Peru O I. Vasquez",112,0,1,0,60,4,6,2,2,187,0,4,191,217,0.321,0.88
"10146","Cochabamba","Cochabamba","Esc. Republica Del Peru O I. Vasquez",133,1,0,0,52,5,6,0,1,198,1,2,201,219,0.263,0.918
"10147","Cochabamba","Cochabamba","Esc. Republica Del Peru O I. Vasquez",123,1,0,0,57,6,9,0,0,196,0,6,202,227,0.291,0.89
"10148","Cochabamba","Cochabamba","Esc. Republica Del Peru O I. Vasquez",119,1,0,0,75,3,5,0,2,205,0,6,211,227,0.366,0.93
"10149","Cochabamba","Cochabamba","Esc. Republica Del Peru O I. Vasquez",118,0,2,3,69,3,5,0,0,200,1,2,203,225,0.345,0.902
"10150","Cochabamba","Cochabamba","Esc. Republica Del Peru O I. Vasquez",108,0,1,0,62,6,4,0,1,182,0,2,184,226,0.341,0.814
"10151","Cochabamba","Cochabamba","Esc. Republica Del Peru O I. Vasquez",122,0,1,0,55,1,9,0,1,189,1,7,197,224,0.291,0.879
"10152","Cochabamba","Cochabamba","Esc. Republica Del Peru O I. Vasquez",103,0,1,1,77,6,4,0,1,193,0,5,198,217,0.399,0.912
"10153","Cochabamba","Cochabamba","Esc. Republica Del Peru O I. Vasquez",119,0,1,0,60,5,6,0,2,193,3,7,203,227,0.311,0.894
"10154","Cochabamba","Cochabamba","Esc. Republica Del Peru O I. Vasquez",123,0,0,1,69,4,4,0,0,201,0,5,206,225,0.343,0.916
"10155","Cochabamba","Cochabamba","Unidad Educativa de La Fuerza Aerea",81,0,0,1,86,5,19,1,1,194,1,3,198,238,0.443,0.832
"10156","Cochabamba","Cochabamba","Unidad Educativa de La Fuerza Aerea",73,0,0,2,79,4,26,2,1,187,2,4,193,238,0.422,0.811
"10157","Cochabamba","Cochabamba","Unidad Educativa de La Fuerza Aerea",97,1,0,0,72,2,20,1,2,195,0,2,197,234,0.369,0.842
"10158","Cochabamba","Cochabamba","Unidad Educativa de La Fuerza Aerea",90,1,1,1,89,2,18,0,0,202,2,6,210,238,0.441,0.882
"10159","Cochabamba","Cochabamba","Unidad Educativa de La Fuerza Aerea",97,0,2,0,72,2,26,0,0,199,0,3,202,237,0.362,0.852
"10160","Cochabamba","Cochabamba","Unidad Educativa de La Fuerza Aerea",101,0,1,1,62,4,25,1,0,195,1,9,205,239,0.318,0.858
"10161","Cochabamba","Cochabamba","Unidad Educativa 14 de Septiembre",155,1,0,1,42,3,8,1,2,213,1,5,219,238,0.197,0.92
"10162","Cochabamba","Cochabamba","Unidad Educativa 14 de Septiembre",161,0,0,1,27,4,7,1,1,202,0,9,211,238,0.134,0.887
"10163","Cochabamba","Cochabamba","Unidad Educativa 14 de Septiembre",162,1,0,0,45,5,8,1,1,223,0,2,225,236,0.202,0.953
"10164","Cochabamba","Cochabamba","Unidad Educativa 14 de Septiembre",151,0,0,0,43,3,9,1,0,207,0,8,215,236,0.208,0.911
"10165","Cochabamba","Cochabamba","Unidad Educativa 14 de Septiembre",148,0,0,1,51,3,6,0,1,210,1,4,215,238,0.243,0.903
"10166","Cochabamba","Cochabamba","Unidad Educativa 14 de Septiembre",148,1,0,0,48,2,9,0,1,209,1,7,217,239,0.23,0.908
"10167","Cochabamba","Cochabamba","Unidad Educativa 14 de Septiembre",167,0,0,0,34,7,6,0,1,215,0,4,219,231,0.158,0.948
"10168","Cochabamba","Cochabamba","Escuela Jose Maria Santivañez",160,0,1,1,35,3,4,0,0,204,0,3,207,225,0.172,0.92
"10169","Cochabamba","Cochabamba","Escuela Jose Maria Santivañez",155,0,0,0,25,1,3,0,0,184,0,3,187,217,0.136,0.862
"10170","Cochabamba","Cochabamba","Escuela Jose Maria Santivañez",144,0,1,0,30,2,4,0,0,181,1,6,188,215,0.166,0.874
"10171","Cochabamba","Cochabamba","Escuela Jose Maria Santivañez",146,0,0,0,34,0,5,0,0,185,1,4,190,217,0.184,0.876
"10172","Cochabamba","Cochabamba","Escuela Jose Maria Santivañez",139,0,1,1,35,4,4,1,0,185,1,5,191,221,0.189,0.864
"10173","Cochabamba","Cochabamba","Escuela Jose Maria Santivañez",148,0,0,0,36,1,3,1,1,190,1,3,194,223,0.189,0.87
"10174","Cochabamba","Cochabamba","Escuela Jose Maria Santivañez",167,0,0,1,29,1,6,0,0,204,0,4,208,228,0.142,0.912
"10175","Cochabamba","Cochabamba","Escuela Jose Maria Santivañez",143,0,0,1,31,1,5,0,0,181,2,8,191,223,0.171,0.857
"10176","Cochabamba","Cochabamba","Escuela Jose Maria Santivañez",154,0,2,0,21,19,0,2,2,200,8,4,212,226,0.105,0.938
"10177","Cochabamba","Cochabamba","Escuela Jose Maria Santivañez",159,0,0,1,29,2,2,0,0,193,0,7,200,223,0.15,0.897
"10178","Cochabamba","Cochabamba","Escuela Jose Maria Santivañez",144,0,0,0,33,3,5,0,0,185,0,8,193,223,0.178,0.865
"10179","Cochabamba","Cochabamba","Escuela Jose Maria Santivañez",142,1,2,0,26,4,6,0,1,182,0,4,186,220,0.143,0.845
"10180","Cochabamba","Cochabamba","Escuela Jose Maria Santivañez",159,0,0,0,34,2,3,0,1,199,1,2,202,230,0.171,0.878
"10181","Cochabamba","Cochabamba","Escuela Jose Maria Santivañez",167,1,0,2,30,0,3,0,0,203,2,2,207,230,0.148,0.9
"10182","Cochabamba","Cochabamba","Escuela Jose Maria Santivañez",149,1,0,1,29,7,8,0,0,195,1,0,196,226,0.149,0.867
"10183","Cochabamba","Cochabamba","Escuela Jose Maria Santivañez",148,1,0,1,31,3,6,0,1,191,1,4,196,219,0.162,0.895
"10184","Cochabamba","Cochabamba","Escuela Jose Maria Santivañez",139,1,0,0,32,2,8,0,0,182,0,7,189,221,0.176,0.855
"10185","Cochabamba","Cochabamba","Escuela Jose Maria Santivañez",145,0,1,0,40,5,8,2,0,201,1,2,204,224,0.199,0.911
"10186","Cochabamba","Cochabamba","Escuela Jose Maria Santivañez",146,0,0,0,29,9,8,1,1,194,0,2,196,217,0.149,0.903
"10187","Cochabamba","Cochabamba","Escuela Jose Maria Santivañez",154,0,0,1,24,3,6,0,1,189,0,4,193,224,0.127,0.862
"10188","Cochabamba","Cochabamba","Colegio Maryknoll",156,0,1,0,29,6,2,1,0,195,0,5,200,216,0.149,0.926
"10189","Cochabamba","Cochabamba","Colegio Maryknoll",154,0,0,0,37,0,3,0,0,194,0,3,197,225,0.191,0.876
"10190","Cochabamba","Cochabamba","Colegio Maryknoll",159,0,1,0,21,2,3,1,0,187,1,2,190,214,0.112,0.888
"10191","Cochabamba","Cochabamba","Colegio Maryknoll",163,1,0,0,23,1,2,0,0,190,0,3,193,220,0.121,0.877
"10192","Cochabamba","Cochabamba","Colegio Maryknoll",141,0,0,0,33,2,5,0,0,181,1,4,186,227,0.182,0.819
"10193","Cochabamba","Cochabamba","Colegio Maryknoll",157,0,0,1,32,3,4,0,1,198,0,4,202,227,0.162,0.89
"10194","Cochabamba","Cochabamba","Colegio Maryknoll",161,0,0,0,26,1,1,0,0,189,1,1,191,215,0.138,0.888
"10195","Cochabamba","Cochabamba","Colegio Maryknoll",157,0,1,0,21,0,1,0,2,182,0,7,189,225,0.115,0.84
"10196","Cochabamba","Cochabamba","Colegio Maryknoll",153,0,0,0,25,3,1,1,1,184,0,2,186,221,0.136,0.842
"10197","Cochabamba","Cochabamba","Colegio Maryknoll",149,1,1,0,22,1,9,0,0,183,0,7,190,216,0.12,0.88
"10198","Cochabamba","Cochabamba","Colegio Maryknoll",143,0,1,1,25,4,2,1,0,177,0,4,181,222,0.141,0.815
"10199","Cochabamba","Cochabamba","Colegio Maryknoll",157,0,0,1,29,3,3,0,0,193,0,3,196,221,0.15,0.887
"10200","Cochabamba","Cochabamba","Colegio Maryknoll",144,0,0,2,31,3,1,0,1,182,0,3,185,220,0.17,0.841
"10201","Cochabamba","Cochabamba","Colegio Maryknoll",155,0,0,1,29,2,3,1,0,191,0,3,194,225,0.152,0.862
"10202","Cochabamba","Cochabamba","Colegio Maryknoll",147,0,0,1,27,3,1,0,1,180,2,7,189,220,0.15,0.859
"10203","Cochabamba","Cochabamba","Colegio Maryknoll",144,0,0,0,33,4,6,1,1,189,0,3,192,219,0.175,0.877
"10204","Cochabamba","Cochabamba","Colegio Maryknoll",164,0,1,0,22,2,4,0,0,193,1,3,197,218,0.114,0.904
"10205","Cochabamba","Cochabamba","Colegio Maryknoll",160,0,0,0,20,1,2,1,0,184,0,3,187,222,0.109,0.842
"10206","Cochabamba","Cochabamba","Colegio Maryknoll",156,1,0,0,18,2,2,0,0,179,0,5,184,217,0.101,0.848
"10207","Cochabamba","Cochabamba","Colegio Maryknoll",152,0,0,0,33,3,1,0,0,189,0,1,190,226,0.175,0.841
"10208","Cochabamba","Cochabamba","Colegio Maryknoll",156,1,0,1,29,0,1,1,0,189,0,3,192,225,0.153,0.853
"10209","Cochabamba","Cochabamba","Colegio Maryknoll",153,0,0,0,24,2,4,1,0,184,1,1,186,220,0.13,0.845
"10210","Cochabamba","Cochabamba","Colegio Maryknoll",151,1,0,0,28,3,4,1,0,188,0,2,190,220,0.149,0.864
"10211","Cochabamba","Cochabamba","Colegio Maryknoll",166,0,0,1,16,1,4,0,0,188,0,2,190,219,0.085,0.868
"10212","Cochabamba","Cochabamba","Liceo Guindalina Loayza",156,0,0,0,36,2,6,1,0,201,0,5,206,228,0.179,0.904
"10213","Cochabamba","Cochabamba","Liceo Guindalina Loayza",157,0,0,1,30,1,2,1,1,193,1,10,204,229,0.155,0.891
"10214","Cochabamba","Cochabamba","Liceo Guindalina Loayza",160,0,0,1,28,3,4,0,0,196,1,5,202,226,0.143,0.894
"10215","Cochabamba","Cochabamba","Liceo Guindalina Loayza",170,0,1,0,23,1,4,1,0,200,3,12,215,230,0.115,0.935
"10216","Cochabamba","Cochabamba","Liceo Guindalina Loayza",148,0,0,0,34,5,3,0,2,192,0,11,203,227,0.177,0.894
"10217","Cochabamba","Cochabamba","Liceo Guindalina Loayza",148,0,0,0,33,2,3,0,0,186,2,10,198,221,0.177,0.896
"10218","Cochabamba","Cochabamba","Liceo Guindalina Loayza",166,0,0,0,25,1,5,0,0,197,0,9,206,228,0.127,0.904
"10219","Cochabamba","Cochabamba","Liceo Guindalina Loayza",179,0,0,1,25,7,2,0,3,217,0,4,221,248,0.115,0.891
"10220","Cochabamba","Cochabamba","Colegio Venezuela",138,0,1,0,39,1,6,1,0,186,5,5,196,216,0.21,0.907
"10221","Cochabamba","Cochabamba","Colegio Venezuela",148,1,0,0,29,1,4,1,2,186,1,8,195,231,0.156,0.844
"10222","Cochabamba","Cochabamba","Colegio Venezuela",141,0,0,2,33,1,8,1,1,187,0,8,195,230,0.176,0.848
"10223","Cochabamba","Cochabamba","Colegio Venezuela",142,0,1,0,39,3,9,0,0,194,0,10,204,229,0.201,0.891
"10224","Cochabamba","Cochabamba","Colegio Venezuela",149,0,0,0,34,4,4,0,1,192,1,7,200,225,0.177,0.889
"10225","Cochabamba","Cochabamba","Colegio Venezuela",145,0,0,0,36,2,3,0,0,186,1,4,191,222,0.194,0.86
"10226","Cochabamba","Cochabamba","Colegio Venezuela",139,1,0,1,36,5,2,0,0,184,1,6,191,217,0.196,0.88
"10227","Cochabamba","Cochabamba","Colegio Venezuela",152,0,0,0,34,5,4,0,1,196,1,4,201,230,0.173,0.874
"10228","Cochabamba","Cochabamba","Colegio Venezuela",141,0,0,0,26,1,4,2,1,175,1,6,182,219,0.149,0.831
"10229","Cochabamba","Cochabamba","Colegio Venezuela",137,0,1,1,29,4,6,2,1,181,1,8,190,223,0.16,0.852
"10230","Cochabamba","Cochabamba","Colegio Venezuela",141,1,0,0,37,2,6,0,1,188,2,3,193,230,0.197,0.839
"10231","Cochabamba","Cochabamba","Colegio Venezuela",142,1,0,1,29,2,3,0,1,179,1,14,194,221,0.162,0.878
"10232","Cochabamba","Cochabamba","Colegio Venezuela",143,0,0,1,39,6,3,2,1,195,1,4,200,227,0.2,0.881
"10233","Cochabamba","Cochabamba","Colegio Venezuela",153,1,0,1,25,3,4,0,2,189,2,3,194,216,0.132,0.898
"10234","Cochabamba","Cochabamba","Colegio Pio XII",110,1,1,1,54,1,11,0,2,181,1,5,187,226,0.298,0.827
"10235","Cochabamba","Cochabamba","Colegio Pio XII",111,1,1,1,49,2,20,0,4,189,1,2,192,221,0.259,0.869
"10236","Cochabamba","Cochabamba","Colegio Pio XII",130,0,1,0,56,3,13,1,2,206,0,7,213,229,0.272,0.93
"10237","Cochabamba","Cochabamba","Colegio Pio XII",106,1,0,1,55,4,15,1,2,185,0,3,188,219,0.297,0.858
"10238","Cochabamba","Cochabamba","Colegio Pio XII",103,0,1,1,70,5,14,0,1,195,1,3,199,232,0.359,0.858
"10239","Cochabamba","Cochabamba","Colegio Pio XII",114,0,1,1,57,0,19,1,1,194,3,5,202,223,0.294,0.906
"10240","Cochabamba","Cochabamba","Colegio Pio XII",128,0,2,0,55,0,15,0,2,202,1,0,203,224,0.272,0.906
"10241","Cochabamba","Cochabamba","Colegio Pio XII",127,1,0,2,51,1,9,2,0,193,1,7,201,226,0.264,0.889
"10242","Cochabamba","Cochabamba","Escuela Bolivar",104,1,0,1,50,4,16,1,3,180,3,5,188,224,0.278,0.839
"10243","Cochabamba","Cochabamba","Escuela Bolivar",110,1,3,0,60,1,11,0,3,189,2,5,196,228,0.317,0.86
"10244","Cochabamba","Cochabamba","Escuela Bolivar",118,1,0,0,49,4,11,0,0,183,2,4,189,221,0.268,0.855
"10245","Cochabamba","Cochabamba","Escuela Bolivar",121,0,1,0,53,1,13,0,3,192,2,5,199,226,0.276,0.881
"10246","Cochabamba","Cochabamba","Escuela Bolivar",112,1,5,0,51,1,8,0,4,182,0,4,186,216,0.28,0.861
"10247","Cochabamba","Cochabamba","Escuela Bolivar",114,0,2,0,52,4,14,1,3,190,1,2,193,224,0.274,0.862
"10248","Cochabamba","Cochabamba","Colegio Ismael Montes O Luis Espinal",76,1,2,0,91,4,13,0,1,188,2,9,199,225,0.484,0.884
"10249","Cochabamba","Cochabamba","Colegio Ismael Montes O Luis Espinal",62,2,4,1,98,5,11,0,1,184,5,6,195,222,0.533,0.878
"10250","Cochabamba","Cochabamba","Colegio Ismael Montes O Luis Espinal",68,0,2,1,103,5,18,0,1,198,0,5,203,230,0.52,0.883
"10251","Cochabamba","Cochabamba","Colegio Ismael Montes O Luis Espinal",74,0,2,0,111,3,9,0,2,201,0,4,205,230,0.552,0.891
"10252","Cochabamba","Cochabamba","Colegio Ismael Montes O Luis Espinal",56,1,3,0,108,3,16,0,4,191,1,7,199,227,0.565,0.877
"10253","Cochabamba","Cochabamba","Colegio Ismael Montes O Luis Espinal",60,2,3,1,113,3,18,0,0,200,4,3,207,225,0.565,0.92
"10254","Cochabamba","Cochabamba","Colegio Ismael Montes O Luis Espinal",80,1,3,2,86,9,20,2,1,204,1,5,210,227,0.422,0.925
"10255","Cochabamba","Cochabamba","Colegio Ismael Montes O Luis Espinal",74,0,0,0,91,8,14,1,0,188,2,9,199,224,0.484,0.888
"10256","Cochabamba","Cochabamba","Colegio Ismael Montes O Luis Espinal",83,0,2,0,93,7,8,1,0,194,3,9,206,230,0.479,0.896
"10257","Cochabamba","Cochabamba","Colegio Ismael Montes O Luis Espinal",82,0,2,1,106,2,11,0,2,206,0,4,210,225,0.515,0.933
"10258","Cochabamba","Cochabamba","Colegio Ismael Montes O Luis Espinal",72,2,0,0,90,5,26,1,2,198,2,3,203,225,0.455,0.902
"10259","Cochabamba","Cochabamba","Colegio Ismael Montes O Luis Espinal",60,0,1,1,119,2,14,0,3,200,3,8,211,230,0.595,0.917
"10260","Cochabamba","Cochabamba","Colegio Ismael Montes O Luis Espinal",73,1,2,0,94,3,11,2,4,190,1,3,194,224,0.495,0.866
"10261","Cochabamba","Cochabamba","Colegio Ismael Montes O Luis Espinal",85,1,2,1,89,4,19,0,2,203,0,6,209,229,0.438,0.913
"10262","Cochabamba","Cochabamba","Colegio Ismael Montes O Luis Espinal",71,0,1,0,103,2,19,0,2,198,0,4,202,227,0.52,0.89
"10263","Cochabamba","Cochabamba","Colegio Ismael Montes O Luis Espinal",82,0,1,0,89,4,13,0,2,191,1,7,199,222,0.466,0.896
"10264","Cochabamba","Cochabamba","Colegio Ismael Montes O Luis Espinal",81,1,0,1,81,3,17,0,0,184,1,7,192,219,0.44,0.877
"10265","Cochabamba","Cochabamba","Colegio Ismael Montes O Luis Espinal",72,1,0,3,92,2,13,1,0,184,4,4,192,222,0.5,0.865
"10266","Cochabamba","Cochabamba","Colegio Ismael Montes O Luis Espinal",73,0,0,0,98,6,14,3,1,195,1,8,204,223,0.503,0.915
"10267","Cochabamba","Cochabamba","Colegio Ismael Montes O Luis Espinal",61,0,1,0,114,2,17,1,0,196,1,5,202,221,0.582,0.914
"10268","Cochabamba","Cochabamba","Unidad Educativa Andres Bello",63,1,0,0,102,3,22,0,0,191,2,5,198,224,0.534,0.884
"10269","Cochabamba","Cochabamba","Unidad Educativa Andres Bello",92,0,2,1,77,4,12,0,2,190,3,5,198,224,0.405,0.884
"10270","Cochabamba","Cochabamba","Unidad Educativa Andres Bello",90,1,1,0,80,5,17,0,1,195,2,8,205,229,0.41,0.895
"10271","Cochabamba","Cochabamba","Unidad Educativa Andres Bello",60,0,1,1,111,8,13,1,2,197,3,5,205,232,0.563,0.884
"10272","Cochabamba","Cochabamba","Unidad Educativa Andres Bello",59,1,0,1,117,3,14,1,1,197,1,8,206,228,0.594,0.904
"10273","Cochabamba","Cochabamba","Unidad Educativa Andres Bello",81,0,1,0,95,6,17,0,2,202,2,4,208,229,0.47,0.908
"10274","Cochabamba","Cochabamba","Unidad Educativa Andres Bello",97,0,2,1,82,4,14,1,2,203,0,3,206,229,0.404,0.9
"10275","Cochabamba","Cochabamba","Unidad Educativa Andres Bello",88,0,1,0,77,8,18,2,2,196,0,5,201,226,0.393,0.889
"10276","Cochabamba","Cochabamba","Unidad Educativa Andres Bello",87,1,2,0,87,3,25,1,1,207,3,5,215,236,0.42,0.911
"10277","Cochabamba","Cochabamba","Unidad Educativa Andres Bello",77,0,3,0,90,3,13,0,2,188,1,9,198,223,0.479,0.888
"10278","Cochabamba","Cochabamba","Unidad Educativa Andres Bello",63,0,0,0,119,1,15,0,1,199,0,11,210,234,0.598,0.897
"10279","Cochabamba","Cochabamba","Unidad Educativa Andres Bello",94,0,1,0,83,4,16,0,1,199,0,2,201,226,0.417,0.889
"10280","Cochabamba","Cochabamba","Unidad Educativa Andres Bello",76,0,3,1,109,3,13,0,2,207,2,4,213,234,0.527,0.91
"10281","Cochabamba","Cochabamba","Unidad Educativa Andres Bello",63,2,1,1,94,3,23,1,1,189,1,9,199,226,0.497,0.881
"10282","Cochabamba","Cochabamba","Unidad Educativa Andres Bello",92,0,1,0,85,6,13,0,0,197,2,10,209,226,0.431,0.925
"10283","Cochabamba","Cochabamba","Unidad Educativa Andres Bello",81,0,0,0,108,1,9,0,1,200,0,6,206,225,0.54,0.916
"10284","Cochabamba","Cochabamba","Unidad Educativa Andres Bello",88,2,1,1,84,9,14,0,0,199,1,4,204,225,0.422,0.907
"10285","Cochabamba","Cochabamba","Unidad Educativa Andres Bello",74,1,0,0,107,4,16,2,2,206,1,4,211,231,0.519,0.913
"10286","Cochabamba","Cochabamba","Unidad Educativa Andres Bello",100,2,0,2,76,6,14,0,1,201,0,4,205,231,0.378,0.887
"10287","Cochabamba","Cochabamba","Unidad Educativa Andres Bello",76,2,0,1,72,4,16,0,1,172,1,3,176,190,0.419,0.926
"10288","Cochabamba","Cochabamba","Unidad Educativa Santa Cruz - Eduardo Ocampo Moscoso",77,1,1,0,117,0,16,0,1,213,0,5,218,239,0.549,0.912
"10289","Cochabamba","Cochabamba","Escuela Buenas Nuevas A",54,0,0,1,103,3,27,0,2,190,0,9,199,226,0.542,0.881
"10290","Cochabamba","Cochabamba","Escuela Buenas Nuevas A",61,0,2,2,96,4,18,0,3,186,3,9,198,221,0.516,0.896
"10291","Cochabamba","Cochabamba","Escuela Buenas Nuevas A",80,3,0,2,90,3,21,0,2,201,0,4,205,227,0.448,0.903
"10292","Cochabamba","Cochabamba","Escuela Buenas Nuevas A",78,1,1,0,101,1,19,0,3,204,2,2,208,232,0.495,0.897
"10293","Cochabamba","Cochabamba","Escuela Buenas Nuevas A",69,0,2,0,97,3,21,0,1,193,0,11,204,226,0.503,0.903
"10294","Cochabamba","Cochabamba","Escuela Buenas Nuevas A",52,0,3,1,114,5,23,1,1,200,1,7,208,227,0.57,0.916
"10295","Cochabamba","Cochabamba","Escuela Buenas Nuevas A",75,0,1,2,87,3,20,0,2,190,1,6,197,222,0.458,0.887
"10296","Cochabamba","Cochabamba","Escuela Buenas Nuevas A",67,0,1,0,88,4,10,1,3,174,3,14,191,223,0.506,0.857
"10297","Cochabamba","Cochabamba","Escuela Buenas Nuevas A",76,0,1,0,98,7,22,0,2,206,0,12,218,231,0.476,0.944
"10298","Cochabamba","Cochabamba","Escuela Buenas Nuevas A",93,1,1,1,92,3,9,1,1,202,2,11,215,228,0.455,0.943
"10299","Cochabamba","Cochabamba","Escuela Buenas Nuevas A",56,0,4,0,104,4,20,0,3,191,3,9,203,229,0.545,0.886
"10300","Cochabamba","Cochabamba","Escuela Buenas Nuevas A",71,1,0,0,100,1,23,1,0,197,3,2,202,224,0.508,0.902
"10301","Cochabamba","Cochabamba","Escuela Buenas Nuevas A",61,0,0,1,96,5,21,0,1,185,0,6,191,222,0.519,0.86
"10302","Cochabamba","Cochabamba","Escuela Buenas Nuevas A",68,0,2,0,94,1,30,1,0,196,4,7,207,225,0.48,0.92
"10303","Cochabamba","Cochabamba","Escuela Buenas Nuevas A",84,1,2,1,67,4,27,1,2,189,2,6,197,226,0.354,0.872
"10304","Cochabamba","Cochabamba","Escuela Buenas Nuevas A",90,2,0,0,86,4,19,0,2,203,1,4,208,227,0.424,0.916
"10305","Cochabamba","Cochabamba","Escuela Buenas Nuevas A",71,0,0,1,98,5,22,0,2,199,1,9,209,225,0.492,0.929
"10306","Cochabamba","Cochabamba","Escuela Buenas Nuevas A",78,0,2,1,96,5,22,0,3,207,1,3,211,231,0.464,0.913
"10307","Cochabamba","Cochabamba","Colegio Buenas Nuevas C",91,0,2,0,85,4,15,1,0,198,0,8,206,225,0.429,0.916
"10308","Cochabamba","Cochabamba","Colegio Buenas Nuevas C",70,0,2,0,82,5,21,0,3,183,5,11,199,224,0.448,0.888
"10309","Cochabamba","Cochabamba","Colegio Buenas Nuevas C",71,1,0,2,97,4,19,0,0,194,1,8,203,234,0.5,0.868
"10310","Cochabamba","Cochabamba","Colegio Buenas Nuevas C",83,0,0,0,86,4,23,0,1,197,1,4,202,223,0.437,0.906
"10311","Cochabamba","Cochabamba","Colegio Buenas Nuevas C",62,1,1,1,97,2,30,0,1,195,0,6,201,223,0.497,0.901
"10312","Cochabamba","Cochabamba","Colegio Buenas Nuevas C",69,0,3,0,95,5,23,0,1,196,4,3,203,226,0.485,0.898
"10313","Cochabamba","Cochabamba","Colegio Buenas Nuevas C",77,0,2,1,94,5,13,0,2,194,3,7,204,221,0.485,0.923
"10314","Cochabamba","Cochabamba","Colegio Buenas Nuevas C",74,1,0,1,83,4,18,1,0,182,3,9,194,217,0.456,0.894
"10315","Cochabamba","Cochabamba","Colegio Buenas Nuevas C",87,0,0,0,79,6,17,1,1,191,2,12,205,226,0.414,0.907
"10316","Cochabamba","Cochabamba","Colegio Buenas Nuevas C",67,1,0,0,91,7,15,0,3,184,1,10,195,222,0.495,0.878
"10317","Cochabamba","Cochabamba","Colegio Buenas Nuevas C",65,0,3,1,86,3,35,0,2,195,3,6,204,229,0.441,0.891
"10318","Cochabamba","Cochabamba","Colegio Buenas Nuevas C",85,0,2,0,70,3,20,1,4,185,0,7,192,213,0.378,0.901
"10319","Cochabamba","Cochabamba","Colegio Buenas Nuevas C",43,1,4,1,103,4,17,0,2,175,2,9,186,214,0.589,0.869
"10320","Cochabamba","Cochabamba","Colegio Buenas Nuevas C",87,0,1,0,85,3,18,0,1,195,2,8,205,225,0.436,0.911
"10321","Cochabamba","Cochabamba","Colegio Buenas Nuevas C",73,0,1,0,87,6,21,0,1,189,1,4,194,228,0.46,0.851
"10322","Cochabamba","Cochabamba","Colegio Buenas Nuevas C",71,1,0,0,105,4,11,1,0,193,4,6,203,229,0.544,0.886
"10323","Cochabamba","Cochabamba","Colegio Buenas Nuevas C",79,1,1,0,79,1,24,0,2,187,1,7,195,216,0.422,0.903
"10324","Cochabamba","Cochabamba","Colegio Buenas Nuevas C",69,1,1,0,106,2,15,0,2,196,0,5,201,224,0.541,0.897
"10325","Cochabamba","Cochabamba","Colegio Buenas Nuevas C",99,2,0,2,75,7,8,2,3,198,1,4,203,220,0.379,0.923
"10326","Cochabamba","Cochabamba","Colegio Buenas Nuevas C",93,2,1,0,73,4,19,2,1,195,0,7,202,227,0.374,0.89
"10327","Cochabamba","Cochabamba","Colegio Buenas Nuevas C",71,0,3,0,96,3,14,0,2,189,1,2,192,222,0.508,0.865
"10328","Cochabamba","Cochabamba","Colegio Buenas Nuevas C",71,1,2,2,87,4,20,1,2,190,4,4,198,217,0.458,0.912
"10329","Cochabamba","Cochabamba","Unidad Educativa Alto Cochabamba",41,0,2,1,125,5,25,0,3,202,2,6,210,237,0.619,0.886
"10330","Cochabamba","Cochabamba","Unidad Educativa Alto Cochabamba",39,0,0,0,132,5,21,0,0,197,3,10,210,234,0.67,0.897
"10331","Cochabamba","Cochabamba","Escuela IV Centenario",112,0,0,1,59,4,13,1,1,191,1,6,198,221,0.309,0.896
"10332","Cochabamba","Cochabamba","Escuela IV Centenario",112,1,0,1,58,4,5,2,0,183,4,5,192,215,0.317,0.893
"10333","Cochabamba","Cochabamba","Escuela IV Centenario",137,1,0,1,49,1,6,0,1,196,2,1,199,221,0.25,0.9
"10334","Cochabamba","Cochabamba","Escuela IV Centenario",103,1,0,1,74,3,11,0,0,193,2,9,204,227,0.383,0.899
"10335","Cochabamba","Cochabamba","Escuela IV Centenario",94,0,0,2,83,2,9,0,1,191,3,6,200,227,0.435,0.881
"10336","Cochabamba","Cochabamba","Escuela IV Centenario",72,1,1,0,86,7,17,1,1,186,2,3,191,216,0.462,0.884
"10337","Cochabamba","Cochabamba","Escuela IV Centenario",115,0,1,1,69,0,10,2,3,201,0,5,206,226,0.343,0.912
"10338","Cochabamba","Cochabamba","Escuela IV Centenario",99,0,1,1,74,5,10,1,0,191,1,9,201,221,0.387,0.91
"10339","Cochabamba","Cochabamba","Escuela IV Centenario",107,0,2,0,68,4,6,1,2,190,1,4,195,219,0.358,0.89
"10340","Cochabamba","Cochabamba","Escuela IV Centenario",101,1,0,1,66,6,6,0,1,182,2,9,193,225,0.363,0.858
"10341","Cochabamba","Cochabamba","Escuela IV Centenario",117,1,0,0,61,4,8,0,1,192,0,4,196,226,0.318,0.867
"10342","Cochabamba","Cochabamba","Escuela IV Centenario",106,0,0,0,82,5,10,0,0,203,0,6,209,232,0.404,0.901
"10343","Cochabamba","Cochabamba","Escuela IV Centenario",103,0,1,2,69,3,8,1,2,189,1,8,198,223,0.365,0.888
"10344","Cochabamba","Cochabamba","Escuela IV Centenario",117,0,1,1,55,2,9,0,2,187,0,4,191,221,0.294,0.864
"10345","Cochabamba","Cochabamba","Escuela IV Centenario",120,2,1,1,64,4,11,0,0,203,3,6,212,230,0.315,0.922
"10346","Cochabamba","Cochabamba","Escuela IV Centenario",119,1,1,0,61,0,7,1,1,191,0,7,198,226,0.319,0.876
"10347","Cochabamba","Cochabamba","Escuela IV Centenario",89,1,1,0,80,7,5,0,0,183,2,6,191,226,0.437,0.845
"10348","Cochabamba","Cochabamba","Escuela IV Centenario",110,1,0,0,72,0,6,1,3,193,2,5,200,222,0.373,0.901
"10349","Cochabamba","Cochabamba","Escuela IV Centenario",112,0,0,1,54,7,10,0,2,186,1,6,193,222,0.29,0.869
"10350","Cochabamba","Cochabamba","Escuela IV Centenario",126,0,0,1,54,2,8,0,2,193,1,5,199,227,0.28,0.877
"10351","Cochabamba","Cochabamba","Escuela IV Centenario",84,2,1,0,78,2,15,0,2,184,1,13,198,223,0.424,0.888
"10352","Cochabamba","Cochabamba","Escuela IV Centenario",114,0,0,0,54,2,9,1,1,181,3,3,187,213,0.298,0.878
"10353","Cochabamba","Cochabamba","Escuela IV Centenario",117,1,1,1,68,2,5,1,2,198,1,4,203,222,0.343,0.914
"10354","Cochabamba","Cochabamba","Escuela IV Centenario",114,1,0,0,69,4,10,0,0,198,1,4,203,231,0.348,0.879
"10355","Cochabamba","Cochabamba","Unidad Educativa Garibaldi",116,0,1,0,67,7,18,0,0,209,3,3,215,237,0.321,0.907
"10356","Cochabamba","Cochabamba","Unidad Educativa Garibaldi",114,0,0,1,75,1,13,0,2,206,3,4,213,237,0.364,0.899
"10357","Cochabamba","Cochabamba","Unidad Educativa Garibaldi",103,0,0,1,74,3,21,0,1,203,1,4,208,238,0.365,0.874
"10358","Cochabamba","Cochabamba","Unidad Educativa Garibaldi",114,0,1,1,73,4,10,0,1,204,4,3,211,239,0.358,0.883
"10359","Cochabamba","Cochabamba","Unidad Educativa Garibaldi",111,1,0,1,74,4,7,0,1,199,3,5,207,232,0.372,0.892
"10360","Cochabamba","Cochabamba","Unidad Educativa Garibaldi",100,1,1,0,76,5,13,0,2,198,3,9,210,235,0.384,0.894
"10361","Cochabamba","Cochabamba","Unidad Educativa Garibaldi",102,1,1,0,91,3,14,2,0,214,0,5,219,236,0.425,0.928
"10362","Cochabamba","Cochabamba","Unidad Educativa Garibaldi",125,0,0,0,58,3,0,22,0,208,3,9,220,238,0.279,0.924
"10363","Cochabamba","Cochabamba","Unidad Educativa Garibaldi",114,0,1,0,76,4,16,0,2,213,2,10,225,238,0.357,0.945
"10364","Cochabamba","Cochabamba","Unidad Educativa Garibaldi",99,0,0,1,81,4,19,1,2,207,0,11,218,237,0.391,0.92
"10365","Cochabamba","Cochabamba","Unidad Educativa Garibaldi",123,0,0,0,66,4,18,0,2,213,1,2,216,235,0.31,0.919
"10366","Cochabamba","Cochabamba","Unidad Educativa Garibaldi",96,0,2,1,77,4,13,0,4,197,1,10,208,235,0.391,0.885
"10367","Cochabamba","Cochabamba","Unidad Educativa Garibaldi",115,0,1,1,69,7,13,0,2,208,1,9,218,241,0.332,0.905
"10368","Cochabamba","Cochabamba","U. E. Raymundo Herman",115,0,0,0,66,2,8,1,0,192,0,7,199,221,0.344,0.9
"10369","Cochabamba","Cochabamba","U. E. Raymundo Herman",127,0,0,0,56,2,6,0,0,191,0,6,197,225,0.293,0.876
"10370","Cochabamba","Cochabamba","U. E. Raymundo Herman",116,1,0,0,64,6,5,0,0,192,3,8,203,224,0.333,0.906
"10371","Cochabamba","Cochabamba","U. E. Raymundo Herman",125,1,1,1,54,3,5,3,2,195,1,4,200,230,0.277,0.87
"10372","Cochabamba","Cochabamba","U. E. Raymundo Herman",111,1,2,1,62,4,9,0,2,192,2,9,203,220,0.323,0.923
"10373","Cochabamba","Cochabamba","U. E. Raymundo Herman",121,0,1,0,57,3,12,0,1,195,2,5,202,227,0.292,0.89
"10374","Cochabamba","Cochabamba","U. E. Raymundo Herman",113,0,1,0,65,4,9,0,0,192,1,7,200,228,0.339,0.877
"10375","Cochabamba","Cochabamba","U. E. Raymundo Herman",106,0,1,2,75,2,5,0,0,191,6,5,202,225,0.393,0.898
"10376","Cochabamba","Cochabamba","U. E. Raymundo Herman",114,2,0,0,66,5,10,1,2,200,1,4,205,227,0.33,0.903
"10377","Cochabamba","Cochabamba","U. E. Raymundo Herman",117,1,0,0,65,3,6,0,2,194,0,6,200,219,0.335,0.913
"10378","Cochabamba","Cochabamba","U. E. Raymundo Herman",106,0,0,1,67,4,9,0,0,187,1,10,198,226,0.358,0.876
"10379","Cochabamba","Cochabamba","U. E. Raymundo Herman",98,0,0,0,72,4,4,0,2,180,1,3,184,219,0.4,0.84
"10380","Cochabamba","Cochabamba","U. E. Raymundo Herman",114,0,0,0,67,4,5,1,0,191,1,7,199,224,0.351,0.888
"10381","Cochabamba","Cochabamba","U. E. Raymundo Herman",121,0,0,2,62,3,5,2,2,197,0,9,206,226,0.315,0.912
"10382","Cochabamba","Cochabamba","U. E. Raymundo Herman",116,0,2,1,63,5,9,0,3,199,2,3,204,225,0.317,0.907
"10383","Cochabamba","Cochabamba","U. E. Raymundo Herman",117,0,1,0,65,4,6,0,0,193,1,3,197,227,0.337,0.868
"10384","Cochabamba","Cochabamba","U. E. Raymundo Herman",107,0,2,0,69,1,13,0,1,193,0,7,200,220,0.358,0.909
"10385","Cochabamba","Cochabamba","U. E. Raymundo Herman",106,0,3,1,43,18,13,3,2,189,0,3,192,220,0.228,0.873
"10386","Cochabamba","Cochabamba","U. E. Raymundo Herman",121,2,1,0,58,3,9,1,2,197,2,5,204,228,0.294,0.895
"10387","Cochabamba","Cochabamba","U. E. Raymundo Herman",126,0,3,1,57,3,7,2,5,204,0,5,209,224,0.279,0.933
"10388","Cochabamba","Cochabamba","U. E. Raymundo Herman",116,0,1,3,56,4,4,0,1,185,0,5,190,217,0.303,0.876
"10389","Cochabamba","Cochabamba","Colegio Nacional Mixto Cochabamba",133,1,0,1,50,3,5,0,1,194,1,4,199,228,0.258,0.873
"10390","Cochabamba","Cochabamba","Colegio Nacional Mixto Cochabamba",139,0,0,0,46,2,5,0,2,194,0,3,197,225,0.237,0.876
"10391","Cochabamba","Cochabamba","Colegio Nacional Mixto Cochabamba",113,0,0,1,65,2,10,0,1,192,0,10,202,223,0.339,0.906
"10392","Cochabamba","Cochabamba","Colegio Nacional Mixto Cochabamba",132,1,0,0,45,3,8,0,0,189,2,5,196,223,0.238,0.879
"10393","Cochabamba","Cochabamba","Colegio Nacional Mixto Cochabamba",126,0,0,1,53,8,10,1,4,203,0,4,207,230,0.261,0.9
"10394","Cochabamba","Cochabamba","Colegio Nacional Mixto Cochabamba",130,0,2,0,53,2,6,0,3,196,2,4,202,232,0.27,0.871
"10395","Cochabamba","Cochabamba","Colegio Nacional Mixto Cochabamba",121,0,0,2,54,3,8,1,1,190,1,4,195,227,0.284,0.859
"10396","Cochabamba","Cochabamba","Colegio Nacional Mixto Cochabamba",116,0,0,2,57,5,5,0,1,186,1,5,192,222,0.306,0.865
"10397","Cochabamba","Cochabamba","Colegio Nacional Mixto Cochabamba",138,0,0,1,52,3,6,1,1,202,2,1,205,224,0.257,0.915
"10398","Cochabamba","Cochabamba","Colegio Nacional Mixto Cochabamba",132,0,0,0,51,4,10,0,1,198,3,4,205,225,0.258,0.911
"10399","Cochabamba","Cochabamba","Colegio Nacional Mixto Cochabamba",133,0,2,0,51,3,5,0,1,195,0,3,198,222,0.262,0.892
"10400","Cochabamba","Cochabamba","Colegio Nacional Mixto Cochabamba",126,1,0,1,43,4,10,0,0,185,2,6,193,227,0.232,0.85
"10401","Cochabamba","Cochabamba","Colegio Nacional Mixto Cochabamba",105,1,0,0,71,5,10,2,3,197,1,10,208,228,0.36,0.912
"10402","Cochabamba","Cochabamba","Colegio Nacional Mixto Cochabamba",121,0,0,1,65,0,8,0,1,196,1,4,201,225,0.332,0.893
"10403","Cochabamba","Cochabamba","Colegio Nacional Mixto Cochabamba",128,0,0,1,51,6,6,1,0,193,2,1,196,219,0.264,0.895
"10404","Cochabamba","Cochabamba","Colegio Nacional Mixto Cochabamba",133,1,1,1,54,2,9,0,1,202,1,1,204,227,0.267,0.899
"10405","Cochabamba","Cochabamba","Colegio Nacional Mixto Cochabamba",121,0,2,0,60,5,2,0,1,191,0,6,197,221,0.314,0.891
"10406","Cochabamba","Cochabamba","Colegio Nacional Mixto Cochabamba",119,0,1,2,61,6,5,0,0,194,1,0,195,222,0.314,0.878
"10407","Cochabamba","Cochabamba","Colegio Nacional Mixto Cochabamba",116,0,0,1,62,1,15,0,2,197,2,6,205,226,0.315,0.907
"10408","Cochabamba","Cochabamba","Colegio Nacional Mixto Cochabamba",126,0,0,3,48,8,13,0,0,198,2,4,204,225,0.242,0.907
"10409","Cochabamba","Cochabamba","Colegio Nacional Mixto Cochabamba",118,1,1,1,52,2,11,1,0,187,1,9,197,225,0.278,0.876
"10410","Cochabamba","Cochabamba","Colegio Nacional Mixto Cochabamba",140,0,0,0,48,6,8,0,1,203,0,0,203,224,0.236,0.906
"10411","Cochabamba","Cochabamba","Colegio Nacional Mixto Cochabamba",116,2,1,0,48,6,12,0,1,186,1,4,191,225,0.258,0.849
"10412","Cochabamba","Cochabamba","Colegio Nacional Mixto Cochabamba",121,0,1,1,52,4,3,2,1,185,0,4,189,223,0.281,0.848
"10413","Cochabamba","Cochabamba","Colegio Nacional Mixto Cochabamba",149,0,0,0,36,4,7,0,1,197,0,4,201,230,0.183,0.874
"10414","Cochabamba","Cochabamba","Colegio Nacional Mixto Cochabamba",115,1,1,0,62,2,11,0,1,193,0,9,202,219,0.321,0.922
"10415","Cochabamba","Cochabamba","U. E. Cosmos",178,0,0,0,44,0,8,1,2,233,2,3,238,240,0.189,0.992
"10416","Cochabamba","Cochabamba","U. E. Cosmos",156,2,1,1,47,1,10,0,0,218,0,9,227,238,0.216,0.954
"10417","Cochabamba","Cochabamba","U. E. Cosmos",164,0,0,0,45,2,16,0,1,228,0,4,232,239,0.197,0.971
"10418","Cochabamba","Cochabamba","Colegio Branco Petricevic",119,0,1,0,58,1,5,1,1,186,1,2,189,223,0.312,0.848
"10419","Cochabamba","Cochabamba","Colegio Branco Petricevic",131,0,1,3,56,5,2,1,0,199,1,3,203,226,0.281,0.898
"10420","Cochabamba","Cochabamba","Colegio Branco Petricevic",159,0,0,1,38,1,2,0,0,201,0,6,207,227,0.189,0.912
"10421","Cochabamba","Cochabamba","Colegio Branco Petricevic",142,1,0,0,48,4,1,1,2,199,0,7,206,229,0.241,0.9
"10422","Cochabamba","Cochabamba","Colegio Branco Petricevic",131,1,0,1,41,4,7,0,0,185,0,9,194,224,0.222,0.866
"10423","Cochabamba","Cochabamba","Colegio Branco Petricevic",152,1,0,0,42,1,2,1,0,199,0,4,203,226,0.211,0.898
"10424","Cochabamba","Cochabamba","Colegio Branco Petricevic",102,1,1,3,79,4,8,2,0,200,1,6,207,231,0.395,0.896
"10425","Cochabamba","Cochabamba","Colegio Branco Petricevic",111,1,0,0,54,3,7,1,1,178,0,8,186,219,0.303,0.849
"10426","Cochabamba","Cochabamba","Colegio Branco Petricevic",133,2,0,2,42,4,5,0,1,189,0,7,196,217,0.222,0.903
"10427","Cochabamba","Cochabamba","Colegio Branco Petricevic",129,1,1,0,45,5,7,2,0,190,3,5,198,228,0.237,0.868
"10428","Cochabamba","Cochabamba","Colegio Branco Petricevic",131,1,0,0,51,2,8,1,0,194,3,4,201,228,0.263,0.882
"10429","Cochabamba","Cochabamba","Colegio Branco Petricevic",131,0,1,2,49,2,3,0,2,190,1,6,197,225,0.258,0.876
"10430","Cochabamba","Cochabamba","Colegio Branco Petricevic",141,0,3,2,43,2,6,0,2,199,0,5,204,231,0.216,0.883
"10431","Cochabamba","Cochabamba","Colegio Branco Petricevic",140,0,1,0,48,3,3,0,2,197,1,2,200,226,0.244,0.885
"10432","Cochabamba","Cochabamba","Colegio Branco Petricevic",121,0,1,0,48,3,8,0,2,183,0,7,190,222,0.262,0.856
"10433","Cochabamba","Cochabamba","Colegio Branco Petricevic",130,0,0,1,50,3,6,0,4,194,1,3,198,225,0.258,0.88
"10434","Cochabamba","Cochabamba","Colegio Branco Petricevic",136,0,1,1,36,3,4,0,1,182,2,7,191,224,0.198,0.853
"10435","Cochabamba","Cochabamba","Colegio Branco Petricevic",141,0,0,2,50,2,5,0,0,200,0,5,205,230,0.25,0.891
"10436","Cochabamba","Cochabamba","Colegio Branco Petricevic",133,0,0,0,53,3,4,1,0,194,1,5,200,227,0.273,0.881
"10437","Cochabamba","Cochabamba","Colegio Branco Petricevic",149,0,1,0,47,1,4,0,0,202,0,7,209,232,0.233,0.901
"10438","Cochabamba","Cochabamba","Colegio Branco Petricevic",121,0,2,1,49,5,7,0,3,188,2,5,195,220,0.261,0.886
"10439","Cochabamba","Cochabamba","Colegio Branco Petricevic",126,1,0,3,48,3,9,1,0,191,1,6,198,222,0.251,0.892
"10440","Cochabamba","Cochabamba","Colegio Branco Petricevic",140,0,0,0,52,5,3,0,0,200,1,3,204,226,0.26,0.903
"10441","Cochabamba","Cochabamba","Colegio Branco Petricevic",122,0,0,1,53,4,3,1,2,186,0,5,191,223,0.285,0.857
"10442","Cochabamba","Cochabamba","Colegio Branco Petricevic",134,1,1,0,54,2,5,0,0,197,2,10,209,226,0.274,0.925
"10443","Cochabamba","Cochabamba","Colegio Branco Petricevic",127,0,0,0,50,2,9,0,1,189,1,9,199,227,0.265,0.877
"10444","Cochabamba","Cochabamba","Colegio Branco Petricevic",129,0,1,0,41,2,5,1,0,179,0,5,184,217,0.229,0.848
"10445","Cochabamba","Cochabamba","Colegio Branco Petricevic",142,0,0,1,47,2,7,1,1,201,1,3,205,229,0.234,0.895
"10446","Cochabamba","Cochabamba","Colegio Branco Petricevic",147,0,0,1,45,2,5,0,2,202,0,3,205,223,0.223,0.919
"10447","Cochabamba","Cochabamba","Colegio Branco Petricevic",114,0,0,0,51,4,6,0,1,176,3,10,189,221,0.29,0.855
"10448","Cochabamba","Cochabamba","Colegio Luis Quintin Vila",119,2,1,1,46,5,7,0,2,183,1,11,195,226,0.251,0.863
"10449","Cochabamba","Cochabamba","Colegio Luis Quintin Vila",127,0,1,1,44,3,3,1,2,182,1,11,194,218,0.242,0.89
"10450","Cochabamba","Cochabamba","Colegio Luis Quintin Vila",143,0,0,0,51,2,1,0,0,197,1,5,203,224,0.259,0.906
"10451","Cochabamba","Cochabamba","Colegio Luis Quintin Vila",127,1,2,1,55,2,6,0,0,194,0,15,209,229,0.284,0.913
"10452","Cochabamba","Cochabamba","Colegio Luis Quintin Vila",138,0,0,0,43,1,3,0,1,186,0,7,193,218,0.231,0.885
"10453","Cochabamba","Cochabamba","Colegio Luis Quintin Vila",125,0,0,0,55,3,7,1,1,192,0,8,200,226,0.286,0.885
"10454","Cochabamba","Cochabamba","Colegio Luis Quintin Vila",123,1,1,0,59,2,10,1,1,198,3,7,208,222,0.298,0.937
"10455","Cochabamba","Cochabamba","Colegio Luis Quintin Vila",151,0,2,0,31,5,6,2,1,198,3,7,208,232,0.157,0.897
"10456","Cochabamba","Cochabamba","Colegio Luis Quintin Vila",133,0,1,1,41,9,8,0,1,194,0,7,201,228,0.211,0.882
"10457","Cochabamba","Cochabamba","Colegio Luis Quintin Vila",132,0,1,0,51,9,6,0,0,199,2,3,204,226,0.256,0.903
"10458","Cochabamba","Cochabamba","Colegio Luis Quintin Vila",139,0,0,2,54,2,6,0,1,204,0,2,206,227,0.265,0.907
"10459","Cochabamba","Cochabamba","Colegio Luis Quintin Vila",132,1,0,0,45,5,3,2,0,188,2,3,193,219,0.239,0.881
"10460","Cochabamba","Cochabamba","Colegio Luis Quintin Vila",116,2,0,0,53,4,18,1,3,197,0,10,207,231,0.269,0.896
"10461","Cochabamba","Cochabamba","Colegio Luis Quintin Vila",133,0,0,0,50,4,3,1,0,191,2,8,201,225,0.262,0.893
"10462","Cochabamba","Cochabamba","Colegio Luis Quintin Vila",145,0,1,0,43,7,5,0,0,201,1,1,203,232,0.214,0.875
"10463","Cochabamba","Cochabamba","Colegio Luis Quintin Vila",125,0,1,0,38,9,7,0,1,181,2,6,189,222,0.21,0.851
"10464","Cochabamba","Cochabamba","Colegio Luis Quintin Vila",124,1,0,0,60,5,4,1,0,195,0,8,203,225,0.308,0.902
"10465","Cochabamba","Cochabamba","Colegio Luis Quintin Vila",149,0,1,0,47,3,6,0,0,206,5,0,211,229,0.228,0.921
"10466","Cochabamba","Cochabamba","Colegio Luis Quintin Vila",132,0,1,1,50,2,7,0,2,195,0,9,204,227,0.256,0.899
"10467","Cochabamba","Cochabamba","Colegio Luis Quintin Vila",132,0,2,0,53,3,5,0,0,195,0,10,205,229,0.272,0.895
"10468","Cochabamba","Cochabamba","Colegio Luis Quintin Vila",143,0,0,0,43,3,8,1,0,198,1,3,202,225,0.217,0.898
"10469","Cochabamba","Cochabamba","Colegio Luis Quintin Vila",126,0,0,0,44,4,4,2,2,182,0,7,189,220,0.242,0.859
"10470","Cochabamba","Cochabamba","Colegio Luis Quintin Vila",136,0,0,0,53,1,2,0,0,192,1,7,200,225,0.276,0.889
"10471","Cochabamba","Cochabamba","Colegio Luis Quintin Vila",134,1,0,0,53,2,7,1,0,198,4,3,205,227,0.268,0.903
"10472","Cochabamba","Cochabamba","Colegio Luis Quintin Vila",136,1,1,2,45,2,4,0,0,191,0,6,197,222,0.236,0.887
"10473","Cochabamba","Cochabamba","Colegio Luis Quintin Vila",140,0,0,0,55,3,1,0,0,199,2,8,209,226,0.276,0.925
"10474","Cochabamba","Cochabamba","Colegio Luis Quintin Vila",139,1,1,0,45,8,4,0,1,199,2,4,205,231,0.226,0.887
"10475","Cochabamba","Cochabamba","Unidad Educativa Facundo Quiroga",156,0,0,0,54,4,8,1,2,225,0,2,227,239,0.24,0.95
"10476","Cochabamba","Cochabamba","Unidad Educativa Facundo Quiroga",156,0,1,0,41,1,10,3,2,214,2,8,224,240,0.192,0.933
"10477","Cochabamba","Cochabamba","Unidad Educativa Facundo Quiroga",157,0,0,0,47,1,10,2,1,218,2,3,223,240,0.216,0.929
"10478","Cochabamba","Cochabamba","Unidad Educativa Facundo Quiroga",158,0,0,0,45,4,7,1,2,217,1,12,230,239,0.207,0.962
"10479","Cochabamba","Cochabamba","Unidad Educativa Facundo Quiroga",143,1,1,0,50,7,11,1,0,214,0,5,219,238,0.234,0.92
"10480","Cochabamba","Cochabamba","Unidad Educativa Facundo Quiroga",147,0,1,0,43,4,11,0,1,207,3,8,218,238,0.208,0.916
"10481","Cochabamba","Cochabamba","Colegio Richard Von Weizacker",149,0,1,1,46,3,0,0,0,200,0,6,206,231,0.23,0.892
"10482","Cochabamba","Cochabamba","Colegio Richard Von Weizacker",174,0,0,0,22,3,0,0,1,200,0,3,203,228,0.11,0.89
"10483","Cochabamba","Cochabamba","Colegio Richard Von Weizacker",143,0,2,0,44,3,5,3,0,200,1,2,203,228,0.22,0.89
"10484","Cochabamba","Cochabamba","Colegio Richard Von Weizacker",155,0,1,2,36,3,4,2,0,203,0,0,203,229,0.177,0.886
"10485","Cochabamba","Cochabamba","Colegio Richard Von Weizacker",152,0,0,0,33,0,5,0,3,193,0,4,197,223,0.171,0.883
"10486","Cochabamba","Cochabamba","Colegio Richard Von Weizacker",137,1,2,0,33,1,8,1,1,184,0,8,192,221,0.179,0.869
"10487","Cochabamba","Cochabamba","Colegio Richard Von Weizacker",148,0,0,2,28,9,6,0,1,194,0,5,199,223,0.144,0.892
"10488","Cochabamba","Cochabamba","Colegio Richard Von Weizacker",149,0,0,0,34,4,5,0,2,194,0,5,199,232,0.175,0.858
"10489","Cochabamba","Cochabamba","Colegio Richard Von Weizacker",153,0,1,2,47,3,5,0,0,211,0,2,213,228,0.223,0.934
"10490","Cochabamba","Cochabamba","Colegio Richard Von Weizacker",156,0,0,0,47,1,6,0,2,212,1,2,215,237,0.222,0.907
"10491","Cochabamba","Cochabamba","Colegio Richard Von Weizacker",162,0,0,1,37,0,4,1,0,205,0,9,214,232,0.18,0.922
"10492","Cochabamba","Cochabamba","Colegio Richard Von Weizacker",145,1,0,0,35,4,5,1,0,191,0,3,194,226,0.183,0.858
"10493","Cochabamba","Cochabamba","U. E. Jorge Vásquez",193,1,1,1,21,3,4,2,0,226,1,5,232,240,0.093,0.967
"10494","Cochabamba","Cochabamba","U. E. Jorge Vásquez",172,0,1,0,36,4,8,1,1,223,1,8,232,239,0.161,0.971
"10495","Cochabamba","Cochabamba","U. E. Jorge Vásquez",174,0,0,0,37,3,10,0,0,224,0,4,228,239,0.165,0.954
"10496","Cochabamba","Cochabamba","U. E. Jorge Vásquez",177,0,0,0,32,2,14,1,0,226,0,4,230,239,0.142,0.962
"10497","Cochabamba","Cochabamba","U. E. Jorge Vásquez",136,0,1,0,26,3,4,2,0,172,0,3,175,188,0.151,0.931
"10498","Cochabamba","Cochabamba","Centro Particular Geronimo De Osorio",130,0,1,0,52,2,8,0,1,194,2,4,200,228,0.268,0.877
"10499","Cochabamba","Cochabamba","Centro Particular Geronimo De Osorio",130,0,0,0,47,2,4,1,0,184,1,7,192,221,0.255,0.869
"10500","Cochabamba","Cochabamba","Centro Particular Geronimo De Osorio",111,0,0,0,61,4,9,1,5,191,3,6,200,227,0.319,0.881
"10501","Cochabamba","Cochabamba","Centro Particular Geronimo De Osorio",134,0,1,0,46,6,11,0,0,198,2,7,207,231,0.232,0.896
"10502","Cochabamba","Cochabamba","Centro Particular Geronimo De Osorio",128,0,1,0,50,4,8,0,0,191,3,7,201,227,0.262,0.885
"10503","Cochabamba","Cochabamba","Centro Particular Geronimo De Osorio",122,0,1,0,60,4,8,0,2,197,2,5,204,229,0.305,0.891
"10504","Cochabamba","Cochabamba","Centro Particular Geronimo De Osorio",109,1,0,1,61,4,7,0,1,184,3,13,200,228,0.332,0.877
"10505","Cochabamba","Cochabamba","Centro Particular Geronimo De Osorio",112,1,3,0,69,2,5,0,3,195,2,4,201,228,0.354,0.882
"10506","Cochabamba","Cochabamba","Centro Particular Geronimo De Osorio",115,1,1,1,64,5,4,0,2,193,1,10,204,228,0.332,0.895
"10507","Cochabamba","Cochabamba","Centro Particular Geronimo De Osorio",122,0,1,0,61,4,13,1,1,203,0,3,206,225,0.3,0.916
"10508","Cochabamba","Cochabamba","Centro Particular Geronimo De Osorio",128,0,1,0,54,4,10,0,2,199,1,5,205,225,0.271,0.911
"10509","Cochabamba","Cochabamba","Centro Particular Geronimo De Osorio",112,1,3,1,57,4,8,0,1,187,0,3,190,216,0.305,0.88
"10510","Cochabamba","Cochabamba","Centro Particular Geronimo De Osorio",128,1,0,0,58,4,4,2,1,198,0,6,204,229,0.293,0.891
"10511","Cochabamba","Cochabamba","Centro Particular Geronimo De Osorio",126,0,1,0,61,4,4,4,1,201,0,6,207,227,0.303,0.912
"10512","Cochabamba","Cochabamba","Centro Particular Geronimo De Osorio",103,1,1,0,72,7,11,1,3,199,3,6,208,227,0.362,0.916
"10513","Cochabamba","Cochabamba","Centro Particular Geronimo De Osorio",120,0,1,1,57,2,5,0,1,187,2,5,194,222,0.305,0.874
"10514","Cochabamba","Cochabamba","Centro Particular Geronimo De Osorio",123,0,0,0,62,8,6,0,1,200,1,5,206,229,0.31,0.9
"10515","Cochabamba","Cochabamba","Centro Particular Geronimo De Osorio",104,0,0,0,63,5,6,0,1,179,0,7,186,217,0.352,0.857
"10516","Cochabamba","Cochabamba","Centro Particular Geronimo De Osorio",133,0,1,1,56,2,5,1,2,201,0,8,209,225,0.279,0.929
"10517","Cochabamba","Cochabamba","Centro Particular Geronimo De Osorio",105,0,1,0,75,8,8,2,0,199,1,2,202,224,0.377,0.902
"10518","Cochabamba","Cochabamba","Centro Particular Geronimo De Osorio",120,1,0,2,63,8,5,1,0,200,0,6,206,226,0.315,0.912
"10519","Cochabamba","Cochabamba","Centro Particular Geronimo De Osorio",110,2,0,0,61,5,8,0,1,187,0,4,191,213,0.326,0.897
"10520","Cochabamba","Cochabamba","Centro Particular Geronimo De Osorio",128,0,1,1,52,7,6,1,0,196,1,4,201,223,0.265,0.901
"10521","Cochabamba","Cochabamba","Centro Particular Geronimo De Osorio",108,0,1,0,71,5,6,0,2,193,0,9,202,234,0.368,0.863
"10522","Cochabamba","Cochabamba","Centro Particular Geronimo De Osorio",132,0,0,0,54,5,5,0,1,197,2,2,201,224,0.274,0.897
"10523","Cochabamba","Cochabamba","Centro Particular Geronimo De Osorio",122,0,0,1,58,2,6,2,2,193,0,5,198,224,0.301,0.884
"10524","Cochabamba","Cochabamba","Centro Particular Geronimo De Osorio",116,0,1,0,59,5,3,0,2,186,0,9,195,220,0.317,0.886
"10525","Cochabamba","Cochabamba","Centro Particular Geronimo De Osorio",133,0,1,0,42,2,9,0,4,191,1,3,195,220,0.22,0.886
"10526","Cochabamba","Cochabamba","Unidad Educativa Esteban Arze",131,1,0,2,53,3,7,0,0,197,1,7,205,221,0.269,0.928
"10527","Cochabamba","Cochabamba","Unidad Educativa Esteban Arze",127,1,0,1,45,3,9,1,3,190,2,7,199,225,0.237,0.884
"10528","Cochabamba","Cochabamba","Unidad Educativa Esteban Arze",112,0,0,0,50,2,7,0,1,172,2,7,181,207,0.291,0.874
"10529","Cochabamba","Cochabamba","Unidad Educativa Esteban Arze",104,0,2,0,72,4,5,0,2,189,2,5,196,221,0.381,0.887
"10530","Cochabamba","Cochabamba","Unidad Educativa Esteban Arze",136,0,0,0,48,2,9,1,0,196,2,4,202,226,0.245,0.894
"10531","Cochabamba","Cochabamba","Unidad Educativa Esteban Arze",115,0,0,0,65,1,10,0,0,191,1,14,206,226,0.34,0.912
"10532","Cochabamba","Cochabamba","Unidad Educativa Esteban Arze",111,1,0,1,47,4,4,1,1,170,0,14,184,214,0.276,0.86
"10533","Cochabamba","Cochabamba","Unidad Educativa Esteban Arze",94,2,2,0,80,3,14,0,1,196,2,6,204,220,0.408,0.927
"10534","Cochabamba","Cochabamba","Unidad Educativa Esteban Arze",113,0,1,1,60,5,5,1,0,186,1,5,192,216,0.323,0.889
"10535","Cochabamba","Cochabamba","Unidad Educativa Esteban Arze",109,0,0,0,69,3,12,2,2,197,0,7,204,224,0.35,0.911
"10536","Cochabamba","Cochabamba","Unidad Educativa Esteban Arze",118,0,1,4,64,3,8,0,1,199,1,10,210,230,0.322,0.913
"10537","Cochabamba","Cochabamba","Unidad Educativa Esteban Arze",127,0,0,1,56,8,6,0,0,198,0,6,204,224,0.283,0.911
"10538","Cochabamba","Cochabamba","Unidad Educativa Esteban Arze",106,0,0,1,65,7,8,1,0,188,4,4,196,222,0.346,0.883
"10539","Cochabamba","Cochabamba","Unidad Educativa Esteban Arze",120,1,1,0,53,6,14,0,0,195,1,5,201,227,0.272,0.885
"10540","Cochabamba","Cochabamba","Colegio Tecnico Humanistico Abaroa",146,0,0,0,47,4,8,1,1,207,0,9,216,235,0.227,0.919
"10541","Cochabamba","Cochabamba","Colegio Tecnico Humanistico Abaroa",131,2,0,1,50,3,18,0,4,209,0,7,216,238,0.239,0.908
"10542","Cochabamba","Cochabamba","Colegio Tecnico Humanistico Abaroa",130,0,2,0,70,7,11,0,0,220,1,4,225,238,0.318,0.945
"10543","Cochabamba","Cochabamba","Colegio Tecnico Humanistico Abaroa",132,1,2,0,56,1,14,0,2,208,0,11,219,239,0.269,0.916
"10544","Cochabamba","Cochabamba","Colegio Tecnico Humanistico Abaroa",131,0,0,1,65,5,13,1,2,218,0,3,221,238,0.298,0.929
"10545","Cochabamba","Cochabamba","Colegio Tecnico Humanistico Abaroa",115,0,2,1,68,6,8,1,0,201,2,12,215,237,0.338,0.907
"10546","Cochabamba","Cochabamba","Colegio Tecnico Humanistico Abaroa",130,0,1,1,64,4,13,0,1,214,0,5,219,237,0.299,0.924
"10547","Cochabamba","Cochabamba","Colegio Tecnico Humanistico Abaroa",141,0,0,3,48,3,16,1,0,212,0,3,215,237,0.226,0.907
"10548","Cochabamba","Cochabamba","Colegio Tecnico Humanistico Abaroa",125,0,0,2,65,6,17,0,1,216,2,6,224,236,0.301,0.949
"10549","Cochabamba","Cochabamba","Colegio Tecnico Humanistico Abaroa",143,0,0,0,54,2,9,0,1,209,2,5,216,237,0.258,0.911
"10550","Cochabamba","Cochabamba","U. E. Nilo Soruco Arancibia",115,0,0,0,56,7,6,1,1,186,1,5,192,203,0.301,0.946
"10551","Cochabamba","Cochabamba","Unidad Educativa Santa Maria Micaela",126,1,0,0,60,3,7,0,1,198,1,6,205,225,0.303,0.911
"10552","Cochabamba","Cochabamba","Unidad Educativa Santa Maria Micaela",134,0,1,0,48,6,7,0,0,196,0,4,200,221,0.245,0.905
"10553","Cochabamba","Cochabamba","Unidad Educativa Santa Maria Micaela",133,0,2,1,55,2,7,0,2,202,0,4,206,225,0.272,0.916
"10554","Cochabamba","Cochabamba","Unidad Educativa Santa Maria Micaela",123,0,2,1,58,4,9,0,2,199,1,6,206,227,0.291,0.907
"10555","Cochabamba","Cochabamba","Unidad Educativa Santa Maria Micaela",106,0,0,0,69,4,5,1,0,185,0,9,194,226,0.373,0.858
"10556","Cochabamba","Cochabamba","Unidad Educativa Santa Maria Micaela",120,0,0,0,57,5,6,1,3,192,1,9,202,223,0.297,0.906
"10557","Cochabamba","Cochabamba","Unidad Educativa Santa Maria Micaela",140,1,0,3,43,3,4,0,0,194,2,9,205,229,0.222,0.895
"10558","Cochabamba","Cochabamba","Unidad Educativa Santa Maria Micaela",119,1,1,1,49,5,5,0,2,183,2,5,190,216,0.268,0.88
"10559","Cochabamba","Cochabamba","Unidad Educativa Santa Maria Micaela",130,0,0,1,46,8,9,0,0,194,2,6,202,226,0.237,0.894
"10560","Cochabamba","Cochabamba","Unidad Educativa Santa Maria Micaela",138,0,0,0,57,1,5,0,0,201,0,5,206,226,0.284,0.912
"10561","Cochabamba","Cochabamba","Unidad Educativa Santa Maria Micaela",127,1,0,1,57,3,7,0,1,197,0,4,201,222,0.289,0.905
"10562","Cochabamba","Cochabamba","Unidad Educativa Santa Maria Micaela",108,0,2,0,74,3,11,0,2,200,0,1,201,228,0.37,0.882
"10563","Cochabamba","Cochabamba","Unidad Educativa Santa Maria Micaela",101,1,3,1,69,5,11,0,0,191,1,9,201,228,0.361,0.882
"10564","Cochabamba","Cochabamba","Unidad Educativa Santa Maria Micaela",136,0,1,1,43,1,8,0,2,192,0,7,199,222,0.224,0.896
"10565","Cochabamba","Cochabamba","Unidad Educativa Santa Maria Micaela",132,0,0,2,57,2,8,0,0,201,1,5,207,231,0.284,0.896
"10566","Cochabamba","Cochabamba","Unidad Educativa Santa Maria Micaela",136,0,1,0,50,5,9,0,0,201,0,7,208,232,0.249,0.897
"10567","Cochabamba","Cochabamba","Unidad Educativa Santa Maria Micaela",130,0,1,0,54,4,5,0,3,197,0,5,202,226,0.274,0.894
"10568","Cochabamba","Cochabamba","Unidad Educativa Santa Maria Micaela",104,0,1,0,69,1,8,0,1,184,0,10,194,221,0.375,0.878
"10569","Cochabamba","Cochabamba","Unidad Educativa Santa Maria Micaela",136,0,0,1,44,4,7,0,1,193,1,6,200,227,0.228,0.881
"10570","Cochabamba","Cochabamba","Unidad Educativa Santa Maria Micaela",103,2,2,0,68,6,6,2,0,189,1,5,195,224,0.36,0.871
"10571","Cochabamba","Cochabamba","Unidad Educativa Santa Maria Micaela",116,0,1,0,54,3,11,2,1,188,0,5,193,221,0.287,0.873
"10572","Cochabamba","Cochabamba","Unidad Educativa Santa Maria Micaela",135,0,1,0,51,4,6,0,0,197,2,5,204,223,0.259,0.915
"10573","Cochabamba","Cochabamba","Unidad Educativa Santa Maria Micaela",115,0,0,1,58,3,14,0,1,192,2,8,202,229,0.302,0.882
"10574","Cochabamba","Cochabamba","Unidad Educativa Santa Maria Micaela",141,1,0,0,40,2,7,0,2,193,0,1,194,222,0.207,0.874
"10575","Cochabamba","Cochabamba","Unidad Educativa Felix Capriles",144,0,0,0,56,2,11,0,1,214,1,5,220,237,0.262,0.928
"10576","Cochabamba","Cochabamba","Unidad Educativa Felix Capriles",122,0,1,0,74,3,7,0,1,208,2,9,219,237,0.356,0.924
"10577","Cochabamba","Cochabamba","Unidad Educativa Felix Capriles",139,0,0,0,55,7,16,1,1,219,0,2,221,238,0.251,0.929
"10578","Cochabamba","Cochabamba","Unidad Educativa Felix Capriles",137,1,1,0,61,6,10,0,1,217,1,5,223,236,0.281,0.945
"10579","Cochabamba","Cochabamba","Unidad Educativa Felix Capriles",125,0,0,1,58,7,9,0,4,204,1,4,209,237,0.284,0.882
"10580","Cochabamba","Cochabamba","Unidad Educativa Felix Capriles",110,1,2,0,45,3,11,0,0,172,0,4,176,202,0.262,0.871
"10581","Cochabamba","Cochabamba","Liceo Adela Zamudio",136,0,0,1,47,3,7,0,0,194,1,4,199,229,0.242,0.869
"10582","Cochabamba","Cochabamba","Liceo Adela Zamudio",131,0,0,0,50,1,7,0,0,189,2,9,200,227,0.265,0.881
"10583","Cochabamba","Cochabamba","Liceo Adela Zamudio",128,0,0,0,43,3,5,0,2,181,1,10,192,223,0.238,0.861
"10584","Cochabamba","Cochabamba","Liceo Adela Zamudio",114,0,1,1,63,0,13,0,1,193,2,4,199,227,0.326,0.877
"10585","Cochabamba","Cochabamba","Liceo Adela Zamudio",139,0,0,0,46,2,5,0,0,192,0,5,197,221,0.24,0.891
"10586","Cochabamba","Cochabamba","Liceo Adela Zamudio",138,0,0,1,29,6,5,0,2,181,1,11,193,220,0.16,0.877
"10587","Cochabamba","Cochabamba","Liceo Adela Zamudio",121,0,0,1,42,6,7,0,0,177,1,3,181,216,0.237,0.838
"10588","Cochabamba","Cochabamba","Liceo Adela Zamudio",119,0,0,1,47,4,5,0,0,176,0,13,189,218,0.267,0.867
"10589","Cochabamba","Cochabamba","Liceo Adela Zamudio",114,0,1,0,49,9,4,1,0,178,3,12,193,224,0.275,0.862
"10590","Cochabamba","Cochabamba","Liceo Adela Zamudio",144,0,0,0,37,4,3,0,1,189,0,3,192,218,0.196,0.881
"10591","Cochabamba","Cochabamba","Liceo Adela Zamudio",143,0,1,0,41,3,2,0,1,191,0,4,195,226,0.215,0.863
"10592","Cochabamba","Cochabamba","Liceo Adela Zamudio",132,0,0,0,40,1,7,1,0,181,1,6,188,214,0.221,0.879
"10593","Cochabamba","Cochabamba","Liceo Adela Zamudio",137,0,0,1,35,1,4,1,2,181,1,7,189,222,0.193,0.851
"10594","Cochabamba","Cochabamba","Liceo Adela Zamudio",144,0,0,1,46,2,5,0,0,198,1,4,203,224,0.232,0.906
"10595","Cochabamba","Cochabamba","Liceo Adela Zamudio",133,0,1,0,40,3,6,0,0,183,2,4,189,221,0.219,0.855
"10596","Cochabamba","Cochabamba","Liceo Adela Zamudio",136,0,1,1,52,0,6,0,0,196,2,4,202,234,0.265,0.863
"10597","Cochabamba","Cochabamba","Unidad Educativa Nataniel Aguirre",113,1,0,1,61,3,22,0,1,202,1,2,205,240,0.302,0.854
"10598","Cochabamba","Cochabamba","Unidad Educativa Nataniel Aguirre",122,1,0,0,41,2,7,0,0,173,1,6,180,200,0.237,0.9
"10599","Cochabamba","Cochabamba","Unidad Educativa Maria Emilia Riquelme (Ex Maria Cristina)",95,0,0,0,76,5,10,0,3,189,0,6,195,221,0.402,0.882
"10600","Cochabamba","Cochabamba","Unidad Educativa Maria Emilia Riquelme (Ex Maria Cristina)",108,0,0,1,76,2,9,0,1,197,1,10,208,230,0.386,0.904
"10601","Cochabamba","Cochabamba","Unidad Educativa Maria Emilia Riquelme (Ex Maria Cristina)",111,0,1,0,75,3,6,0,4,200,2,6,208,228,0.375,0.912
"10602","Cochabamba","Cochabamba","Unidad Educativa Maria Emilia Riquelme (Ex Maria Cristina)",94,0,1,2,78,0,17,1,2,195,1,8,204,228,0.4,0.895
"10603","Cochabamba","Cochabamba","Unidad Educativa Maria Emilia Riquelme (Ex Maria Cristina)",91,0,1,1,75,4,19,0,2,193,2,11,206,225,0.389,0.916
"10604","Cochabamba","Cochabamba","Unidad Educativa Maria Emilia Riquelme (Ex Maria Cristina)",114,1,0,0,67,2,10,0,0,194,1,9,204,232,0.345,0.879
"10605","Cochabamba","Cochabamba","Unidad Educativa Maria Emilia Riquelme (Ex Maria Cristina)",101,0,1,1,74,3,8,1,3,192,0,9,201,227,0.385,0.885
"10606","Cochabamba","Cochabamba","Unidad Educativa Maria Emilia Riquelme (Ex Maria Cristina)",98,0,2,1,81,5,10,0,0,197,2,6,205,228,0.411,0.899
"10607","Cochabamba","Cochabamba","Unidad Educativa Maria Emilia Riquelme (Ex Maria Cristina)",98,0,2,2,78,6,6,0,1,193,0,8,201,224,0.404,0.897
"10608","Cochabamba","Cochabamba","Unidad Educativa Maria Emilia Riquelme (Ex Maria Cristina)",124,0,2,0,65,4,8,0,1,204,1,4,209,228,0.319,0.917
"10609","Cochabamba","Cochabamba","Unidad Educativa Maria Emilia Riquelme (Ex Maria Cristina)",112,0,0,1,56,4,20,1,1,195,0,7,202,230,0.287,0.878
"10610","Cochabamba","Cochabamba","Unidad Educativa Maria Emilia Riquelme (Ex Maria Cristina)",119,0,0,0,68,4,13,0,0,204,3,4,211,233,0.333,0.906
"10611","Cochabamba","Cochabamba","Unidad Educativa Maria Emilia Riquelme (Ex Maria Cristina)",104,1,1,1,69,5,9,0,0,190,0,9,199,229,0.363,0.869
"10612","Cochabamba","Cochabamba","Unidad Educativa Maria Emilia Riquelme (Ex Maria Cristina)",122,0,1,0,70,1,5,1,1,201,1,4,206,226,0.348,0.912
"10613","Cochabamba","Cochabamba","Unidad Educativa Maria Emilia Riquelme (Ex Maria Cristina)",102,1,1,0,77,4,7,0,1,193,1,5,199,215,0.399,0.926
"10614","Cochabamba","Cochabamba","Unidad Educativa Jose Ignacio Sanjines",132,0,2,0,52,5,15,0,1,207,1,10,218,236,0.251,0.924
"10615","Cochabamba","Cochabamba","Unidad Educativa Jose Ignacio Sanjines",102,0,1,0,89,5,15,0,1,213,0,2,215,236,0.418,0.911
"10616","Cochabamba","Cochabamba","Unidad Educativa Jose Ignacio Sanjines",131,0,1,0,69,6,8,1,0,216,2,4,222,239,0.319,0.929
"10617","Cochabamba","Cochabamba","Unidad Educativa Jose Ignacio Sanjines",106,1,0,0,65,4,14,1,0,191,1,1,193,234,0.34,0.825
"10618","Cochabamba","Cochabamba","Unidad Educativa Jose Ignacio Sanjines",118,0,1,1,68,6,8,0,1,203,0,5,208,234,0.335,0.889
"10619","Cochabamba","Cochabamba","Unidad Educativa Jose Ignacio Sanjines",133,0,2,0,54,4,15,1,2,211,1,13,225,237,0.256,0.949
"10620","Cochabamba","Cochabamba","Unidad Educativa Jose Ignacio Sanjines",141,0,0,1,57,7,9,4,0,219,0,2,221,235,0.26,0.94
"10621","Cochabamba","Cochabamba","Seminario San Jose",131,1,1,1,46,2,2,1,1,186,0,11,197,228,0.247,0.864
"10622","Cochabamba","Cochabamba","Seminario San Jose",100,1,0,0,73,7,6,0,0,187,1,7,195,222,0.39,0.878
"10623","Cochabamba","Cochabamba","Seminario San Jose",128,0,2,0,50,2,8,0,0,190,1,9,200,221,0.263,0.905
"10624","Cochabamba","Cochabamba","Seminario San Jose",126,1,2,1,62,4,7,0,0,203,0,3,206,224,0.305,0.92
"10625","Cochabamba","Cochabamba","Seminario San Jose",131,1,0,1,59,7,4,0,0,203,0,1,204,221,0.291,0.923
"10626","Cochabamba","Cochabamba","Seminario San Jose",123,0,0,0,63,0,9,0,0,195,2,0,197,226,0.323,0.872
"10627","Cochabamba","Cochabamba","Seminario San Jose",143,0,1,1,54,2,4,1,0,206,1,8,215,229,0.262,0.939
"10628","Cochabamba","Cochabamba","Seminario San Jose",117,0,1,0,67,5,4,0,2,196,0,7,203,227,0.342,0.894
"10629","Cochabamba","Cochabamba","Seminario San Jose",139,1,0,3,47,5,7,2,0,204,1,8,213,229,0.23,0.93
"10630","Cochabamba","Cochabamba","Seminario San Jose",123,0,1,1,64,5,11,1,0,206,0,4,210,231,0.311,0.909
"10631","Cochabamba","Cochabamba","Seminario San Jose",121,2,0,0,59,5,13,0,1,201,1,7,209,225,0.294,0.929
"10632","Cochabamba","Cochabamba","Seminario San Jose",135,0,1,0,52,1,2,0,0,191,1,6,198,223,0.272,0.888
"10633","Cochabamba","Cochabamba","Seminario San Jose",146,1,1,0,53,4,5,1,0,211,0,2,213,232,0.251,0.918
"10634","Cochabamba","Cochabamba","Seminario San Jose",126,0,1,1,59,5,8,1,1,202,1,7,210,227,0.292,0.925
"10635","Cochabamba","Cochabamba","CEMA Centro Frutillitas",160,0,1,1,46,2,14,0,0,224,0,4,228,238,0.205,0.958
"10636","Cochabamba","Cochabamba","CEMA Centro Frutillitas",143,0,0,1,58,2,9,0,2,215,0,4,219,238,0.27,0.92
"10637","Cochabamba","Cochabamba","CEMA Centro Frutillitas",153,0,1,0,51,0,7,1,0,213,0,9,222,239,0.239,0.929
"10638","Cochabamba","Cochabamba","CEMA Centro Frutillitas",115,0,0,1,35,0,2,0,1,154,0,3,157,176,0.227,0.892
"10639","Cochabamba","Cochabamba","Esc. Fiscal Juan XXIII A – Juancito Pinto",119,0,0,1,57,2,9,0,0,188,1,8,197,224,0.303,0.879
"10640","Cochabamba","Cochabamba","Esc. Fiscal Juan XXIII A – Juancito Pinto",128,0,2,2,59,6,2,1,2,202,2,2,206,225,0.292,0.916
"10641","Cochabamba","Cochabamba","Esc. Fiscal Juan XXIII A – Juancito Pinto",118,0,0,1,73,0,7,3,1,203,1,4,208,233,0.36,0.893
"10642","Cochabamba","Cochabamba","Esc. Fiscal Juan XXIII A – Juancito Pinto",134,0,1,0,52,2,7,0,1,197,0,6,203,228,0.264,0.89
"10643","Cochabamba","Cochabamba","Esc. Fiscal Juan XXIII A – Juancito Pinto",136,0,0,1,67,1,6,0,1,212,0,4,216,231,0.316,0.935
"10644","Cochabamba","Cochabamba","Esc. Fiscal Juan XXIII A – Juancito Pinto",127,0,0,0,57,3,8,1,0,196,4,4,204,226,0.291,0.903
"10645","Cochabamba","Cochabamba","Esc. Fiscal Juan XXIII A – Juancito Pinto",131,0,0,0,67,4,6,0,2,210,0,3,213,228,0.319,0.934
"10646","Cochabamba","Cochabamba","Esc. Fiscal Juan XXIII A – Juancito Pinto",126,0,0,1,62,4,11,0,2,206,0,3,209,226,0.301,0.925
"10647","Cochabamba","Cochabamba","Esc. Fiscal Juan XXIII A – Juancito Pinto",110,0,0,0,80,4,2,1,0,197,0,3,200,227,0.406,0.881
"10648","Cochabamba","Cochabamba","Esc. Fiscal Juan XXIII A – Juancito Pinto",134,0,0,1,63,5,5,2,1,211,0,7,218,234,0.299,0.932
"10649","Cochabamba","Cochabamba","Esc. Fiscal Juan XXIII A – Juancito Pinto",136,0,4,1,55,1,9,0,1,207,1,4,212,234,0.266,0.906
"10650","Cochabamba","Cochabamba","Escuela Fiscal Juan XXIII A",129,1,3,0,47,2,8,1,1,192,3,4,199,226,0.245,0.881
"10651","Cochabamba","Cochabamba","Escuela Fiscal Juan XXIII A",119,1,0,1,60,5,5,1,4,196,1,11,208,231,0.306,0.9
"10652","Cochabamba","Cochabamba","Escuela Fiscal Juan XXIII A",117,0,0,0,60,4,8,1,1,191,1,6,198,227,0.314,0.872
"10653","Cochabamba","Cochabamba","Escuela Fiscal Juan XXIII A",102,0,1,0,70,3,6,0,1,183,2,5,190,225,0.383,0.844
"10654","Cochabamba","Cochabamba","Escuela Fiscal Juan XXIII A",110,0,1,0,78,3,9,0,0,201,0,4,205,229,0.388,0.895
"10655","Cochabamba","Cochabamba","Escuela Fiscal Juan XXIII A",118,1,0,1,59,7,6,0,1,193,0,5,198,231,0.306,0.857
"10656","Cochabamba","Cochabamba","Escuela Fiscal Juan XXIII A",129,1,1,1,58,1,8,0,1,200,2,5,207,233,0.29,0.888
"10657","Cochabamba","Cochabamba","Escuela Fiscal Juan XXIII A",110,0,0,1,73,9,6,2,1,202,4,5,211,222,0.361,0.95
"10658","Cochabamba","Cochabamba","Escuela Fiscal Juan XXIII A",127,0,0,0,60,1,9,0,0,197,0,5,202,228,0.305,0.886
"10659","Cochabamba","Cochabamba","Escuela Fiscal Juan XXIII A",112,0,1,0,68,4,17,0,0,202,1,3,206,222,0.337,0.928
"10660","Cochabamba","Cochabamba","Escuela Fiscal Juan XXIII A",107,1,0,0,59,5,5,0,2,179,2,9,190,222,0.33,0.856
"10661","Cochabamba","Cochabamba","Escuela Fiscal Juan XXIII A",107,0,2,0,73,6,7,0,1,196,3,3,202,224,0.372,0.902
"10662","Cochabamba","Cochabamba","Escuela Fiscal Juan XXIII A",120,0,0,0,62,1,2,0,0,185,1,6,192,214,0.335,0.897
"10663","Cochabamba","Cochabamba","Escuela Fiscal Juan XXIII A",131,0,1,0,56,1,5,1,1,196,0,5,201,224,0.286,0.897
"10664","Cochabamba","Cochabamba","Escuela Fiscal Juan XXIII A",120,0,0,0,57,1,7,1,0,186,0,5,191,224,0.306,0.853
"10665","Cochabamba","Cochabamba","Escuela Fiscal Juan XXIII A",130,0,0,0,51,3,4,2,1,191,0,8,199,227,0.267,0.877
"10666","Cochabamba","Cochabamba","Escuela Fiscal Juan XXIII A",130,0,2,0,63,1,5,3,1,205,0,0,205,223,0.307,0.919
"10667","Cochabamba","Cochabamba","Escuela Fiscal Juan XXIII A",105,0,0,1,50,2,11,0,3,172,1,4,177,204,0.291,0.868
"10668","Cochabamba","Cochabamba","Escuela Gutierrez Mariscal",95,2,0,0,94,7,8,0,1,207,2,6,215,230,0.454,0.935
"10669","Cochabamba","Cochabamba","Escuela Gutierrez Mariscal",99,1,0,1,90,4,7,2,4,208,2,3,213,232,0.433,0.918
"10670","Cochabamba","Cochabamba","Escuela Gutierrez Mariscal",105,0,2,0,69,3,11,1,2,193,0,5,198,229,0.358,0.865
"10671","Cochabamba","Cochabamba","Escuela Gutierrez Mariscal",124,1,0,0,63,6,5,0,0,199,0,10,209,233,0.317,0.897
"10672","Cochabamba","Cochabamba","Escuela Gutierrez Mariscal",106,0,0,0,84,1,12,0,0,203,0,11,214,233,0.414,0.918
"10673","Cochabamba","Cochabamba","Escuela Gutierrez Mariscal",122,0,0,2,70,3,6,0,1,204,1,7,212,228,0.343,0.93
"10674","Cochabamba","Cochabamba","Escuela Gutierrez Mariscal",85,0,5,1,101,3,12,1,4,212,2,3,217,229,0.476,0.948
"10675","Cochabamba","Cochabamba","Escuela Gutierrez Mariscal",99,0,2,0,85,4,12,0,1,203,0,6,209,228,0.419,0.917
"10676","Cochabamba","Cochabamba","Escuela Gutierrez Mariscal",117,1,0,1,69,2,13,0,2,205,1,4,210,229,0.337,0.917
"10677","Cochabamba","Cochabamba","Escuela Gutierrez Mariscal",107,0,1,1,73,4,14,1,3,204,2,11,217,233,0.358,0.931
"10678","Cochabamba","Cochabamba","Escuela Gutierrez Mariscal",107,0,0,0,78,9,14,1,0,209,2,5,216,233,0.373,0.927
"10679","Cochabamba","Cochabamba","Escuela Gutierrez Mariscal",117,1,3,0,69,4,10,0,2,206,0,6,212,229,0.335,0.926
"10680","Cochabamba","Cochabamba","Escuela Gutierrez Mariscal",109,0,0,0,68,10,9,0,0,196,2,10,208,226,0.347,0.92
"10681","Cochabamba","Cochabamba","Escuela Gutierrez Mariscal",96,0,0,1,94,5,5,0,0,201,2,9,212,235,0.468,0.902
"10682","Cochabamba","Cochabamba","Escuela Gutierrez Mariscal",109,0,0,0,77,5,8,1,1,201,0,9,210,225,0.383,0.933
"10683","Cochabamba","Cochabamba","Escuela Gutierrez Mariscal",81,0,1,0,86,7,12,0,1,188,1,7,196,225,0.457,0.871
"10684","Cochabamba","Cochabamba","Escuela Gutierrez Mariscal",84,0,0,0,101,2,14,1,4,206,1,7,214,229,0.49,0.934
"10685","Cochabamba","Cochabamba","Escuela Gutierrez Mariscal",104,0,1,0,75,1,13,1,0,195,0,9,204,229,0.385,0.891
"10686","Cochabamba","Cochabamba","Escuela Gutierrez Mariscal",116,0,0,1,74,3,6,0,1,201,1,5,207,229,0.368,0.904
"10687","Cochabamba","Cochabamba","Escuela Gutierrez Mariscal",125,0,2,1,52,8,10,0,1,199,2,3,204,225,0.261,0.907
"10688","Cochabamba","Cochabamba","Escuela Gutierrez Mariscal",115,0,0,0,68,4,11,0,2,200,0,8,208,226,0.34,0.92
"10689","Cochabamba","Cochabamba","Escuela Gutierrez Mariscal",122,0,0,0,69,5,10,0,1,207,4,4,215,232,0.333,0.927
"10690","Cochabamba","Cochabamba","Escuela Gutierrez Mariscal",102,0,1,0,81,8,12,1,1,206,2,2,210,223,0.393,0.942
"10691","Cochabamba","Cochabamba","Escuela Gutierrez Mariscal",111,0,1,1,61,5,11,0,4,194,3,8,205,226,0.314,0.907
"10692","Cochabamba","Cochabamba","Escuela Gutierrez Mariscal",115,0,2,0,76,2,6,0,1,202,1,4,207,220,0.376,0.941
"10693","Cochabamba","Cochabamba","Escuela Gutierrez Mariscal",106,1,1,0,80,4,8,0,3,203,3,10,216,233,0.394,0.927
"10694","Cochabamba","Cochabamba","Escuela Gutierrez Mariscal",123,0,1,0,76,1,7,0,0,208,0,8,216,231,0.365,0.935
"10695","Cochabamba","Cochabamba","Escuela Gutierrez Mariscal",121,1,1,0,64,5,11,0,1,204,0,6,210,226,0.314,0.929
"10696","Cochabamba","Cochabamba","Escuela Gutierrez Mariscal",115,1,1,0,60,5,9,0,0,191,1,14,206,228,0.314,0.904
"10697","Cochabamba","Cochabamba","Escuela Gutierrez Mariscal",104,0,0,0,67,8,10,0,3,192,1,10,203,230,0.349,0.883
"10698","Cochabamba","Cochabamba","U. E. Nuestra Señora de la Merced A",113,1,0,1,65,5,26,0,0,211,0,11,222,239,0.308,0.929
"10699","Cochabamba","Cochabamba","U. E. Nuestra Señora de la Merced A",101,1,1,1,103,7,14,0,0,228,1,4,233,239,0.452,0.975
"10700","Cochabamba","Cochabamba","U. E. Nuestra Señora de la Merced A",113,0,1,1,87,5,15,1,3,226,2,8,236,244,0.385,0.967
"10701","Cochabamba","Cochabamba","Unidad Educativa Vision Mundial",70,1,1,0,91,5,17,0,1,186,1,6,193,224,0.489,0.862
"10702","Cochabamba","Cochabamba","Unidad Educativa Vision Mundial",79,0,0,0,97,2,9,2,1,190,2,6,198,227,0.511,0.872
"10703","Cochabamba","Cochabamba","Unidad Educativa Vision Mundial",70,2,1,1,103,6,12,0,2,197,1,4,202,228,0.523,0.886
"10704","Cochabamba","Cochabamba","Unidad Educativa Vision Mundial",64,0,2,2,92,2,20,0,2,184,1,13,198,226,0.5,0.876
"10705","Cochabamba","Cochabamba","Unidad Educativa Vision Mundial",51,1,1,1,115,4,20,0,0,193,0,7,200,232,0.596,0.862
"10706","Cochabamba","Cochabamba","Unidad Educativa Vision Mundial",53,0,1,0,128,8,16,1,0,207,1,6,214,230,0.618,0.93
"10707","Cochabamba","Cochabamba","Unidad Educativa Vision Mundial",89,2,0,2,91,5,15,0,3,207,0,6,213,229,0.44,0.93
"10708","Cochabamba","Cochabamba","Unidad Educativa Vision Mundial",69,2,0,0,96,4,11,1,1,184,2,12,198,222,0.522,0.892
"10709","Cochabamba","Cochabamba","Unidad Educativa Vision Mundial",82,0,0,0,86,2,16,1,1,188,1,5,194,218,0.457,0.89
"10710","Cochabamba","Cochabamba","Unidad Educativa Vision Mundial",47,0,1,0,113,1,31,0,0,193,1,3,197,232,0.585,0.849
"10711","Cochabamba","Cochabamba","Unidad Educativa Vision Mundial",61,1,2,0,102,7,18,0,2,193,0,12,205,228,0.528,0.899
"10712","Cochabamba","Cochabamba","Unidad Educativa Vision Mundial",61,1,0,2,116,1,13,0,3,197,0,6,203,231,0.589,0.879
"10713","Cochabamba","Cochabamba","Unidad Educativa Vision Mundial",72,0,2,2,102,2,16,0,1,197,1,3,201,222,0.518,0.905
"10714","Cochabamba","Cochabamba","Unidad Educativa Vision Mundial",59,0,0,0,116,1,16,0,1,193,3,1,197,232,0.601,0.849
"10715","Cochabamba","Cochabamba","Unidad Educativa Vision Mundial",57,0,1,1,107,3,17,0,5,191,4,5,200,218,0.56,0.917
"10716","Cochabamba","Cochabamba","Unidad Educativa Vision Mundial",80,0,1,0,95,4,14,0,3,197,0,5,202,226,0.482,0.894
"10717","Cochabamba","Cochabamba","Unidad Educativa Vision Mundial",54,1,2,0,106,4,17,2,1,187,5,8,200,226,0.567,0.885
"10718","Cochabamba","Cochabamba","Unidad Educativa Vision Mundial",72,1,2,0,91,4,16,1,0,187,3,12,202,230,0.487,0.878
"10719","Cochabamba","Cochabamba","Unidad Educativa Vision Mundial",68,0,0,0,101,3,13,1,1,187,3,6,196,229,0.54,0.856
"10720","Cochabamba","Cochabamba","Unidad Educativa Vision Mundial",65,0,2,1,100,4,15,1,3,191,2,6,199,224,0.524,0.888
"10721","Cochabamba","Cochabamba","Unidad Educativa Vision Mundial",81,0,1,1,89,4,14,0,1,191,3,7,201,230,0.466,0.874
"10722","Cochabamba","Cochabamba","Unidad Educativa Vision Mundial",75,0,1,1,104,3,10,0,2,196,0,3,199,226,0.531,0.881
"10723","Cochabamba","Cochabamba","Unidad Educativa Rene Crespo",34,0,0,0,120,4,34,1,0,193,1,6,200,229,0.622,0.873
"10724","Cochabamba","Cochabamba","Unidad Educativa Rene Crespo",47,0,1,2,111,6,27,0,2,196,7,6,209,235,0.566,0.889
"10725","Cochabamba","Cochabamba","Unidad Educativa Rene Crespo",47,1,0,0,113,5,31,0,3,200,3,6,209,230,0.565,0.909
"10726","Cochabamba","Cochabamba","Unidad Educativa Rene Crespo",44,1,1,1,127,4,20,0,3,201,5,1,207,230,0.632,0.9
"10727","Cochabamba","Cochabamba","Unidad Educativa Maria Josefa Mujia",51,0,0,0,134,5,18,0,3,211,5,8,224,237,0.635,0.945
"10728","Cochabamba","Cochabamba","Unidad Educativa Maria Josefa Mujia",31,0,2,0,145,3,30,0,2,213,1,6,220,234,0.681,0.94
"10729","Cochabamba","Cochabamba","Unidad Educativa Maria Josefa Mujia",31,2,2,3,134,3,27,0,3,205,4,7,216,233,0.654,0.927
"10730","Cochabamba","Cochabamba","Unidad Educativa Maria Josefa Mujia",32,0,2,0,138,5,32,0,0,209,4,7,220,236,0.66,0.932
"10731","Cochabamba","Cochabamba","Unidad Educativa Maria Josefa Mujia",21,0,0,1,131,0,22,0,0,175,2,40,217,233,0.749,0.931
"10732","Cochabamba","Cochabamba","Unidad Educativa Maria Josefa Mujia",28,0,3,0,147,3,17,2,4,204,3,3,210,230,0.721,0.913
"10733","Cochabamba","Cochabamba","Unidad Educativa Maria Josefa Mujia",33,0,0,0,147,1,28,0,4,213,3,2,218,234,0.69,0.932
"10734","Cochabamba","Cochabamba","Unidad Educativa Maria Josefa Mujia",31,1,3,0,149,3,24,0,2,213,2,3,218,236,0.7,0.924
"10735","Cochabamba","Cochabamba","Unidad Educativa Maria Josefa Mujia",32,1,4,0,152,3,22,0,1,215,4,5,224,233,0.707,0.961
"10736","Cochabamba","Cochabamba","Unidad Educativa Maria Josefa Mujia",28,2,4,3,143,3,24,1,2,210,5,7,222,235,0.681,0.945
"10737","Cochabamba","Cochabamba","Unidad Educativa Maria Josefa Mujia",30,1,4,1,151,3,23,0,3,216,1,8,225,236,0.699,0.953
"10738","Cochabamba","Cochabamba","Unidad Educativa Maria Josefa Mujia",28,1,2,2,147,3,25,0,2,210,0,6,216,236,0.7,0.915
"10739","Cochabamba","Cochabamba","Unidad Educativa Maria Josefa Mujia",30,0,3,1,159,2,19,0,4,218,1,5,224,239,0.729,0.937
"10740","Cochabamba","Cochabamba","Unidad Educativa Maria Josefa Mujia",41,0,0,0,130,4,26,0,5,206,1,8,215,234,0.631,0.919
"10741","Cochabamba","Cochabamba","Unidad Educativa Maria Josefa Mujia",35,0,1,0,141,3,25,0,3,208,4,5,217,236,0.678,0.919
"10742","Cochabamba","Cochabamba","Unidad Educativa Maria Josefa Mujia",48,2,1,0,141,4,17,1,2,216,5,3,224,234,0.653,0.957
"10743","Cochabamba","Cochabamba","Unidad Educativa Maria Josefa Mujia",38,0,2,0,132,1,21,0,3,197,9,7,213,228,0.67,0.934
"10744","Cochabamba","Cochabamba","U. E. Tiquirani",63,1,0,0,118,1,16,0,1,200,3,4,207,227,0.59,0.912
"10745","Cochabamba","Cochabamba","U. E. Tiquirani",69,0,0,1,103,2,19,0,1,195,1,7,203,228,0.528,0.89
"10746","Cochabamba","Cochabamba","U. E. Tiquirani",56,1,0,0,115,4,22,0,1,199,2,2,203,229,0.578,0.886
"10747","Cochabamba","Cochabamba","U. E. Tiquirani",65,0,2,0,108,1,18,0,1,195,0,5,200,224,0.554,0.893
"10748","Cochabamba","Cochabamba","U. E. Tiquirani",39,0,1,0,126,6,28,1,1,202,1,6,209,230,0.624,0.909
"10749","Cochabamba","Cochabamba","U. E. Tiquirani",55,0,1,0,112,3,18,0,0,189,3,8,200,229,0.593,0.873
"10750","Cochabamba","Cochabamba","U. E. Tiquirani",57,0,0,0,111,3,27,0,2,200,2,4,206,229,0.555,0.9
"10751","Cochabamba","Cochabamba","U. E. Tiquirani",58,1,0,2,105,2,23,0,2,193,2,12,207,233,0.544,0.888
"10752","Cochabamba","Cochabamba","U. E. Tiquirani",71,0,1,0,108,6,24,1,2,213,1,2,216,233,0.507,0.927
"10753","Cochabamba","Cochabamba","U. E. Tiquirani",49,1,0,0,115,3,18,0,2,188,3,11,202,230,0.612,0.878
"10754","Cochabamba","Cochabamba","U. E. Tiquirani",40,1,1,1,134,6,21,0,1,205,1,6,212,234,0.654,0.906
"10755","Cochabamba","Cochabamba","U. E. Tiquirani",38,1,1,1,120,5,27,0,2,195,1,4,200,231,0.615,0.866
"10756","Cochabamba","Cochabamba","U. E. Tiquirani",53,0,3,0,115,3,17,0,5,196,0,9,205,227,0.587,0.903
"10757","Cochabamba","Cochabamba","U. E. Tiquirani",46,1,0,0,111,1,16,0,3,178,6,8,192,227,0.624,0.846
"10758","Cochabamba","Cochabamba","U. E. Tiquirani",50,1,0,0,121,3,16,2,2,195,0,7,202,233,0.621,0.867
"10759","Cochabamba","Cochabamba","U. E. Tiquirani",72,0,0,0,107,7,18,0,1,205,4,6,215,232,0.522,0.927
"10760","Cochabamba","Cochabamba","U. E. Tiquirani",71,0,0,1,97,5,18,1,3,196,1,8,205,229,0.495,0.895
"10761","Cochabamba","Cochabamba","U. E. Tiquirani",62,0,2,1,114,5,14,0,2,200,1,12,213,229,0.57,0.93
"10762","Cochabamba","Cochabamba","U. E. Tiquirani",59,1,0,2,99,6,17,1,2,187,0,12,199,228,0.529,0.873
"10763","Cochabamba","Cochabamba","U. E. Tiquirani",61,0,0,0,108,5,15,0,2,191,1,9,201,230,0.565,0.874
"10764","Cochabamba","Cochabamba","U. E. Tiquirani",56,0,0,1,123,2,22,0,5,209,1,6,216,231,0.589,0.935
"10765","Cochabamba","Cochabamba","Unidad Educativa Stefano Hotellier",51,0,3,0,131,2,19,0,3,209,3,8,220,239,0.627,0.921
"10766","Cochabamba","Cochabamba","Unidad Educativa Stefano Hotellier",42,2,1,0,122,2,35,1,2,207,0,10,217,234,0.589,0.927
"10767","Cochabamba","Cochabamba","Unidad Educativa Stefano Hotellier",23,1,0,0,159,2,30,0,0,215,4,5,224,237,0.74,0.945
"10768","Cochabamba","Cochabamba","Unidad Educativa Stefano Hotellier",24,0,0,0,144,4,28,0,2,202,1,8,211,230,0.713,0.917
"10769","Cochabamba","Cochabamba","Unidad Educativa Stefano Hotellier",36,1,2,0,144,5,23,0,2,213,1,7,221,233,0.676,0.948
"10770","Cochabamba","Cochabamba","Unidad Educativa Stefano Hotellier",34,0,1,1,139,1,27,1,1,205,1,5,211,236,0.678,0.894
"10771","Cochabamba","Cochabamba","Unidad Educativa Stefano Hotellier",36,0,1,0,156,2,20,0,1,216,3,3,222,237,0.722,0.937
"10772","Cochabamba","Cochabamba","Unidad Educativa Stefano Hotellier",43,2,2,1,145,0,24,0,2,219,0,10,229,237,0.662,0.966
"10773","Cochabamba","Cochabamba","Unidad Educativa Stefano Hotellier",34,0,1,0,151,2,18,0,2,208,1,3,212,232,0.726,0.914
"10774","Cochabamba","Cochabamba","Unidad Educativa Stefano Hotellier",27,0,0,0,156,6,23,0,0,212,2,4,218,235,0.736,0.928
"10775","Cochabamba","Cochabamba","Unidad Educativa Stefano Hotellier",40,0,2,1,160,2,13,0,0,218,1,7,226,238,0.734,0.95
"10776","Cochabamba","Cochabamba","Unidad Educativa Stefano Hotellier",44,1,2,0,159,3,16,0,2,227,3,3,233,246,0.7,0.947
"10777","Cochabamba","Cochabamba","Escuela Gerardo Vargas",39,0,2,1,119,1,27,0,1,190,4,7,201,226,0.626,0.889
"10778","Cochabamba","Cochabamba","Escuela Gerardo Vargas",39,2,0,3,119,3,19,0,2,187,5,8,200,227,0.636,0.881
"10779","Cochabamba","Cochabamba","Escuela Gerardo Vargas",49,0,3,0,116,3,15,0,2,188,5,11,204,229,0.617,0.891
"10780","Cochabamba","Cochabamba","Escuela Gerardo Vargas",42,1,3,1,127,3,16,0,4,197,3,12,212,233,0.645,0.91
"10781","Cochabamba","Cochabamba","Escuela Gerardo Vargas",32,1,1,1,123,2,23,0,2,185,3,6,194,226,0.665,0.858
"10782","Cochabamba","Cochabamba","Escuela Gerardo Vargas",38,0,4,0,136,0,20,0,0,198,1,8,207,234,0.687,0.885
"10783","Cochabamba","Cochabamba","Escuela Gerardo Vargas",36,0,2,0,126,2,26,0,0,192,2,9,203,228,0.656,0.89
"10784","Cochabamba","Cochabamba","Escuela Gerardo Vargas",43,0,4,0,119,3,20,2,0,191,3,4,198,230,0.623,0.861
"10785","Cochabamba","Cochabamba","Escuela Gerardo Vargas",48,0,0,0,124,4,20,0,0,196,1,9,206,229,0.633,0.9
"10786","Cochabamba","Cochabamba","Escuela Gerardo Vargas",59,0,0,0,107,5,23,2,2,198,3,5,206,228,0.54,0.904
"10787","Cochabamba","Cochabamba","Escuela Gerardo Vargas",39,1,1,0,122,2,10,0,5,180,0,10,190,228,0.678,0.833
"10788","Cochabamba","Cochabamba","Escuela Gerardo Vargas",44,0,1,1,119,0,21,0,2,188,2,10,200,222,0.633,0.901
"10789","Cochabamba","Cochabamba","Escuela Gerardo Vargas",40,1,1,1,127,2,16,1,1,190,4,6,200,230,0.668,0.87
"10790","Cochabamba","Cochabamba","Escuela Gerardo Vargas",27,0,0,0,140,4,13,0,3,187,2,14,203,229,0.749,0.886
"10791","Cochabamba","Cochabamba","Escuela Gerardo Vargas",36,1,1,0,131,4,26,0,3,202,1,10,213,230,0.649,0.926
"10792","Cochabamba","Cochabamba","Escuela Gerardo Vargas",43,0,1,0,119,3,24,1,1,192,0,5,197,226,0.62,0.872
"10793","Cochabamba","Cochabamba","Escuela Gerardo Vargas",42,1,2,1,135,4,16,0,2,203,1,4,208,230,0.665,0.904
"10794","Cochabamba","Cochabamba","Escuela Gerardo Vargas",38,1,3,1,129,2,18,1,1,194,2,6,202,230,0.665,0.878
"10795","Cochabamba","Cochabamba","Escuela Gerardo Vargas",51,0,0,1,130,0,19,0,2,203,0,2,205,232,0.64,0.884
"10796","Cochabamba","Cochabamba","Escuela Gerardo Vargas",38,2,2,0,133,3,22,0,3,203,0,5,208,230,0.655,0.904
"10797","Cochabamba","Cochabamba","Escuela Gerardo Vargas",54,0,1,0,119,0,21,0,1,196,2,8,206,229,0.607,0.9
"10798","Cochabamba","Cochabamba","Escuela Gerardo Vargas",53,1,4,1,114,4,14,1,1,193,1,10,204,229,0.591,0.891
"10799","Cochabamba","Cochabamba","Escuela Gerardo Vargas",51,0,2,0,112,3,26,1,2,197,2,4,203,232,0.569,0.875
"10800","Cochabamba","Cochabamba","Escuela Gerardo Vargas",44,1,1,1,117,3,20,1,2,190,4,4,198,227,0.616,0.872
"10801","Cochabamba","Cochabamba","Escuela Gerardo Vargas",32,1,3,0,131,2,25,0,1,195,4,9,208,239,0.672,0.87
"10802","Cochabamba","Cochabamba","Unidad Educativa San Miguel Alta Tension",43,1,1,0,140,3,29,1,1,219,0,5,224,238,0.639,0.941
"10803","Cochabamba","Cochabamba","Unidad Educativa San Miguel Alta Tension",34,1,0,1,138,1,29,0,1,205,2,9,216,237,0.673,0.911
"10804","Cochabamba","Cochabamba","Unidad Educativa San Miguel Alta Tension",36,0,0,0,143,3,23,0,4,209,3,5,217,237,0.684,0.916
"10805","Cochabamba","Cochabamba","Unidad Educativa San Miguel Alta Tension",34,1,2,0,151,1,38,2,1,230,0,0,230,239,0.657,0.962
"10806","Cochabamba","Cochabamba","Unidad Educativa San Miguel Alta Tension",33,0,4,0,110,14,0,1,3,165,45,5,215,238,0.667,0.903
"10807","Cochabamba","Cochabamba","Unidad Educativa El Salvador San Javier",60,1,0,2,121,3,15,1,1,204,2,6,212,227,0.593,0.934
"10808","Cochabamba","Cochabamba","Unidad Educativa El Salvador San Javier",66,1,0,1,103,5,22,0,2,200,1,4,205,230,0.515,0.891
"10809","Cochabamba","Cochabamba","Unidad Educativa El Salvador San Javier",57,1,3,1,105,2,24,0,1,194,2,5,201,231,0.541,0.87
"10810","Cochabamba","Cochabamba","Unidad Educativa El Salvador San Javier",49,0,8,0,94,13,0,1,9,174,26,5,205,231,0.54,0.887
"10811","Cochabamba","Cochabamba","Unidad Educativa El Salvador San Javier",54,3,3,1,114,2,16,2,1,196,0,2,198,228,0.582,0.868
"10812","Cochabamba","Cochabamba","Unidad Educativa El Salvador San Javier",54,0,0,0,125,2,16,0,1,198,2,7,207,230,0.631,0.9
"10813","Cochabamba","Cochabamba","Unidad Educativa El Salvador San Javier",48,2,0,0,121,1,19,1,0,192,1,6,199,232,0.63,0.858
"10814","Cochabamba","Cochabamba","Unidad Educativa El Salvador San Javier",63,0,1,0,101,4,20,0,1,190,1,1,192,224,0.532,0.857
"10815","Cochabamba","Cochabamba","Unidad Educativa El Salvador San Javier",45,2,4,0,138,4,17,0,1,211,0,8,219,235,0.654,0.932
"10816","Cochabamba","Cochabamba","Unidad Educativa El Salvador San Javier",48,1,4,0,129,1,21,0,0,204,1,4,209,229,0.632,0.913
"10817","Cochabamba","Cochabamba","Unidad Educativa El Salvador San Javier",54,1,3,0,111,4,23,2,1,199,3,5,207,227,0.558,0.912
"10818","Cochabamba","Cochabamba","Unidad Educativa El Salvador San Javier",67,0,1,2,107,5,15,1,1,199,2,5,206,230,0.538,0.896
"10819","Cochabamba","Cochabamba","Unidad Educativa El Salvador San Javier",65,1,3,0,111,5,13,0,2,200,2,4,206,226,0.555,0.912
"10820","Cochabamba","Cochabamba","Unidad Educativa El Salvador San Javier",61,0,0,0,122,5,16,0,0,204,1,3,208,231,0.598,0.9
"10821","Cochabamba","Cochabamba","Unidad Educativa El Salvador San Javier",55,0,2,1,120,0,26,0,0,204,1,5,210,235,0.588,0.894
"10822","Cochabamba","Cochabamba","Unidad Educativa El Salvador San Javier",54,1,2,1,119,5,18,0,0,200,0,10,210,231,0.595,0.909
"10823","Cochabamba","Cochabamba","Unidad Educativa El Salvador San Javier",62,1,2,0,102,4,10,0,1,182,2,9,193,221,0.56,0.873
"10824","Cochabamba","Cochabamba","Unidad Educativa El Salvador San Javier",59,0,1,2,115,3,12,0,3,195,2,5,202,229,0.59,0.882
"10825","Cochabamba","Cochabamba","Unidad Educativa El Salvador San Javier",80,0,1,2,87,1,22,0,0,193,2,9,204,230,0.451,0.887
"10826","Cochabamba","Cochabamba","Unidad Educativa El Salvador San Javier",54,0,0,2,102,8,24,0,1,191,2,5,198,226,0.534,0.876
"10827","Cochabamba","Cochabamba","U. E. Túpac Katari",19,0,1,0,164,1,27,0,3,215,8,6,229,240,0.763,0.954
"10828","Cochabamba","Cochabamba","U. E. El Molino",54,1,1,0,122,5,32,0,2,217,3,9,229,239,0.562,0.958
"10829","Cochabamba","Cochabamba","U. E. El Molino",54,1,2,0,134,2,27,1,1,222,3,3,228,238,0.604,0.958
"10830","Cochabamba","Cochabamba","U. E. El Molino",68,0,3,1,112,5,32,0,0,221,2,11,234,246,0.507,0.951
"10831","Cochabamba","Cochabamba","Colegio Venjamnin",43,0,0,1,126,6,32,0,1,209,3,5,217,238,0.603,0.912
"10832","Cochabamba","Cochabamba","Colegio Venjamnin",62,2,0,1,103,1,29,0,2,200,1,10,211,237,0.515,0.89
"10833","Cochabamba","Cochabamba","Colegio Venjamnin",50,0,2,0,126,1,24,0,3,206,3,6,215,237,0.612,0.907
"10834","Cochabamba","Cochabamba","Colegio Venjamnin",53,0,0,0,120,2,43,0,2,220,1,7,228,238,0.545,0.958
"10835","Cochabamba","Cochabamba","Colegio Venjamnin",46,1,2,1,128,4,30,1,2,215,2,5,222,234,0.595,0.949
"10836","Cochabamba","Cochabamba","Colegio Venjamnin",40,1,4,1,132,5,27,0,0,210,1,6,217,237,0.629,0.916
"10837","Cochabamba","Cochabamba","Colegio Venjamnin",51,0,1,0,123,3,31,0,1,210,1,6,217,237,0.586,0.916
"10838","Cochabamba","Cochabamba","Colegio Venjamnin",44,1,1,1,111,6,32,1,3,200,2,8,210,233,0.555,0.901
"10839","Cochabamba","Cochabamba","Colegio Venjamnin",64,1,1,0,106,2,32,1,3,210,1,4,215,235,0.505,0.915
"10840","Cochabamba","Cochabamba","Colegio Venjamnin",40,1,0,0,125,2,35,0,0,203,4,11,218,239,0.616,0.912
"10841","Cochabamba","Cochabamba","Colegio Venjamnin",60,1,2,0,121,2,25,0,0,211,1,7,219,237,0.573,0.924
"10842","Cochabamba","Cochabamba","Colegio Venjamnin",60,0,2,1,111,4,24,0,1,203,2,6,211,237,0.547,0.89
"10843","Cochabamba","Cochabamba","Colegio Venjamnin",61,0,3,0,111,2,22,0,1,200,1,9,210,239,0.555,0.879
"10844","Cochabamba","Cochabamba","Unidad Educativa Siglo XX - Gabriela Mistral",52,1,1,0,121,2,27,0,1,205,1,5,211,236,0.59,0.894
"10845","Cochabamba","Cochabamba","Unidad Educativa Siglo XX - Gabriela Mistral",48,1,0,0,111,5,32,2,2,201,3,6,210,236,0.552,0.89
"10846","Cochabamba","Cochabamba","Unidad Educativa Siglo XX - Gabriela Mistral",53,0,2,0,118,5,29,1,4,212,1,5,218,238,0.557,0.916
"10847","Cochabamba","Cochabamba","Unidad Educativa Siglo XX - Gabriela Mistral",40,0,2,0,125,7,34,0,0,208,2,5,215,239,0.601,0.9
"10848","Cochabamba","Cochabamba","Unidad Educativa Siglo XX - Gabriela Mistral",44,1,2,0,124,4,29,0,0,204,0,4,208,235,0.608,0.885
"10849","Cochabamba","Cochabamba","Unidad Educativa Siglo XX - Gabriela Mistral",46,1,1,1,126,5,30,0,0,210,3,4,217,235,0.6,0.923
"10850","Cochabamba","Cochabamba","Unidad Educativa Siglo XX - Gabriela Mistral",39,0,3,1,135,2,25,0,1,206,2,5,213,238,0.655,0.895
"10851","Cochabamba","Cochabamba","Unidad Educativa Siglo XX - Gabriela Mistral",51,0,0,1,127,2,27,1,4,213,2,2,217,239,0.596,0.908
"10852","Cochabamba","Cochabamba","Unidad Educativa Siglo XX - Gabriela Mistral",55,0,1,0,108,4,23,1,0,192,2,5,199,238,0.562,0.836
"10853","Cochabamba","Cochabamba","Colegio San Francisco (Villa Pagador)",36,1,4,0,127,1,28,0,2,199,6,6,211,231,0.638,0.913
"10854","Cochabamba","Cochabamba","Colegio San Francisco (Villa Pagador)",29,0,2,1,137,4,30,1,1,205,3,3,211,232,0.668,0.909
"10855","Cochabamba","Cochabamba","Colegio San Francisco (Villa Pagador)",31,1,1,1,143,1,21,0,1,200,0,7,207,231,0.715,0.896
"10856","Cochabamba","Cochabamba","Colegio San Francisco (Villa Pagador)",41,0,2,1,136,3,27,1,0,211,0,5,216,231,0.645,0.935
"10857","Cochabamba","Cochabamba","Colegio San Francisco (Villa Pagador)",41,1,2,0,135,4,23,0,2,208,0,5,213,228,0.649,0.934
"10858","Cochabamba","Cochabamba","Colegio San Francisco (Villa Pagador)",36,0,2,0,134,4,18,0,1,195,3,4,202,232,0.687,0.871
"10859","Cochabamba","Cochabamba","Colegio San Francisco (Villa Pagador)",35,1,0,0,131,4,27,0,0,198,4,8,210,235,0.662,0.894
"10860","Cochabamba","Cochabamba","Colegio San Francisco (Villa Pagador)",25,0,2,0,150,2,31,1,1,212,1,2,215,235,0.708,0.915
"10861","Cochabamba","Cochabamba","Colegio San Francisco (Villa Pagador)",37,1,2,0,120,2,25,0,5,192,4,5,201,230,0.625,0.874
"10862","Cochabamba","Cochabamba","Colegio San Francisco (Villa Pagador)",35,0,0,0,142,1,15,0,0,193,4,5,202,231,0.736,0.874
"10863","Cochabamba","Cochabamba","Colegio San Francisco (Villa Pagador)",32,0,0,2,141,2,25,1,1,204,6,11,221,232,0.691,0.953
"10864","Cochabamba","Cochabamba","Colegio San Francisco (Villa Pagador)",40,2,0,1,117,4,25,1,2,192,1,10,203,232,0.609,0.875
"10865","Cochabamba","Cochabamba","Colegio San Francisco (Villa Pagador)",40,0,2,0,127,3,29,0,3,204,2,9,215,230,0.623,0.935
"10866","Cochabamba","Cochabamba","Colegio San Francisco (Villa Pagador)",35,0,1,1,139,2,33,0,1,212,2,6,220,234,0.656,0.94
"10867","Cochabamba","Cochabamba","Colegio San Francisco (Villa Pagador)",23,1,1,0,143,2,27,0,0,197,2,10,209,232,0.726,0.901
"10868","Cochabamba","Cochabamba","Colegio San Francisco (Villa Pagador)",43,1,1,0,118,2,31,0,1,197,2,11,210,232,0.599,0.905
"10869","Cochabamba","Cochabamba","Colegio San Francisco (Villa Pagador)",37,1,4,2,136,3,26,0,0,209,1,2,212,231,0.651,0.918
"10870","Cochabamba","Cochabamba","Colegio San Francisco (Villa Pagador)",40,0,2,0,119,1,37,0,2,201,0,8,209,235,0.592,0.889
"10871","Cochabamba","Cochabamba","Colegio San Francisco (Villa Pagador)",21,1,2,0,137,2,28,1,1,193,3,16,212,229,0.71,0.926
"10872","Cochabamba","Cochabamba","Colegio San Francisco (Villa Pagador)",41,0,3,0,127,1,27,1,5,205,2,6,213,234,0.62,0.91
"10873","Cochabamba","Cochabamba","Colegio San Francisco (Villa Pagador)",41,0,1,0,132,2,29,1,2,208,0,3,211,229,0.635,0.921
"10874","Cochabamba","Cochabamba","Colegio San Francisco (Villa Pagador)",34,1,0,1,124,0,29,0,3,192,1,6,199,231,0.646,0.861
"10875","Cochabamba","Cochabamba","Colegio San Francisco (Villa Pagador)",30,1,2,0,138,2,29,0,4,206,1,2,209,230,0.67,0.909
"10876","Cochabamba","Cochabamba","Colegio San Francisco (Villa Pagador)",38,0,2,0,128,5,21,1,3,198,5,7,210,231,0.646,0.909
"10877","Cochabamba","Cochabamba","Colegio San Francisco (Villa Pagador)",39,0,3,0,144,3,14,0,2,205,1,4,210,233,0.702,0.901
"10878","Cochabamba","Cochabamba","Colegio San Francisco (Villa Pagador)",25,1,3,2,132,3,34,0,4,204,4,5,213,232,0.647,0.918
"10879","Cochabamba","Cochabamba","Colegio San Francisco (Villa Pagador)",32,0,2,0,130,1,25,0,5,195,5,7,207,234,0.667,0.885
"10880","Cochabamba","Cochabamba","Colegio San Francisco (Villa Pagador)",32,0,2,0,144,3,22,0,2,205,3,7,215,234,0.702,0.919
"10881","Cochabamba","Cochabamba","Colegio San Francisco (Villa Pagador)",39,0,2,0,134,1,24,1,1,202,3,5,210,229,0.663,0.917
"10882","Cochabamba","Cochabamba","Colegio San Francisco (Villa Pagador)",37,1,1,0,137,2,26,1,2,207,3,5,215,232,0.662,0.927
"10883","Cochabamba","Cochabamba","Colegio San Francisco (Villa Pagador)",46,0,2,1,129,1,23,0,0,202,1,11,214,234,0.639,0.915
"10884","Cochabamba","Cochabamba","Colegio San Francisco (Villa Pagador)",54,1,4,0,128,4,24,3,7,225,1,8,234,249,0.569,0.94
"10885","Cochabamba","Cochabamba","Colegio Sebastian Pagador",34,1,5,0,133,1,26,0,2,202,2,4,208,224,0.658,0.929
"10886","Cochabamba","Cochabamba","Colegio Sebastian Pagador",52,2,0,1,115,3,12,0,3,188,2,3,193,223,0.612,0.865
"10887","Cochabamba","Cochabamba","Colegio Sebastian Pagador",34,0,1,0,137,2,21,0,1,196,3,9,208,231,0.699,0.9
"10888","Cochabamba","Cochabamba","Colegio Sebastian Pagador",49,2,4,1,126,2,18,0,3,205,2,3,210,230,0.615,0.913
"10889","Cochabamba","Cochabamba","Colegio Sebastian Pagador",47,1,0,0,105,2,26,0,1,182,4,4,190,224,0.577,0.848
"10890","Cochabamba","Cochabamba","Colegio Sebastian Pagador",53,1,0,0,121,1,29,1,0,206,0,5,211,224,0.587,0.942
"10891","Cochabamba","Cochabamba","Colegio Sebastian Pagador",44,2,3,1,118,8,32,0,2,210,3,6,219,230,0.562,0.952
"10892","Cochabamba","Cochabamba","Colegio Sebastian Pagador",50,1,0,1,118,2,21,0,1,194,1,9,204,227,0.608,0.899
"10893","Cochabamba","Cochabamba","Colegio Sebastian Pagador",50,1,1,0,120,3,17,0,2,194,0,8,202,229,0.619,0.882
"10894","Cochabamba","Cochabamba","Colegio Sebastian Pagador",56,1,3,1,114,1,21,0,0,197,3,5,205,232,0.579,0.884
"10895","Cochabamba","Cochabamba","Colegio Sebastian Pagador",37,0,1,0,128,3,25,0,1,195,0,6,201,224,0.656,0.897
"10896","Cochabamba","Cochabamba","Colegio Sebastian Pagador",52,1,1,1,122,0,23,0,5,205,0,5,210,228,0.595,0.921
"10897","Cochabamba","Cochabamba","Colegio Sebastian Pagador",28,0,4,0,134,1,24,0,1,192,1,6,199,224,0.698,0.888
"10898","Cochabamba","Cochabamba","Colegio Sebastian Pagador",41,1,1,1,127,3,20,0,1,195,3,4,202,219,0.651,0.922
"10899","Cochabamba","Cochabamba","Colegio Sebastian Pagador",46,1,1,0,120,3,29,0,2,202,0,6,208,230,0.594,0.904
"10900","Cochabamba","Cochabamba","Colegio Sebastian Pagador",41,1,2,1,118,1,22,2,1,189,2,11,202,223,0.624,0.906
"10901","Cochabamba","Cochabamba","Colegio Sebastian Pagador",38,2,1,0,122,4,32,0,0,199,2,1,202,231,0.613,0.874
"10902","Cochabamba","Cochabamba","Colegio Sebastian Pagador",36,0,1,1,130,2,26,0,3,199,0,4,203,228,0.653,0.89
"10903","Cochabamba","Cochabamba","Colegio Sebastian Pagador",45,0,0,0,130,1,13,0,1,190,2,7,199,218,0.684,0.913
"10904","Cochabamba","Cochabamba","Colegio Sebastian Pagador",60,1,1,0,112,1,23,0,0,198,1,4,203,218,0.566,0.931
"10905","Cochabamba","Cochabamba","Colegio Sebastian Pagador",50,0,0,0,116,3,28,0,2,199,3,6,208,223,0.583,0.933
"10906","Cochabamba","Cochabamba","Colegio Sebastian Pagador",42,1,1,2,118,2,24,1,4,195,2,8,205,221,0.605,0.928
"10907","Cochabamba","Cochabamba","Colegio Sebastian Pagador",40,0,1,0,130,3,25,0,3,202,2,2,206,227,0.644,0.907
"10908","Cochabamba","Cochabamba","Colegio Sebastian Pagador",48,0,1,0,129,2,21,1,2,204,0,3,207,228,0.632,0.908
"10909","Cochabamba","Cochabamba","Colegio Sebastian Pagador",18,1,2,1,136,3,31,0,4,196,2,10,208,226,0.694,0.92
"10910","Cochabamba","Cochabamba","Colegio Sebastian Pagador",47,1,2,0,121,3,20,0,0,194,5,2,201,228,0.624,0.882
"10911","Cochabamba","Cochabamba","Colegio Sebastian Pagador",42,1,1,0,126,3,23,0,3,199,1,9,209,233,0.633,0.897
"10912","Cochabamba","Cochabamba","Colegio Sebastian Pagador",40,1,2,0,137,1,17,0,4,202,0,2,204,226,0.678,0.903
"10913","Cochabamba","Cochabamba","Colegio Sebastian Pagador",27,0,2,0,131,1,30,0,6,197,2,5,204,229,0.665,0.891
"10914","Cochabamba","Cochabamba","Colegio Sebastian Pagador",39,0,1,0,122,0,24,1,1,188,2,12,202,226,0.649,0.894
"10915","Cochabamba","Cochabamba","Colegio Sebastian Pagador",42,1,5,1,119,9,24,1,4,206,2,5,213,229,0.578,0.93
"10916","Cochabamba","Cochabamba","Colegio Sebastian Pagador",45,0,3,1,126,5,17,1,9,207,0,4,211,226,0.609,0.934
"10917","Cochabamba","Cochabamba","Colegio Sebastian Pagador",45,0,2,0,118,4,21,0,3,193,1,12,206,228,0.611,0.904
"10918","Cochabamba","Cochabamba","Colegio Sebastian Pagador",32,0,1,1,121,1,28,1,3,188,1,5,194,223,0.644,0.87
"10919","Cochabamba","Cochabamba","Colegio Sebastian Pagador",36,0,0,0,135,2,23,0,1,197,1,4,202,225,0.685,0.898
"10920","Cochabamba","Cochabamba","Colegio Sebastian Pagador",40,0,2,1,117,0,28,0,2,190,4,6,200,223,0.616,0.897
"10921","Cochabamba","Cochabamba","Colegio Sebastian Pagador",44,1,2,1,126,2,21,1,4,202,2,8,212,235,0.624,0.902
"10922","Cochabamba","Cochabamba","Colegio Sebastian Pagador",18,0,2,0,153,4,21,0,5,203,1,3,207,227,0.754,0.912
"10923","Cochabamba","Cochabamba","Colegio Sebastian Pagador",40,0,3,0,101,4,39,1,1,189,1,7,197,221,0.534,0.891
"10924","Cochabamba","Cochabamba","Colegio Sebastian Pagador",41,1,2,2,108,7,27,0,2,190,2,3,195,223,0.568,0.874
"10925","Cochabamba","Cochabamba","Colegio Sebastian Pagador",48,1,3,0,124,3,15,0,2,196,2,2,200,225,0.633,0.889
"10926","Cochabamba","Cochabamba","Colegio Sebastian Pagador",50,0,0,1,115,3,33,2,2,206,3,10,219,234,0.558,0.936
"10927","Cochabamba","Cochabamba","Colegio Sebastian Pagador",49,1,3,0,119,2,14,0,2,190,5,6,201,226,0.626,0.889
"10928","Cochabamba","Cochabamba","Colegio Sebastian Pagador",45,0,1,0,122,2,24,0,1,195,0,4,199,226,0.626,0.881
"10929","Cochabamba","Cochabamba","Colegio Sebastian Pagador",20,1,1,2,157,0,21,0,3,205,1,3,209,228,0.766,0.917
"10930","Cochabamba","Cochabamba","Colegio Sebastian Pagador",51,2,0,0,118,1,23,0,2,197,3,7,207,224,0.599,0.924
"10931","Cochabamba","Cochabamba","Colegio Sebastian Pagador",36,0,0,1,130,3,33,0,5,208,3,2,213,230,0.625,0.926
"10932","Cochabamba","Cochabamba","Colegio Sebastian Pagador",41,1,1,0,123,1,25,1,0,193,5,6,204,226,0.637,0.903
"10933","Cochabamba","Cochabamba","Colegio Sebastian Pagador",39,1,1,0,117,0,22,0,0,180,0,9,189,222,0.65,0.851
"10934","Cochabamba","Cochabamba","Unidad Educativa 9 de Marzo",26,1,1,2,170,0,17,0,2,219,2,7,228,240,0.776,0.95
"10935","Cochabamba","Cochabamba","Unidad Educativa 9 de Marzo",39,0,0,0,150,4,23,0,0,216,2,3,221,239,0.694,0.925
"10936","Cochabamba","Cochabamba","Unidad Educativa 9 de Marzo",29,0,3,0,153,4,24,0,1,214,3,9,226,238,0.715,0.95
"10937","Cochabamba","Cochabamba","Unidad Educativa 9 de Marzo",28,1,5,0,160,2,22,0,0,218,3,10,231,237,0.734,0.975
"10938","Cochabamba","Cochabamba","Unidad Educativa 9 de Marzo",18,0,5,0,167,3,23,0,2,218,3,4,225,236,0.766,0.953
"10939","Cochabamba","Cochabamba","Unidad Educativa 9 de Marzo",27,0,2,2,157,3,30,1,0,222,3,1,226,234,0.707,0.966
"10940","Cochabamba","Cochabamba","Unidad Educativa 9 de Marzo",24,0,0,0,155,2,25,0,0,206,3,11,220,237,0.752,0.928
"10941","Cochabamba","Cochabamba","Unidad Educativa 9 de Marzo",16,0,0,0,161,3,26,0,0,206,2,13,221,237,0.782,0.932
"10942","Cochabamba","Cochabamba","Unidad Educativa Juan Jose Torrez",43,1,0,0,147,0,29,0,1,221,1,4,226,239,0.665,0.946
"10943","Cochabamba","Cochabamba","Unidad Educativa Juan Jose Torrez",33,1,2,0,143,2,28,0,2,211,1,5,217,238,0.678,0.912
"10944","Cochabamba","Cochabamba","Unidad Educativa Juan Jose Torrez",37,1,5,1,147,3,20,1,4,219,4,3,226,236,0.671,0.958
"10945","Cochabamba","Cochabamba","Unidad Educativa Juan Jose Torrez",51,0,1,1,126,1,0,29,1,210,3,6,219,239,0.6,0.916
"10946","Cochabamba","Cochabamba","Unidad Educativa Juan Jose Torrez",34,0,1,0,129,2,45,0,0,211,4,6,221,239,0.611,0.925
"10947","Cochabamba","Cochabamba","Unidad Educativa Juan Jose Torrez",35,0,1,0,144,2,27,0,3,212,2,7,221,237,0.679,0.932
"10948","Cochabamba","Cochabamba","Unidad Educativa Juan Jose Torrez",29,0,0,0,132,5,35,0,2,203,4,10,217,238,0.65,0.912
"10949","Cochabamba","Cochabamba","Unidad Educativa Juan Jose Torrez",43,1,2,0,127,2,28,0,1,204,1,5,210,235,0.623,0.894
"10950","Cochabamba","Cochabamba","Unidad Educativa Juan Jose Torrez",40,0,1,1,138,4,28,0,1,213,3,3,219,236,0.648,0.928
"10951","Cochabamba","Cochabamba","Unidad Educativa Juan Jose Torrez",35,2,3,0,135,1,31,0,2,209,0,6,215,238,0.646,0.903
"10952","Cochabamba","Cochabamba","U. E. Peniel",44,1,1,0,119,4,52,0,3,224,3,4,231,240,0.531,0.963
"10953","Cochabamba","Cochabamba","U. E. Pentecostal de Bolivia",42,1,0,0,130,7,33,0,1,214,4,10,228,239,0.607,0.954
"10954","Cochabamba","Cochabamba","U. E. Pentecostal de Bolivia",53,1,0,1,130,4,30,1,1,221,3,4,228,240,0.588,0.95
"10955","Cochabamba","Cochabamba","U. E. Pentecostal de Bolivia",49,0,2,0,129,3,38,0,5,226,4,4,234,240,0.571,0.975
"10956","Cochabamba","Cochabamba","U. E. Canaán",69,0,0,1,73,0,37,1,3,184,0,2,186,200,0.397,0.93
"10957","Cochabamba","Cochabamba","Campo Ferial",82,2,1,0,77,4,18,0,3,187,2,7,196,221,0.412,0.887
"10958","Cochabamba","Cochabamba","Campo Ferial",83,3,0,0,94,3,17,1,1,202,2,11,215,231,0.465,0.931
"10959","Cochabamba","Cochabamba","Campo Ferial",92,1,3,1,81,4,15,0,4,201,1,4,206,222,0.403,0.928
"10960","Cochabamba","Cochabamba","Campo Ferial",87,1,1,0,82,3,24,1,2,201,1,5,207,228,0.408,0.908
"10961","Cochabamba","Cochabamba","Campo Ferial",71,1,3,0,101,2,32,1,1,212,1,3,216,233,0.476,0.927
"10962","Cochabamba","Cochabamba","Campo Ferial",90,0,1,1,85,2,12,0,2,193,1,11,205,225,0.44,0.911
"10963","Cochabamba","Cochabamba","Campo Ferial",78,1,1,2,86,4,15,0,1,188,1,15,204,227,0.457,0.899
"10964","Cochabamba","Cochabamba","Campo Ferial",85,1,2,0,86,3,12,1,4,194,2,8,204,229,0.443,0.891
"10965","Cochabamba","Cochabamba","Campo Ferial",93,0,0,0,98,3,14,0,2,210,1,4,215,233,0.467,0.923
"10966","Cochabamba","Cochabamba","Campo Ferial",101,0,1,1,87,4,15,0,0,209,2,4,215,233,0.416,0.923
"10967","Cochabamba","Cochabamba","Campo Ferial",83,0,3,0,91,3,16,0,2,198,3,6,207,228,0.46,0.908
"10968","Cochabamba","Cochabamba","Campo Ferial",77,2,0,0,85,5,24,0,2,195,0,4,199,228,0.436,0.873
"10969","Cochabamba","Cochabamba","Campo Ferial",67,0,5,0,109,2,21,0,0,204,2,6,212,228,0.534,0.93
"10970","Cochabamba","Cochabamba","Campo Ferial",80,1,1,0,96,5,19,1,0,203,1,7,211,230,0.473,0.917
"10971","Cochabamba","Cochabamba","Campo Ferial",82,2,4,0,92,0,12,1,1,194,1,9,204,227,0.474,0.899
"10972","Cochabamba","Cochabamba","Campo Ferial",78,2,1,2,83,1,17,1,4,189,2,7,198,230,0.439,0.861
"10973","Cochabamba","Cochabamba","Campo Ferial",91,0,2,1,84,3,21,0,1,203,0,4,207,231,0.414,0.896
"10974","Cochabamba","Cochabamba","Campo Ferial",98,0,0,0,92,4,7,0,0,201,0,4,205,225,0.458,0.911
"10975","Cochabamba","Cochabamba","Campo Ferial",82,0,1,1,91,2,12,1,2,192,1,7,200,230,0.474,0.87
"10976","Cochabamba","Cochabamba","Campo Ferial",99,0,1,0,68,8,22,0,1,199,3,6,208,231,0.342,0.9
"10977","Cochabamba","Cochabamba","Campo Ferial",81,1,0,1,94,1,5,0,1,184,2,5,191,223,0.511,0.857
"10978","Cochabamba","Cochabamba","Campo Ferial",84,1,3,0,85,1,15,0,0,189,1,14,204,226,0.45,0.903
"10979","Cochabamba","Cochabamba","Unidad Educativa 26 de Octubre",80,1,0,0,113,5,13,0,1,213,1,3,217,236,0.531,0.919
"10980","Cochabamba","Cochabamba","Unidad Educativa 26 de Octubre",92,0,2,0,106,4,16,0,6,226,2,2,230,240,0.469,0.958
"10981","Cochabamba","Cochabamba","Unidad Educativa 26 de Octubre",72,1,0,0,113,3,23,1,1,214,3,5,222,239,0.528,0.929
"10982","Cochabamba","Cochabamba","Unidad Educativa 26 de Octubre",75,0,2,1,71,2,21,0,1,173,0,6,179,194,0.41,0.923
"10983","Cochabamba","Cochabamba","Colegio Santa Luisa Marillac",57,0,1,2,104,7,19,1,1,192,2,14,208,226,0.542,0.92
"10984","Cochabamba","Cochabamba","Colegio Santa Luisa Marillac",66,1,0,0,116,1,13,0,1,198,1,6,205,229,0.586,0.895
"10985","Cochabamba","Cochabamba","Colegio Santa Luisa Marillac",59,2,2,0,114,2,15,0,0,194,4,5,203,226,0.588,0.898
"10986","Cochabamba","Cochabamba","Colegio Santa Luisa Marillac",62,1,1,0,102,0,18,0,3,187,2,7,196,223,0.545,0.879
"10987","Cochabamba","Cochabamba","Colegio Santa Luisa Marillac",66,1,0,1,124,5,18,0,1,216,2,4,222,231,0.574,0.961
"10988","Cochabamba","Cochabamba","Colegio Santa Luisa Marillac",59,4,1,1,108,2,24,0,4,203,0,6,209,225,0.532,0.929
"10989","Cochabamba","Cochabamba","Colegio Santa Luisa Marillac",50,1,6,0,105,3,25,0,4,194,5,5,204,222,0.541,0.919
"10990","Cochabamba","Cochabamba","Colegio Santa Luisa Marillac",47,0,3,1,124,4,19,0,1,199,0,7,206,234,0.623,0.88
"10991","Cochabamba","Cochabamba","Colegio Santa Luisa Marillac",58,1,1,0,102,3,22,1,1,189,2,15,206,228,0.54,0.904
"10992","Cochabamba","Cochabamba","Colegio Santa Luisa Marillac",56,0,0,1,116,6,20,2,0,201,3,3,207,229,0.577,0.904
"10993","Cochabamba","Cochabamba","Colegio Santa Luisa Marillac",55,1,2,0,124,3,19,0,1,205,3,2,210,229,0.605,0.917
"10994","Cochabamba","Cochabamba","Colegio Santa Luisa Marillac",56,0,0,1,116,6,16,0,2,197,5,7,209,231,0.589,0.905
"10995","Cochabamba","Cochabamba","Colegio Santa Luisa Marillac",61,0,2,2,107,4,25,1,1,203,2,6,211,228,0.527,0.925
"10996","Cochabamba","Cochabamba","Colegio Santa Luisa Marillac",50,0,2,0,119,2,23,0,2,198,1,8,207,225,0.601,0.92
"10997","Cochabamba","Cochabamba","Colegio Santa Luisa Marillac",50,0,1,0,123,3,21,0,3,201,0,10,211,232,0.612,0.909
"10998","Cochabamba","Cochabamba","Colegio Santa Luisa Marillac",51,1,1,0,126,5,16,0,2,202,2,6,210,227,0.624,0.925
"10999","Cochabamba","Cochabamba","Colegio Santa Luisa Marillac",74,0,2,1,83,2,22,1,1,186,3,9,198,220,0.446,0.9
"11000","Cochabamba","Cochabamba","Colegio Santa Luisa Marillac",61,2,1,1,127,2,13,0,0,207,1,6,214,229,0.614,0.934
"11001","Cochabamba","Cochabamba","Colegio Santa Luisa Marillac",70,1,1,0,110,7,17,0,1,207,0,4,211,228,0.531,0.925
"11002","Cochabamba","Cochabamba","Colegio Santa Luisa Marillac",64,1,2,0,99,4,22,1,3,196,0,6,202,227,0.505,0.89
"11003","Cochabamba","Cochabamba","Colegio Santa Luisa Marillac",73,0,1,0,87,6,14,0,0,181,2,11,194,222,0.481,0.874
"11004","Cochabamba","Cochabamba","Colegio Santa Luisa Marillac",73,3,1,2,103,0,15,0,2,199,4,0,203,229,0.518,0.886
"11005","Cochabamba","Cochabamba","Colegio Santa Luisa Marillac",57,0,0,0,119,2,20,0,1,199,0,9,208,228,0.598,0.912
"11006","Cochabamba","Cochabamba","Colegio Santa Luisa Marillac",79,0,1,0,99,6,15,1,2,203,1,3,207,227,0.488,0.912
"11007","Cochabamba","Cochabamba","Colegio Santa Luisa Marillac",60,1,3,0,110,4,14,2,4,198,0,8,206,223,0.556,0.924
"11008","Cochabamba","Cochabamba","Colegio Martin Cardenas",92,1,3,1,90,6,7,0,1,201,4,5,210,227,0.448,0.925
"11009","Cochabamba","Cochabamba","Colegio Martin Cardenas",132,0,0,0,61,1,6,1,2,203,1,5,209,222,0.3,0.941
"11010","Cochabamba","Cochabamba","Colegio Martin Cardenas",92,0,0,1,95,1,15,1,1,206,1,4,211,231,0.461,0.913
"11011","Cochabamba","Cochabamba","Colegio Martin Cardenas",100,0,1,1,93,4,8,0,4,211,3,1,215,228,0.441,0.943
"11012","Cochabamba","Cochabamba","Colegio Martin Cardenas",76,0,1,0,90,4,31,0,2,204,2,4,210,227,0.441,0.925
"11013","Cochabamba","Cochabamba","Colegio Martin Cardenas",98,1,1,1,83,4,13,0,0,201,0,4,205,226,0.413,0.907
"11014","Cochabamba","Cochabamba","Colegio Martin Cardenas",88,0,2,0,87,1,18,0,3,199,1,4,204,226,0.437,0.903
"11015","Cochabamba","Cochabamba","Colegio Martin Cardenas",107,2,0,0,81,1,14,0,1,206,1,7,214,229,0.393,0.934
"11016","Cochabamba","Cochabamba","Colegio Martin Cardenas",92,0,3,0,88,4,12,1,2,202,1,2,205,229,0.436,0.895
"11017","Cochabamba","Cochabamba","Colegio Martin Cardenas",100,0,0,0,81,4,15,0,0,200,1,8,209,229,0.405,0.913
"11018","Cochabamba","Cochabamba","Colegio Martin Cardenas",69,0,3,0,95,5,19,3,3,197,1,10,208,230,0.482,0.904
"11019","Cochabamba","Cochabamba","Colegio Martin Cardenas",104,2,0,1,79,4,14,0,2,206,0,5,211,232,0.383,0.909
"11020","Cochabamba","Cochabamba","Colegio Martin Cardenas",98,0,1,0,77,4,8,2,1,191,1,6,198,219,0.403,0.904
"11021","Cochabamba","Cochabamba","Colegio Martin Cardenas",118,0,0,3,71,3,14,0,1,210,1,2,213,225,0.338,0.947
"11022","Cochabamba","Cochabamba","Colegio Martin Cardenas",83,0,0,1,107,3,11,1,2,208,1,3,212,235,0.514,0.902
"11023","Cochabamba","Cochabamba","Colegio Martin Cardenas",110,0,1,0,68,2,11,1,0,193,1,7,201,227,0.352,0.885
"11024","Cochabamba","Cochabamba","Colegio Martin Cardenas",100,0,0,0,92,5,4,0,2,203,2,6,211,225,0.453,0.938
"11025","Cochabamba","Cochabamba","Colegio Martin Cardenas",88,1,0,2,85,2,10,1,3,192,0,4,196,223,0.443,0.879
"11026","Cochabamba","Cochabamba","Colegio Martin Cardenas",104,0,0,0,79,0,7,0,0,190,1,7,198,222,0.416,0.892
"11027","Cochabamba","Cochabamba","Escuela Ricardo Prudencio",64,0,2,2,107,1,20,0,0,196,2,8,206,232,0.546,0.888
"11028","Cochabamba","Cochabamba","Escuela Ricardo Prudencio",78,2,1,0,100,3,17,0,3,204,1,6,211,232,0.49,0.909
"11029","Cochabamba","Cochabamba","Escuela Ricardo Prudencio",74,0,1,2,106,2,15,0,2,202,1,2,205,234,0.525,0.876
"11030","Cochabamba","Cochabamba","Escuela Ricardo Prudencio",58,0,1,0,104,4,31,0,1,199,1,7,207,231,0.523,0.896
"11031","Cochabamba","Cochabamba","Escuela Ricardo Prudencio",61,0,0,0,106,2,22,1,3,195,1,5,201,230,0.544,0.874
"11032","Cochabamba","Cochabamba","Escuela Ricardo Prudencio",75,2,1,3,96,2,23,0,0,202,0,6,208,228,0.475,0.912
"11033","Cochabamba","Cochabamba","Escuela Ricardo Prudencio",72,0,1,0,92,1,11,0,6,183,1,15,199,231,0.503,0.861
"11034","Cochabamba","Cochabamba","Escuela Ricardo Prudencio",69,0,0,0,92,3,28,0,5,197,1,7,205,228,0.467,0.899
"11035","Cochabamba","Cochabamba","Escuela Ricardo Prudencio",55,0,3,1,114,5,15,0,5,198,0,7,205,230,0.576,0.891
"11036","Cochabamba","Cochabamba","Escuela Ricardo Prudencio",89,1,1,0,90,5,15,0,1,202,3,3,208,233,0.446,0.893
"11037","Cochabamba","Cochabamba","Escuela Ricardo Prudencio",76,2,1,0,91,4,18,0,0,192,1,9,202,225,0.474,0.898
"11038","Cochabamba","Cochabamba","Escuela Ricardo Prudencio",64,0,0,0,95,4,22,0,1,186,5,7,198,228,0.511,0.868
"11039","Cochabamba","Cochabamba","Escuela Ricardo Prudencio",79,0,1,0,90,4,17,0,0,191,2,12,205,234,0.471,0.876
"11040","Cochabamba","Cochabamba","Escuela Ricardo Prudencio",66,0,0,0,97,5,15,0,2,185,1,15,201,230,0.524,0.874
"11041","Cochabamba","Cochabamba","Unidad Educativa America Del Sur - Mejillones A",74,0,0,0,101,4,30,0,1,210,1,11,222,238,0.481,0.933
"11042","Cochabamba","Cochabamba","Unidad Educativa America Del Sur - Mejillones A",80,2,1,0,105,2,23,2,1,216,0,5,221,239,0.486,0.925
"11043","Cochabamba","Cochabamba","Unidad Educativa America Del Sur - Mejillones A",85,0,1,0,100,2,25,0,2,215,2,2,219,236,0.465,0.928
"11044","Cochabamba","Cochabamba","Universidad Catolica",142,0,0,0,38,1,6,0,0,187,1,4,192,224,0.203,0.857
"11045","Cochabamba","Cochabamba","Universidad Catolica",150,0,1,0,25,6,3,2,1,188,0,2,190,224,0.133,0.848
"11046","Cochabamba","Cochabamba","Universidad Catolica",164,0,0,0,25,1,5,0,0,195,0,4,199,229,0.128,0.869
"11047","Cochabamba","Cochabamba","Universidad Catolica",152,0,0,0,23,4,5,0,1,185,0,2,187,229,0.124,0.817
"11048","Cochabamba","Cochabamba","Universidad Catolica",152,1,0,0,36,6,5,0,0,200,0,2,202,224,0.18,0.902
"11049","Cochabamba","Cochabamba","Universidad Catolica",122,0,1,0,52,5,7,0,1,188,0,3,191,229,0.277,0.834
"11050","Cochabamba","Cochabamba","Universidad Catolica",125,0,1,2,51,3,4,2,0,188,2,2,192,218,0.271,0.881
"11051","Cochabamba","Cochabamba","Universidad Catolica",135,0,0,0,37,1,3,2,0,178,1,5,184,222,0.208,0.829
"11052","Cochabamba","Cochabamba","Universidad Catolica",127,3,0,1,44,3,6,0,1,185,0,3,188,224,0.238,0.839
"11053","Cochabamba","Cochabamba","Universidad Catolica",151,1,0,0,35,0,2,0,0,189,0,5,194,224,0.185,0.866
"11054","Cochabamba","Cochabamba","Universidad Catolica",143,1,1,0,28,7,4,1,0,185,1,10,196,222,0.151,0.883
"11055","Cochabamba","Cochabamba","Universidad Catolica",134,0,0,1,33,1,7,2,0,178,0,2,180,230,0.185,0.783
"11056","Cochabamba","Cochabamba","Universidad Catolica",138,0,0,0,37,2,8,0,0,185,3,9,197,236,0.2,0.835
"11057","Cochabamba","Cochabamba","Universidad Catolica",139,0,1,2,34,3,7,0,0,186,1,2,189,229,0.183,0.825
"11058","Cochabamba","Cochabamba","Universidad Catolica",155,1,1,0,27,1,7,2,0,194,4,4,202,224,0.139,0.902
"11059","Cochabamba","Cochabamba","Universidad Catolica",141,1,1,0,34,3,3,0,1,184,0,4,188,223,0.185,0.843
"11060","Cochabamba","Cochabamba","Universidad Catolica",153,0,0,0,34,2,3,0,1,193,0,1,194,220,0.176,0.882
"11061","Cochabamba","Cochabamba","Universidad Catolica",144,0,0,0,35,5,4,0,1,189,0,4,193,224,0.185,0.862
"11062","Cochabamba","Cochabamba","Universidad Catolica",144,0,0,0,35,4,4,0,0,187,1,4,192,224,0.187,0.857
"11063","Cochabamba","Cochabamba","Universidad Catolica",156,0,1,0,31,0,8,1,2,199,2,1,202,227,0.156,0.89
"11064","Cochabamba","Cochabamba","Universidad Catolica",148,2,0,0,33,2,4,0,0,189,1,2,192,222,0.175,0.865
"11065","Cochabamba","Cochabamba","Universidad Catolica",128,1,0,1,32,2,5,1,1,171,0,5,176,219,0.187,0.804
"11066","Cochabamba","Cochabamba","Universidad Catolica",136,0,0,0,53,2,5,0,1,197,1,7,205,231,0.269,0.887
"11067","Cochabamba","Cochabamba","Universidad Catolica",156,0,0,0,40,3,5,0,0,204,0,3,207,231,0.196,0.896
"11068","Cochabamba","Cochabamba","Universidad Catolica",142,1,1,0,54,0,7,0,1,206,2,1,209,231,0.262,0.905
"11069","Cochabamba","Cochabamba","Universidad Catolica",151,0,0,0,35,4,4,0,0,194,0,6,200,223,0.18,0.897
"11070","Cochabamba","Cochabamba","U. E. San Agustín",148,0,1,2,37,1,6,0,2,197,2,5,204,230,0.188,0.887
"11071","Cochabamba","Cochabamba","U. E. San Agustín",160,0,0,0,33,2,3,0,2,200,2,5,207,227,0.165,0.912
"11072","Cochabamba","Cochabamba","U. E. San Agustín",155,0,0,0,42,0,4,1,0,202,0,4,206,230,0.208,0.896
"11073","Cochabamba","Cochabamba","U. E. San Agustín",156,0,0,0,32,3,5,1,1,198,3,4,205,226,0.162,0.907
"11074","Cochabamba","Cochabamba","U. E. San Agustín",128,0,1,0,52,5,11,1,0,198,1,5,204,231,0.263,0.883
"11075","Cochabamba","Cochabamba","U. E. San Agustín",148,0,1,0,42,1,6,2,1,201,3,2,206,225,0.209,0.916
"11076","Cochabamba","Cochabamba","U. E. San Agustín",136,0,0,0,47,0,6,0,0,189,2,10,201,224,0.249,0.897
"11077","Cochabamba","Cochabamba","U. E. San Agustín",157,1,0,0,44,1,4,1,0,208,0,4,212,233,0.212,0.91
"11078","Cochabamba","Cochabamba","U. E. San Agustín",149,0,1,0,39,3,8,1,0,201,2,3,206,225,0.194,0.916
"11079","Cochabamba","Cochabamba","U. E. San Agustín",141,0,1,1,53,2,6,0,0,204,0,7,211,228,0.26,0.925
"11080","Cochabamba","Cochabamba","U. E. San Agustín",153,0,0,0,41,1,6,1,0,202,2,3,207,230,0.203,0.9
"11081","Cochabamba","Cochabamba","U. E. San Agustín",143,0,0,0,57,1,6,1,1,209,0,4,213,231,0.273,0.922
"11082","Cochabamba","Cochabamba","U. E. San Agustín",143,0,0,0,40,1,9,0,1,194,1,5,200,224,0.206,0.893
"11083","Cochabamba","Cochabamba","U. E. San Agustín",149,0,2,0,40,1,8,1,1,202,1,4,207,230,0.198,0.9
"11084","Cochabamba","Cochabamba","U. E. San Agustín",156,1,1,1,34,0,6,1,1,201,1,3,205,228,0.169,0.899
"11085","Cochabamba","Cochabamba","U. E. San Agustín",155,0,0,0,37,2,8,0,0,202,0,6,208,225,0.183,0.924
"11086","Cochabamba","Cochabamba","U. E. San Agustín",153,0,1,1,32,3,7,0,2,199,1,4,204,229,0.161,0.891
"11087","Cochabamba","Cochabamba","U. E. San Agustín",145,0,2,0,44,2,8,0,1,202,1,8,211,227,0.218,0.93
"11088","Cochabamba","Cochabamba","U. E. San Agustín",157,0,0,1,50,2,4,1,1,216,0,5,221,248,0.231,0.891
"11089","Cochabamba","Cochabamba","Colegio La Salle Fiscal",126,0,1,0,52,5,4,0,0,188,2,8,198,220,0.277,0.9
"11090","Cochabamba","Cochabamba","Colegio La Salle Fiscal",146,0,2,0,39,4,7,0,0,198,0,8,206,225,0.197,0.916
"11091","Cochabamba","Cochabamba","Colegio La Salle Fiscal",143,0,0,0,49,0,4,0,0,196,2,4,202,230,0.25,0.878
"11092","Cochabamba","Cochabamba","Colegio La Salle Fiscal",132,0,0,0,54,3,11,1,0,201,1,3,205,224,0.269,0.915
"11093","Cochabamba","Cochabamba","Colegio La Salle Fiscal",133,0,0,0,56,5,4,0,0,198,1,3,202,219,0.283,0.922
"11094","Cochabamba","Cochabamba","Colegio La Salle Fiscal",119,0,1,1,63,0,7,1,1,193,3,6,202,220,0.326,0.918
"11095","Cochabamba","Cochabamba","Colegio La Salle Fiscal",115,0,3,0,62,5,10,2,0,197,1,3,201,227,0.315,0.885
"11096","Cochabamba","Cochabamba","Colegio La Salle Fiscal",127,1,0,0,49,6,3,1,0,187,0,2,189,217,0.262,0.871
"11097","Cochabamba","Cochabamba","Colegio La Salle Fiscal",138,0,3,0,42,2,8,0,1,194,0,5,199,222,0.216,0.896
"11098","Cochabamba","Cochabamba","Colegio La Salle Fiscal",125,1,1,0,63,2,6,0,1,199,0,4,203,225,0.317,0.902
"11099","Cochabamba","Cochabamba","Colegio La Salle Fiscal",131,0,1,1,59,1,13,0,0,206,0,5,211,231,0.286,0.913
"11100","Cochabamba","Cochabamba","Colegio La Salle Fiscal",119,1,3,0,48,1,7,0,1,180,3,11,194,223,0.267,0.87
"11101","Cochabamba","Cochabamba","Colegio La Salle Fiscal",115,0,1,1,64,4,5,0,2,192,0,8,200,230,0.333,0.87
"11102","Cochabamba","Cochabamba","Colegio La Salle Fiscal",118,0,1,0,53,3,7,1,1,184,1,5,190,217,0.288,0.876
"11103","Cochabamba","Cochabamba","Colegio La Salle Fiscal",129,0,1,0,39,2,1,1,2,175,0,6,181,217,0.223,0.834
"11104","Cochabamba","Cochabamba","Colegio La Salle Fiscal",142,1,1,0,47,3,4,0,3,201,1,2,204,227,0.234,0.899
"11105","Cochabamba","Cochabamba","Colegio La Salle Fiscal",141,1,1,0,45,7,6,0,0,201,1,8,210,225,0.224,0.933
"11106","Cochabamba","Cochabamba","Colegio La Salle Fiscal",128,1,0,2,51,4,9,1,2,198,0,4,202,224,0.258,0.902
"11107","Cochabamba","Cochabamba","Colegio La Salle Fiscal",125,0,0,1,48,9,0,0,0,183,1,6,190,214,0.262,0.888
"11108","Cochabamba","Cochabamba","Colegio La Salle Fiscal",135,1,2,0,44,0,4,1,0,187,1,2,190,213,0.235,0.892
"11109","Cochabamba","Cochabamba","Colegio La Salle Fiscal",122,0,2,1,39,3,10,0,1,178,2,4,184,213,0.219,0.864
"11110","Cochabamba","Cochabamba","Colegio La Salle Fiscal",129,1,1,0,55,3,7,0,5,201,0,3,204,221,0.274,0.923
"11111","Cochabamba","Cochabamba","Colegio La Salle Fiscal",137,0,0,1,42,3,6,0,1,190,3,2,195,224,0.221,0.871
"11112","Cochabamba","Cochabamba","Colegio La Salle Fiscal",133,1,0,0,52,3,2,1,1,193,2,7,202,225,0.269,0.898
"11113","Cochabamba","Cochabamba","Colegio La Salle Fiscal",135,0,1,0,46,2,6,0,1,191,0,2,193,216,0.241,0.894
"11114","Cochabamba","Cochabamba","Unidad Educativa Obispo Anaya",77,1,4,1,89,3,22,0,3,200,1,3,204,230,0.445,0.887
"11115","Cochabamba","Cochabamba","Unidad Educativa Obispo Anaya",66,2,0,0,103,7,22,0,0,200,1,6,207,224,0.515,0.924
"11116","Cochabamba","Cochabamba","Unidad Educativa Obispo Anaya",56,0,0,1,120,2,20,0,3,202,0,3,205,232,0.594,0.884
"11117","Cochabamba","Cochabamba","Unidad Educativa Obispo Anaya",52,1,1,1,130,4,15,0,1,205,1,7,213,231,0.634,0.922
"11118","Cochabamba","Cochabamba","Unidad Educativa Obispo Anaya",63,0,1,0,109,3,18,0,0,194,1,7,202,231,0.562,0.874
"11119","Cochabamba","Cochabamba","Unidad Educativa Obispo Anaya",56,1,0,2,116,5,23,0,1,204,0,0,204,230,0.569,0.887
"11120","Cochabamba","Cochabamba","Unidad Educativa Obispo Anaya",47,0,0,0,124,4,19,0,1,195,3,1,199,226,0.636,0.881
"11121","Cochabamba","Cochabamba","Unidad Educativa Obispo Anaya",48,0,2,0,125,6,16,0,0,197,1,13,211,231,0.635,0.913
"11122","Cochabamba","Cochabamba","Unidad Educativa Obispo Anaya",58,0,1,0,112,3,16,0,2,192,2,3,197,234,0.583,0.842
"11123","Cochabamba","Cochabamba","Unidad Educativa Obispo Anaya",48,1,0,0,106,3,29,1,2,190,2,11,203,224,0.558,0.906
"11124","Cochabamba","Cochabamba","Unidad Educativa Obispo Anaya",61,1,1,1,104,3,19,1,0,191,1,6,198,227,0.545,0.872
"11125","Cochabamba","Cochabamba","Unidad Educativa Obispo Anaya",57,0,0,0,120,5,15,0,3,200,2,6,208,228,0.6,0.912
"11126","Cochabamba","Cochabamba","Unidad Educativa Obispo Anaya",58,0,0,0,118,3,17,1,1,198,1,4,203,227,0.596,0.894
"11127","Cochabamba","Cochabamba","Centro Integrado El Salvador S-Vera Cruz",53,0,2,0,132,6,10,0,0,203,2,2,207,222,0.65,0.932
"11128","Cochabamba","Cochabamba","Centro Integrado El Salvador S-Vera Cruz",52,1,2,1,111,2,20,0,1,190,4,4,198,221,0.584,0.896
"11129","Cochabamba","Cochabamba","Centro Integrado El Salvador S-Vera Cruz",35,0,1,0,124,1,21,0,4,186,1,7,194,221,0.667,0.878
"11130","Cochabamba","Cochabamba","Centro Integrado El Salvador S-Vera Cruz",45,1,1,1,111,2,14,0,3,178,2,7,187,223,0.624,0.839
"11131","Cochabamba","Cochabamba","Centro Integrado El Salvador S-Vera Cruz",61,1,0,0,91,5,18,1,2,179,1,10,190,219,0.508,0.868
"11132","Cochabamba","Cochabamba","Centro Integrado El Salvador S-Vera Cruz",58,1,2,1,109,4,13,0,2,190,3,6,199,226,0.574,0.881
"11133","Cochabamba","Cochabamba","Centro Integrado El Salvador S-Vera Cruz",50,0,3,1,109,1,13,1,0,178,2,8,188,219,0.612,0.858
"11134","Cochabamba","Cochabamba","Centro Integrado El Salvador S-Vera Cruz",48,0,0,0,118,3,16,0,3,188,1,7,196,223,0.628,0.879
"11135","Cochabamba","Cochabamba","Centro Integrado El Salvador S-Vera Cruz",55,1,1,2,122,1,20,0,0,202,0,6,208,226,0.604,0.92
"11136","Cochabamba","Cochabamba","Centro Integrado El Salvador S-Vera Cruz",49,0,0,0,121,7,12,0,2,191,2,5,198,225,0.634,0.88
"11137","Cochabamba","Cochabamba","Centro Integrado El Salvador S-Vera Cruz",63,0,1,1,112,3,15,0,1,196,3,7,206,225,0.571,0.916
"11138","Cochabamba","Cochabamba","Centro Integrado El Salvador S-Vera Cruz",68,1,1,1,106,3,8,1,0,189,0,9,198,223,0.561,0.888
"11139","Cochabamba","Cochabamba","Unidad Educativa Nueva Vera Cruz",42,0,1,0,123,2,24,2,1,195,3,8,206,232,0.631,0.888
"11140","Cochabamba","Cochabamba","Unidad Educativa Nueva Vera Cruz",44,0,2,0,142,0,18,1,2,209,1,7,217,235,0.679,0.923
"11141","Cochabamba","Cochabamba","Unidad Educativa Nueva Vera Cruz",36,0,1,0,136,3,29,1,2,208,3,5,216,232,0.654,0.931
"11142","Cochabamba","Cochabamba","Unidad Educativa Nueva Vera Cruz",27,0,0,0,144,0,23,0,0,194,6,7,207,229,0.742,0.904
"11143","Cochabamba","Cochabamba","Unidad Educativa Nueva Vera Cruz",44,1,2,0,133,5,23,1,1,210,4,4,218,238,0.633,0.916
"11144","Cochabamba","Cochabamba","Unidad Educativa Nueva Vera Cruz",30,4,0,0,140,1,30,0,2,207,1,8,216,231,0.676,0.935
"11145","Cochabamba","Cochabamba","Unidad Educativa Nueva Vera Cruz",48,1,2,2,130,3,20,0,1,207,5,7,219,234,0.628,0.936
"11146","Cochabamba","Cochabamba","Unidad Educativa Nueva Vera Cruz",40,3,1,1,123,5,22,0,3,198,2,8,208,231,0.621,0.9
"11147","Cochabamba","Cochabamba","Unidad Educativa Nueva Vera Cruz",41,0,1,1,131,5,23,0,0,202,3,7,212,233,0.649,0.91
"11148","Cochabamba","Cochabamba","Unidad Educativa Nueva Vera Cruz",41,2,1,1,136,1,19,0,2,203,2,10,215,230,0.67,0.935
"11149","Cochabamba","Cochabamba","Unidad Educativa Nueva Vera Cruz",36,0,1,1,127,1,28,0,1,195,1,10,206,227,0.651,0.907
"11150","Cochabamba","Cochabamba","Unidad Educativa Nueva Vera Cruz",34,0,3,0,134,2,21,1,0,195,2,7,204,231,0.687,0.883
"11151","Cochabamba","Cochabamba","Unidad Educativa Nueva Vera Cruz",38,1,0,1,127,2,26,0,1,196,2,4,202,232,0.648,0.871
"11152","Cochabamba","Cochabamba","Unidad Educativa Nueva Vera Cruz",45,0,0,1,134,1,16,0,1,198,0,9,207,230,0.677,0.9
"11153","Cochabamba","Cochabamba","Unidad Educativa Nueva Vera Cruz",39,1,0,0,154,4,12,0,1,211,0,2,213,236,0.73,0.903
"11154","Cochabamba","Cochabamba","Unidad Educativa Nueva Vera Cruz",44,0,1,0,118,8,24,0,2,197,0,6,203,223,0.599,0.91
"11155","Cochabamba","Cochabamba","Colegio San Antonio De Pucara",35,0,1,0,102,5,6,0,2,151,51,6,208,229,0.675,0.908
"11156","Cochabamba","Cochabamba","Colegio San Antonio De Pucara",62,1,1,1,116,2,22,0,1,206,3,10,219,234,0.563,0.936
"11157","Cochabamba","Cochabamba","Colegio San Antonio De Pucara",64,0,2,0,113,3,16,0,1,199,1,5,205,229,0.568,0.895
"11158","Cochabamba","Cochabamba","Colegio San Antonio De Pucara",44,0,0,0,126,5,12,0,1,188,4,6,198,230,0.67,0.861
"11159","Cochabamba","Cochabamba","Colegio San Antonio De Pucara",47,0,2,0,121,5,24,0,4,203,3,8,214,235,0.596,0.911
"11160","Cochabamba","Cochabamba","Colegio San Antonio De Pucara",43,0,1,0,122,5,20,0,1,192,3,8,203,230,0.635,0.883
"11161","Cochabamba","Cochabamba","Colegio San Antonio De Pucara",52,0,3,0,113,2,27,0,3,200,0,8,208,228,0.565,0.912
"11162","Cochabamba","Cochabamba","Colegio San Antonio De Pucara",44,0,2,0,126,5,14,0,4,195,5,3,203,229,0.646,0.886
"11163","Cochabamba","Cochabamba","Colegio San Antonio De Pucara",49,0,1,1,121,3,17,0,2,194,1,5,200,231,0.624,0.866
"11164","Cochabamba","Cochabamba","Colegio San Antonio De Pucara",44,0,0,0,133,3,24,0,1,205,1,5,211,227,0.649,0.93
"11165","Cochabamba","Cochabamba","Colegio San Antonio De Pucara",29,2,1,0,139,4,16,0,3,194,3,5,202,235,0.716,0.86
"11166","Cochabamba","Cochabamba","Colegio San Antonio De Pucara",40,0,4,1,128,2,26,0,2,203,0,7,210,234,0.631,0.897
"11167","Cochabamba","Cochabamba","Colegio San Antonio De Pucara",33,0,1,0,142,1,12,2,2,193,3,5,201,233,0.736,0.863
"11168","Cochabamba","Cochabamba","Colegio San Antonio De Pucara",28,2,1,0,154,1,19,0,1,206,1,4,211,235,0.748,0.898
"11169","Cochabamba","Cochabamba","Colegio San Antonio De Pucara",55,1,1,2,114,4,21,0,1,199,1,7,207,233,0.573,0.888
"11170","Cochabamba","Cochabamba","Colegio San Antonio De Pucara",35,0,1,0,140,1,18,0,4,199,1,7,207,227,0.704,0.912
"11171","Cochabamba","Cochabamba","Colegio San Antonio De Pucara",61,2,1,0,114,5,13,0,1,197,0,5,202,232,0.579,0.871
"11172","Cochabamba","Cochabamba","Colegio San Antonio De Pucara",44,2,3,1,130,2,16,0,0,198,1,8,207,236,0.657,0.877
"11173","Cochabamba","Cochabamba","Colegio San Antonio De Pucara",61,0,1,0,111,4,14,0,4,195,3,4,202,231,0.569,0.874
"11174","Cochabamba","Cochabamba","Colegio San Antonio De Pucara",59,0,2,0,98,3,30,0,0,192,4,6,202,227,0.51,0.89
"11175","Cochabamba","Cochabamba","Colegio San Antonio De Pucara",63,1,1,0,111,1,23,0,0,200,2,6,208,230,0.555,0.904
"11176","Cochabamba","Cochabamba","Colegio San Antonio De Pucara",48,0,2,1,115,1,20,0,2,189,3,6,198,232,0.608,0.853
"11177","Cochabamba","Cochabamba","Colegio San Antonio De Pucara",63,1,1,2,107,3,20,1,1,199,2,7,208,232,0.538,0.897
"11178","Cochabamba","Cochabamba","Colegio San Antonio De Pucara",37,0,2,0,131,3,25,0,2,200,3,3,206,233,0.655,0.884
"11179","Cochabamba","Cochabamba","Colegio San Antonio De Pucara",41,1,2,2,135,1,24,1,1,208,0,8,216,232,0.649,0.931
"11180","Cochabamba","Cochabamba","Colegio San Antonio De Pucara",35,0,2,0,131,7,29,1,1,206,2,5,213,232,0.636,0.918
"11181","Cochabamba","Cochabamba","Colegio San Antonio De Pucara",64,0,1,0,116,4,13,0,1,199,1,4,204,228,0.583,0.895
"11182","Cochabamba","Cochabamba","Colegio San Antonio De Pucara",53,0,2,1,123,3,22,0,1,205,1,7,213,235,0.6,0.906
"11183","Cochabamba","Cochabamba","Colegio San Antonio De Pucara",43,0,2,2,138,4,22,0,1,212,2,6,220,231,0.651,0.952
"11184","Cochabamba","Cochabamba","Colegio San Antonio De Pucara",31,3,3,0,129,4,29,1,3,203,3,3,209,230,0.635,0.909
"11185","Cochabamba","Cochabamba","Colegio San Antonio De Pucara",33,0,5,1,146,3,20,0,0,208,2,3,213,236,0.702,0.903
"11186","Cochabamba","Cochabamba","Colegio San Antonio De Pucara",48,0,1,0,119,3,16,0,1,188,5,2,195,229,0.633,0.852
"11187","Cochabamba","Cochabamba","Colegio San Antonio De Pucara",49,0,2,1,125,0,21,0,2,200,2,6,208,227,0.625,0.916
"11188","Cochabamba","Cochabamba","Colegio San Antonio De Pucara",58,0,1,0,112,15,13,0,0,199,0,6,205,227,0.563,0.903
"11189","Cochabamba","Cochabamba","Colegio San Antonio De Pucara",59,1,1,0,113,2,21,1,1,199,2,8,209,230,0.568,0.909
"11190","Cochabamba","Cochabamba","Colegio San Antonio De Pucara",55,0,1,0,115,4,14,0,0,189,1,5,195,230,0.608,0.848
"11191","Cochabamba","Cochabamba","Colegio San Antonio De Pucara",53,0,3,0,112,3,22,0,0,193,0,11,204,229,0.58,0.891
"11192","Cochabamba","Cochabamba","Colegio San Antonio De Pucara",55,1,1,0,118,1,22,0,2,200,1,10,211,230,0.59,0.917
"11193","Cochabamba","Cochabamba","Colegio San Antonio De Pucara",51,1,1,1,117,4,15,0,3,193,3,6,202,230,0.606,0.878
"11194","Cochabamba","Cochabamba","Colegio San Antonio De Pucara",37,0,1,0,138,1,23,0,2,202,2,4,208,235,0.683,0.885
"11195","Cochabamba","Cochabamba","Colegio San Antonio De Pucara",54,0,1,1,126,2,19,1,1,205,0,3,208,232,0.615,0.897
"11196","Cochabamba","Cochabamba","Colegio San Antonio De Pucara",66,1,0,0,103,8,18,0,3,199,1,8,208,229,0.518,0.908
"11197","Cochabamba","Cochabamba","Colegio San Antonio De Pucara",66,0,0,0,106,5,9,0,6,192,1,11,204,231,0.552,0.883
"11198","Cochabamba","Cochabamba","Colegio San Antonio De Pucara",47,0,2,0,114,1,36,1,3,204,0,8,212,234,0.559,0.906
"11199","Cochabamba","Cochabamba","Colegio San Antonio De Pucara",61,1,1,2,114,5,13,0,1,198,0,7,205,230,0.576,0.891
"11200","Cochabamba","Cochabamba","Colegio San Antonio De Pucara",31,0,3,0,146,3,15,0,0,198,2,7,207,229,0.737,0.904
"11201","Cochabamba","Cochabamba","Colegio San Antonio De Pucara",54,1,2,1,122,5,20,0,0,205,0,5,210,227,0.595,0.925
"11202","Cochabamba","Cochabamba","Colegio San Antonio De Pucara",33,1,0,0,144,2,23,0,2,205,0,1,206,228,0.702,0.904
"11203","Cochabamba","Cochabamba","Colegio San Antonio De Pucara",58,0,0,1,113,6,15,0,2,195,2,8,205,229,0.579,0.895
"11204","Cochabamba","Cochabamba","Colegio San Antonio De Pucara",54,1,1,0,106,5,23,0,0,190,1,6,197,226,0.558,0.872
"11205","Cochabamba","Cochabamba","Colegio San Antonio De Pucara",48,0,0,0,112,5,27,0,3,195,3,4,202,232,0.574,0.871
"11206","Cochabamba","Cochabamba","Colegio San Antonio De Pucara",52,0,1,0,121,5,22,0,3,204,0,5,209,230,0.593,0.909
"11207","Cochabamba","Cochabamba","Colegio San Antonio De Pucara",38,0,3,0,143,5,16,0,1,206,0,4,210,233,0.694,0.901
"11208","Cochabamba","Cochabamba","Unidad Educativa Atiy",45,0,0,0,131,3,32,1,1,213,2,5,220,235,0.615,0.936
"11209","Cochabamba","Cochabamba","Unidad Educativa Atiy",30,1,0,1,146,6,28,0,1,213,1,9,223,237,0.685,0.941
"11210","Cochabamba","Cochabamba","Unidad Educativa Atiy",43,0,1,0,142,6,24,0,2,218,4,5,227,237,0.651,0.958
"11211","Cochabamba","Cochabamba","Unidad Educativa Atiy",57,1,1,0,125,3,32,0,3,222,0,2,224,239,0.563,0.937
"11212","Cochabamba","Cochabamba","Unidad Educativa Atiy",28,1,4,0,145,3,27,2,1,211,3,4,218,239,0.687,0.912
"11213","Cochabamba","Cochabamba","Unidad Educativa Atiy",46,1,2,1,136,0,24,1,2,213,2,4,219,235,0.638,0.932
"11214","Cochabamba","Cochabamba","Unidad Educativa Atiy",49,0,1,1,133,8,18,0,1,211,0,8,219,232,0.63,0.944
"11215","Cochabamba","Cochabamba","Unidad Educativa Atiy",35,0,4,0,131,0,17,0,2,189,1,5,195,211,0.693,0.924
"11216","Cochabamba","Cochabamba","Hogar Comunitario Disneylandia",59,0,0,0,121,5,23,0,1,209,0,6,215,238,0.579,0.903
"11217","Cochabamba","Cochabamba","U. E. Luz y Verdad",77,0,1,0,105,5,22,1,2,213,3,4,220,239,0.493,0.921
"11218","Cochabamba","Cochabamba","Unidad Educativa Bolivia (La Maica)",49,0,1,0,136,4,6,0,3,199,2,14,215,232,0.683,0.927
"11219","Cochabamba","Cochabamba","Unidad Educativa Bolivia (La Maica)",35,0,1,1,141,7,11,1,1,198,6,7,211,227,0.712,0.93
"11220","Cochabamba","Cochabamba","Unidad Educativa Bolivia (La Maica)",33,0,0,0,155,4,10,1,2,205,4,3,212,233,0.756,0.91
"11221","Cochabamba","Cochabamba","Unidad Educativa Bolivia (La Maica)",33,0,0,2,140,6,5,2,1,189,5,7,201,226,0.741,0.889
"11222","Cochabamba","Cochabamba","Unidad Educativa Bolivia (La Maica)",43,2,3,3,129,6,10,0,0,196,1,8,205,234,0.658,0.876
"11223","Cochabamba","Cochabamba","Unidad Educativa Bolivia (La Maica)",37,0,0,0,142,4,8,1,2,194,4,12,210,228,0.732,0.921
"11224","Cochabamba","Cochabamba","Unidad Educativa Bolivia (La Maica)",33,1,0,0,112,3,15,0,6,170,2,6,178,199,0.659,0.894
"11225","Cochabamba","Cochabamba","Unidad Educativa Demetrio Canelas",54,0,1,1,139,4,8,0,0,207,3,2,212,226,0.671,0.938
"11226","Cochabamba","Cochabamba","Unidad Educativa Demetrio Canelas",58,1,0,0,109,7,10,0,2,187,6,13,206,228,0.583,0.904
"11227","Cochabamba","Cochabamba","Unidad Educativa Demetrio Canelas",45,0,1,1,128,9,14,1,2,201,3,11,215,233,0.637,0.923
"11228","Cochabamba","Cochabamba","Unidad Educativa Demetrio Canelas",45,1,2,0,130,4,7,1,0,190,1,11,202,223,0.684,0.906
"11229","Cochabamba","Cochabamba","Unidad Educativa Demetrio Canelas",37,1,0,1,136,4,16,0,0,195,1,5,201,222,0.697,0.905
"11230","Cochabamba","Cochabamba","Unidad Educativa Demetrio Canelas",47,0,1,0,133,3,21,1,0,206,2,11,219,230,0.646,0.952
"11231","Cochabamba","Cochabamba","Unidad Educativa Demetrio Canelas",46,1,1,0,129,4,15,1,0,197,8,7,212,227,0.655,0.934
"11232","Cochabamba","Cochabamba","Unidad Educativa Demetrio Canelas",41,1,3,0,150,6,9,0,1,211,3,4,218,230,0.711,0.948
"11233","Cochabamba","Cochabamba","Unidad Educativa Demetrio Canelas",52,0,1,1,116,5,13,1,1,190,3,10,203,227,0.611,0.894
"11234","Cochabamba","Cochabamba","Unidad Educativa Demetrio Canelas",52,0,1,0,134,10,11,1,1,210,1,3,214,230,0.638,0.93
"11235","Cochabamba","Cochabamba","Unidad Educativa Demetrio Canelas",35,0,0,1,103,7,17,0,0,163,3,4,170,183,0.632,0.929
"11236","Cochabamba","Cochabamba","Colegio Laura Vicuña",46,0,0,0,118,7,21,0,2,194,4,10,208,227,0.608,0.916
"11237","Cochabamba","Cochabamba","Colegio Laura Vicuña",68,0,1,1,116,6,12,0,0,204,1,5,210,229,0.569,0.917
"11238","Cochabamba","Cochabamba","Colegio Laura Vicuña",49,0,0,1,122,7,15,0,0,194,1,11,206,226,0.629,0.912
"11239","Cochabamba","Cochabamba","Colegio Laura Vicuña",62,1,3,2,108,5,16,0,2,199,1,9,209,227,0.543,0.921
"11240","Cochabamba","Cochabamba","Colegio Laura Vicuña",68,0,1,0,109,1,16,0,1,196,3,8,207,228,0.556,0.908
"11241","Cochabamba","Cochabamba","Colegio Laura Vicuña",46,1,1,0,122,2,18,0,2,192,1,9,202,226,0.635,0.894
"11242","Cochabamba","Cochabamba","Unidad Educativa Antonio Diez",51,0,2,0,138,4,20,1,2,218,0,4,222,237,0.633,0.937
"11243","Cochabamba","Cochabamba","Unidad Educativa Antonio Diez",48,1,1,0,138,3,21,1,1,214,2,8,224,239,0.645,0.937
"11244","Cochabamba","Cochabamba","Unidad Educativa Antonio Diez",28,0,3,1,153,3,26,0,3,217,1,12,230,239,0.705,0.962
"11245","Cochabamba","Cochabamba","Unidad Educativa Antonio Diez",32,0,2,2,146,5,31,0,1,219,2,2,223,232,0.667,0.961
"11246","Cochabamba","Cochabamba","Unidad Educativa Antonio Diez",57,3,1,0,129,6,16,1,4,217,4,5,226,238,0.594,0.95
"11247","Cochabamba","Cochabamba","Unidad Educativa Antonio Diez",48,1,3,0,141,4,15,0,2,214,2,8,224,238,0.659,0.941
"11248","Cochabamba","Cochabamba","Unidad Educativa Antonio Diez",53,0,0,0,136,5,18,0,3,215,1,5,221,234,0.633,0.944
"11249","Cochabamba","Cochabamba","Unidad Educativa Antonio Diez",42,0,3,0,151,4,17,0,2,219,1,9,229,239,0.689,0.958
"11250","Cochabamba","Cochabamba","Unidad Educativa Antonio Diez",48,1,0,0,139,6,19,0,3,216,4,6,226,238,0.644,0.95
"11251","Cochabamba","Cochabamba","Unidad Educativa Antonio Diez",40,0,2,0,134,2,33,1,3,215,1,9,225,236,0.623,0.953
"11252","Cochabamba","Cochabamba","Unidad Educativa Antonio Diez",40,0,0,2,156,4,14,0,3,219,1,6,226,240,0.712,0.942
"11253","Cochabamba","Cochabamba","Unidad Educativa Antonio Diez",53,0,0,0,137,2,16,1,1,210,4,6,220,240,0.652,0.917
"11254","Cochabamba","Cochabamba","Unidad Educativa Antonio Diez",55,0,0,0,140,4,14,0,4,217,2,7,226,237,0.645,0.954
"11255","Cochabamba","Cochabamba","U. E. El Mirador",15,1,2,0,199,3,17,0,1,238,6,7,251,258,0.836,0.973
"11256","Cochabamba","Cochabamba","Escuela 6 de Agosto",29,0,1,0,139,1,26,0,2,198,3,7,208,231,0.702,0.9
"11257","Cochabamba","Cochabamba","Escuela 6 de Agosto",28,2,2,0,144,1,21,1,2,201,3,6,210,229,0.716,0.917
"11258","Cochabamba","Cochabamba","Escuela 6 de Agosto",24,1,3,2,134,2,39,0,5,210,2,3,215,234,0.638,0.919
"11259","Cochabamba","Cochabamba","Escuela 6 de Agosto",48,0,2,0,136,2,23,1,0,212,3,3,218,235,0.642,0.928
"11260","Cochabamba","Cochabamba","Escuela 6 de Agosto",35,0,3,0,141,3,19,0,2,203,3,10,216,233,0.695,0.927
"11261","Cochabamba","Cochabamba","Escuela 6 de Agosto",29,0,6,0,145,1,24,0,1,206,0,6,212,232,0.704,0.914
"11262","Cochabamba","Cochabamba","Escuela 6 de Agosto",21,3,2,0,160,1,14,0,2,203,3,8,214,230,0.788,0.93
"11263","Cochabamba","Cochabamba","Escuela 6 de Agosto",27,0,4,1,146,8,22,0,1,209,2,10,221,236,0.699,0.936
"11264","Cochabamba","Cochabamba","Escuela 6 de Agosto",20,1,4,1,160,4,15,1,1,207,2,8,217,234,0.773,0.927
"11265","Cochabamba","Cochabamba","Escuela 6 de Agosto",23,0,2,0,149,5,19,0,1,199,6,3,208,229,0.749,0.908
"11266","Cochabamba","Cochabamba","Escuela 6 de Agosto",28,0,2,1,164,1,19,0,1,216,2,7,225,236,0.759,0.953
"11267","Cochabamba","Cochabamba","Escuela 6 de Agosto",31,0,4,1,147,1,12,1,3,200,6,8,214,232,0.735,0.922
"11268","Cochabamba","Cochabamba","Escuela 6 de Agosto",27,2,3,1,151,3,23,0,0,210,0,2,212,232,0.719,0.914
"11269","Cochabamba","Cochabamba","Escuela 6 de Agosto",31,1,1,0,157,1,12,0,2,205,7,2,214,230,0.766,0.93
"11270","Cochabamba","Cochabamba","Escuela 6 de Agosto",34,0,5,0,143,3,28,0,0,213,7,9,229,237,0.671,0.966
"11271","Cochabamba","Cochabamba","Escuela 6 de Agosto",18,2,5,2,150,2,16,0,0,195,2,15,212,233,0.769,0.91
"11272","Cochabamba","Cochabamba","Escuela 6 de Agosto",23,0,4,0,162,0,18,0,3,210,1,5,216,234,0.771,0.923
"11273","Cochabamba","Cochabamba","Escuela 6 de Agosto",22,0,4,0,157,5,22,0,0,210,1,4,215,230,0.748,0.935
"11274","Cochabamba","Cochabamba","Escuela 6 de Agosto",25,0,3,0,158,2,19,0,0,207,1,8,216,237,0.763,0.911
"11275","Cochabamba","Cochabamba","Escuela 6 de Agosto",26,1,6,0,160,0,11,0,2,206,0,9,215,228,0.777,0.943
"11276","Cochabamba","Cochabamba","Escuela 6 de Agosto",34,0,1,0,153,8,15,0,1,212,0,8,220,234,0.722,0.94
"11277","Cochabamba","Cochabamba","Escuela 6 de Agosto",35,1,2,1,148,1,22,1,0,211,3,2,216,233,0.701,0.927
"11278","Cochabamba","Cochabamba","Escuela 6 de Agosto",32,2,1,0,152,3,10,0,3,203,2,9,214,233,0.749,0.918
"11279","Cochabamba","Cochabamba","Escuela 6 de Agosto",38,1,2,0,137,3,20,0,2,203,1,9,213,230,0.675,0.926
"11280","Cochabamba","Cochabamba","Escuela 6 de Agosto",38,0,4,0,134,3,30,0,2,211,3,7,221,232,0.635,0.953
"11281","Cochabamba","Cochabamba","Escuela 6 de Agosto",31,0,2,0,144,2,17,0,0,196,3,2,201,227,0.735,0.885
"11282","Cochabamba","Cochabamba","Escuela 6 de Agosto",38,0,1,1,140,7,15,1,0,203,0,7,210,234,0.69,0.897
"11283","Cochabamba","Cochabamba","Escuela 6 de Agosto",37,0,2,2,127,3,23,0,1,195,3,10,208,230,0.651,0.904
"11284","Cochabamba","Cochabamba","Escuela 6 de Agosto",21,1,2,0,163,2,18,1,2,210,2,7,219,233,0.776,0.94
"11285","Cochabamba","Cochabamba","Escuela 6 de Agosto",36,0,4,1,153,3,17,0,2,216,0,0,216,232,0.708,0.931
"11286","Cochabamba","Cochabamba","Escuela 6 de Agosto",15,0,4,0,130,7,20,0,2,178,41,1,220,237,0.73,0.928
"11287","Cochabamba","Cochabamba","Unidad Educativa Nueva Esperanza",23,2,0,2,140,6,25,0,1,199,4,5,208,233,0.704,0.893
"11288","Cochabamba","Cochabamba","Unidad Educativa Nueva Esperanza",21,0,4,2,146,3,20,0,0,196,3,11,210,225,0.745,0.933
"11289","Cochabamba","Cochabamba","Unidad Educativa Nueva Esperanza",30,0,1,1,142,4,23,1,6,208,5,7,220,236,0.683,0.932
"11290","Cochabamba","Cochabamba","Unidad Educativa Nueva Esperanza",28,0,2,0,155,3,17,0,2,207,3,7,217,233,0.749,0.931
"11291","Cochabamba","Cochabamba","Unidad Educativa Nueva Esperanza",25,1,3,1,143,0,26,2,1,202,4,3,209,231,0.708,0.905
"11292","Cochabamba","Cochabamba","Unidad Educativa Nueva Esperanza",9,0,1,1,164,3,28,0,1,207,3,6,216,234,0.792,0.923
"11293","Cochabamba","Cochabamba","Unidad Educativa Nueva Esperanza",23,0,2,0,152,4,23,2,3,209,2,4,215,231,0.727,0.931
"11294","Cochabamba","Cochabamba","Unidad Educativa Nueva Esperanza",21,1,0,1,165,1,19,0,2,210,3,5,218,234,0.786,0.932
"11295","Cochabamba","Cochabamba","Unidad Educativa Nueva Esperanza",37,0,1,1,140,4,20,0,1,204,1,7,212,231,0.686,0.918
"11296","Cochabamba","Cochabamba","Unidad Educativa Nueva Esperanza",20,0,1,0,153,3,22,0,3,202,4,5,211,232,0.757,0.909
"11297","Cochabamba","Cochabamba","Unidad Educativa Nueva Esperanza",35,1,3,1,139,0,25,0,0,204,2,13,219,233,0.681,0.94
"11298","Cochabamba","Cochabamba","Unidad Educativa Nueva Esperanza",27,1,2,3,138,3,15,1,3,193,1,11,205,236,0.715,0.869
"11299","Cochabamba","Cochabamba","Unidad Educativa Nueva Esperanza",24,1,0,0,151,4,24,0,2,206,1,3,210,225,0.733,0.933
"11300","Cochabamba","Cochabamba","Unidad Educativa Nueva Esperanza",24,1,2,0,133,1,26,0,1,188,1,18,207,233,0.707,0.888
"11301","Cochabamba","Cochabamba","Unidad Educativa Nueva Esperanza",28,0,3,1,140,3,18,0,2,195,2,7,204,230,0.718,0.887
"11302","Cochabamba","Cochabamba","Unidad Educativa Nueva Esperanza",15,0,1,1,162,3,23,0,0,205,3,9,217,234,0.79,0.927
"11303","Cochabamba","Cochabamba","Unidad Educativa Nueva Esperanza",33,0,4,0,132,3,26,0,2,200,2,5,207,233,0.66,0.888
"11304","Cochabamba","Cochabamba","Unidad Educativa Nueva Esperanza",25,0,0,0,159,2,12,0,4,202,3,8,213,227,0.787,0.938
"11305","Cochabamba","Cochabamba","Unidad Educativa Nueva Esperanza",32,0,1,1,141,2,27,0,1,205,3,9,217,234,0.688,0.927
"11306","Cochabamba","Cochabamba","Unidad Educativa Nueva Esperanza",20,0,5,0,153,2,25,0,3,208,1,5,214,231,0.736,0.926
"11307","Cochabamba","Cochabamba","Unidad Educativa Nueva Esperanza",19,0,0,0,153,0,20,0,1,193,1,8,202,222,0.793,0.91
"11308","Cochabamba","Cochabamba","Unidad Educativa Nueva Esperanza",31,0,0,0,137,3,25,0,0,196,4,7,207,229,0.699,0.904
"11309","Cochabamba","Cochabamba","Unidad Educativa Nueva Esperanza",33,1,4,0,148,2,14,0,3,205,1,6,212,229,0.722,0.926
"11310","Cochabamba","Cochabamba","Unidad Educativa Nueva Esperanza",37,0,4,1,135,1,29,0,1,208,3,2,213,233,0.649,0.914
"11311","Cochabamba","Cochabamba","Unidad Educativa Nueva Esperanza",26,0,1,0,158,0,23,0,2,210,1,6,217,231,0.752,0.939
"11312","Cochabamba","Cochabamba","U.E. Israel",34,0,1,0,163,2,30,0,0,230,0,2,232,239,0.709,0.971
"11313","Cochabamba","Cochabamba","U.E. Israel",21,0,0,0,162,5,32,0,0,220,2,4,226,239,0.736,0.946
"11314","Cochabamba","Cochabamba","U.E. Israel",22,0,2,0,167,0,25,0,1,217,3,3,223,239,0.77,0.933
"11315","Cochabamba","Cochabamba","U.E. Israel",25,1,4,1,140,2,35,0,2,210,1,11,222,237,0.667,0.937
"11316","Cochabamba","Cochabamba","U.E. Israel",27,0,1,2,145,4,30,0,2,211,5,8,224,238,0.687,0.941
"11317","Cochabamba","Cochabamba","U.E. Israel",24,0,1,1,151,7,29,0,3,216,5,4,225,237,0.699,0.949
"11318","Cochabamba","Cochabamba","U.E. Israel",22,0,3,0,166,4,22,1,3,221,1,3,225,238,0.751,0.945
"11319","Cochabamba","Cochabamba","U.E. Israel",45,1,2,0,135,6,30,0,1,220,1,6,227,239,0.614,0.95
"11320","Cochabamba","Cochabamba","Unidad Educativa Hno Pacifico Feletti",22,0,1,1,155,1,21,0,2,203,7,13,223,239,0.764,0.933
"11321","Cochabamba","Cochabamba","Unidad Educativa Hno Pacifico Feletti",31,0,1,1,148,3,26,1,4,215,2,9,226,239,0.688,0.946
"11322","Cochabamba","Cochabamba","Unidad Educativa Hno Pacifico Feletti",22,1,1,0,163,1,25,0,2,215,5,5,225,238,0.758,0.945
"11323","Cochabamba","Cochabamba","Unidad Educativa Hno Pacifico Feletti",16,0,0,0,146,2,26,0,0,190,4,24,218,239,0.768,0.912
"11324","Cochabamba","Cochabamba","Unidad Educativa Hno Pacifico Feletti",19,0,1,1,158,2,21,0,3,205,3,8,216,235,0.771,0.919
"11325","Cochabamba","Cochabamba","Unidad Educativa Hno Pacifico Feletti",27,1,4,1,156,3,27,0,1,220,2,1,223,239,0.709,0.933
"11326","Cochabamba","Cochabamba","Unidad Educativa Hno Pacifico Feletti",26,1,1,0,157,4,29,0,2,220,1,8,229,239,0.714,0.958
"11327","Cochabamba","Cochabamba","Unidad Educativa Hno Pacifico Feletti",15,0,3,0,159,6,32,0,0,215,2,5,222,237,0.74,0.937
"11328","Cochabamba","Cochabamba","Unidad Educativa Hno Pacifico Feletti",19,0,2,0,153,5,34,2,2,217,1,8,226,239,0.705,0.946
"11329","Cochabamba","Cochabamba","Unidad Educativa Hno Pacifico Feletti",22,1,2,1,150,5,30,1,1,213,3,5,221,238,0.704,0.929
"11330","Cochabamba","Cochabamba","Unidad Educativa Hno Pacifico Feletti",28,0,1,0,153,3,26,0,0,211,3,5,219,236,0.725,0.928
"11331","Cochabamba","Cochabamba","Unidad Educativa Hno Pacifico Feletti",19,1,1,1,174,0,21,0,1,218,4,3,225,239,0.798,0.941
"11332","Cochabamba","Cochabamba","Unidad Educativa Hno Pacifico Feletti",29,0,4,0,160,5,27,0,2,227,1,6,234,247,0.705,0.947
"11333","Cochabamba","Cochabamba","Escuela Eusebio Tudela",40,0,1,0,147,3,6,0,0,197,1,4,202,229,0.746,0.882
"11334","Cochabamba","Cochabamba","Escuela Eusebio Tudela",49,0,1,0,123,7,12,3,3,198,1,13,212,230,0.621,0.922
"11335","Cochabamba","Cochabamba","Escuela Eusebio Tudela",40,0,3,0,141,2,18,0,1,205,1,6,212,236,0.688,0.898
"11336","Cochabamba","Cochabamba","Escuela Eusebio Tudela",29,0,4,0,141,0,35,0,5,214,1,5,220,238,0.659,0.924
"11337","Cochabamba","Cochabamba","Escuela Eusebio Tudela",21,0,3,0,146,3,27,0,0,200,2,6,208,224,0.73,0.929
"11338","Cochabamba","Cochabamba","Escuela Eusebio Tudela",31,0,1,0,144,5,31,0,2,214,2,5,221,236,0.673,0.936
"11339","Cochabamba","Cochabamba","Escuela Eusebio Tudela",42,0,4,1,139,5,15,1,2,209,3,4,216,235,0.665,0.919
"11340","Cochabamba","Cochabamba","Escuela Eusebio Tudela",31,1,1,0,151,1,14,0,6,205,4,7,216,234,0.737,0.923
"11341","Cochabamba","Cochabamba","Escuela Eusebio Tudela",52,0,3,0,126,5,20,0,1,207,1,2,210,230,0.609,0.913
"11342","Cochabamba","Cochabamba","Escuela Eusebio Tudela",25,0,1,0,155,0,19,0,1,201,2,10,213,235,0.771,0.906
"11343","Cochabamba","Cochabamba","Escuela Eusebio Tudela",38,1,1,0,132,7,24,0,1,204,5,9,218,235,0.647,0.928
"11344","Cochabamba","Cochabamba","Escuela Eusebio Tudela",30,1,0,0,147,1,22,0,0,201,0,10,211,232,0.731,0.909
"11345","Cochabamba","Cochabamba","Escuela Eusebio Tudela",44,0,1,0,148,2,13,1,1,210,5,6,221,236,0.705,0.936
"11346","Cochabamba","Cochabamba","Escuela Eusebio Tudela",40,1,4,1,137,4,25,0,0,212,3,3,218,227,0.646,0.96
"11347","Cochabamba","Cochabamba","Escuela Eusebio Tudela",48,0,2,0,135,5,13,0,2,205,2,7,214,233,0.659,0.918
"11348","Cochabamba","Cochabamba","Escuela Eusebio Tudela",43,1,2,0,133,2,16,1,2,200,4,11,215,231,0.665,0.931
"11349","Cochabamba","Cochabamba","Escuela Eusebio Tudela",35,3,2,0,136,4,17,1,1,199,4,6,209,227,0.683,0.921
"11350","Cochabamba","Cochabamba","Escuela Eusebio Tudela",44,0,2,0,131,8,19,0,2,206,2,6,214,233,0.636,0.918
"11351","Cochabamba","Cochabamba","Escuela Eusebio Tudela",33,0,0,0,138,5,21,0,2,199,1,4,204,228,0.693,0.895
"11352","Cochabamba","Cochabamba","U. E. Patria Nueva",30,0,1,0,148,0,19,0,2,200,3,7,210,228,0.74,0.921
"11353","Cochabamba","Cochabamba","U. E. Patria Nueva",21,2,0,0,160,1,11,1,2,198,1,11,210,232,0.808,0.905
"11354","Cochabamba","Cochabamba","U. E. Patria Nueva",18,0,2,2,152,4,11,1,0,190,2,13,205,226,0.8,0.907
"11355","Cochabamba","Cochabamba","U. E. Patria Nueva",32,0,3,0,137,4,17,0,2,195,2,8,205,231,0.703,0.887
"11356","Cochabamba","Cochabamba","U. E. Patria Nueva",28,0,1,0,158,0,24,0,1,212,1,6,219,236,0.745,0.928
"11357","Cochabamba","Cochabamba","U. E. Patria Nueva",17,0,3,0,148,2,30,1,0,201,4,1,206,230,0.736,0.896
"11358","Cochabamba","Cochabamba","U. E. Patria Nueva",22,0,3,0,129,1,26,0,1,182,2,5,189,223,0.709,0.848
"11359","Cochabamba","Cochabamba","U. E. Patria Nueva",14,1,1,2,154,2,28,0,0,202,1,9,212,226,0.762,0.938
"11360","Cochabamba","Cochabamba","U. E. Patria Nueva",19,0,1,2,153,6,24,0,5,210,3,7,220,234,0.729,0.94
"11361","Cochabamba","Cochabamba","U. E. Patria Nueva",22,0,0,1,148,3,19,0,1,194,0,10,204,225,0.763,0.907
"11362","Cochabamba","Cochabamba","U. E. Patria Nueva",24,0,0,0,159,7,22,0,3,215,0,6,221,231,0.74,0.957
"11363","Cochabamba","Cochabamba","U. E. Patria Nueva",23,0,1,0,136,5,20,0,5,190,3,9,202,231,0.716,0.874
"11364","Cochabamba","Cochabamba","U. E. Patria Nueva",31,3,1,0,153,0,18,0,1,207,6,4,217,231,0.739,0.939
"11365","Cochabamba","Cochabamba","U. E. Patria Nueva",26,1,1,0,144,1,27,0,2,202,3,1,206,233,0.713,0.884
"11366","Cochabamba","Cochabamba","U. E. Patria Nueva",28,1,4,0,147,3,21,1,1,206,6,2,214,227,0.714,0.943
"11367","Cochabamba","Cochabamba","U. E. Patria Nueva",24,1,2,0,150,1,31,0,5,214,1,3,218,233,0.701,0.936
"11368","Cochabamba","Cochabamba","U. E. Patria Nueva",22,1,3,0,141,2,22,0,2,193,0,19,212,235,0.731,0.902
"11369","Cochabamba","Cochabamba","U. E. Patria Nueva",23,0,1,1,145,2,23,1,2,198,3,5,206,226,0.732,0.912
"11370","Cochabamba","Cochabamba","U. E. Patria Nueva",15,1,3,0,168,5,16,0,2,210,2,2,214,230,0.8,0.93
"11371","Cochabamba","Cochabamba","U. E. Patria Nueva",32,0,0,1,143,5,27,0,2,210,6,2,218,234,0.681,0.932
"11372","Cochabamba","Cochabamba","U. E. Patria Nueva",24,1,2,0,143,3,23,1,3,200,4,6,210,235,0.715,0.894
"11373","Cochabamba","Cochabamba","U. E. Patria Nueva",24,0,3,2,140,5,29,0,3,206,3,5,214,229,0.68,0.934
"11374","Cochabamba","Cochabamba","U. E. Patria Nueva",30,0,1,0,151,3,18,0,2,205,1,11,217,236,0.737,0.919
"11375","Cochabamba","Cochabamba","U. E. Patria Nueva",26,0,0,0,149,2,0,1,1,179,0,4,183,221,0.832,0.828
"11376","Cochabamba","Cochabamba","U. E. Patria Nueva",13,0,2,0,155,1,23,1,3,198,0,7,205,229,0.783,0.895
"11377","Cochabamba","Cochabamba","U. E. Patria Nueva",23,0,3,0,157,3,9,0,1,196,0,6,202,226,0.801,0.894
"11378","Cochabamba","Cochabamba","U. E. Patria Nueva",30,0,1,0,145,2,13,1,3,195,3,13,211,230,0.744,0.917
"11379","Cochabamba","Cochabamba","U. E. Patria Nueva",27,0,1,0,134,0,30,0,0,192,0,7,199,230,0.698,0.865
"11380","Cochabamba","Cochabamba","U. E. Patria Nueva",27,1,0,0,152,4,17,0,2,203,2,7,212,230,0.749,0.922
"11381","Cochabamba","Cochabamba","U. E. Padre Luis Diez del Pozo",65,0,1,2,128,4,19,1,0,220,3,10,233,240,0.582,0.971
"11382","Cochabamba","Cochabamba","U. E. Padre Luis Diez del Pozo",61,0,0,1,124,2,33,0,1,222,2,8,232,240,0.559,0.967
"11383","Cochabamba","Cochabamba","U. E. Padre Luis Diez del Pozo",60,0,1,0,118,7,30,0,1,217,3,9,229,238,0.544,0.962
"11384","Cochabamba","Cochabamba","U. E. Padre Luis Diez del Pozo",76,2,0,1,112,8,28,0,0,227,3,4,234,240,0.493,0.975
"11385","Cochabamba","Cochabamba","Escuela Ceferino Namuncura",28,0,1,0,137,1,27,1,2,197,3,6,206,232,0.695,0.888
"11386","Cochabamba","Cochabamba","Escuela Ceferino Namuncura",34,0,0,0,130,1,15,1,0,181,4,5,190,222,0.718,0.856
"11387","Cochabamba","Cochabamba","Escuela Ceferino Namuncura",23,0,0,0,151,5,14,0,1,194,1,6,201,233,0.778,0.863
"11388","Cochabamba","Cochabamba","Escuela Ceferino Namuncura",53,0,1,0,129,10,14,0,0,207,0,3,210,225,0.623,0.933
"11389","Cochabamba","Cochabamba","Escuela Ceferino Namuncura",42,0,0,1,122,2,19,0,1,187,5,7,199,234,0.652,0.85
"11390","Cochabamba","Cochabamba","Escuela Ceferino Namuncura",42,0,0,1,136,2,14,1,2,198,0,9,207,226,0.687,0.916
"11391","Cochabamba","Cochabamba","Unidad Educ. Eduardo Lopez O E. Don Bosco",66,0,1,0,97,11,19,0,0,194,1,6,201,226,0.5,0.889
"11392","Cochabamba","Cochabamba","Unidad Educ. Eduardo Lopez O E. Don Bosco",76,0,1,0,97,3,18,1,1,197,4,5,206,230,0.492,0.896
"11393","Cochabamba","Cochabamba","Unidad Educ. Eduardo Lopez O E. Don Bosco",55,0,0,0,128,2,12,2,2,201,4,1,206,232,0.637,0.888
"11394","Cochabamba","Cochabamba","Unidad Educ. Eduardo Lopez O E. Don Bosco",51,1,1,1,113,5,17,0,0,189,4,10,203,227,0.598,0.894
"11395","Cochabamba","Cochabamba","Unidad Educ. Eduardo Lopez O E. Don Bosco",54,0,1,0,108,13,17,0,3,196,0,3,199,225,0.551,0.884
"11396","Cochabamba","Cochabamba","Unidad Educ. Eduardo Lopez O E. Don Bosco",68,0,0,0,109,6,11,0,1,195,5,4,204,226,0.559,0.903
"11397","Cochabamba","Cochabamba","Unidad Educ. Eduardo Lopez O E. Don Bosco",52,0,0,0,123,2,21,0,0,198,1,5,204,230,0.621,0.887
"11398","Cochabamba","Cochabamba","Unidad Educ. Eduardo Lopez O E. Don Bosco",49,0,0,0,130,8,7,0,1,195,2,7,204,229,0.667,0.891
"11399","Cochabamba","Cochabamba","Unidad Educ. Eduardo Lopez O E. Don Bosco",73,2,0,0,111,4,12,0,4,206,0,5,211,230,0.539,0.917
"11400","Cochabamba","Cochabamba","Unidad Educ. Eduardo Lopez O E. Don Bosco",57,1,0,0,119,8,11,0,4,200,1,3,204,225,0.595,0.907
"11401","Cochabamba","Cochabamba","Unidad Educ. Eduardo Lopez O E. Don Bosco",64,0,2,0,105,4,6,0,3,184,7,6,197,219,0.571,0.9
"11402","Cochabamba","Cochabamba","Unidad Educ. Eduardo Lopez O E. Don Bosco",52,4,0,1,119,7,15,0,1,199,0,11,210,230,0.598,0.913
"11403","Cochabamba","Cochabamba","Unidad Educ. Eduardo Lopez O E. Don Bosco",79,1,0,0,108,6,14,0,0,208,1,3,212,229,0.519,0.926
"11404","Cochabamba","Cochabamba","Liceo  Mercedes Candia De Ovando",114,0,1,1,48,7,7,0,0,178,0,11,189,217,0.27,0.871
"11405","Cochabamba","Cochabamba","Liceo  Mercedes Candia De Ovando",135,0,1,0,39,3,9,1,1,189,0,3,192,220,0.206,0.873
"11406","Cochabamba","Cochabamba","Liceo  Mercedes Candia De Ovando",133,0,0,0,49,7,2,0,0,191,1,11,203,227,0.257,0.894
"11407","Cochabamba","Cochabamba","Liceo  Mercedes Candia De Ovando",129,1,0,1,51,6,13,0,0,201,0,8,209,231,0.254,0.905
"11408","Cochabamba","Cochabamba","Liceo  Mercedes Candia De Ovando",139,0,0,1,57,3,5,0,0,205,0,4,209,230,0.278,0.909
"11409","Cochabamba","Cochabamba","Liceo  Mercedes Candia De Ovando",142,0,0,1,50,4,4,1,0,202,0,5,207,225,0.248,0.92
"11410","Cochabamba","Cochabamba","Liceo  Mercedes Candia De Ovando",125,0,1,1,56,6,5,0,1,195,1,5,201,227,0.287,0.885
"11411","Cochabamba","Cochabamba","Liceo  Mercedes Candia De Ovando",155,1,2,0,36,3,9,0,0,206,0,1,207,224,0.175,0.924
"11412","Cochabamba","Cochabamba","Liceo  Mercedes Candia De Ovando",129,0,0,0,54,4,4,0,0,191,0,7,198,220,0.283,0.9
"11413","Cochabamba","Cochabamba","Liceo  Mercedes Candia De Ovando",142,0,0,0,45,4,10,0,0,201,2,6,209,228,0.224,0.917
"11414","Cochabamba","Cochabamba","Liceo  Mercedes Candia De Ovando",129,1,1,0,42,4,10,1,0,188,0,6,194,225,0.223,0.862
"11415","Cochabamba","Cochabamba","Liceo  Mercedes Candia De Ovando",120,0,0,0,53,3,13,0,0,189,1,8,198,228,0.28,0.868
"11416","Cochabamba","Cochabamba","Liceo  Mercedes Candia De Ovando",140,0,1,1,48,6,9,0,0,205,1,4,210,225,0.234,0.933
"11417","Cochabamba","Cochabamba","Liceo  Mercedes Candia De Ovando",140,0,0,0,48,4,5,0,0,197,0,7,204,231,0.244,0.883
"11418","Cochabamba","Cochabamba","Liceo  Mercedes Candia De Ovando",119,1,0,0,48,3,8,0,0,179,2,11,192,226,0.268,0.85
"11419","Cochabamba","Cochabamba","Liceo  Mercedes Candia De Ovando",149,0,1,0,41,1,6,0,1,199,1,4,204,222,0.206,0.919
"11420","Cochabamba","Cochabamba","Liceo  Mercedes Candia De Ovando",129,0,0,0,49,4,9,0,0,191,1,7,199,218,0.257,0.913
"11421","Cochabamba","Cochabamba","Liceo  Mercedes Candia De Ovando",140,2,1,1,39,1,5,1,1,191,5,7,203,222,0.204,0.914
"11422","Cochabamba","Cochabamba","Liceo  Mercedes Candia De Ovando",146,0,0,0,34,2,9,0,0,191,2,6,199,225,0.178,0.884
"11423","Cochabamba","Cochabamba","Liceo  Mercedes Candia De Ovando",137,0,0,1,47,7,6,0,0,198,0,4,202,225,0.237,0.898
"11424","Cochabamba","Cochabamba","Colegio San Rafael",148,0,1,0,38,3,7,0,0,197,1,3,201,220,0.193,0.914
"11425","Cochabamba","Cochabamba","Colegio San Rafael",138,1,0,1,47,4,8,0,0,199,0,4,203,223,0.236,0.91
"11426","Cochabamba","Cochabamba","Colegio San Rafael",130,1,2,0,50,3,9,0,1,196,2,6,204,231,0.255,0.883
"11427","Cochabamba","Cochabamba","Colegio San Rafael",126,1,0,1,46,1,6,3,3,187,1,6,194,221,0.246,0.878
"11428","Cochabamba","Cochabamba","Colegio San Rafael",119,0,2,2,58,2,4,0,2,189,0,6,195,219,0.307,0.89
"11429","Cochabamba","Cochabamba","Colegio San Rafael",143,0,0,0,34,3,4,0,1,185,0,7,192,223,0.184,0.861
"11430","Cochabamba","Cochabamba","Colegio San Rafael",135,0,0,0,42,2,9,0,1,189,0,9,198,219,0.222,0.904
"11431","Cochabamba","Cochabamba","Colegio San Rafael",153,2,1,2,26,2,9,0,0,195,1,2,198,225,0.133,0.88
"11432","Cochabamba","Cochabamba","Colegio San Rafael",119,2,0,0,55,3,6,1,1,187,0,6,193,215,0.294,0.898
"11433","Cochabamba","Cochabamba","Colegio San Rafael",135,0,1,1,42,4,8,0,2,193,1,7,201,225,0.218,0.893
"11434","Cochabamba","Cochabamba","Colegio San Rafael",145,0,0,0,43,2,5,1,1,197,3,5,205,222,0.218,0.923
"11435","Cochabamba","Cochabamba","Colegio San Rafael",125,0,2,0,46,6,4,0,0,183,1,1,185,217,0.251,0.853
"11436","Cochabamba","Cochabamba","Colegio San Rafael",144,2,0,0,35,1,9,0,2,193,0,2,195,218,0.181,0.894
"11437","Cochabamba","Cochabamba","Colegio San Rafael",139,0,0,1,49,2,7,1,0,199,0,0,199,230,0.246,0.865
"11438","Cochabamba","Cochabamba","Colegio San Rafael",129,1,0,0,34,1,7,0,0,172,0,6,178,220,0.198,0.809
"11439","Cochabamba","Cochabamba","Colegio San Rafael",129,0,0,1,46,2,8,0,1,187,0,4,191,224,0.246,0.853
"11440","Cochabamba","Cochabamba","Colegio San Rafael",137,0,2,0,42,2,6,1,1,191,0,2,193,224,0.22,0.862
"11441","Cochabamba","Cochabamba","Colegio San Rafael",133,2,0,2,35,2,8,0,0,182,1,4,187,220,0.192,0.85
"11442","Cochabamba","Cochabamba","Colegio San Rafael",119,1,1,1,42,5,8,0,0,177,0,2,179,218,0.237,0.821
"11443","Cochabamba","Cochabamba","Colegio San Rafael",138,0,1,1,33,5,14,0,3,195,3,3,201,227,0.169,0.885
"11444","Cochabamba","Cochabamba","U. E. Ave María",146,1,1,0,58,1,8,1,1,217,1,2,220,240,0.267,0.917
"11445","Cochabamba","Cochabamba","U. E. Ave María",116,0,0,1,38,4,6,2,0,167,1,1,169,181,0.228,0.934
"11446","Cochabamba","Cochabamba","Escuela Central Taquiña C",102,2,0,1,79,4,12,0,0,200,0,7,207,225,0.395,0.92
"11447","Cochabamba","Cochabamba","Escuela Central Taquiña C",88,1,2,1,90,6,13,0,1,202,4,9,215,231,0.446,0.931
"11448","Cochabamba","Cochabamba","Escuela Central Taquiña C",98,1,1,2,78,3,20,1,2,206,2,4,212,233,0.379,0.91
"11449","Cochabamba","Cochabamba","Escuela Central Taquiña C",94,1,0,0,73,3,19,0,2,192,1,9,202,227,0.38,0.89
"11450","Cochabamba","Cochabamba","Escuela Central Taquiña C",93,1,3,0,83,6,18,0,2,206,2,9,217,231,0.403,0.939
"11451","Cochabamba","Cochabamba","Escuela Central Taquiña C",85,1,0,0,82,4,15,0,3,190,2,11,203,228,0.432,0.89
"11452","Cochabamba","Cochabamba","Escuela Central Taquiña C",82,0,1,0,100,2,23,1,0,209,0,4,213,228,0.478,0.934
"11453","Cochabamba","Cochabamba","Escuela Central Taquiña C",88,0,2,3,88,2,19,0,3,205,1,3,209,228,0.429,0.917
"11454","Cochabamba","Cochabamba","Escuela Central Taquiña C",98,0,1,0,76,3,18,1,0,197,3,8,208,227,0.386,0.916
"11455","Cochabamba","Cochabamba","Escuela Central Taquiña C",100,0,1,1,84,5,10,1,0,202,1,8,211,236,0.416,0.894
"11456","Cochabamba","Cochabamba","Escuela Central Taquiña C",85,0,0,0,88,3,20,0,3,199,2,9,210,230,0.442,0.913
"11457","Cochabamba","Cochabamba","Escuela Central Taquiña C",90,0,2,2,84,4,13,0,1,196,1,5,202,235,0.429,0.86
"11458","Cochabamba","Cochabamba","Escuela Central Taquiña C",87,1,1,0,82,7,23,0,3,204,2,6,212,234,0.402,0.906
"11459","Cochabamba","Cochabamba","Escuela Central Taquiña C",89,0,2,0,90,2,18,1,2,204,1,5,210,233,0.441,0.901
"11460","Cochabamba","Cochabamba","Escuela Central Taquiña C",78,0,3,1,85,4,19,0,1,191,1,11,203,225,0.445,0.902
"11461","Cochabamba","Cochabamba","Escuela Central Taquiña C",68,0,3,0,97,5,25,0,1,199,1,9,209,231,0.487,0.905
"11462","Cochabamba","Cochabamba","Escuela Central Taquiña C",55,0,4,1,110,4,24,0,1,199,2,11,212,233,0.553,0.91
"11463","Cochabamba","Cochabamba","Escuela Central Taquiña C",99,0,0,0,81,3,13,1,2,199,1,1,201,227,0.407,0.885
"11464","Cochabamba","Cochabamba","Escuela Central Taquiña C",103,0,0,2,78,2,13,1,1,200,2,10,212,228,0.39,0.93
"11465","Cochabamba","Cochabamba","Escuela Central Taquiña C",117,1,1,1,70,0,6,1,3,200,0,9,209,233,0.35,0.897
"11466","Cochabamba","Cochabamba","Escuela Central Taquiña C",93,0,0,0,94,5,8,1,1,202,0,7,209,231,0.465,0.905
"11467","Cochabamba","Cochabamba","Escuela Central Taquiña C",99,2,0,1,80,1,20,0,2,205,0,6,211,228,0.39,0.925
"11468","Cochabamba","Cochabamba","Escuela Central Taquiña C",90,1,0,1,83,2,15,0,3,195,1,5,201,225,0.426,0.893
"11469","Cochabamba","Cochabamba","Escuela Central Taquiña C",90,0,0,1,81,4,13,2,0,191,0,8,199,225,0.424,0.884
"11470","Cochabamba","Cochabamba","Escuela Central Taquiña C",96,0,2,0,74,4,9,2,0,187,2,5,194,231,0.396,0.84
"11471","Cochabamba","Cochabamba","Escuela Central Taquiña C",102,0,1,0,75,8,12,3,2,203,0,7,210,233,0.369,0.901
"11472","Cochabamba","Cochabamba","Escuela Central Taquiña C",100,1,0,1,76,5,15,1,1,200,1,9,210,227,0.38,0.925
"11473","Cochabamba","Cochabamba","Escuela Central Taquiña C",105,1,3,0,75,2,16,0,0,202,0,5,207,232,0.371,0.892
"11474","Cochabamba","Cochabamba","Escuela Central Taquiña C",103,0,1,0,83,4,18,0,0,209,1,3,213,232,0.397,0.918
"11475","Cochabamba","Cochabamba","Escuela Central Taquiña C",83,1,1,0,83,3,23,1,2,197,0,11,208,227,0.421,0.916
"11476","Cochabamba","Cochabamba","Escuela Central Taquiña C",100,1,1,2,80,5,18,2,4,213,0,2,215,232,0.376,0.927
"11477","Cochabamba","Cochabamba","Escuela Central Taquiña A",94,0,0,0,93,4,9,0,0,200,3,6,209,230,0.465,0.909
"11478","Cochabamba","Cochabamba","Escuela Central Taquiña A",83,0,1,0,93,3,18,0,1,199,0,6,205,229,0.467,0.895
"11479","Cochabamba","Cochabamba","Escuela Central Taquiña A",101,0,0,0,74,5,17,2,1,200,4,7,211,231,0.37,0.913
"11480","Cochabamba","Cochabamba","Escuela Central Taquiña A",90,0,1,0,85,1,17,1,0,195,2,6,203,228,0.436,0.89
"11481","Cochabamba","Cochabamba","Escuela Central Taquiña A",69,2,0,0,104,3,21,0,0,199,1,7,207,230,0.523,0.9
"11482","Cochabamba","Cochabamba","Escuela Central Taquiña A",59,1,1,0,120,2,14,0,3,200,1,6,207,228,0.6,0.908
"11483","Cochabamba","Cochabamba","Escuela Central Taquiña A",84,0,2,0,95,4,21,0,1,207,0,5,212,232,0.459,0.914
"11484","Cochabamba","Cochabamba","Escuela Central Taquiña A",84,0,2,0,86,3,14,2,2,193,1,3,197,230,0.446,0.857
"11485","Cochabamba","Cochabamba","Escuela Central Taquiña A",70,0,0,1,96,5,11,1,1,185,3,13,201,225,0.519,0.893
"11486","Cochabamba","Cochabamba","Escuela Central Taquiña A",86,0,2,1,88,5,11,2,2,197,2,5,204,225,0.447,0.907
"11487","Cochabamba","Cochabamba","Escuela Central Taquiña A",83,0,2,0,89,7,22,2,3,208,0,5,213,232,0.428,0.918
"11488","Cochabamba","Cochabamba","Escuela Central Taquiña A",85,0,1,0,92,6,15,0,0,199,1,5,205,231,0.462,0.887
"11489","Cochabamba","Cochabamba","Escuela Central Taquiña A",80,2,1,0,84,0,26,0,1,194,1,8,203,235,0.433,0.864
"11490","Cochabamba","Cochabamba","Escuela Central Taquiña A",55,1,1,2,120,4,17,1,3,204,1,7,212,233,0.588,0.91
"11491","Cochabamba","Cochabamba","Escuela Central Taquiña A",74,1,1,0,93,6,14,1,4,194,1,4,199,225,0.479,0.884
"11492","Cochabamba","Cochabamba","Escuela Central Taquiña A",82,1,1,0,85,10,18,0,3,200,3,8,211,230,0.425,0.917
"11493","Cochabamba","Cochabamba","Escuela Central Taquiña A",104,0,0,1,80,3,14,0,2,204,1,5,210,229,0.392,0.917
"11494","Cochabamba","Cochabamba","Escuela Central Taquiña A",80,1,1,3,80,6,12,0,3,186,0,10,196,228,0.43,0.86
"11495","Cochabamba","Cochabamba","Escuela Central Taquiña A",90,1,2,0,97,0,13,1,2,206,1,5,212,230,0.471,0.922
"11496","Cochabamba","Cochabamba","Escuela Central Taquiña A",91,0,2,0,76,4,19,0,1,193,1,7,201,230,0.394,0.874
"11497","Cochabamba","Cochabamba","Escuela Central Taquiña A",104,0,1,0,73,1,10,0,2,191,2,7,200,232,0.382,0.862
"11498","Cochabamba","Cochabamba","Escuela Central Taquiña A",87,2,1,0,89,4,9,3,3,198,0,11,209,229,0.449,0.913
"11499","Cochabamba","Cochabamba","Escuela Central Taquiña A",79,2,2,0,74,6,30,1,4,198,0,4,202,227,0.374,0.89
"11500","Cochabamba","Cochabamba","Escuela Central Taquiña A",96,0,0,0,77,2,18,0,3,196,2,6,204,227,0.393,0.899
"11501","Cochabamba","Cochabamba","Escuela Central Taquiña A",96,2,0,0,91,5,10,0,1,205,3,8,216,231,0.444,0.935
"11502","Cochabamba","Cochabamba","Escuela Central Taquiña A",73,0,2,0,58,2,16,0,1,152,3,5,160,176,0.382,0.909
"11503","Cochabamba","Cochabamba","Sede Social Sindicato Agrario Taquiña",73,0,2,0,81,3,16,0,1,176,0,2,178,186,0.46,0.957
"11504","Cochabamba","Cochabamba","Unidad Educativa Santiago",67,1,2,0,102,6,19,0,2,199,2,7,208,230,0.513,0.904
"11505","Cochabamba","Cochabamba","Unidad Educativa Santiago",101,1,1,0,70,6,23,0,2,204,1,7,212,228,0.343,0.93
"11506","Cochabamba","Cochabamba","Unidad Educativa Santiago",78,0,0,0,99,4,0,18,2,201,2,10,213,228,0.493,0.934
"11507","Cochabamba","Cochabamba","Unidad Educativa Santiago",83,1,3,0,98,2,9,1,2,199,2,5,206,231,0.492,0.892
"11508","Cochabamba","Cochabamba","Unidad Educativa Santiago",67,1,0,1,105,4,27,0,1,206,0,7,213,232,0.51,0.918
"11509","Cochabamba","Cochabamba","Unidad Educativa Santiago",84,0,2,0,97,5,13,1,0,202,3,4,209,230,0.48,0.909
"11510","Cochabamba","Cochabamba","Unidad Educativa Santiago",77,0,0,0,102,2,11,1,1,194,1,10,205,228,0.526,0.899
"11511","Cochabamba","Cochabamba","Unidad Educativa Santiago",83,0,1,1,90,5,27,0,0,207,3,5,215,228,0.435,0.943
"11512","Cochabamba","Cochabamba","Unidad Educativa Santiago",65,1,0,1,103,2,18,1,2,193,2,10,205,227,0.534,0.903
"11513","Cochabamba","Cochabamba","Unidad Educativa Santiago",80,0,1,0,89,2,22,0,1,195,6,6,207,231,0.456,0.896
"11514","Cochabamba","Cochabamba","Unidad Educativa Santiago",106,1,1,0,75,4,15,0,3,205,3,6,214,229,0.366,0.934
"11515","Cochabamba","Cochabamba","Unidad Educativa Santiago",89,1,1,0,82,4,10,0,3,190,1,17,208,228,0.432,0.912
"11516","Cochabamba","Cochabamba","Unidad Educativa Santiago",91,1,2,3,81,5,17,1,0,201,1,5,207,228,0.403,0.908
"11517","Cochabamba","Cochabamba","Unidad Educativa Santiago",82,0,1,1,104,1,13,0,0,202,1,10,213,231,0.515,0.922
"11518","Cochabamba","Cochabamba","Unidad Educativa Santiago",67,4,0,1,90,2,21,0,2,187,6,6,199,229,0.481,0.869
"11519","Cochabamba","Cochabamba","Unidad Educativa Santiago",103,1,1,2,62,4,19,0,3,195,2,5,202,226,0.318,0.894
"11520","Cochabamba","Cochabamba","Unidad Educativa Santiago",58,0,1,0,71,4,15,0,2,151,2,6,159,175,0.47,0.909
"11521","Cochabamba","Cochabamba","Colegio Marista Nuestra Señora Del Pilar",109,0,1,1,62,3,10,0,1,187,3,4,194,222,0.332,0.874
"11522","Cochabamba","Cochabamba","Colegio Marista Nuestra Señora Del Pilar",102,0,1,0,73,4,16,2,0,198,1,7,206,233,0.369,0.884
"11523","Cochabamba","Cochabamba","Colegio Marista Nuestra Señora Del Pilar",85,2,1,1,82,8,13,0,1,193,1,4,198,219,0.425,0.904
"11524","Cochabamba","Cochabamba","Colegio Marista Nuestra Señora Del Pilar",111,0,0,0,61,3,18,0,3,196,1,4,201,228,0.311,0.882
"11525","Cochabamba","Cochabamba","Colegio Marista Nuestra Señora Del Pilar",109,0,0,1,61,3,14,0,1,189,1,8,198,231,0.323,0.857
"11526","Cochabamba","Cochabamba","Colegio Marista Nuestra Señora Del Pilar",86,2,1,1,91,1,22,0,0,204,1,6,211,230,0.446,0.917
"11527","Cochabamba","Cochabamba","Colegio Marista Nuestra Señora Del Pilar",89,0,3,0,85,6,13,0,3,199,2,5,206,231,0.427,0.892
"11528","Cochabamba","Cochabamba","Colegio Marista Nuestra Señora Del Pilar",111,0,1,2,66,3,10,1,2,196,3,7,206,227,0.337,0.907
"11529","Cochabamba","Cochabamba","Colegio Marista Nuestra Señora Del Pilar",114,0,0,0,71,2,9,0,1,197,1,4,202,226,0.36,0.894
"11530","Cochabamba","Cochabamba","Colegio Marista Nuestra Señora Del Pilar",100,0,0,2,76,2,18,0,2,200,1,5,206,226,0.38,0.912
"11531","Cochabamba","Cochabamba","Colegio Marista Nuestra Señora Del Pilar",113,0,0,1,65,4,12,0,1,196,0,7,203,226,0.332,0.898
"11532","Cochabamba","Cochabamba","Colegio Marista Nuestra Señora Del Pilar",114,0,1,1,66,5,16,2,0,205,1,3,209,231,0.322,0.905
"11533","Cochabamba","Cochabamba","Colegio Marista Nuestra Señora Del Pilar",110,1,1,0,71,3,14,2,4,206,1,4,211,233,0.345,0.906
"11534","Cochabamba","Cochabamba","Colegio Marista Nuestra Señora Del Pilar",96,0,0,0,62,5,17,0,2,182,1,8,191,228,0.341,0.838
"11535","Cochabamba","Cochabamba","Colegio Marista Nuestra Señora Del Pilar",116,0,0,0,58,4,13,1,0,192,1,9,202,228,0.302,0.886
"11536","Cochabamba","Cochabamba","Colegio Marista Nuestra Señora Del Pilar",112,0,1,0,62,4,10,0,0,189,2,4,195,228,0.328,0.855
"11537","Cochabamba","Cochabamba","Colegio Marista Nuestra Señora Del Pilar",131,0,1,2,58,3,7,0,3,205,0,3,208,229,0.283,0.908
"11538","Cochabamba","Cochabamba","Colegio Marista Nuestra Señora Del Pilar",102,0,1,0,74,3,9,0,0,189,0,10,199,229,0.392,0.869
"11539","Cochabamba","Cochabamba","Colegio Marista Nuestra Señora Del Pilar",110,0,1,0,57,0,19,0,0,187,2,7,196,228,0.305,0.86
"11540","Cochabamba","Cochabamba","Colegio Marista Nuestra Señora Del Pilar",95,0,0,0,81,6,10,0,2,194,4,8,206,234,0.418,0.88
"11541","Cochabamba","Cochabamba","Colegio Marista Nuestra Señora Del Pilar",115,1,1,0,53,0,11,0,1,182,2,7,191,229,0.291,0.834
"11542","Cochabamba","Cochabamba","Colegio Marista Nuestra Señora Del Pilar",126,0,0,0,61,3,11,1,1,203,1,3,207,227,0.3,0.912
"11543","Cochabamba","Cochabamba","Colegio Marista Nuestra Señora Del Pilar",112,1,0,0,61,1,18,0,1,194,0,5,199,232,0.314,0.858
"11544","Cochabamba","Cochabamba","Colegio Marista Nuestra Señora Del Pilar",115,2,1,0,67,1,15,0,3,204,0,7,211,230,0.328,0.917
"11545","Cochabamba","Cochabamba","Colegio Marista Nuestra Señora Del Pilar",99,0,2,0,71,6,11,0,0,189,2,7,198,221,0.376,0.896
"11546","Cochabamba","Cochabamba","Colegio Marista Nuestra Señora Del Pilar",103,1,0,3,74,3,12,0,1,197,3,3,203,227,0.376,0.894
"11547","Cochabamba","Cochabamba","U. E. Santa Mónica",95,1,1,0,91,4,33,1,0,226,1,5,232,240,0.403,0.967
"11548","Cochabamba","Cochabamba","U. E. Santa Mónica",109,1,1,0,90,5,18,0,2,226,0,6,232,239,0.398,0.971
"11549","Cochabamba","Cochabamba","U. E. Santa Mónica",91,1,1,0,91,4,29,0,1,218,0,3,221,235,0.417,0.94
"11550","Cochabamba","Cochabamba","U. E. Santa Mónica",116,0,1,0,84,2,20,0,0,223,0,9,232,239,0.377,0.971
"11551","Cochabamba","Cochabamba","U. E. John Dewey",165,0,0,0,45,6,9,0,1,226,0,7,233,239,0.199,0.975
"11552","Cochabamba","Cochabamba","U. E. John Dewey",159,0,0,0,51,4,9,0,2,225,0,6,231,240,0.227,0.963
"11553","Cochabamba","Cochabamba","U. E. John Dewey",152,1,0,0,44,4,7,2,0,210,1,5,216,232,0.21,0.931
"11554","Cochabamba","Cochabamba","U. E. San Nicolas Club de Leones",33,0,0,2,152,3,20,0,2,212,1,3,216,232,0.717,0.931
"11555","Cochabamba","Cochabamba","U. E. San Nicolas Club de Leones",23,1,3,2,159,3,22,0,0,213,3,6,222,234,0.746,0.949
"11556","Cochabamba","Cochabamba","U. E. San Nicolas Club de Leones",16,1,1,2,174,1,21,0,0,216,3,4,223,235,0.806,0.949
"11557","Cochabamba","Cochabamba","U. E. San Nicolas Club de Leones",20,1,0,0,182,2,18,0,0,223,0,7,230,238,0.816,0.966
"11558","Cochabamba","Cochabamba","U. E. San Nicolas Club de Leones",22,0,0,2,170,2,21,0,0,217,1,6,224,237,0.783,0.945
"11559","Cochabamba","Cochabamba","U. E. San Nicolas Club de Leones",21,1,0,0,167,1,19,0,0,209,5,7,221,235,0.799,0.94
"11560","Cochabamba","Cochabamba","U. E. San Nicolas Club de Leones",17,0,3,0,164,8,20,0,1,213,3,6,222,233,0.77,0.953
"11561","Cochabamba","Cochabamba","U. E. San Nicolas Club de Leones",18,0,2,0,171,1,18,0,2,212,0,8,220,237,0.807,0.928
"11562","Cochabamba","Cochabamba","U. E. San Nicolas Club de Leones",33,0,2,1,154,1,17,0,1,209,0,13,222,236,0.737,0.941
"11563","Cochabamba","Cochabamba","U. E. San Nicolas Club de Leones",18,1,2,0,177,3,18,1,0,220,3,5,228,237,0.805,0.962
"11564","Cochabamba","Cochabamba","U. E. San Nicolas Club de Leones",25,0,2,0,155,2,31,1,1,217,2,6,225,235,0.714,0.957
"11565","Cochabamba","Cochabamba","U. E. San Nicolas Club de Leones",16,0,3,1,183,3,17,0,0,223,2,2,227,235,0.821,0.966
"11566","Cochabamba","Cochabamba","U. E. San Nicolas Club de Leones",21,0,1,0,132,2,11,0,1,168,2,10,180,189,0.786,0.952
"11567","Cochabamba","Cochabamba","U.E. Nacional San Isidro",25,0,4,0,154,3,14,0,2,202,2,9,213,232,0.762,0.918
"11568","Cochabamba","Cochabamba","U.E. Nacional San Isidro",28,0,3,0,136,3,25,0,6,201,5,11,217,233,0.677,0.931
"11569","Cochabamba","Cochabamba","U.E. Nacional San Isidro",27,0,2,1,142,0,22,2,3,199,3,4,206,230,0.714,0.896
"11570","Cochabamba","Cochabamba","U.E. Nacional San Isidro",36,0,1,0,139,0,24,0,2,202,1,8,211,225,0.688,0.938
"11571","Cochabamba","Cochabamba","U.E. Nacional San Isidro",20,0,1,0,154,2,22,0,1,200,4,9,213,231,0.77,0.922
"11572","Cochabamba","Cochabamba","U.E. Nacional San Isidro",19,0,1,1,162,2,18,1,3,207,2,2,211,231,0.783,0.913
"11573","Cochabamba","Cochabamba","U.E. Nacional San Isidro",15,0,1,1,157,0,25,1,3,203,3,8,214,234,0.773,0.915
"11574","Cochabamba","Cochabamba","U.E. Nacional San Isidro",26,0,3,1,147,3,16,1,2,199,6,6,211,234,0.739,0.902
"11575","Cochabamba","Cochabamba","U.E. Nacional San Isidro",31,1,1,0,146,1,27,2,1,210,1,6,217,232,0.695,0.935
"11576","Cochabamba","Cochabamba","U.E. Nacional San Isidro",28,0,4,1,143,2,39,0,0,217,1,5,223,232,0.659,0.961
"11577","Cochabamba","Cochabamba","U.E. Nacional San Isidro",19,0,5,0,144,2,27,0,1,198,2,8,208,228,0.727,0.912
"11578","Cochabamba","Cochabamba","U.E. Nacional San Isidro",14,2,4,0,151,4,28,0,1,204,4,5,213,228,0.74,0.934
"11579","Cochabamba","Cochabamba","U.E. Nacional San Isidro",25,1,1,0,158,0,29,0,0,214,1,4,219,233,0.738,0.94
"11580","Cochabamba","Cochabamba","U.E. Nacional San Isidro",40,0,3,1,130,2,18,0,4,198,2,8,208,230,0.657,0.904
"11581","Cochabamba","Cochabamba","U.E. Nacional San Isidro",30,0,2,1,138,5,24,1,2,203,2,12,217,232,0.68,0.935
"11582","Cochabamba","Cochabamba","U.E. Nacional San Isidro",17,2,1,1,140,3,26,3,0,193,4,3,200,230,0.725,0.87
"11583","Cochabamba","Cochabamba","U.E. Nacional San Isidro",29,0,2,0,157,1,15,0,2,206,2,8,216,230,0.762,0.939
"11584","Cochabamba","Cochabamba","U.E. Nacional San Isidro",24,1,3,1,144,3,24,0,2,202,2,4,208,231,0.713,0.9
"11585","Cochabamba","Cochabamba","U.E. Nacional San Isidro",35,0,3,0,125,4,23,1,1,192,5,7,204,227,0.651,0.899
"11586","Cochabamba","Cochabamba","U.E. Nacional San Isidro",24,0,5,0,103,5,16,1,1,155,1,5,161,177,0.665,0.91
"11587","Cochabamba","Cochabamba","U. E. San Francisco Javier",23,0,1,0,145,3,45,0,2,219,2,5,226,240,0.662,0.942
"11588","Cochabamba","Cochabamba","U. E. San Francisco Javier",31,0,3,0,154,5,30,0,0,223,2,4,229,240,0.691,0.954
"11589","Cochabamba","Cochabamba","U. E. San Francisco Javier",25,0,3,0,151,9,28,0,2,218,1,4,223,243,0.693,0.918
"11590","Cochabamba","Cochabamba","Colegio Federico Froebel",136,0,0,0,49,5,9,1,1,201,0,9,210,228,0.244,0.921
"11591","Cochabamba","Cochabamba","Colegio Federico Froebel",147,0,0,1,44,4,5,1,0,202,1,5,208,230,0.218,0.904
"11592","Cochabamba","Cochabamba","Colegio Federico Froebel",158,1,0,0,31,3,1,0,1,195,0,9,204,230,0.159,0.887
"11593","Cochabamba","Cochabamba","Colegio Federico Froebel",123,1,0,0,50,2,11,0,0,187,2,5,194,225,0.267,0.862
"11594","Cochabamba","Cochabamba","Colegio Federico Froebel",121,0,0,1,51,6,12,0,2,193,1,6,200,229,0.264,0.873
"11595","Cochabamba","Cochabamba","Colegio Federico Froebel",123,0,0,0,61,6,5,0,1,196,0,9,205,234,0.311,0.876
"11596","Cochabamba","Cochabamba","Colegio Federico Froebel",129,0,0,3,48,5,11,1,1,198,1,3,202,232,0.242,0.871
"11597","Cochabamba","Cochabamba","Colegio Federico Froebel",130,0,0,0,48,5,12,0,1,196,2,5,203,228,0.245,0.89
"11598","Cochabamba","Cochabamba","Colegio Federico Froebel",131,0,0,0,45,4,7,0,0,187,1,4,192,224,0.241,0.857
"11599","Cochabamba","Cochabamba","Colegio Federico Froebel",122,1,0,3,48,4,8,0,1,187,2,11,200,229,0.257,0.873
"11600","Cochabamba","Cochabamba","Colegio Federico Froebel",128,0,0,0,59,5,7,3,0,202,1,5,208,233,0.292,0.893
"11601","Cochabamba","Cochabamba","Colegio Federico Froebel",143,0,2,0,39,7,7,0,0,198,3,5,206,228,0.197,0.904
"11602","Cochabamba","Cochabamba","Colegio Federico Froebel",140,0,0,1,47,1,5,0,0,194,1,7,202,227,0.242,0.89
"11603","Cochabamba","Cochabamba","Colegio Federico Froebel",146,0,0,1,42,2,2,0,1,194,1,7,202,227,0.216,0.89
"11604","Cochabamba","Cochabamba","Colegio Federico Froebel",136,1,0,0,59,3,3,0,1,203,0,3,206,230,0.291,0.896
"11605","Cochabamba","Cochabamba","Colegio Federico Froebel",145,1,1,0,40,3,6,0,0,196,1,4,201,231,0.204,0.87
"11606","Cochabamba","Cochabamba","Colegio Federico Froebel",137,1,0,0,51,2,6,1,0,198,1,1,200,234,0.258,0.855
"11607","Cochabamba","Cochabamba","Colegio Federico Froebel",135,1,0,0,52,0,12,1,1,202,2,6,210,227,0.257,0.925
"11608","Cochabamba","Cochabamba","Colegio Irlandes",168,0,0,0,33,2,2,2,0,207,0,5,212,233,0.159,0.91
"11609","Cochabamba","Cochabamba","Colegio Irlandes",168,0,0,0,22,0,4,1,0,195,0,2,197,227,0.113,0.868
"11610","Cochabamba","Cochabamba","Colegio Irlandes",150,1,0,1,16,1,6,0,0,175,0,5,180,193,0.091,0.933
"11611","Cochabamba","Cochabamba","Universidad Ucatec (Ex Ceivo)",140,0,1,0,48,2,6,2,1,200,3,0,203,226,0.24,0.898
"11612","Cochabamba","Cochabamba","Universidad Ucatec (Ex Ceivo)",142,1,0,1,44,2,9,0,1,200,1,3,204,223,0.22,0.915
"11613","Cochabamba","Cochabamba","Universidad Ucatec (Ex Ceivo)",143,0,0,0,50,3,7,0,0,203,0,6,209,229,0.246,0.913
"11614","Cochabamba","Cochabamba","Universidad Ucatec (Ex Ceivo)",140,0,0,0,47,5,8,0,0,200,0,8,208,228,0.235,0.912
"11615","Cochabamba","Cochabamba","Universidad Ucatec (Ex Ceivo)",158,0,1,0,32,2,9,0,0,202,0,7,209,228,0.158,0.917
"11616","Cochabamba","Cochabamba","Universidad Ucatec (Ex Ceivo)",138,1,0,0,51,4,16,0,0,210,0,4,214,230,0.243,0.93
"11617","Cochabamba","Cochabamba","Universidad Ucatec (Ex Ceivo)",135,0,0,1,46,6,10,1,0,199,0,6,205,225,0.231,0.911
"11618","Cochabamba","Cochabamba","Universidad Ucatec (Ex Ceivo)",173,0,2,0,29,2,2,0,0,208,1,3,212,227,0.139,0.934
"11619","Cochabamba","Cochabamba","Universidad Ucatec (Ex Ceivo)",161,0,2,0,37,3,10,0,0,213,0,3,216,232,0.174,0.931
"11620","Cochabamba","Cochabamba","Universidad Ucatec (Ex Ceivo)",154,0,6,1,27,3,7,0,0,198,2,6,206,232,0.136,0.888
"11621","Cochabamba","Cochabamba","Universidad Ucatec (Ex Ceivo)",144,0,0,0,44,3,10,1,0,202,0,7,209,232,0.218,0.901
"11622","Cochabamba","Cochabamba","Universidad Ucatec (Ex Ceivo)",140,0,0,1,48,5,8,0,0,202,2,3,207,229,0.238,0.904
"11623","Cochabamba","Cochabamba","Unidad Educativa Rene Barrientos Ortuño",27,0,1,0,136,4,21,0,0,189,1,9,199,223,0.72,0.892
"11624","Cochabamba","Cochabamba","Unidad Educativa Rene Barrientos Ortuño",32,0,3,0,137,2,19,1,1,195,2,10,207,233,0.703,0.888
"11625","Cochabamba","Cochabamba","Unidad Educativa Rene Barrientos Ortuño",32,1,2,0,137,7,13,0,0,192,2,9,203,226,0.714,0.898
"11626","Cochabamba","Cochabamba","Unidad Educativa Rene Barrientos Ortuño",36,0,0,1,136,3,17,1,5,199,2,5,206,229,0.683,0.9
"11627","Cochabamba","Cochabamba","Unidad Educativa Rene Barrientos Ortuño",26,0,0,1,138,2,24,0,0,191,5,6,202,226,0.723,0.894
"11628","Cochabamba","Cochabamba","Unidad Educativa Rene Barrientos Ortuño",25,1,1,0,160,4,19,2,2,214,2,7,223,235,0.748,0.949
"11629","Cochabamba","Cochabamba","Unidad Educativa Rene Barrientos Ortuño",34,1,0,1,131,5,17,0,0,189,0,10,199,222,0.693,0.896
"11630","Cochabamba","Cochabamba","Unidad Educativa Rene Barrientos Ortuño",25,1,2,0,150,2,19,0,1,200,3,6,209,232,0.75,0.901
"11631","Cochabamba","Cochabamba","Unidad Educativa Rene Barrientos Ortuño",45,0,0,0,126,1,13,0,1,186,2,8,196,231,0.677,0.848
"11632","Cochabamba","Cochabamba","Unidad Educativa Rene Barrientos Ortuño",30,0,2,0,150,4,15,0,0,201,1,6,208,224,0.746,0.929
"11633","Cochabamba","Cochabamba","Unidad Educativa Rene Barrientos Ortuño",43,0,1,1,134,5,8,1,1,194,3,7,204,227,0.691,0.899
"11634","Cochabamba","Cochabamba","Unidad Educativa Rene Barrientos Ortuño",29,2,0,0,130,3,23,0,1,188,3,8,199,230,0.691,0.865
"11635","Cochabamba","Cochabamba","Unidad Educativa Rene Barrientos Ortuño",34,1,2,0,146,2,15,1,1,202,2,5,209,235,0.723,0.889
"11636","Cochabamba","Cochabamba","Unidad Educativa Rene Barrientos Ortuño",20,0,1,1,159,2,13,0,0,196,2,12,210,228,0.811,0.921
"11637","Cochabamba","Cochabamba","Unidad Educativa Rene Barrientos Ortuño",22,2,0,0,155,11,18,0,3,211,1,5,217,235,0.735,0.923
"11638","Cochabamba","Cochabamba","Unidad Educativa Rene Barrientos Ortuño",18,0,2,0,150,0,12,0,2,184,3,9,196,224,0.815,0.875
"11639","Cochabamba","Cochabamba","Unidad Educativa Rene Barrientos Ortuño",38,0,1,0,136,0,20,0,1,196,1,5,202,228,0.694,0.886
"11640","Cochabamba","Cochabamba","Unidad Educativa Rene Barrientos Ortuño",35,2,1,0,128,3,13,0,1,183,1,9,193,233,0.699,0.828
"11641","Cochabamba","Cochabamba","Unidad Educativa Rene Barrientos Ortuño",24,0,0,0,140,3,24,0,0,191,2,6,199,225,0.733,0.884
"11642","Cochabamba","Cochabamba","Unidad Educativa Rene Barrientos Ortuño",22,0,0,0,149,2,21,2,0,196,4,6,206,227,0.76,0.907
"11643","Cochabamba","Cochabamba","Unidad Educativa Rene Barrientos Ortuño",30,0,4,0,141,0,18,0,0,193,5,7,205,231,0.731,0.887
"11644","Cochabamba","Cochabamba","Unidad Educativa Rene Barrientos Ortuño",29,0,0,1,124,5,24,0,1,184,1,14,199,227,0.674,0.877
"11645","Cochabamba","Cochabamba","Unidad Educativa Rene Barrientos Ortuño",30,1,1,0,140,4,14,0,0,190,2,4,196,225,0.737,0.871
"11646","Cochabamba","Cochabamba","Unidad Educativa Rene Barrientos Ortuño",39,0,1,0,137,3,16,1,1,198,1,6,205,222,0.692,0.923
"11647","Cochabamba","Cochabamba","Unidad Educativa Rene Barrientos Ortuño",24,1,0,0,157,4,10,0,0,196,3,8,207,232,0.801,0.892
"11648","Cochabamba","Cochabamba","Unidad Educativa Rene Barrientos Ortuño",43,0,2,2,134,7,13,0,0,201,3,4,208,231,0.667,0.9
"11649","Cochabamba","Cochabamba","Unidad Educativa Rene Barrientos Ortuño",46,0,4,0,122,5,22,0,1,200,0,5,205,228,0.61,0.899
"11650","Cochabamba","Cochabamba","Unidad Educativa Rene Barrientos Ortuño",37,0,0,0,139,2,18,0,1,197,1,3,201,233,0.706,0.863
"11651","Cochabamba","Cochabamba","Unidad Educativa Barbara Lamas",11,0,2,0,165,2,22,0,0,202,4,4,210,228,0.817,0.921
"11652","Cochabamba","Cochabamba","Unidad Educativa Barbara Lamas",21,0,0,0,168,0,19,1,0,209,1,3,213,234,0.804,0.91
"11653","Cochabamba","Cochabamba","Unidad Educativa Barbara Lamas",11,0,3,0,165,1,15,2,1,198,7,6,211,232,0.833,0.909
"11654","Cochabamba","Cochabamba","Unidad Educativa Barbara Lamas",20,2,2,0,163,1,9,0,1,198,5,5,208,228,0.823,0.912
"11655","Cochabamba","Cochabamba","Unidad Educativa Barbara Lamas",11,2,0,2,170,2,20,1,1,209,2,6,217,232,0.813,0.935
"11656","Cochabamba","Cochabamba","Unidad Educativa Barbara Lamas",17,1,5,0,133,8,0,1,2,167,8,41,216,233,0.796,0.927
"11657","Cochabamba","Cochabamba","Unidad Educativa Barbara Lamas",20,0,2,1,168,3,18,0,0,212,5,3,220,234,0.792,0.94
"11658","Cochabamba","Cochabamba","Unidad Educativa Barbara Lamas",16,1,0,0,163,3,16,0,0,199,3,11,213,235,0.819,0.906
"11659","Cochabamba","Cochabamba","Unidad Educativa Barbara Lamas",17,0,3,0,168,2,14,1,0,205,2,6,213,232,0.82,0.918
"11660","Cochabamba","Cochabamba","Unidad Educativa Barbara Lamas",12,2,0,0,170,1,16,0,0,201,3,8,212,237,0.846,0.895
"11661","Cochabamba","Cochabamba","Unidad Educativa Barbara Lamas",22,1,0,0,157,4,21,0,1,206,4,6,216,237,0.762,0.911
"11662","Cochabamba","Cochabamba","Unidad Educativa Barbara Lamas",16,1,1,0,169,4,13,0,5,209,4,2,215,238,0.809,0.903
"11663","Cochabamba","Cochabamba","Unidad Educativa Barbara Lamas",21,0,0,0,159,3,17,0,0,200,6,5,211,230,0.795,0.917
"11664","Cochabamba","Cochabamba","Unidad Educativa Barbara Lamas",22,2,0,1,147,1,25,0,0,198,0,5,203,232,0.742,0.875
"11665","Cochabamba","Cochabamba","Unidad Educativa Barbara Lamas",18,0,0,0,167,2,17,1,0,205,2,9,216,236,0.815,0.915
"11666","Cochabamba","Cochabamba","Unidad Educativa Barbara Lamas",22,0,2,1,159,3,15,1,0,203,1,5,209,232,0.783,0.901
"11667","Cochabamba","Cochabamba","Unidad Educativa Barbara Lamas",18,1,0,0,148,4,24,0,1,196,8,10,214,232,0.755,0.922
"11668","Cochabamba","Cochabamba","Unidad Educativa Barbara Lamas",16,0,3,0,162,0,24,1,0,206,4,3,213,235,0.786,0.906
"11669","Cochabamba","Cochabamba","Unidad Educativa Barbara Lamas",13,1,0,1,167,1,14,0,1,198,6,8,212,233,0.843,0.91
"11670","Cochabamba","Cochabamba","Unidad Educativa Verdad y Vida",27,1,1,1,150,3,22,0,1,206,3,10,219,235,0.728,0.932
"11671","Cochabamba","Cochabamba","Unidad Educativa Verdad y Vida",30,0,1,0,151,3,25,0,1,211,3,6,220,239,0.716,0.921
"11672","Cochabamba","Cochabamba","Unidad Educativa Verdad y Vida",25,0,1,0,149,5,22,0,2,204,5,6,215,238,0.73,0.903
"11673","Cochabamba","Cochabamba","Unidad Educativa Verdad y Vida",23,0,2,0,152,3,24,0,1,205,7,9,221,239,0.741,0.925
"11674","Cochabamba","Cochabamba","Unidad Educativa Verdad y Vida",21,0,0,0,151,1,35,0,2,210,2,4,216,238,0.719,0.908
"11675","Cochabamba","Cochabamba","Unidad Educativa Verdad y Vida",19,0,3,0,142,4,30,0,0,198,5,5,208,238,0.717,0.874
"11676","Cochabamba","Cochabamba","Unidad Educativa Verdad y Vida",28,0,1,0,153,2,22,0,1,207,2,3,212,238,0.739,0.891
"11677","Cochabamba","Cochabamba","Unidad Educativa Verdad y Vida",25,0,0,1,151,2,29,1,2,211,3,5,219,238,0.716,0.92
"11678","Cochabamba","Cochabamba","Unidad Educativa Verdad y Vida",19,0,1,0,153,2,24,0,1,200,8,8,216,236,0.765,0.915
"11679","Cochabamba","Cochabamba","Unidad Educativa Verdad y Vida",21,0,1,0,143,3,29,1,1,199,4,11,214,235,0.719,0.911
"11680","Cochabamba","Cochabamba","Unidad Educativa Verdad y Vida",14,1,0,0,166,3,27,0,2,213,1,3,217,239,0.779,0.908
"11681","Cochabamba","Cochabamba","Unidad Educativa Verdad y Vida",25,0,0,0,151,1,33,0,0,210,0,3,213,236,0.719,0.903
"11682","Cochabamba","Cochabamba","Unidad Educativa Verdad y Vida",21,0,0,1,176,2,10,0,2,212,1,5,218,237,0.83,0.92
"11683","Cochabamba","Cochabamba","Unidad Educativa Verdad y Vida",18,0,0,0,161,2,26,0,2,209,3,3,215,236,0.77,0.911
"11684","Cochabamba","Cochabamba","Unidad Educativa Verdad y Vida",26,0,0,0,151,3,30,1,0,211,1,7,219,238,0.716,0.92
"11685","Cochabamba","Cochabamba","Unidad Educativa Verdad y Vida",29,1,0,0,151,2,21,0,2,206,4,9,219,238,0.733,0.92
"11686","Cochabamba","Cochabamba","Unidad Educativa Verdad y Vida",20,0,0,0,160,7,18,0,1,206,2,9,217,236,0.777,0.919
"11687","Cochabamba","Cochabamba","Unidad Educativa Verdad y Vida",41,0,1,1,161,1,12,0,0,217,6,4,227,240,0.742,0.946
"11688","Cochabamba","Cochabamba","Unidad Educativa Verdad y Vida",35,0,2,1,146,2,28,0,2,216,0,3,219,237,0.676,0.924
"11689","Cochabamba","Cochabamba","U. E. Francisco Javier Baldivieso Luna",68,0,0,0,133,3,20,1,0,225,0,9,234,238,0.591,0.983
"11690","Cochabamba","Cochabamba","U. E. Francisco Javier Baldivieso Luna",69,3,0,0,138,5,10,0,1,226,3,4,233,238,0.611,0.979
"11691","Cochabamba","Cochabamba","U. E. Francisco Javier Baldivieso Luna",75,0,1,1,118,5,16,0,3,219,3,11,233,240,0.539,0.971
"11692","Cochabamba","Cochabamba","U. E. Francisco Javier Baldivieso Luna",67,0,1,0,136,2,16,0,2,224,1,4,229,240,0.607,0.954
"11693","Cochabamba","Cochabamba","U. E. Francisco Javier Baldivieso Luna",100,1,0,0,100,2,18,1,1,223,2,7,232,239,0.448,0.971
"11694","Cochabamba","Cochabamba","U. E. San Vicente de Paul",34,1,2,0,161,1,29,0,0,228,0,2,230,238,0.706,0.966
"11695","Cochabamba","Cochabamba","U. E. San Vicente de Paul",30,0,0,1,159,3,22,1,1,217,4,2,223,239,0.733,0.933
"11696","Cochabamba","Cochabamba","U. E. San Vicente de Paul",39,1,1,0,154,5,17,0,1,218,1,11,230,238,0.706,0.966
"11697","Cochabamba","Cochabamba","Escuela Carlos Medinaceli",69,0,0,0,101,4,26,0,3,203,2,8,213,232,0.498,0.918
"11698","Cochabamba","Cochabamba","Escuela Carlos Medinaceli",52,0,3,0,116,2,19,0,0,192,3,4,199,231,0.604,0.861
"11699","Cochabamba","Cochabamba","Escuela Carlos Medinaceli",65,1,2,0,110,6,15,0,2,201,1,4,206,229,0.547,0.9
"11700","Cochabamba","Cochabamba","Escuela Carlos Medinaceli",59,0,2,2,107,6,27,0,3,206,1,7,214,232,0.519,0.922
"11701","Cochabamba","Cochabamba","Escuela Carlos Medinaceli",55,1,2,0,121,4,24,0,1,208,2,2,212,232,0.582,0.914
"11702","Cochabamba","Cochabamba","Escuela Carlos Medinaceli",55,2,1,0,104,7,25,0,2,196,3,10,209,232,0.531,0.901
"11703","Cochabamba","Cochabamba","Escuela Carlos Medinaceli",58,0,0,0,121,5,9,0,2,195,3,5,203,232,0.621,0.875
"11704","Cochabamba","Cochabamba","Escuela Carlos Medinaceli",63,0,1,2,110,2,21,1,0,200,1,7,208,234,0.55,0.889
"11705","Cochabamba","Cochabamba","Escuela Carlos Medinaceli",67,0,2,0,110,6,17,0,1,203,1,9,213,234,0.542,0.91
"11706","Cochabamba","Cochabamba","Escuela Carlos Medinaceli",52,0,0,2,114,3,24,1,3,199,1,11,211,230,0.573,0.917
"11707","Cochabamba","Cochabamba","Escuela Carlos Medinaceli",56,1,1,1,119,6,25,1,2,212,1,7,220,235,0.561,0.936
"11708","Cochabamba","Cochabamba","Escuela Carlos Medinaceli",76,1,2,1,99,2,13,0,1,195,1,6,202,230,0.508,0.878
"11709","Cochabamba","Cochabamba","Escuela Carlos Medinaceli",63,0,2,0,104,7,14,0,0,190,1,11,202,230,0.547,0.878
"11710","Cochabamba","Cochabamba","Escuela Carlos Medinaceli",55,1,1,0,116,3,24,0,1,201,2,5,208,233,0.577,0.893
"11711","Cochabamba","Cochabamba","Escuela Carlos Medinaceli",63,0,1,0,102,6,27,0,2,201,1,4,206,233,0.507,0.884
"11712","Cochabamba","Cochabamba","Escuela Carlos Medinaceli",42,0,1,1,129,4,24,0,4,205,1,2,208,232,0.629,0.897
"11713","Cochabamba","Cochabamba","Escuela Carlos Medinaceli",54,1,1,0,110,5,27,0,3,201,0,7,208,230,0.547,0.904
"11714","Cochabamba","Cochabamba","Escuela Carlos Medinaceli",81,0,1,0,88,4,26,0,1,201,0,4,205,232,0.438,0.884
"11715","Cochabamba","Cochabamba","Escuela Carlos Medinaceli",68,3,1,1,99,8,15,0,6,201,2,5,208,232,0.493,0.897
"11716","Cochabamba","Cochabamba","Escuela Carlos Medinaceli",52,1,2,1,113,6,21,1,1,198,2,4,204,233,0.571,0.876
"11717","Cochabamba","Cochabamba","Escuela Carlos Medinaceli",64,2,1,0,95,4,19,1,2,188,3,8,199,228,0.505,0.873
"11718","Cochabamba","Cochabamba","Escuela Carlos Medinaceli",62,0,3,1,113,4,18,0,1,202,0,4,206,231,0.559,0.892
"11719","Cochabamba","Cochabamba","Escuela Carlos Medinaceli",52,1,2,1,114,2,22,0,0,194,2,8,204,235,0.588,0.868
"11720","Cochabamba","Cochabamba","Escuela Carlos Medinaceli",58,0,0,0,112,2,23,0,1,196,1,7,204,225,0.571,0.907
"11721","Cochabamba","Cochabamba","Escuela Carlos Medinaceli",82,0,1,1,100,4,12,0,4,204,3,9,216,229,0.49,0.943
"11722","Cochabamba","Cochabamba","Escuela Carlos Medinaceli",65,2,0,0,103,9,11,0,2,192,4,10,206,230,0.536,0.896
"11723","Cochabamba","Cochabamba","Escuela Carlos Medinaceli",74,1,1,0,97,6,17,1,2,199,2,10,211,234,0.487,0.902
"11724","Cochabamba","Cochabamba","Escuela Carlos Medinaceli",66,0,3,1,103,5,15,0,3,196,1,8,205,232,0.526,0.884
"11725","Cochabamba","Cochabamba","Escuela Carlos Medinaceli",73,1,1,0,91,5,20,0,2,193,2,4,199,234,0.472,0.85
"11726","Cochabamba","Cochabamba","U. E. Juancito Pinto B",24,0,2,0,169,3,19,0,1,218,6,5,229,240,0.775,0.954
"11727","Cochabamba","Cochabamba","U. E. Juancito Pinto B",13,3,1,0,174,3,20,0,2,216,4,7,227,237,0.806,0.958
"11728","Cochabamba","Cochabamba","U. E. Juancito Pinto B",18,0,0,0,184,4,16,0,0,222,5,7,234,240,0.829,0.975
"11729","Cochabamba","Cochabamba","U. E. Juancito Pinto B",16,0,2,0,175,0,19,0,3,215,3,13,231,237,0.814,0.975
"11730","Cochabamba","Cochabamba","U. E. Juancito Pinto B",15,0,1,0,174,3,23,0,1,217,2,6,225,237,0.802,0.949
"11731","Cochabamba","Cochabamba","U. E. Juancito Pinto B",9,1,0,0,185,0,23,0,2,220,5,6,231,240,0.841,0.963
"11732","Cochabamba","Cochabamba","U. E. Juancito Pinto B",20,0,0,0,187,3,15,0,1,226,2,1,229,238,0.827,0.962
"11733","Cochabamba","Cochabamba","Escuela Antofagasta",122,0,1,1,62,2,9,0,0,197,0,8,205,225,0.315,0.911
"11734","Cochabamba","Cochabamba","Escuela Antofagasta",147,0,1,0,45,4,1,0,1,199,1,7,207,225,0.226,0.92
"11735","Cochabamba","Cochabamba","Escuela Antofagasta",118,0,0,0,53,2,4,0,0,177,5,13,195,224,0.299,0.871
"11736","Cochabamba","Cochabamba","Escuela Antofagasta",146,1,2,0,45,4,4,0,1,203,0,5,208,225,0.222,0.924
"11737","Cochabamba","Cochabamba","Escuela Antofagasta",137,0,0,0,51,2,5,0,2,197,1,6,204,225,0.259,0.907
"11738","Cochabamba","Cochabamba","Escuela Antofagasta",111,0,0,1,70,2,6,1,1,192,0,7,199,223,0.365,0.892
"11739","Cochabamba","Cochabamba","Escuela Antofagasta",128,1,0,0,49,2,9,0,2,191,2,4,197,226,0.257,0.872
"11740","Cochabamba","Cochabamba","Escuela Antofagasta",118,0,1,0,48,2,3,0,0,172,2,5,179,217,0.279,0.825
"11741","Cochabamba","Cochabamba","Escuela Antofagasta",132,0,0,0,61,2,6,0,1,202,1,6,209,228,0.302,0.917
"11742","Cochabamba","Cochabamba","Escuela Antofagasta",128,0,0,0,49,2,5,1,1,186,1,9,196,228,0.263,0.86
"11743","Cochabamba","Cochabamba","Escuela Antofagasta",129,0,3,1,51,4,8,1,0,197,0,2,199,226,0.259,0.881
"11744","Cochabamba","Cochabamba","Escuela Antofagasta",118,0,1,1,63,3,7,0,1,194,1,3,198,230,0.325,0.861
"11745","Cochabamba","Cochabamba","Escuela Antofagasta",115,0,1,0,58,3,5,0,1,183,1,5,189,222,0.317,0.851
"11746","Cochabamba","Cochabamba","Escuela Antofagasta",114,0,0,0,66,0,10,0,0,190,2,5,197,222,0.347,0.887
"11747","Cochabamba","Cochabamba","Escuela Antofagasta",128,0,0,0,54,5,8,0,2,197,1,3,201,222,0.274,0.905
"11748","Cochabamba","Cochabamba","Escuela Antofagasta",135,0,0,3,42,3,7,0,1,191,0,4,195,223,0.22,0.874
"11749","Cochabamba","Cochabamba","Escuela Antofagasta",145,3,0,0,44,4,8,0,1,205,3,2,210,228,0.215,0.921
"11750","Cochabamba","Cochabamba","Escuela Antofagasta",147,0,1,0,46,2,6,1,1,204,2,3,209,229,0.225,0.913
"11751","Cochabamba","Cochabamba","Escuela Antofagasta",123,1,0,0,47,2,7,0,0,180,1,3,184,220,0.261,0.836
"11752","Cochabamba","Cochabamba","Escuela Antofagasta",134,0,0,0,40,3,7,1,0,185,2,7,194,219,0.216,0.886
"11753","Cochabamba","Cochabamba","Escuela Antofagasta",130,1,0,1,45,8,8,0,1,194,0,5,199,226,0.232,0.881
"11754","Cochabamba","Cochabamba","Escuela Antofagasta",122,0,5,0,61,2,8,0,1,199,0,9,208,228,0.307,0.912
"11755","Cochabamba","Cochabamba","Escuela Antofagasta",136,1,0,0,50,3,12,0,1,203,0,2,205,228,0.246,0.899
"11756","Cochabamba","Cochabamba","Escuela Antofagasta",141,1,0,0,45,1,7,1,0,196,1,3,200,232,0.23,0.862
"11757","Cochabamba","Cochabamba","Escuela Antofagasta",113,0,1,0,62,2,3,0,2,183,2,6,191,224,0.339,0.853
"11758","Cochabamba","Cochabamba","Escuela Antofagasta",124,0,0,0,38,6,2,0,0,170,0,0,170,194,0.224,0.876
"11759","Cochabamba","Cochabamba","Unidad Educativa Rosendo Peña",161,0,0,0,45,1,7,0,4,218,1,5,224,237,0.206,0.945
"11760","Cochabamba","Cochabamba","Unidad Educativa Rosendo Peña",155,1,0,0,51,4,5,0,3,219,0,9,228,237,0.233,0.962
"11761","Cochabamba","Cochabamba","Unidad Educativa Rosendo Peña",147,0,0,0,57,5,8,0,0,217,0,6,223,237,0.263,0.941
"11762","Cochabamba","Cochabamba","Unidad Educativa Rosendo Peña",146,1,0,3,49,2,14,0,0,215,1,9,225,237,0.228,0.949
"11763","Cochabamba","Cochabamba","Unidad Educativa Rosendo Peña",149,0,0,0,47,1,12,0,1,210,0,5,215,236,0.224,0.911
"11764","Cochabamba","Cochabamba","Unidad Educativa Rosendo Peña",119,0,0,0,35,4,14,0,0,172,1,4,177,187,0.203,0.947
"11765","Cochabamba","Cochabamba","U. E. San José",158,0,1,1,56,2,10,1,0,229,3,2,234,238,0.245,0.983
"11766","Cochabamba","Cochabamba","U. E. San José",149,1,1,0,47,7,17,0,2,224,0,4,228,240,0.21,0.95
"11767","Cochabamba","Cochabamba","U. E. San José",155,1,1,2,60,1,9,0,0,229,1,2,232,239,0.262,0.971
"11768","Cochabamba","Cochabamba","U. E. San José",155,1,1,0,52,3,10,0,3,225,0,8,233,239,0.231,0.975
"11769","Cochabamba","Cochabamba","Unidad Educativa Dionisio Morales Choque",26,0,1,0,155,3,16,1,1,203,3,6,212,233,0.764,0.91
"11770","Cochabamba","Cochabamba","Unidad Educativa Dionisio Morales Choque",19,0,1,0,160,0,12,0,1,193,1,7,201,230,0.829,0.874
"11771","Cochabamba","Cochabamba","Unidad Educativa Dionisio Morales Choque",18,0,0,0,168,1,12,0,1,200,2,8,210,231,0.84,0.909
"11772","Cochabamba","Cochabamba","Unidad Educativa Dionisio Morales Choque",30,2,0,1,158,2,17,1,3,214,0,5,219,236,0.738,0.928
"11773","Cochabamba","Cochabamba","Unidad Educativa Dionisio Morales Choque",17,0,2,1,167,0,25,0,1,213,0,3,216,236,0.784,0.915
"11774","Cochabamba","Cochabamba","Unidad Educativa Dionisio Morales Choque",25,0,2,0,151,3,13,0,2,196,2,5,203,231,0.77,0.879
"11775","Cochabamba","Cochabamba","Unidad Educativa Dionisio Morales Choque",16,0,1,0,173,5,17,0,1,213,1,5,219,237,0.812,0.924
"11776","Cochabamba","Cochabamba","Unidad Educativa Dionisio Morales Choque",23,1,0,0,151,3,15,0,1,194,2,5,201,229,0.778,0.878
"11777","Cochabamba","Cochabamba","Unidad Educativa Dionisio Morales Choque",17,0,0,0,173,0,14,0,0,204,1,4,209,234,0.848,0.893
"11778","Cochabamba","Cochabamba","Unidad Educativa Dionisio Morales Choque",25,0,1,0,159,0,17,0,0,202,0,7,209,232,0.787,0.901
"11779","Cochabamba","Cochabamba","Unidad Educativa Dionisio Morales Choque",15,0,1,0,169,2,18,1,2,208,3,2,213,234,0.812,0.91
"11780","Cochabamba","Cochabamba","Unidad Educativa Dionisio Morales Choque",26,0,1,0,139,3,18,0,1,188,1,11,200,227,0.739,0.881
"11781","Cochabamba","Cochabamba","Unidad Educativa Dionisio Morales Choque",22,1,4,0,153,3,19,0,0,202,2,3,207,232,0.757,0.892
"11782","Cochabamba","Cochabamba","Unidad Educativa Dionisio Morales Choque",23,0,0,0,144,7,19,1,2,196,3,5,204,227,0.735,0.899
"11783","Cochabamba","Cochabamba","Unidad Educativa Dionisio Morales Choque",20,0,1,0,161,2,16,0,0,200,2,12,214,232,0.805,0.922
"11784","Cochabamba","Cochabamba","Unidad Educativa Dionisio Morales Choque",28,1,1,0,168,0,17,0,0,215,2,6,223,238,0.781,0.937
"11785","Cochabamba","Cochabamba","Unidad Educativa Dionisio Morales Choque",26,0,1,1,165,3,9,0,0,205,1,6,212,230,0.805,0.922
"11786","Cochabamba","Cochabamba","Unidad Educativa Dionisio Morales Choque",12,0,2,0,162,5,18,0,0,199,1,13,213,229,0.814,0.93
"11787","Cochabamba","Cochabamba","Unidad Educativa Dionisio Morales Choque",20,0,1,0,150,1,25,1,1,199,1,8,208,231,0.754,0.9
"11788","Cochabamba","Cochabamba","Unidad Educativa Dionisio Morales Choque",15,1,2,0,169,2,16,0,1,206,3,6,215,233,0.82,0.923
"11789","Cochabamba","Cochabamba","Unidad Educativa Dionisio Morales Choque",20,0,1,0,162,3,17,0,1,204,3,11,218,236,0.794,0.924
"11790","Cochabamba","Cochabamba","Unidad Educativa Dionisio Morales Choque",31,0,1,1,142,3,17,1,0,196,2,8,206,232,0.724,0.888
"11791","Cochabamba","Cochabamba","Unidad Educativa Dionisio Morales Choque",24,0,1,0,163,2,20,0,2,212,1,7,220,234,0.769,0.94
"11792","Cochabamba","Cochabamba","Unidad Educativa Dionisio Morales Choque",28,0,0,0,162,2,11,1,0,204,2,5,211,230,0.794,0.917
"11793","Cochabamba","Cochabamba","Unidad Educativa Dionisio Morales Choque",20,0,0,0,163,0,16,0,1,200,4,4,208,234,0.815,0.889
"11794","Cochabamba","Cochabamba","Unidad Educativa Dionisio Morales Choque",22,0,0,0,149,2,27,1,1,202,0,4,206,226,0.738,0.912
"11795","Cochabamba","Cochabamba","Unidad Educativa Dionisio Morales Choque",26,0,0,1,139,2,32,0,0,200,2,8,210,226,0.695,0.929
"11796","Cochabamba","Cochabamba","Unidad Educativa Dionisio Morales Choque",25,1,1,2,154,0,12,1,0,196,0,12,208,231,0.786,0.9
"11797","Cochabamba","Cochabamba","Unidad Educativa Dionisio Morales Choque",16,1,0,2,157,4,17,1,0,198,1,4,203,228,0.793,0.89
"11798","Cochabamba","Cochabamba","Unidad Educativa Dionisio Morales Choque",19,0,5,2,155,1,22,2,0,206,1,6,213,232,0.752,0.918
"11799","Cochabamba","Cochabamba","Unidad Educativa Dionisio Morales Choque",26,0,2,0,150,1,16,1,0,196,1,11,208,231,0.765,0.9
"11800","Cochabamba","Cochabamba","Unidad Educativa Dionisio Morales Choque",24,1,1,1,146,5,16,0,1,195,4,6,205,232,0.749,0.884
"11801","Cochabamba","Cochabamba","Unidad Educativa Dionisio Morales Choque",29,3,1,0,135,3,24,0,0,195,4,5,204,230,0.692,0.887
"11802","Cochabamba","Cochabamba","Unidad Educativa Dionisio Morales Choque",21,0,0,1,166,2,13,0,2,205,2,6,213,236,0.81,0.903
"11803","Cochabamba","Cochabamba","Unidad Educativa Dionisio Morales Choque",17,0,10,0,172,2,0,5,5,211,1,4,216,233,0.815,0.927
"11804","Cochabamba","Cochabamba","Unidad Educativa Dionisio Morales Choque",30,1,0,0,142,2,17,0,2,194,3,11,208,230,0.732,0.904
"11805","Cochabamba","Cochabamba","Unidad Educativa Voces Libres",8,1,2,1,187,2,19,0,1,221,3,7,231,239,0.846,0.967
"11806","Cochabamba","Cochabamba","Unidad Educativa Voces Libres",16,0,0,0,170,4,18,0,2,210,3,5,218,239,0.81,0.912
"11807","Cochabamba","Cochabamba","Unidad Educativa Voces Libres",26,0,1,1,177,4,17,0,0,226,1,2,229,236,0.783,0.97
"11808","Cochabamba","Cochabamba","Unidad Educativa Voces Libres",22,0,2,0,171,2,23,0,3,223,5,2,230,240,0.767,0.958
"11809","Cochabamba","Cochabamba","Unidad Educativa Voces Libres",18,0,2,0,179,1,20,1,4,225,0,5,230,240,0.796,0.958
"11810","Cochabamba","Cochabamba","U.E. José Carlos Carrillo",66,3,4,1,132,6,16,1,2,231,3,1,235,239,0.571,0.983
"11811","Cochabamba","Cochabamba","U.E. José Carlos Carrillo",54,2,1,0,139,5,23,0,0,224,3,7,234,239,0.621,0.979
"11812","Cochabamba","Cochabamba","U.E. José Carlos Carrillo",61,1,0,1,135,5,11,1,4,219,3,7,229,239,0.616,0.958
"11813","Cochabamba","Cochabamba","U.E. José Carlos Carrillo",69,0,2,0,133,6,15,1,0,226,1,7,234,238,0.588,0.983
"11814","Cochabamba","Cochabamba","U.E. José Carlos Carrillo",44,0,0,0,154,9,15,0,2,224,1,8,233,239,0.688,0.975
"11815","Cochabamba","Cochabamba","U.E. José Carlos Carrillo",35,1,1,0,113,4,12,0,0,166,4,6,176,180,0.681,0.978
"11816","Cochabamba","Aiquile","Escuela Simon Rodriguez",40,2,1,1,114,4,15,0,1,178,3,14,195,221,0.64,0.882
"11817","Cochabamba","Aiquile","Escuela Simon Rodriguez",34,2,1,0,124,1,12,0,4,178,3,5,186,228,0.697,0.816
"11818","Cochabamba","Aiquile","Escuela Simon Rodriguez",42,0,1,0,122,2,15,1,0,183,2,10,195,225,0.667,0.867
"11819","Cochabamba","Aiquile","Escuela Simon Rodriguez",50,0,0,0,118,2,12,0,4,186,3,5,194,222,0.634,0.874
"11820","Cochabamba","Aiquile","Escuela Simon Rodriguez",39,1,1,1,131,1,12,1,0,187,1,7,195,235,0.701,0.83
"11821","Cochabamba","Aiquile","Escuela Simon Rodriguez",47,1,2,0,115,1,20,2,0,188,7,5,200,228,0.612,0.877
"11822","Cochabamba","Aiquile","Escuela Simon Rodriguez",35,2,1,0,123,1,10,0,2,174,1,9,184,224,0.707,0.821
"11823","Cochabamba","Aiquile","Escuela Simon Rodriguez",52,1,0,1,122,1,18,1,1,197,0,3,200,228,0.619,0.877
"11824","Cochabamba","Aiquile","Escuela Simon Rodriguez",42,1,0,0,113,2,15,0,0,173,3,9,185,224,0.653,0.826
"11825","Cochabamba","Aiquile","Escuela Simon Rodriguez",34,2,0,0,118,3,9,1,3,170,5,12,187,224,0.694,0.835
"11826","Cochabamba","Aiquile","Escuela Simon Rodriguez",43,2,0,0,110,1,11,0,0,167,6,6,179,219,0.659,0.817
"11827","Cochabamba","Aiquile","Escuela Simon Rodriguez",40,1,1,1,124,3,16,0,0,186,9,13,208,226,0.667,0.92
"11828","Cochabamba","Aiquile","Escuela Manuel De Ugarte",38,1,0,2,105,3,13,0,0,162,6,19,187,220,0.648,0.85
"11829","Cochabamba","Aiquile","Escuela Manuel De Ugarte",41,0,1,1,131,1,8,0,0,183,6,11,200,223,0.716,0.897
"11830","Cochabamba","Aiquile","Escuela Manuel De Ugarte",42,2,0,2,113,2,8,1,0,170,5,18,193,222,0.665,0.869
"11831","Cochabamba","Aiquile","Escuela Manuel De Ugarte",42,0,1,0,120,2,10,0,3,178,4,12,194,216,0.674,0.898
"11832","Cochabamba","Aiquile","Escuela Manuel De Ugarte",47,0,0,0,122,2,9,0,2,182,1,12,195,225,0.67,0.867
"11833","Cochabamba","Aiquile","Escuela Manuel De Ugarte",31,0,1,2,127,0,13,0,4,178,6,12,196,219,0.713,0.895
"11834","Cochabamba","Aiquile","Escuela Manuel De Ugarte",39,2,1,2,134,2,9,0,0,189,2,7,198,221,0.709,0.896
"11835","Cochabamba","Aiquile","Escuela Manuel De Ugarte",41,0,2,2,112,5,12,1,2,177,2,13,192,225,0.633,0.853
"11836","Cochabamba","Aiquile","Escuela Manuel De Ugarte",48,4,1,0,103,1,11,0,1,169,2,16,187,223,0.609,0.839
"11837","Cochabamba","Aiquile","Escuela Manuel De Ugarte",57,2,1,0,112,0,8,1,0,181,3,10,194,220,0.619,0.882
"11838","Cochabamba","Aiquile","Escuela Manuel De Ugarte",38,2,1,1,114,1,7,0,1,165,1,21,187,214,0.691,0.874
"11839","Cochabamba","Aiquile","Escuela Manuel De Ugarte",40,0,0,0,117,3,5,2,4,171,5,14,190,218,0.684,0.872
"11840","Cochabamba","Aiquile","Escuela 20 de Diciembre",40,2,0,1,119,3,11,0,0,176,8,8,192,221,0.676,0.869
"11841","Cochabamba","Aiquile","Escuela 20 de Diciembre",41,1,2,0,114,1,5,1,1,166,14,10,190,221,0.687,0.86
"11842","Cochabamba","Aiquile","Escuela 20 de Diciembre",54,2,2,0,108,4,7,0,1,178,3,8,189,213,0.607,0.887
"11843","Cochabamba","Aiquile","Escuela 20 de Diciembre",55,0,0,0,110,2,3,0,1,171,4,21,196,220,0.643,0.891
"11844","Cochabamba","Aiquile","Escuela 20 de Diciembre",47,1,1,1,121,3,3,0,0,177,2,9,188,216,0.684,0.87
"11845","Cochabamba","Aiquile","Escuela 20 de Diciembre",44,0,0,2,104,2,10,0,0,162,2,25,189,215,0.642,0.879
"11846","Cochabamba","Aiquile","Escuela 20 de Diciembre",34,2,0,0,125,8,9,2,1,181,4,10,195,221,0.691,0.882
"11847","Cochabamba","Aiquile","Escuela 20 de Diciembre",43,0,0,1,115,3,11,0,1,174,7,13,194,226,0.661,0.858
"11848","Cochabamba","Aiquile","Escuela 20 de Diciembre",65,0,0,0,93,4,8,2,0,172,3,10,185,212,0.541,0.873
"11849","Cochabamba","Aiquile","Escuela 20 de Diciembre",46,0,0,1,107,0,8,0,1,163,5,10,178,212,0.656,0.84
"11850","Cochabamba","Aiquile","Escuela 20 de Diciembre",54,2,1,1,116,4,4,3,0,185,6,9,200,223,0.627,0.897
"11851","Cochabamba","Aiquile","Escuela 20 de Diciembre",33,1,1,0,145,2,6,1,0,189,2,14,205,227,0.767,0.903
"11852","Cochabamba","Aiquile","Nucleo Escolar El Cercado",1,3,1,1,155,0,1,0,1,163,7,7,177,211,0.951,0.839
"11853","Cochabamba","Aiquile","Nucleo Educativo Tipajara",1,1,0,0,189,0,0,0,0,191,2,7,200,222,0.99,0.901
"11854","Cochabamba","Aiquile","Unidad Educativa Novillero",11,2,0,2,150,0,5,2,0,172,1,8,181,204,0.872,0.887
"11855","Cochabamba","Aiquile","Unidad Educativa Novillero",7,0,1,0,156,2,2,2,0,170,1,10,181,211,0.918,0.858
"11856","Cochabamba","Aiquile","Nucleo Escolar Villa Granado",5,0,1,0,166,0,1,0,0,173,3,7,183,209,0.96,0.876
"11857","Cochabamba","Aiquile","Nucleo Escolar Villa Granado",3,1,0,1,167,1,5,1,0,179,2,7,188,216,0.933,0.87
"11858","Cochabamba","Aiquile","Nucleo Escolar Villa Granado",2,0,0,1,164,0,0,0,0,167,5,12,184,206,0.982,0.893
"11859","Cochabamba","Aiquile","Nucleo Escolar Villa Granado",5,0,1,1,166,1,4,0,0,178,3,11,192,219,0.933,0.877
"11860","Cochabamba","Aiquile","Unidad Educativa Estanzuela",4,1,2,0,150,0,10,1,2,170,4,4,178,202,0.882,0.881
"11861","Cochabamba","Aiquile","Unidad Educativa Quiroga",14,0,0,0,151,1,6,0,0,172,3,11,186,211,0.878,0.882
"11862","Cochabamba","Aiquile","Unidad Educativa Quiroga",8,2,4,0,141,0,4,0,0,159,10,8,177,210,0.887,0.843
"11863","Cochabamba","Aiquile","Unidad Educativa Quiroga",0,0,1,1,160,3,2,1,1,169,3,7,179,216,0.947,0.829
"11864","Cochabamba","Aiquile","Unidad Educativa Quiroga",5,2,1,0,181,0,3,1,1,194,3,10,207,223,0.933,0.928
"11865","Cochabamba","Aiquile","Unidad Educativa Lagarpampa",1,5,2,1,143,0,6,0,0,158,1,6,165,218,0.905,0.757
"11866","Cochabamba","Aiquile","Unidad Educativa Eje Pampa",6,1,1,0,163,2,8,2,1,184,5,8,197,216,0.886,0.912
"11867","Cochabamba","Aiquile","Unidad Educativa Panama",4,5,1,1,173,1,1,1,1,188,12,8,208,226,0.92,0.92
"11868","Cochabamba","Aiquile","Unidad Educativa Kewiñal",13,6,3,3,130,0,5,10,0,170,27,28,225,243,0.765,0.926
"11869","Cochabamba","Aiquile","Unidad Educativa Laime",1,0,1,1,170,0,3,6,0,182,10,17,209,231,0.934,0.905
"11870","Cochabamba","Aiquile","U.E. San Antonio",3,2,0,2,176,1,5,0,0,189,8,11,208,210,0.931,0.99
"11871","Cochabamba","Aiquile","U. E. Tipa Pampa",2,0,2,2,191,2,5,0,0,204,3,2,209,212,0.936,0.986
"11872","Cochabamba","Pasorapa","Colegio Tte.Cnel. Nataniel Verduguez",69,3,0,0,74,7,9,1,1,164,0,17,181,213,0.451,0.85
"11873","Cochabamba","Pasorapa","Colegio Tte.Cnel. Nataniel Verduguez",70,2,3,1,71,8,5,0,2,162,3,14,179,211,0.438,0.848
"11874","Cochabamba","Pasorapa","Colegio Tte.Cnel. Nataniel Verduguez",69,1,1,0,74,9,8,4,2,168,3,23,194,216,0.44,0.898
"11875","Cochabamba","Pasorapa","Colegio Tte.Cnel. Nataniel Verduguez",62,1,1,0,94,9,4,1,3,175,1,16,192,228,0.537,0.842
"11876","Cochabamba","Pasorapa","Escuela Central Quinori",18,1,3,2,129,5,6,2,0,166,8,4,178,219,0.777,0.813
"11877","Cochabamba","Omereque","Unidad Educativa Omereque",15,3,1,0,151,2,18,1,0,191,1,5,197,227,0.791,0.868
"11878","Cochabamba","Omereque","Unidad Educativa Omereque",22,3,1,0,134,7,27,1,1,196,4,3,203,232,0.684,0.875
"11879","Cochabamba","Omereque","Unidad Educativa Omereque",13,0,2,0,164,3,18,3,0,203,2,5,210,223,0.808,0.942
"11880","Cochabamba","Omereque","Unidad Educativa Omereque",20,1,1,1,149,4,26,2,0,204,2,6,212,229,0.73,0.926
"11881","Cochabamba","Omereque","Unidad Educativa Omereque",5,0,0,0,157,2,24,0,1,189,2,4,195,224,0.831,0.871
"11882","Cochabamba","Omereque","Unidad Educativa Omereque",17,0,0,0,132,6,21,0,0,176,5,6,187,227,0.75,0.824
"11883","Cochabamba","Omereque","Unidad Educativa Omereque",7,0,1,0,149,3,30,0,0,190,8,10,208,230,0.784,0.904
"11884","Cochabamba","Omereque","Unidad Educativa Omereque",19,1,1,1,139,7,28,0,1,197,3,9,209,227,0.706,0.921
"11885","Cochabamba","Omereque","Unidad Educativa Omereque",11,0,1,1,133,1,25,1,1,174,1,5,180,202,0.764,0.891
"11886","Cochabamba","Omereque","Escuela Central Peña Colorada",14,2,1,3,146,3,13,2,2,186,3,9,198,227,0.785,0.872
"11887","Cochabamba","Omereque","Escuela Central Peña Colorada",17,1,1,1,154,4,7,1,0,186,2,8,196,230,0.828,0.852
"11888","Cochabamba","Omereque","Unidad Educativa Perereta",9,0,2,0,133,3,20,0,4,171,8,9,188,218,0.778,0.862
"11889","Cochabamba","Omereque","Escuela Seccional Perez",20,1,1,0,129,8,8,0,0,167,8,3,178,200,0.772,0.89
"11890","Cochabamba","Ayopaya (Villa de Independencia)","U.E. Jose Miguel Lanza",8,1,0,1,128,1,25,2,0,166,6,16,188,222,0.771,0.847
"11891","Cochabamba","Ayopaya (Villa de Independencia)","U.E. Jose Miguel Lanza",7,1,0,1,153,0,14,0,0,176,5,12,193,225,0.869,0.858
"11892","Cochabamba","Ayopaya (Villa de Independencia)","U.E. Jose Miguel Lanza",13,3,5,2,142,2,16,1,0,184,10,10,204,225,0.772,0.907
"11893","Cochabamba","Ayopaya (Villa de Independencia)","U.E. Jose Miguel Lanza",14,2,3,1,130,1,20,2,0,173,6,12,191,219,0.751,0.872
"11894","Cochabamba","Ayopaya (Villa de Independencia)","U.E. Jose Miguel Lanza",18,0,2,0,129,2,20,0,0,171,10,14,195,218,0.754,0.894
"11895","Cochabamba","Ayopaya (Villa de Independencia)","U.E. Jose Miguel Lanza",11,3,3,1,135,1,17,1,1,173,1,5,179,222,0.78,0.806
"11896","Cochabamba","Ayopaya (Villa de Independencia)","U.E. Jose Miguel Lanza",14,3,5,1,131,3,13,2,0,172,4,15,191,227,0.762,0.841
"11897","Cochabamba","Ayopaya (Villa de Independencia)","U.E. Jose Miguel Lanza",12,0,3,1,142,1,11,1,0,171,2,17,190,224,0.83,0.848
"11898","Cochabamba","Ayopaya (Villa de Independencia)","U.E. Jose Miguel Lanza",25,3,2,0,128,2,22,0,1,183,10,5,198,222,0.699,0.892
"11899","Cochabamba","Ayopaya (Villa de Independencia)","U.E. Jose Miguel Lanza",14,2,0,1,135,1,17,1,0,171,2,12,185,220,0.789,0.841
"11900","Cochabamba","Ayopaya (Villa de Independencia)","U.E. Jose Miguel Lanza",18,3,6,3,125,0,17,0,1,173,7,11,191,228,0.723,0.838
"11901","Cochabamba","Ayopaya (Villa de Independencia)","U.E. Jose Miguel Lanza",13,1,3,0,131,3,15,0,1,167,8,12,187,217,0.784,0.862
"11902","Cochabamba","Ayopaya (Villa de Independencia)","Unidad Educativa Machaca",8,3,2,1,127,1,18,0,2,162,8,13,183,219,0.784,0.836
"11903","Cochabamba","Ayopaya (Villa de Independencia)","Escuela Mariano Baptista (Calchani)",1,1,0,1,153,2,3,0,0,161,5,8,174,217,0.95,0.802
"11904","Cochabamba","Ayopaya (Villa de Independencia)","Escuela Mariano Baptista (Calchani)",0,1,0,0,180,1,2,0,2,186,2,6,194,235,0.968,0.826
"11905","Cochabamba","Ayopaya (Villa de Independencia)","Colegio Simon Bolivar Fe y Alegria",4,0,1,1,140,0,44,1,1,192,7,14,213,227,0.729,0.938
"11906","Cochabamba","Ayopaya (Villa de Independencia)","Colegio Simon Bolivar Fe y Alegria",14,8,6,2,122,5,26,3,2,188,8,11,207,229,0.649,0.904
"11907","Cochabamba","Ayopaya (Villa de Independencia)","Colegio Simon Bolivar Fe y Alegria",20,0,1,0,122,0,44,0,0,187,5,9,201,221,0.652,0.91
"11908","Cochabamba","Ayopaya (Villa de Independencia)","Colegio Simon Bolivar Fe y Alegria",21,1,1,3,129,4,37,2,1,199,6,14,219,230,0.648,0.952
"11909","Cochabamba","Ayopaya (Villa de Independencia)","Colegio Simon Bolivar Fe y Alegria",12,1,3,0,134,5,31,1,3,190,2,15,207,227,0.705,0.912
"11910","Cochabamba","Ayopaya (Villa de Independencia)","Colegio Simon Bolivar Fe y Alegria",29,1,2,3,127,3,25,0,3,193,9,15,217,229,0.658,0.948
"11911","Cochabamba","Ayopaya (Villa de Independencia)","Colegio Simon Bolivar Fe y Alegria",24,1,4,0,115,2,46,2,3,197,5,14,216,230,0.584,0.939
"11912","Cochabamba","Ayopaya (Villa de Independencia)","Colegio Simon Bolivar Fe y Alegria",23,1,3,0,130,2,37,1,1,198,3,10,211,223,0.657,0.946
"11913","Cochabamba","Ayopaya (Villa de Independencia)","Colegio Simon Bolivar Fe y Alegria",12,4,3,2,130,5,30,2,0,188,9,8,205,226,0.691,0.907
"11914","Cochabamba","Ayopaya (Villa de Independencia)","Colegio Simon Bolivar Fe y Alegria",27,1,1,0,105,3,50,0,0,187,6,14,207,230,0.561,0.9
"11915","Cochabamba","Ayopaya (Villa de Independencia)","Unidad Educativa Pocanche",4,3,1,1,154,2,3,1,1,170,17,14,201,228,0.906,0.882
"11916","Cochabamba","Ayopaya (Villa de Independencia)","Unidad Educativa Pocanche",2,2,0,0,169,2,6,2,1,184,12,10,206,238,0.918,0.866
"11917","Cochabamba","Ayopaya (Villa de Independencia)","Unidad Educativa Sisi Palermo",1,1,1,1,169,4,11,1,2,191,4,17,212,227,0.885,0.934
"11918","Cochabamba","Ayopaya (Villa de Independencia)","Colegio Chamacoma",1,2,1,1,144,0,7,1,0,157,7,6,170,226,0.917,0.752
"11919","Cochabamba","Ayopaya (Villa de Independencia)","Unidad Educativa Sabino Wallku",3,5,0,3,149,0,5,3,0,168,6,7,181,208,0.887,0.87
"11920","Cochabamba","Ayopaya (Villa de Independencia)","Unidad Educativa Sabino Wallku",5,1,1,1,171,0,3,1,0,183,1,6,190,219,0.934,0.868
"11921","Cochabamba","Ayopaya (Villa de Independencia)","Unidad Educativa Villa Pucara",12,0,0,1,133,3,3,5,1,158,9,12,179,220,0.842,0.814
"11922","Cochabamba","Ayopaya (Villa de Independencia)","Unidad Educativa Villa Pucara",7,6,0,3,140,7,3,1,1,168,11,12,191,220,0.833,0.868
"11923","Cochabamba","Ayopaya (Villa de Independencia)","Unidad Educativa Charahuaytu",3,3,1,0,145,0,11,0,1,164,15,6,185,226,0.884,0.819
"11924","Cochabamba","Ayopaya (Villa de Independencia)","Unidad Educativa Charahuaytu",4,2,2,0,151,2,11,5,0,177,2,14,193,212,0.853,0.91
"11925","Cochabamba","Ayopaya (Villa de Independencia)","Unidad Educativa Charahuaytu",1,2,1,2,158,1,15,0,0,180,9,9,198,229,0.878,0.865
"11926","Cochabamba","Ayopaya (Villa de Independencia)","Unidad Educativa Charahuaytu",5,1,2,2,147,1,13,3,1,175,4,11,190,220,0.84,0.864
"11927","Cochabamba","Ayopaya (Villa de Independencia)","Unidad Educativa Chapisuyo A",3,2,1,4,156,2,11,0,0,179,7,9,195,221,0.872,0.882
"11928","Cochabamba","Ayopaya (Villa de Independencia)","Unidad Educativa Chapisuyo A",1,3,1,0,165,1,12,1,0,184,3,8,195,218,0.897,0.894
"11929","Cochabamba","Ayopaya (Villa de Independencia)","Unidad Educativa Chapisuyo A",1,2,0,1,184,0,4,0,0,192,1,7,200,229,0.958,0.873
"11930","Cochabamba","Ayopaya (Villa de Independencia)","U. E. Cotani",0,1,4,3,168,0,13,1,0,190,4,12,206,212,0.884,0.972
"11931","Cochabamba","Ayopaya (Villa de Independencia)","U. E. Llajma",0,0,0,3,200,2,5,0,0,210,1,8,219,222,0.952,0.986
"11932","Cochabamba","Ayopaya (Villa de Independencia)","U. E. Cuesta Cuchu",0,0,1,0,162,0,0,0,0,163,0,2,165,166,0.994,0.994
"11933","Cochabamba","Ayopaya (Villa de Independencia)","U. E. Qhulaya",3,2,0,1,200,1,7,2,0,216,6,7,229,236,0.926,0.97
"11934","Cochabamba","Morochata","Escuela Mariano Baptista- Morochata",9,0,0,1,158,1,10,2,1,182,8,5,195,213,0.868,0.915
"11935","Cochabamba","Morochata","Escuela Mariano Baptista- Morochata",3,1,0,0,173,2,10,1,0,190,5,12,207,215,0.911,0.963
"11936","Cochabamba","Morochata","Escuela Mariano Baptista- Morochata",0,0,1,1,181,1,5,0,0,189,7,5,201,222,0.958,0.905
"11937","Cochabamba","Morochata","Escuela Mariano Baptista- Morochata",0,0,0,0,166,0,9,0,0,175,0,17,192,216,0.949,0.889
"11938","Cochabamba","Morochata","Escuela Mariano Baptista- Morochata",6,0,0,0,169,1,6,1,0,183,5,7,195,217,0.923,0.899
"11939","Cochabamba","Morochata","Escuela Mariano Baptista- Morochata",3,3,1,1,154,1,13,0,0,176,0,22,198,212,0.875,0.934
"11940","Cochabamba","Morochata","Escuela Mariano Baptista- Morochata",7,1,0,0,168,1,9,0,1,187,4,10,201,226,0.898,0.889
"11941","Cochabamba","Morochata","Colegio Rene Barrientos Ortuño -Piusilla",2,1,1,0,165,0,14,0,1,184,2,13,199,220,0.897,0.905
"11942","Cochabamba","Morochata","Colegio Rene Barrientos Ortuño -Piusilla",7,0,0,0,151,2,12,0,0,172,7,14,193,225,0.878,0.858
"11943","Cochabamba","Morochata","Escuela Gildaro Antezana Rojas",3,5,0,0,162,1,6,0,1,178,8,22,208,226,0.91,0.92
"11944","Cochabamba","Morochata","Escuela Gildaro Antezana Rojas",1,0,0,0,174,0,3,0,0,178,0,27,205,222,0.978,0.923
"11945","Cochabamba","Morochata","Escuela Gildaro Antezana Rojas",1,1,0,1,196,0,3,0,0,202,0,3,205,220,0.97,0.932
"11946","Cochabamba","Morochata","Escuela Gildaro Antezana Rojas",0,0,0,0,181,0,3,0,0,184,3,14,201,218,0.984,0.922
"11947","Cochabamba","Morochata","Escuela Julio Espinoza Canelas-Punacachi",5,1,0,1,147,3,8,1,1,167,14,8,189,217,0.88,0.871
"11948","Cochabamba","Morochata","Escuela Julio Espinoza Canelas-Punacachi",6,6,2,2,124,1,10,2,2,155,22,8,185,214,0.8,0.864
"11949","Cochabamba","Morochata","Escuela Hilarion Grageda - Yayani",6,1,3,0,132,0,23,1,0,166,12,12,190,220,0.795,0.864
"11950","Cochabamba","Morochata","Escuela Hilarion Grageda - Yayani",3,1,1,2,149,0,20,1,0,177,12,3,192,225,0.842,0.853
"11951","Cochabamba","Morochata","Escuela Hilarion Grageda - Yayani",2,0,4,0,139,2,10,1,2,160,9,11,180,222,0.869,0.811
"11952","Cochabamba","Morochata","Escuela 26 de Mayo - Chaupisuyo B",8,4,1,0,165,1,13,0,1,193,5,17,215,235,0.855,0.915
"11953","Cochabamba","Morochata","Escuela 26 de Mayo - Chaupisuyo B",2,0,0,2,180,2,2,3,0,191,5,10,206,226,0.942,0.912
"11954","Cochabamba","Morochata","Escuela 26 de Mayo - Chaupisuyo B",1,2,0,2,167,1,8,2,0,183,0,17,200,220,0.913,0.909
"11955","Cochabamba","Morochata","Escuela 26 de Mayo - Chaupisuyo B",0,0,0,0,161,1,2,0,0,164,5,6,175,187,0.982,0.936
"11956","Cochabamba","Morochata","Unidad Educativa Iglesiani",1,1,1,1,185,1,7,0,1,198,0,2,200,215,0.934,0.93
"11957","Cochabamba","Morochata","Unidad Educativa Humamarca",3,2,0,2,182,0,8,0,1,198,9,11,218,234,0.919,0.932
"11958","Cochabamba","Morochata","U. E. Tuiruni",0,1,0,1,199,1,3,0,0,205,0,3,208,211,0.971,0.986
"11959","Cochabamba","Cocapata","Colegio Secundario Cocapata",7,1,0,0,154,2,6,0,0,170,2,10,182,224,0.906,0.812
"11960","Cochabamba","Cocapata","Unidad Educativa Icari",0,3,0,1,172,1,18,2,0,197,0,4,201,224,0.873,0.897
"11961","Cochabamba","Cocapata","Escuela Pedro Domingo Murillo -Calientes",2,1,0,1,175,1,12,1,0,193,4,3,200,228,0.907,0.877
"11962","Cochabamba","Cocapata","Escuela Pedro Domingo Murillo -Calientes",1,1,0,1,185,0,12,2,0,202,9,2,213,223,0.916,0.955
"11963","Cochabamba","Cocapata","Escuela Pedro Domingo Murillo -Calientes",1,0,1,0,165,2,11,0,0,180,3,7,190,203,0.917,0.936
"11964","Cochabamba","Cocapata","Escuela 15 de Febrero (El Choro)",2,2,0,1,170,4,12,0,0,191,0,8,199,225,0.89,0.884
"11965","Cochabamba","Cocapata","Escuela 15 de Febrero (El Choro)",6,3,3,1,160,2,7,3,0,185,3,12,200,226,0.865,0.885
"11966","Cochabamba","Cocapata","Escuela 15 de Febrero (El Choro)",7,3,0,1,162,4,8,0,2,187,3,4,194,222,0.866,0.874
"11967","Cochabamba","Cocapata","Unidad Educativa Tunari (Pucarita)",3,0,0,0,175,0,1,2,0,181,3,10,194,230,0.967,0.843
"11968","Cochabamba","Cocapata","Unidad Educativa Tunari (Pucarita)",1,2,0,0,172,0,2,2,0,179,8,13,200,233,0.961,0.858
"11969","Cochabamba","Cocapata","Escuela Oscar Alfaro - Villa Vinto",5,3,2,0,156,2,10,1,0,179,5,19,203,228,0.872,0.89
"11970","Cochabamba","Cocapata","Escuela Oscar Alfaro - Villa Vinto",1,1,1,0,194,1,8,1,0,207,0,11,218,230,0.937,0.948
"11971","Cochabamba","Cocapata","Escuela Oscar Alfaro - Villa Vinto",1,2,5,2,150,3,5,1,0,169,8,16,193,216,0.888,0.894
"11972","Cochabamba","Cocapata","Nucleo German Busch (Chillavi)",0,2,1,0,139,0,14,1,1,158,5,7,170,185,0.88,0.919
"11973","Cochabamba","Cocapata","Escuela Choquecamata (Falsuri)",7,3,1,1,132,4,28,1,0,177,8,16,201,231,0.746,0.87
"11974","Cochabamba","Cocapata","Escuela Choquecamata (Falsuri)",11,2,1,1,107,1,36,2,0,161,12,20,193,225,0.665,0.858
"11975","Cochabamba","Cocapata","Escuela Choquecamata (Falsuri)",9,0,2,0,118,1,20,1,0,151,7,26,184,204,0.781,0.902
"11976","Cochabamba","Cocapata","Nucleo Escolar Pedro Laime Chuspi",1,2,0,1,168,0,12,0,0,184,3,17,204,232,0.913,0.879
"11977","Cochabamba","Cocapata","Unidad Educativa Chiaraje",0,2,1,2,188,2,12,0,0,207,1,6,214,233,0.908,0.918
"11978","Cochabamba","Cocapata","Escuela Seccional Machacayma",2,4,2,4,152,5,8,3,1,181,9,12,202,229,0.84,0.882
"11979","Cochabamba","Cocapata","Escuela Seccional Machacayma",6,4,2,2,175,0,4,0,0,193,4,6,203,227,0.907,0.894
"11980","Cochabamba","Cocapata","Unidad Educativa Maravillas",6,3,2,4,155,1,9,0,0,180,8,13,201,232,0.861,0.866
"11981","Cochabamba","Cocapata","Unidad Educativa El Chorito",6,3,2,1,143,4,33,1,1,194,8,15,217,229,0.737,0.948
"11982","Cochabamba","Cocapata","Unidad Educativa Colorado",2,0,0,0,200,1,8,0,0,211,1,5,217,232,0.948,0.935
"11983","Cochabamba","Cocapata","Unidad Educativa Totorani",8,3,0,7,174,3,22,0,1,218,2,6,226,234,0.798,0.966
"11984","Cochabamba","Cocapata","Unidad Educativa Totorani",0,1,2,2,159,3,16,1,0,184,6,10,200,211,0.864,0.948
"11985","Cochabamba","Cocapata","U.E. Seque Rancho",19,5,10,0,158,3,11,0,0,206,5,11,222,240,0.767,0.925
"11986","Cochabamba","Cocapata","U.E. Tocorani",7,5,0,1,154,3,14,5,1,190,19,22,231,250,0.811,0.924
"11987","Cochabamba","Cocapata","U.E. Muñoz Cueva",4,0,7,0,156,1,10,4,0,182,4,20,206,209,0.857,0.986
"11988","Cochabamba","Tarata","Colegio My. Victor Ustariz",46,1,3,1,112,6,12,0,2,183,4,9,196,230,0.612,0.852
"11989","Cochabamba","Tarata","Colegio My. Victor Ustariz",47,1,1,0,114,4,13,0,3,183,3,9,195,229,0.623,0.852
"11990","Cochabamba","Tarata","Colegio My. Victor Ustariz",25,1,1,1,138,5,16,0,1,188,2,1,191,232,0.734,0.823
"11991","Cochabamba","Tarata","Colegio My. Victor Ustariz",24,0,2,0,137,2,9,0,2,176,4,5,185,226,0.778,0.819
"11992","Cochabamba","Tarata","Colegio My. Victor Ustariz",33,0,0,0,118,3,16,0,1,171,1,6,178,229,0.69,0.777
"11993","Cochabamba","Tarata","Colegio My. Victor Ustariz",34,1,1,0,137,1,10,1,0,185,1,8,194,224,0.741,0.866
"11994","Cochabamba","Tarata","Colegio My. Victor Ustariz",31,1,5,0,137,1,10,0,0,185,4,8,197,234,0.741,0.842
"11995","Cochabamba","Tarata","Colegio My. Victor Ustariz",36,0,2,0,136,4,8,0,1,187,5,3,195,228,0.727,0.855
"11996","Cochabamba","Tarata","Colegio My. Victor Ustariz",25,0,1,0,130,4,14,0,3,177,3,9,189,227,0.734,0.833
"11997","Cochabamba","Tarata","Colegio My. Victor Ustariz",37,2,0,1,122,4,16,0,0,182,2,10,194,230,0.67,0.843
"11998","Cochabamba","Tarata","Colegio My. Victor Ustariz",29,0,1,0,133,3,16,0,2,184,0,5,189,227,0.723,0.833
"11999","Cochabamba","Tarata","Escuela Rene Barrientos O.",52,1,1,0,117,2,7,0,2,182,1,7,190,224,0.643,0.848
"12000","Cochabamba","Tarata","Escuela Rene Barrientos O.",33,0,0,2,130,1,7,0,1,174,2,5,181,219,0.747,0.826
"12001","Cochabamba","Tarata","Escuela Rene Barrientos O.",31,1,0,0,122,2,11,0,3,170,4,11,185,225,0.718,0.822
"12002","Cochabamba","Tarata","Escuela Rene Barrientos O.",37,1,0,0,122,2,8,0,1,171,7,6,184,221,0.713,0.833
"12003","Cochabamba","Tarata","Escuela Rene Barrientos O.",32,1,1,0,133,1,11,0,2,181,3,3,187,229,0.735,0.817
"12004","Cochabamba","Tarata","Escuela Rene Barrientos O.",34,0,0,1,127,5,7,2,3,179,7,7,193,221,0.709,0.873
"12005","Cochabamba","Tarata","Escuela Rene Barrientos O.",31,1,1,0,128,3,13,0,0,177,4,5,186,219,0.723,0.849
"12006","Cochabamba","Tarata","Escuela Esteban Arze",43,0,1,0,138,0,8,0,0,190,3,4,197,224,0.726,0.879
"12007","Cochabamba","Tarata","Escuela Esteban Arze",29,1,1,1,127,7,13,0,1,180,3,10,193,222,0.706,0.869
"12008","Cochabamba","Tarata","Escuela Esteban Arze",34,1,2,0,136,0,10,0,2,185,4,3,192,224,0.735,0.857
"12009","Cochabamba","Tarata","Escuela Esteban Arze",33,0,1,2,131,1,10,0,1,179,5,4,188,226,0.732,0.832
"12010","Cochabamba","Tarata","Escuela Esteban Arze",32,0,1,0,138,2,12,1,1,187,1,3,191,230,0.738,0.83
"12011","Cochabamba","Tarata","Escuela Esteban Arze",43,0,1,0,129,2,6,0,1,182,2,11,195,217,0.709,0.899
"12012","Cochabamba","Tarata","Unidad Educativa Huayculi",4,1,0,0,171,1,5,0,1,183,1,16,200,223,0.934,0.897
"12013","Cochabamba","Tarata","Unidad Educativa Huayculi",9,0,1,0,161,1,3,0,0,175,3,7,185,214,0.92,0.864
"12014","Cochabamba","Tarata","Unidad Educativa Huayculi",8,0,2,0,176,1,2,0,0,189,6,7,202,219,0.931,0.922
"12015","Cochabamba","Tarata","Escuela Luis Terrazas",2,0,0,0,163,0,1,0,0,166,4,4,174,201,0.982,0.866
"12016","Cochabamba","Tarata","Unidad Educativa Huerta Mayu",1,0,0,0,197,0,1,0,0,199,0,3,202,215,0.99,0.94
"12017","Cochabamba","Anzaldo","U. E. San Jose de Calazans-Litoral",20,2,0,0,130,2,9,0,3,166,9,10,185,216,0.783,0.856
"12018","Cochabamba","Anzaldo","U. E. San Jose de Calazans-Litoral",16,3,3,0,139,1,6,0,1,169,8,12,189,217,0.822,0.871
"12019","Cochabamba","Anzaldo","U. E. San Jose de Calazans-Litoral",11,6,0,0,139,0,3,0,1,160,17,10,187,216,0.869,0.866
"12020","Cochabamba","Anzaldo","U. E. San Jose de Calazans-Litoral",11,1,0,0,155,2,5,0,1,175,6,13,194,213,0.886,0.911
"12021","Cochabamba","Anzaldo","U. E. San Jose de Calazans-Litoral",10,3,4,0,148,1,4,0,0,170,12,11,193,216,0.871,0.894
"12022","Cochabamba","Anzaldo","U. E. San Jose de Calazans-Litoral",5,3,2,2,153,0,12,1,2,180,1,10,191,218,0.85,0.876
"12023","Cochabamba","Anzaldo","U. E. San Jose de Calazans-Litoral",24,2,0,1,118,2,2,1,2,152,11,15,178,210,0.776,0.848
"12024","Cochabamba","Anzaldo","U. E. San Jose de Calazans-Litoral",7,2,1,1,166,1,2,1,0,181,10,6,197,229,0.917,0.86
"12025","Cochabamba","Anzaldo","U. E. San Jose de Calazans-Litoral",13,1,2,0,137,0,14,0,0,167,16,9,192,220,0.82,0.873
"12026","Cochabamba","Anzaldo","U. E. San Jose de Calazans-Litoral",31,1,0,0,135,0,11,1,0,179,4,5,188,216,0.754,0.87
"12027","Cochabamba","Anzaldo","U. E. San Jose de Calazans-Litoral",15,2,2,2,127,1,15,1,2,167,10,8,185,204,0.76,0.907
"12028","Cochabamba","Anzaldo","Esc. Esteban Andia Escobar - Paccha Pata",4,2,0,1,144,3,3,3,3,163,3,3,169,193,0.883,0.876
"12029","Cochabamba","Anzaldo","Nucleo Educativo La Viña",3,2,0,3,173,1,12,0,0,194,0,6,200,227,0.892,0.881
"12030","Cochabamba","Anzaldo","Unidad Educativa Arturo Sarmiento",3,2,3,0,152,1,2,0,0,163,5,15,183,211,0.933,0.867
"12031","Cochabamba","Arbieto","Centro Educativo German Busch - Arbieto",29,0,0,0,119,2,4,0,0,154,6,2,162,210,0.773,0.771
"12032","Cochabamba","Arbieto","Centro Educativo German Busch - Arbieto",21,1,0,1,133,0,4,1,2,163,5,5,173,224,0.816,0.772
"12033","Cochabamba","Arbieto","Centro Educativo German Busch - Arbieto",26,3,0,0,134,1,0,0,3,167,3,4,174,221,0.802,0.787
"12034","Cochabamba","Arbieto","Centro Educativo German Busch - Arbieto",15,0,0,1,142,2,11,0,1,172,3,5,180,222,0.826,0.811
"12035","Cochabamba","Arbieto","Centro Educativo German Busch - Arbieto",13,1,1,0,137,0,9,0,2,163,1,5,169,214,0.84,0.79
"12036","Cochabamba","Arbieto","Centro Educativo German Busch - Arbieto",27,0,0,0,130,3,8,0,1,169,5,3,177,222,0.769,0.797
"12037","Cochabamba","Arbieto","Centro Educativo German Busch - Arbieto",19,1,1,1,126,2,11,1,3,165,1,12,178,216,0.764,0.824
"12038","Cochabamba","Arbieto","Centro Educativo German Busch - Arbieto",12,3,0,1,132,3,7,0,1,159,1,2,162,197,0.83,0.822
"12039","Cochabamba","Arbieto","Centro Educativo German Busch - Arbieto",44,1,0,0,115,1,8,1,3,173,1,9,183,216,0.665,0.847
"12040","Cochabamba","Arbieto","Unidad Educativa 6 de Junio - Mamanaca",15,0,0,0,155,2,4,0,1,177,5,4,186,224,0.876,0.83
"12041","Cochabamba","Arbieto","Unidad Educativa 6 de Junio - Mamanaca",8,0,0,1,137,5,5,1,0,157,2,14,173,221,0.873,0.783
"12042","Cochabamba","Arbieto","Unidad Educativa 6 de Junio - Mamanaca",17,0,0,1,140,0,6,0,1,165,2,1,168,216,0.848,0.778
"12043","Cochabamba","Arbieto","Unidad Educativa Antonio Arnez -Aranjuez",35,2,1,1,123,2,12,0,1,177,1,11,189,212,0.695,0.892
"12044","Cochabamba","Arbieto","Unidad Educativa Antonio Arnez -Aranjuez",22,0,0,1,116,4,8,0,0,151,1,9,161,189,0.768,0.852
"12045","Cochabamba","Arbieto","Escuela Seccional Arpita",13,0,0,1,137,3,13,0,2,169,2,5,176,214,0.811,0.822
"12046","Cochabamba","Arbieto","Escuela Seccional Arpita",9,1,0,1,141,4,6,0,0,162,4,4,170,213,0.87,0.798
"12047","Cochabamba","Arbieto","Escuela Seccional Arpita",4,0,1,0,162,2,12,1,0,182,4,8,194,221,0.89,0.878
"12048","Cochabamba","Arbieto","Escuela Seccional Arpita",10,2,1,1,136,0,9,1,1,161,2,7,170,208,0.845,0.817
"12049","Cochabamba","Arbieto","Escuela Seccional Arpita",7,0,1,0,156,0,7,0,0,171,2,5,178,215,0.912,0.828
"12050","Cochabamba","Arbieto","Unidad Educativa Carlos Canelas",9,0,0,1,176,1,11,0,2,200,1,9,210,232,0.88,0.905
"12051","Cochabamba","Arbieto","Unidad Educativa Carlos Canelas",13,0,1,0,173,2,16,0,0,205,4,11,220,234,0.844,0.94
"12052","Cochabamba","Arbieto","Unidad Educativa Carlos Canelas",17,0,1,1,167,1,23,0,0,210,2,7,219,231,0.795,0.948
"12053","Cochabamba","Arbieto","Unidad Educativa Carlos Canelas",7,1,2,0,179,1,17,0,1,208,1,8,217,238,0.861,0.912
"12054","Cochabamba","Arbieto","Unidad Educativa Carlos Canelas",5,0,0,0,171,1,15,0,1,193,4,7,204,231,0.886,0.883
"12055","Cochabamba","Arbieto","Unidad Educativa Carlos Canelas",14,2,0,0,160,0,16,0,0,192,8,6,206,233,0.833,0.884
"12056","Cochabamba","Arbieto","Unidad Educativa Carlos Canelas",16,0,0,0,170,1,15,1,1,204,3,6,213,230,0.833,0.926
"12057","Cochabamba","Arbieto","Unidad Educativa Carlos Canelas",21,0,2,0,174,3,6,0,2,208,0,4,212,234,0.837,0.906
"12058","Cochabamba","Arbieto","Unidad Educativa Carlos Canelas",11,2,1,0,169,1,17,2,0,203,6,6,215,232,0.833,0.927
"12059","Cochabamba","Arbieto","Unidad Educativa Carlos Canelas",14,2,0,0,177,1,13,0,1,208,5,5,218,231,0.851,0.944
"12060","Cochabamba","Arbieto","Unidad Educativa Carlos Canelas",10,0,1,1,151,3,21,0,1,188,2,14,204,230,0.803,0.887
"12061","Cochabamba","Arbieto","Unidad Educativa Carlos Canelas",16,0,4,0,178,0,13,0,1,212,3,6,221,230,0.84,0.961
"12062","Cochabamba","Arbieto","Unidad Educativa Carlos Canelas",15,1,1,0,169,1,12,2,3,204,2,8,214,235,0.828,0.911
"12063","Cochabamba","Arbieto","Unidad Educativa Carlos Canelas",18,1,1,2,167,5,8,1,1,204,7,5,216,235,0.819,0.919
"12064","Cochabamba","Arbieto","Unidad Educativa Carlos Canelas",9,0,1,1,176,2,17,0,2,208,2,10,220,233,0.846,0.944
"12065","Cochabamba","Arbieto","U.E. Betty Barrientos",22,0,0,2,176,0,21,0,0,221,4,5,230,240,0.796,0.958
"12066","Cochabamba","Arbieto","U. E. Casimiro López Terrazas",49,0,1,0,125,1,10,2,4,192,3,3,198,226,0.651,0.876
"12067","Cochabamba","Arbieto","U. E. Casimiro López Terrazas",42,0,1,0,134,4,15,1,0,197,5,7,209,225,0.68,0.929
"12068","Cochabamba","Sacabamba","Escuela Eliseo Torrico - Sacabamba",8,2,0,1,141,2,17,0,0,171,4,6,181,210,0.825,0.862
"12069","Cochabamba","Sacabamba","Escuela Eliseo Torrico - Sacabamba",11,3,2,0,137,2,31,1,1,188,2,6,196,215,0.729,0.912
"12070","Cochabamba","Sacabamba","Escuela Eliseo Torrico - Sacabamba",6,3,2,2,139,0,28,2,1,183,2,8,193,217,0.76,0.889
"12071","Cochabamba","Sacabamba","Escuela Seccional Challaque",3,0,0,1,158,1,7,0,0,170,5,11,186,205,0.929,0.907
"12072","Cochabamba","Sacabamba","Nucleo Matarani",11,2,1,1,164,2,9,0,0,190,5,8,203,223,0.863,0.91
"12073","Cochabamba","Sacabamba","Nucleo Matarani",5,2,1,0,154,0,7,2,0,171,3,13,187,216,0.901,0.866
"12074","Cochabamba","Sacabamba","Nucleo Matarani",6,1,2,0,171,2,21,0,0,203,4,10,217,237,0.842,0.916
"12075","Cochabamba","Sacabamba","Nucleo Escolar Quekoma",3,0,0,0,165,3,9,0,0,180,0,6,186,210,0.917,0.886
"12076","Cochabamba","Sacabamba","Unidad Educativa Apillapa",4,1,2,0,154,1,5,0,0,167,3,8,178,197,0.922,0.904
"12077","Cochabamba","Arani","Escuela Gualberto Villarroel",43,2,1,0,122,1,9,0,1,179,2,14,195,224,0.682,0.871
"12078","Cochabamba","Arani","Escuela Gualberto Villarroel",34,1,0,0,145,1,6,0,0,187,4,8,199,216,0.775,0.921
"12079","Cochabamba","Arani","Escuela Gualberto Villarroel",35,0,1,1,129,2,20,0,1,189,3,5,197,225,0.683,0.876
"12080","Cochabamba","Arani","Escuela Gualberto Villarroel",27,0,2,1,140,1,10,1,0,182,7,10,199,223,0.769,0.892
"12081","Cochabamba","Arani","Escuela Gualberto Villarroel",24,1,0,1,152,3,13,0,2,196,1,4,201,226,0.776,0.889
"12082","Cochabamba","Arani","Escuela Gualberto Villarroel",35,0,0,0,139,0,14,1,2,191,5,11,207,226,0.728,0.916
"12083","Cochabamba","Arani","Escuela Gualberto Villarroel",37,0,0,0,140,2,12,0,0,191,4,8,203,227,0.733,0.894
"12084","Cochabamba","Arani","Escuela Gualberto Villarroel",34,0,0,0,138,0,12,0,0,184,7,8,199,224,0.75,0.888
"12085","Cochabamba","Arani","Escuela Gualberto Villarroel",43,1,0,0,122,1,8,0,2,177,3,13,193,218,0.689,0.885
"12086","Cochabamba","Arani","Escuela Gualberto Villarroel",27,1,0,0,123,3,26,1,0,181,5,5,191,220,0.68,0.868
"12087","Cochabamba","Arani","Escuela Gualberto Villarroel",28,1,0,1,136,1,17,0,0,184,5,5,194,216,0.739,0.898
"12088","Cochabamba","Arani","Escuela Gualberto Villarroel",51,2,0,0,122,3,16,0,0,194,4,5,203,227,0.629,0.894
"12089","Cochabamba","Arani","Escuela Gualberto Villarroel",33,0,2,0,135,6,15,1,1,193,3,8,204,225,0.699,0.907
"12090","Cochabamba","Arani","Escuela Gualberto Villarroel",42,2,0,0,110,2,7,1,0,164,6,26,196,225,0.671,0.871
"12091","Cochabamba","Arani","U.E. Arani",53,2,2,2,97,2,12,1,2,173,4,14,191,216,0.561,0.884
"12092","Cochabamba","Arani","U.E. Arani",54,1,0,0,119,2,20,1,1,198,3,6,207,231,0.601,0.896
"12093","Cochabamba","Arani","U.E. Arani",41,0,1,0,133,1,13,0,1,190,2,7,199,224,0.7,0.888
"12094","Cochabamba","Arani","U.E. Arani",40,0,0,0,126,0,7,11,1,185,3,3,191,216,0.681,0.884
"12095","Cochabamba","Arani","U.E. Arani",33,1,2,0,117,3,24,0,0,180,2,13,195,220,0.65,0.886
"12096","Cochabamba","Arani","U.E. Arani",70,1,0,0,106,3,12,2,0,194,4,7,205,225,0.546,0.911
"12097","Cochabamba","Arani","U.E. Arani",34,0,1,0,131,1,16,0,2,185,6,6,197,217,0.708,0.908
"12098","Cochabamba","Arani","U.E. Arani",55,0,1,1,102,7,12,0,0,178,3,9,190,214,0.573,0.888
"12099","Cochabamba","Arani","U.E. Arani",49,0,1,2,115,3,14,0,1,185,7,11,203,219,0.622,0.927
"12100","Cochabamba","Arani","U.E. Arani",45,0,1,1,118,1,13,0,2,181,2,9,192,220,0.652,0.873
"12101","Cochabamba","Arani","U.E. Arani",46,0,1,1,113,4,12,2,0,179,3,4,186,218,0.631,0.853
"12102","Cochabamba","Arani","U.E. Arani",36,0,3,1,129,2,12,1,2,186,4,8,198,222,0.694,0.892
"12103","Cochabamba","Arani","U.E. Arani",59,1,0,0,109,1,8,0,1,179,3,12,194,221,0.609,0.878
"12104","Cochabamba","Arani","Unidad Educativa Collpaciaco",18,0,0,1,132,3,7,0,0,161,5,17,183,215,0.82,0.851
"12105","Cochabamba","Arani","Unidad Educativa Collpaciaco",9,2,0,1,145,0,13,0,1,171,3,11,185,206,0.848,0.898
"12106","Cochabamba","Arani","Unidad Educativa Collpaciaco",19,2,1,2,162,1,6,0,0,193,3,6,202,226,0.839,0.894
"12107","Cochabamba","Arani","Escuela Mixta Pocoata",14,1,1,2,142,4,1,0,0,165,7,13,185,215,0.861,0.86
"12108","Cochabamba","Arani","Escuela Mixta Pocoata",35,0,1,0,125,4,4,1,1,171,6,13,190,214,0.731,0.888
"12109","Cochabamba","Vacas","Escuela Experimental Vacas",5,0,1,0,166,0,9,0,0,181,5,5,191,214,0.917,0.893
"12110","Cochabamba","Vacas","Escuela Experimental Vacas",4,1,0,0,181,1,7,0,0,194,7,5,206,222,0.933,0.928
"12111","Cochabamba","Vacas","Escuela Experimental Vacas",10,1,0,0,162,3,6,0,1,183,6,9,198,212,0.885,0.934
"12112","Cochabamba","Vacas","Escuela Experimental Vacas",11,1,0,0,168,0,11,0,0,191,3,8,202,219,0.88,0.922
"12113","Cochabamba","Vacas","Escuela Experimental Vacas",11,2,0,0,163,2,19,0,1,198,7,4,209,221,0.823,0.946
"12114","Cochabamba","Vacas","Escuela Experimental Vacas",22,1,0,0,153,2,6,0,1,185,3,13,201,221,0.827,0.91
"12115","Cochabamba","Vacas","Escuela Experimental Vacas",4,2,1,1,162,0,9,2,0,181,4,7,192,213,0.895,0.901
"12116","Cochabamba","Vacas","Escuela Experimental Vacas",3,0,1,0,190,0,1,0,0,195,5,3,203,223,0.974,0.91
"12117","Cochabamba","Vacas","Escuela Experimental Vacas",2,1,2,0,181,0,6,0,0,192,2,2,196,219,0.943,0.895
"12118","Cochabamba","Vacas","Escuela Experimental Vacas",4,2,1,0,153,1,5,0,1,167,7,11,185,215,0.916,0.86
"12119","Cochabamba","Vacas","Escuela Experimental Vacas",8,0,0,2,167,3,7,0,0,187,1,10,198,215,0.893,0.921
"12120","Cochabamba","Vacas","Escuela Experimental Vacas",6,1,0,0,167,1,14,0,2,191,1,9,201,220,0.874,0.914
"12121","Cochabamba","Vacas","Escuela Experimental Vacas",9,0,0,1,162,0,12,1,0,185,2,11,198,217,0.876,0.912
"12122","Cochabamba","Vacas","Escuela Seccional Rodeo A",3,0,10,1,183,1,4,1,0,203,4,6,213,221,0.901,0.964
"12123","Cochabamba","Vacas","Escuela Seccional Rodeo A",7,1,1,1,163,1,4,2,0,180,10,3,193,210,0.906,0.919
"12124","Cochabamba","Vacas","Escuela Seccional Rodeo A",6,3,1,0,175,1,8,0,0,194,4,3,201,220,0.902,0.914
"12125","Cochabamba","Vacas","Escuela Seccional Rodeo A",4,1,0,2,172,2,5,0,1,187,7,5,199,217,0.92,0.917
"12126","Cochabamba","Vacas","Escuela Seccional Rodeo A",5,1,1,0,189,0,4,1,1,202,4,4,210,214,0.936,0.981
"12127","Cochabamba","Vacas","Unidad Educativa Totorapampa",1,0,1,1,183,0,4,0,0,190,0,10,200,216,0.963,0.926
"12128","Cochabamba","Vacas","U.E. David Morato Cañadas",2,0,0,0,202,1,12,0,0,217,3,8,228,233,0.931,0.979
"12129","Cochabamba","Vacas","U.E. David Morato Cañadas",2,1,0,0,201,2,11,0,1,218,0,10,228,234,0.922,0.974
"12130","Cochabamba","Vacas","U.E. David Morato Cañadas",0,0,0,0,162,0,1,0,0,163,0,15,178,183,0.994,0.973
"12131","Cochabamba","Arque","Escuela Nataniel Aguirre",11,3,2,1,164,2,6,0,2,191,17,5,213,226,0.859,0.942
"12132","Cochabamba","Arque","Escuela Nataniel Aguirre",6,1,1,1,180,0,7,0,1,197,1,6,204,222,0.914,0.919
"12133","Cochabamba","Arque","Escuela Nataniel Aguirre",3,0,1,0,139,1,14,0,0,158,7,7,172,223,0.88,0.771
"12134","Cochabamba","Arque","Escuela Nataniel Aguirre",7,3,3,0,150,2,6,0,1,172,8,7,187,213,0.872,0.878
"12135","Cochabamba","Arque","Escuela Juana Azurduy - Pongo K'Asa",2,1,0,2,177,0,1,1,0,184,3,2,189,212,0.962,0.892
"12136","Cochabamba","Arque","Escuela Juana Azurduy - Pongo K'Asa",7,0,0,1,162,0,6,1,0,177,9,5,191,226,0.915,0.845
"12137","Cochabamba","Arque","Escuela E Internado Dario Antezana V.",0,0,0,0,168,0,2,0,0,170,0,16,186,225,0.988,0.827
"12138","Cochabamba","Arque","Escuela E Internado Dario Antezana V.",0,0,0,0,195,0,0,0,0,195,0,1,196,223,1,0.879
"12139","Cochabamba","Arque","Escuela E Internado Dario Antezana V.",0,1,1,0,165,0,1,0,0,168,0,1,169,189,0.982,0.894
"12140","Cochabamba","Arque","U.E. San Pedro",2,2,2,5,156,2,4,0,0,173,8,12,193,223,0.902,0.865
"12141","Cochabamba","Arque","Escuela Marcelo Quiroga Santa Cruz",7,1,0,2,159,1,10,0,1,181,3,7,191,221,0.878,0.864
"12142","Cochabamba","Arque","Escuela Marcelo Quiroga Santa Cruz",2,0,2,4,152,1,7,1,1,170,3,10,183,216,0.894,0.847
"12143","Cochabamba","Arque","Escuela Marcelo Quiroga Santa Cruz",1,5,0,1,165,4,4,0,0,180,6,14,200,221,0.917,0.905
"12144","Cochabamba","Arque","Escuela Marcelo Quiroga Santa Cruz",7,0,3,1,162,1,4,1,0,179,7,6,192,217,0.905,0.885
"12145","Cochabamba","Arque","Unidad Escolar Tupac Katari - Tarujayña",1,0,0,0,158,3,11,0,0,173,5,7,185,212,0.913,0.873
"12146","Cochabamba","Arque","Unidad Educativa Huaycha",0,0,0,0,219,0,1,0,0,220,3,3,226,231,0.995,0.978
"12147","Cochabamba","Arque","Unidad Educativa Huaycha",0,0,1,0,195,1,1,1,0,199,0,2,201,210,0.98,0.957
"12148","Cochabamba","Arque","Unidad Educativa Changolla",0,1,1,1,190,2,5,0,0,200,5,5,210,232,0.95,0.905
"12149","Cochabamba","Arque","U.E. Dña. Adela Zamudio",1,2,3,2,185,5,8,0,1,207,2,26,235,240,0.894,0.979
"12150","Cochabamba","Tacopaya","Escuela Adolfo Mercado",0,0,1,1,200,0,1,0,0,203,1,5,209,221,0.985,0.946
"12151","Cochabamba","Tacopaya","Escuela Adolfo Mercado",2,1,4,0,180,0,2,1,0,190,5,10,205,218,0.947,0.94
"12152","Cochabamba","Tacopaya","Escuela Adolfo Mercado",3,1,1,1,173,0,1,1,0,181,3,5,189,208,0.956,0.909
"12153","Cochabamba","Tacopaya","Escuela Adolfo Mercado",3,3,1,0,191,0,2,0,1,201,2,4,207,222,0.95,0.932
"12154","Cochabamba","Tacopaya","Escuela Adolfo Mercado",0,2,0,2,192,0,1,1,0,198,4,5,207,224,0.97,0.924
"12155","Cochabamba","Tacopaya","Unidad Educativa Aniceto Arce",2,1,0,2,163,1,9,0,0,178,3,4,185,218,0.916,0.849
"12156","Cochabamba","Tacopaya","Escuela Seccional Rene Barrientos",2,4,2,0,142,1,2,4,0,157,3,16,176,214,0.904,0.822
"12157","Cochabamba","Tacopaya","Escuela Seccional Rene Barrientos",5,1,1,0,152,2,5,1,0,167,6,7,180,216,0.91,0.833
"12158","Cochabamba","Tacopaya","Unidad Educativa Michayani Grande",3,0,2,1,142,1,6,0,0,155,2,19,176,215,0.916,0.819
"12159","Cochabamba","Tacopaya","Escuela Elizardo Perez (Totorapampa)",2,1,2,0,157,4,17,2,0,185,5,17,207,218,0.849,0.95
"12160","Cochabamba","Tacopaya","Escuela Elizardo Perez (Totorapampa)",2,3,2,2,167,5,7,1,0,189,5,20,214,230,0.884,0.93
"12161","Cochabamba","Tacopaya","Escuela Martin Cardenas (Tujuta)",1,1,0,0,174,1,8,1,3,189,4,1,194,223,0.921,0.87
"12162","Cochabamba","Tacopaya","Unidad Educativa Auquipampa",0,0,0,0,201,0,0,0,0,201,0,11,212,226,1,0.938
"12163","Cochabamba","Tacopaya","Unidad Educativa Auquipampa",0,0,0,0,211,0,1,0,0,212,0,3,215,221,0.995,0.973
"12164","Cochabamba","Tacopaya","U. E. 12 de Abril",3,0,0,1,197,0,1,1,0,203,1,3,207,210,0.97,0.986
"12165","Cochabamba","Capinota","Escuela Victor Barrientos",27,0,0,0,122,2,22,0,0,173,4,15,192,217,0.705,0.885
"12166","Cochabamba","Capinota","Escuela Victor Barrientos",57,0,1,1,96,2,9,0,1,167,3,7,177,210,0.575,0.843
"12167","Cochabamba","Capinota","Escuela Victor Barrientos",57,1,1,1,117,0,22,0,0,199,3,1,203,225,0.588,0.902
"12168","Cochabamba","Capinota","Escuela Victor Barrientos",39,0,2,0,120,0,19,0,0,180,2,11,193,224,0.667,0.862
"12169","Cochabamba","Capinota","Escuela Victor Barrientos",37,1,0,1,124,2,21,0,0,186,2,6,194,220,0.667,0.882
"12170","Cochabamba","Capinota","Escuela Victor Barrientos",27,2,2,3,138,1,14,1,1,189,4,6,199,220,0.73,0.905
"12171","Cochabamba","Capinota","Escuela Victor Barrientos",52,0,0,0,110,5,13,1,3,184,4,13,201,222,0.598,0.905
"12172","Cochabamba","Capinota","Escuela Victor Barrientos",35,2,0,2,115,1,16,0,3,174,6,11,191,218,0.661,0.876
"12173","Cochabamba","Capinota","Escuela Victor Barrientos",33,3,0,2,108,9,11,1,0,167,4,13,184,214,0.647,0.86
"12174","Cochabamba","Capinota","Escuela Victor Barrientos",46,0,1,0,104,2,16,0,1,170,9,8,187,225,0.612,0.831
"12175","Cochabamba","Capinota","Escuela Victor Barrientos",25,1,1,2,138,0,15,0,0,182,4,11,197,224,0.758,0.879
"12176","Cochabamba","Capinota","Escuela Victor Barrientos",53,0,1,0,117,3,7,0,1,182,2,12,196,223,0.643,0.879
"12177","Cochabamba","Capinota","Escuela Victor Barrientos",49,0,0,0,129,0,15,0,0,193,4,8,205,218,0.668,0.94
"12178","Cochabamba","Capinota","Escuela Victor Barrientos",32,0,0,0,126,3,18,0,3,182,2,9,193,220,0.692,0.877
"12179","Cochabamba","Capinota","Escuela Victor Barrientos",34,1,0,0,122,2,22,0,1,182,5,6,193,214,0.67,0.902
"12180","Cochabamba","Capinota","Escuela Victor Barrientos",39,2,1,0,114,1,16,0,0,173,2,8,183,211,0.659,0.867
"12181","Cochabamba","Capinota","Escuela Victor Barrientos",52,1,1,1,106,2,15,1,0,179,1,9,189,217,0.592,0.871
"12182","Cochabamba","Capinota","Escuela Victor Barrientos",44,0,3,0,119,0,11,2,2,181,4,9,194,221,0.657,0.878
"12183","Cochabamba","Capinota","Escuela Victor Barrientos",32,2,1,1,126,2,17,1,1,183,4,9,196,219,0.689,0.895
"12184","Cochabamba","Capinota","Unidad Educativa Juana Azurduy De Padilla",37,1,0,0,147,1,21,1,4,212,1,8,221,240,0.693,0.921
"12185","Cochabamba","Capinota","Unidad Educativa Juana Azurduy De Padilla",20,2,1,0,161,3,17,0,1,205,1,7,213,236,0.785,0.903
"12186","Cochabamba","Capinota","Unidad Educativa Juana Azurduy De Padilla",25,3,0,1,144,2,28,0,2,205,1,4,210,237,0.702,0.886
"12187","Cochabamba","Capinota","Unidad Educativa Juana Azurduy De Padilla",28,1,1,0,154,1,27,1,0,213,2,4,219,237,0.723,0.924
"12188","Cochabamba","Capinota","Unidad Educativa Juana Azurduy De Padilla",26,0,0,0,149,1,25,1,0,202,1,10,213,237,0.738,0.899
"12189","Cochabamba","Capinota","Unidad Educativa Juana Azurduy De Padilla",24,0,1,0,139,0,21,0,0,185,2,11,198,209,0.751,0.947
"12190","Cochabamba","Capinota","U. E. Oscar Unzaga De La Vega",38,1,1,1,152,1,21,0,2,217,3,13,233,240,0.7,0.971
"12191","Cochabamba","Capinota","U. E. Oscar Unzaga De La Vega",46,0,0,1,133,1,12,0,3,196,5,4,205,210,0.679,0.976
"12192","Cochabamba","Capinota","Unidad Educativa Custodio Ayaviri",67,0,0,1,112,4,18,2,3,207,3,6,216,230,0.541,0.939
"12193","Cochabamba","Capinota","Unidad Educativa Custodio Ayaviri",43,1,0,1,136,1,13,0,0,195,1,14,210,224,0.697,0.938
"12194","Cochabamba","Capinota","Unidad Educativa Custodio Ayaviri",36,2,0,1,138,3,25,0,2,207,6,7,220,232,0.667,0.948
"12195","Cochabamba","Capinota","Unidad Educativa Custodio Ayaviri",41,0,0,0,137,1,20,0,1,200,5,8,213,225,0.685,0.947
"12196","Cochabamba","Capinota","Unidad Educativa Custodio Ayaviri",45,3,1,0,138,6,15,2,0,210,4,10,224,236,0.657,0.949
"12197","Cochabamba","Capinota","Unidad Educativa Custodio Ayaviri",58,1,0,1,112,3,22,0,1,198,3,6,207,222,0.566,0.932
"12198","Cochabamba","Capinota","Unidad Educativa Custodio Ayaviri",58,2,2,2,124,6,17,0,0,211,0,2,213,230,0.588,0.926
"12199","Cochabamba","Capinota","Unidad Educativa Custodio Ayaviri",38,1,0,3,133,6,17,0,3,201,4,10,215,229,0.662,0.939
"12200","Cochabamba","Capinota","Unidad Educativa Custodio Ayaviri",47,0,1,1,112,6,19,3,1,190,3,17,210,229,0.589,0.917
"12201","Cochabamba","Capinota","Unidad Educativa Custodio Ayaviri",61,0,0,1,115,2,21,0,0,200,2,8,210,228,0.575,0.921
"12202","Cochabamba","Capinota","Unidad Educativa Custodio Ayaviri",48,1,0,0,120,6,19,1,2,197,5,13,215,231,0.609,0.931
"12203","Cochabamba","Capinota","Unidad Educativa Custodio Ayaviri",55,0,0,0,121,5,20,0,3,204,5,8,217,233,0.593,0.931
"12204","Cochabamba","Capinota","Unidad Educativa Custodio Ayaviri",48,0,1,0,127,2,21,0,1,200,2,9,211,229,0.635,0.921
"12205","Cochabamba","Capinota","Unidad Educativa Custodio Ayaviri",56,0,1,0,113,4,20,0,1,195,3,10,208,225,0.579,0.924
"12206","Cochabamba","Capinota","Unidad Educativa Custodio Ayaviri",53,1,2,0,120,5,11,0,1,193,4,12,209,226,0.622,0.925
"12207","Cochabamba","Capinota","Unidad Educativa Gustavo Garcia (Charamo)",29,0,3,0,137,2,12,0,2,185,4,14,203,225,0.741,0.902
"12208","Cochabamba","Capinota","Unidad Educativa Gustavo Garcia (Charamo)",36,0,1,0,129,3,15,0,0,184,6,12,202,228,0.701,0.886
"12209","Cochabamba","Capinota","Unidad Educativa Gustavo Garcia (Charamo)",13,0,0,1,137,2,16,0,0,169,8,22,199,224,0.811,0.888
"12210","Cochabamba","Capinota","Unidad Educativa Gustavo Garcia (Charamo)",25,1,1,2,141,2,12,0,0,184,3,11,198,219,0.766,0.904
"12211","Cochabamba","Capinota","Escuela Apillapampa",4,1,0,0,146,4,7,1,0,163,9,14,186,218,0.896,0.853
"12212","Cochabamba","Capinota","Escuela Apillapampa",1,2,0,0,181,0,4,1,0,189,2,4,195,216,0.958,0.903
"12213","Cochabamba","Capinota","Escuela Apillapampa",7,1,1,0,177,1,6,0,1,194,4,4,202,219,0.912,0.922
"12214","Cochabamba","Capinota","Nucleo Central Hornoma",2,3,0,0,160,0,0,3,1,169,10,14,193,206,0.947,0.937
"12215","Cochabamba","Capinota","Escuela Central Marcavi",3,0,0,0,171,0,3,0,7,184,6,6,196,207,0.929,0.947
"12216","Cochabamba","Capinota","Unidad Educativa Yatamoco",13,1,2,1,158,1,11,2,2,191,9,19,219,238,0.827,0.92
"12217","Cochabamba","Capinota","Unidad Educativa Yatamoco",18,1,0,0,157,4,23,1,1,205,9,8,222,234,0.766,0.949
"12218","Cochabamba","Capinota","U. E. Playa Ancha",9,1,1,0,191,1,13,0,2,218,8,5,231,239,0.876,0.967
"12219","Cochabamba","Santivañez","Escuela Prudencio Arauco (Santivañez)",27,1,1,1,135,4,9,1,0,179,4,3,186,220,0.754,0.845
"12220","Cochabamba","Santivañez","Escuela Prudencio Arauco (Santivañez)",32,0,1,0,133,0,16,0,2,184,2,10,196,225,0.723,0.871
"12221","Cochabamba","Santivañez","Escuela Prudencio Arauco (Santivañez)",20,0,2,1,152,1,21,0,1,198,1,6,205,230,0.768,0.891
"12222","Cochabamba","Santivañez","Escuela Prudencio Arauco (Santivañez)",26,1,1,0,141,2,10,0,1,182,2,10,194,216,0.775,0.898
"12223","Cochabamba","Santivañez","Escuela Prudencio Arauco (Santivañez)",44,0,0,1,135,2,11,0,4,197,4,7,208,229,0.685,0.908
"12224","Cochabamba","Santivañez","Escuela Prudencio Arauco (Santivañez)",23,1,2,0,145,3,18,1,1,194,2,6,202,224,0.747,0.902
"12225","Cochabamba","Santivañez","Escuela Prudencio Arauco (Santivañez)",17,0,2,3,146,1,12,0,0,181,3,6,190,221,0.807,0.86
"12226","Cochabamba","Santivañez","Escuela Prudencio Arauco (Santivañez)",32,0,0,0,133,2,15,1,1,184,5,5,194,221,0.723,0.878
"12227","Cochabamba","Santivañez","Escuela Prudencio Arauco (Santivañez)",25,0,0,1,136,3,14,0,0,179,3,6,188,219,0.76,0.858
"12228","Cochabamba","Santivañez","Escuela Prudencio Arauco (Santivañez)",29,0,0,0,139,0,23,0,0,191,2,5,198,229,0.728,0.865
"12229","Cochabamba","Santivañez","Sede Social Chojtama",27,0,0,0,155,1,13,2,2,200,4,8,212,233,0.775,0.91
"12230","Cochabamba","Santivañez","U. E. Castor Zambrana Huayñacota",10,0,0,0,152,0,8,0,0,170,1,3,174,220,0.894,0.791
"12231","Cochabamba","Santivañez","U. E. Castor Zambrana Huayñacota",10,1,0,0,164,2,6,0,0,183,0,6,189,226,0.896,0.836
"12232","Cochabamba","Santivañez","Unidad Educativa Rocha Rancho",16,1,2,0,145,1,12,1,1,179,6,3,188,215,0.81,0.874
"12233","Cochabamba","Santivañez","Unidad Educativa Rocha Rancho",5,0,0,0,170,2,11,0,1,189,2,6,197,224,0.899,0.879
"12234","Cochabamba","Santivañez","Sub Central Enrique Encinas (Ex Calera)",10,0,0,1,173,2,6,2,2,196,7,3,206,221,0.883,0.932
"12235","Cochabamba","Santivañez","Sub Central Enrique Encinas (Ex Calera)",8,3,2,1,168,2,5,1,0,190,3,8,201,220,0.884,0.914
"12236","Cochabamba","Santivañez","Sub Central Enrique Encinas (Ex Calera)",6,0,1,0,153,0,5,1,0,166,0,1,167,184,0.922,0.908
"12237","Cochabamba","Santivañez","Unidad Educativa Caporaya",3,0,0,2,169,1,7,2,0,184,4,4,192,214,0.918,0.897
"12238","Cochabamba","Santivañez","Unidad Educativa Jose Rivera",30,3,0,0,146,3,9,0,0,191,3,7,201,216,0.764,0.931
"12239","Cochabamba","Sicaya","Nucleo Humanistico Sicaya",8,1,1,3,176,1,8,0,0,198,3,11,212,224,0.889,0.946
"12240","Cochabamba","Sicaya","Nucleo Humanistico Sicaya",5,0,2,0,179,0,10,0,0,196,3,7,206,222,0.913,0.928
"12241","Cochabamba","Sicaya","Nucleo Humanistico Sicaya",1,2,0,0,182,1,4,0,1,191,3,3,197,220,0.953,0.895
"12242","Cochabamba","Sicaya","Nucleo Humanistico Sicaya",2,1,1,0,187,2,6,0,0,199,5,7,211,228,0.94,0.925
"12243","Cochabamba","Sicaya","Nucleo Humanistico Sicaya",8,0,1,0,152,0,4,0,0,165,3,5,173,196,0.921,0.883
"12244","Cochabamba","Sicaya","U. E. Orcoma",12,3,1,0,176,1,4,0,1,198,2,9,209,226,0.889,0.925
"12245","Cochabamba","Sicaya","U. E. Orcoma",10,0,0,0,176,3,1,1,0,191,1,4,196,220,0.921,0.891
"12246","Cochabamba","Sicaya","U. E. Orcoma",8,1,0,0,168,0,3,3,0,183,5,9,197,219,0.918,0.9
"12247","Cochabamba","Cliza","Colegio Juan de Dios Balderrama",36,0,0,1,130,2,8,0,0,177,4,6,187,216,0.734,0.866
"12248","Cochabamba","Cliza","Colegio Juan de Dios Balderrama",29,0,1,0,120,2,14,0,0,166,4,8,178,216,0.723,0.824
"12249","Cochabamba","Cliza","Colegio Juan de Dios Balderrama",40,2,0,0,135,2,7,1,0,187,3,7,197,226,0.722,0.872
"12250","Cochabamba","Cliza","Colegio Juan de Dios Balderrama",33,0,3,1,126,3,13,0,0,179,1,3,183,216,0.704,0.847
"12251","Cochabamba","Cliza","Colegio Juan de Dios Balderrama",29,0,1,0,150,1,11,1,1,194,2,8,204,226,0.773,0.903
"12252","Cochabamba","Cliza","Colegio Juan de Dios Balderrama",39,1,1,0,132,0,14,0,0,187,3,9,199,229,0.706,0.869
"12253","Cochabamba","Cliza","Colegio Juan de Dios Balderrama",54,0,0,1,111,4,9,2,1,182,1,8,191,224,0.61,0.853
"12254","Cochabamba","Cliza","Colegio Juan de Dios Balderrama",53,1,0,1,110,3,14,1,0,183,3,11,197,220,0.601,0.895
"12255","Cochabamba","Cliza","Colegio Juan de Dios Balderrama",45,1,0,0,117,2,12,0,0,177,2,12,191,224,0.661,0.853
"12256","Cochabamba","Cliza","Colegio Juan de Dios Balderrama",37,0,1,0,121,2,15,0,0,176,7,7,190,222,0.688,0.856
"12257","Cochabamba","Cliza","Colegio Juan de Dios Balderrama",42,0,0,0,129,1,13,0,1,186,2,9,197,226,0.694,0.872
"12258","Cochabamba","Cliza","Colegio Juan de Dios Balderrama",31,1,2,0,129,4,11,0,0,178,1,4,183,216,0.725,0.847
"12259","Cochabamba","Cliza","Colegio Juan de Dios Balderrama",22,1,3,0,139,1,14,0,1,181,3,3,187,229,0.768,0.817
"12260","Cochabamba","Cliza","Colegio Juan de Dios Balderrama",27,0,0,0,158,1,16,0,1,203,2,4,209,232,0.778,0.901
"12261","Cochabamba","Cliza","Colegio Juan de Dios Balderrama",48,0,0,0,102,5,11,1,0,167,2,6,175,213,0.611,0.822
"12262","Cochabamba","Cliza","Colegio Juan de Dios Balderrama",33,0,0,1,132,4,15,0,1,186,1,4,191,224,0.71,0.853
"12263","Cochabamba","Cliza","Colegio Juan de Dios Balderrama",46,0,0,0,130,0,6,0,1,183,3,4,190,226,0.71,0.841
"12264","Cochabamba","Cliza","Colegio Juan de Dios Balderrama",30,1,0,0,139,4,9,0,0,183,5,3,191,225,0.76,0.849
"12265","Cochabamba","Cliza","Colegio Juan de Dios Balderrama",51,0,0,0,120,3,21,0,1,196,2,11,209,234,0.612,0.893
"12266","Cochabamba","Cliza","Colegio Juan de Dios Balderrama",37,0,0,0,127,1,18,0,0,183,5,7,195,220,0.694,0.886
"12267","Cochabamba","Cliza","Colegio Juan de Dios Balderrama",38,0,1,0,131,4,6,0,3,183,0,6,189,219,0.716,0.863
"12268","Cochabamba","Cliza","Colegio Juan de Dios Balderrama",39,0,1,1,120,6,11,0,0,178,3,7,188,221,0.674,0.851
"12269","Cochabamba","Cliza","Colegio Juan de Dios Balderrama",39,1,0,0,126,7,8,1,1,183,0,9,192,221,0.689,0.869
"12270","Cochabamba","Cliza","Colegio Juan de Dios Balderrama",43,1,0,0,127,5,8,0,1,185,2,1,188,216,0.686,0.87
"12271","Cochabamba","Cliza","Colegio Juan de Dios Balderrama",46,1,0,0,133,2,10,0,0,192,1,9,202,224,0.693,0.902
"12272","Cochabamba","Cliza","Colegio Juan de Dios Balderrama",37,2,0,1,112,2,22,0,0,176,4,7,187,217,0.636,0.862
"12273","Cochabamba","Cliza","Colegio Juan de Dios Balderrama",52,0,0,0,114,5,11,0,0,182,1,5,188,223,0.626,0.843
"12274","Cochabamba","Cliza","Colegio Juan de Dios Balderrama",32,3,3,0,123,1,21,0,0,183,2,2,187,221,0.672,0.846
"12275","Cochabamba","Cliza","Escuela Sucre",40,0,1,1,120,3,8,1,0,174,4,9,187,220,0.69,0.85
"12276","Cochabamba","Cliza","Escuela Sucre",41,1,0,0,122,4,9,0,2,179,3,4,186,225,0.682,0.827
"12277","Cochabamba","Cliza","Escuela Sucre",22,0,0,0,143,4,11,0,1,181,3,6,190,225,0.79,0.844
"12278","Cochabamba","Cliza","Escuela Sucre",22,1,0,0,147,3,8,0,0,181,4,2,187,223,0.812,0.839
"12279","Cochabamba","Cliza","Escuela Sucre",43,0,0,0,110,2,10,0,1,166,4,8,178,220,0.663,0.809
"12280","Cochabamba","Cliza","Escuela Sucre",38,1,1,0,137,1,9,0,1,188,3,4,195,226,0.729,0.863
"12281","Cochabamba","Cliza","Escuela Sucre",32,1,0,0,140,3,9,0,1,186,0,7,193,222,0.753,0.869
"12282","Cochabamba","Cliza","Escuela Sucre",37,2,0,1,115,1,15,0,1,172,3,6,181,223,0.669,0.812
"12283","Cochabamba","Cliza","Escuela Sucre",22,0,1,0,142,5,10,2,1,183,2,7,192,222,0.776,0.865
"12284","Cochabamba","Cliza","Escuela Sucre",41,1,0,1,112,1,13,0,3,172,2,12,186,223,0.651,0.834
"12285","Cochabamba","Cliza","Escuela Sucre",25,0,0,0,118,0,15,1,1,160,2,6,168,215,0.738,0.781
"12286","Cochabamba","Cliza","Escuela Sucre",27,1,1,4,124,1,12,0,2,172,0,7,179,215,0.721,0.833
"12287","Cochabamba","Cliza","Escuela Sucre",32,0,0,0,131,4,11,0,0,178,4,8,190,222,0.736,0.856
"12288","Cochabamba","Cliza","Escuela Sucre",44,0,2,0,121,0,10,0,0,177,1,10,188,218,0.684,0.862
"12289","Cochabamba","Cliza","Escuela Sucre",33,1,1,0,119,4,7,1,0,166,4,8,178,214,0.717,0.832
"12290","Cochabamba","Cliza","Escuela Sucre",30,0,0,2,134,2,11,0,3,182,2,5,189,226,0.736,0.836
"12291","Cochabamba","Cliza","Escuela Sucre",39,0,1,0,120,3,7,0,4,174,4,2,180,220,0.69,0.818
"12292","Cochabamba","Cliza","Escuela Sucre",46,0,0,0,127,0,10,0,1,184,1,3,188,217,0.69,0.866
"12293","Cochabamba","Cliza","Escuela Sucre",45,1,0,1,128,4,10,0,1,190,2,4,196,227,0.674,0.863
"12294","Cochabamba","Cliza","Unidad Educativa Chullpas",6,0,1,1,162,2,5,0,1,178,1,10,189,217,0.91,0.871
"12295","Cochabamba","Cliza","Unidad Educativa Chullpas",13,0,0,0,146,2,4,1,2,168,7,10,185,211,0.869,0.877
"12296","Cochabamba","Cliza","Unidad Educativa Chullpas",22,0,0,0,136,0,7,0,0,165,5,7,177,202,0.824,0.876
"12297","Cochabamba","Cliza","Unidad Educativa Huasacalle",11,0,0,1,166,1,11,0,1,191,3,12,206,224,0.869,0.92
"12298","Cochabamba","Cliza","Unidad Educativa Huasacalle",19,3,1,1,158,5,5,0,2,194,2,4,200,222,0.814,0.901
"12299","Cochabamba","Cliza","Unidad Educativa Huasacalle",28,0,1,0,166,2,4,0,0,201,2,2,205,223,0.826,0.919
"12300","Cochabamba","Cliza","Colegio Nacional Mixto Ucureña",37,0,0,0,138,1,10,2,3,191,4,9,204,218,0.723,0.936
"12301","Cochabamba","Cliza","Colegio Nacional Mixto Ucureña",44,1,0,1,127,6,11,0,1,191,4,3,198,223,0.665,0.888
"12302","Cochabamba","Cliza","Colegio Nacional Mixto Ucureña",25,0,0,0,163,4,8,0,0,200,0,3,203,227,0.815,0.894
"12303","Cochabamba","Cliza","Colegio Nacional Mixto Ucureña",32,0,1,0,147,3,9,0,2,194,1,2,197,218,0.758,0.904
"12304","Cochabamba","Cliza","Colegio Nacional Mixto Ucureña",23,0,0,0,146,1,7,0,1,178,6,9,193,221,0.82,0.873
"12305","Cochabamba","Cliza","Colegio Nacional Mixto Ucureña",38,1,1,1,150,1,5,0,2,199,17,7,223,223,0.754,1
"12306","Cochabamba","Cliza","Colegio Nacional Mixto Ucureña",23,0,0,2,151,6,14,0,0,196,1,2,199,225,0.77,0.884
"12307","Cochabamba","Cliza","Colegio Nacional Mixto Ucureña",21,0,2,1,150,2,9,0,2,187,1,10,198,221,0.802,0.896
"12308","Cochabamba","Cliza","Colegio Nacional Mixto Ucureña",40,0,1,0,130,1,13,0,1,186,2,9,197,226,0.699,0.872
"12309","Cochabamba","Cliza","Colegio Nacional Mixto Ucureña",41,0,1,0,135,2,7,0,0,186,0,6,192,214,0.726,0.897
"12310","Cochabamba","Cliza","Colegio Nacional Mixto Ucureña",29,1,1,1,150,1,6,0,0,189,0,7,196,220,0.794,0.891
"12311","Cochabamba","Cliza","Unidad Educativa Santa Lucia",26,1,0,1,132,0,6,1,2,169,8,5,182,216,0.781,0.843
"12312","Cochabamba","Cliza","Unidad Educativa Santa Lucia",19,1,0,0,121,2,11,1,3,158,2,5,165,218,0.766,0.757
"12313","Cochabamba","Cliza","Escuela San Isidro",16,1,0,1,140,2,6,1,1,168,5,3,176,218,0.833,0.807
"12314","Cochabamba","Cliza","Escuela San Isidro",8,0,0,0,140,1,3,0,0,152,3,6,161,217,0.921,0.742
"12315","Cochabamba","Toco","Colegio Ambrosini",15,0,2,0,146,2,6,0,0,171,4,5,180,220,0.854,0.818
"12316","Cochabamba","Toco","Colegio Ambrosini",22,0,0,0,142,0,0,0,1,165,5,5,175,213,0.861,0.822
"12317","Cochabamba","Toco","Colegio Ambrosini",14,0,0,0,150,1,1,0,1,167,6,2,175,214,0.898,0.818
"12318","Cochabamba","Toco","Colegio Ambrosini",22,1,0,0,140,1,5,0,0,169,0,10,179,215,0.828,0.833
"12319","Cochabamba","Toco","Colegio Ambrosini",14,0,0,1,129,2,6,1,0,153,3,13,169,210,0.843,0.805
"12320","Cochabamba","Toco","Colegio Ambrosini",15,0,0,0,143,2,6,0,0,166,3,6,175,214,0.861,0.818
"12321","Cochabamba","Toco","Colegio Ambrosini",15,0,0,0,138,2,4,0,0,159,3,5,167,206,0.868,0.811
"12322","Cochabamba","Toco","Colegio Ambrosini",9,0,0,0,158,0,3,0,0,170,3,4,177,218,0.929,0.812
"12323","Cochabamba","Toco","Colegio Ambrosini",10,1,1,0,131,2,6,1,0,152,6,5,163,215,0.862,0.758
"12324","Cochabamba","Toco","Colegio Ambrosini",13,0,0,0,135,1,5,1,1,156,4,4,164,208,0.865,0.788
"12325","Cochabamba","Toco","Colegio Ambrosini",16,1,0,1,137,0,4,0,0,159,4,6,169,211,0.862,0.801
"12326","Cochabamba","Toco","Unidad Educativa Siches",3,1,1,0,168,1,5,2,1,182,8,3,193,216,0.923,0.894
"12327","Cochabamba","Toco","U.E. Ana Rancho",11,1,0,0,187,2,8,0,2,211,4,8,223,235,0.886,0.949
"12328","Cochabamba","Toco","U.E. Ana Rancho",9,1,1,0,171,0,4,0,0,186,5,5,196,209,0.919,0.938
"12329","Cochabamba","Toco","U.E. Chullpa Loma",16,1,0,1,178,2,3,0,1,202,7,4,213,233,0.881,0.914
"12330","Cochabamba","Tolata","Colegio Victor Rosales",35,0,3,1,105,2,19,0,2,167,5,9,181,223,0.629,0.812
"12331","Cochabamba","Tolata","Colegio Victor Rosales",25,1,1,0,113,3,16,0,5,164,3,6,173,220,0.689,0.786
"12332","Cochabamba","Tolata","Colegio Victor Rosales",22,1,0,0,141,3,13,0,1,181,4,8,193,226,0.779,0.854
"12333","Cochabamba","Tolata","Colegio Victor Rosales",33,1,1,0,127,2,10,0,1,175,1,3,179,221,0.726,0.81
"12334","Cochabamba","Tolata","Colegio Victor Rosales",32,0,0,1,112,2,15,0,1,163,1,9,173,218,0.687,0.794
"12335","Cochabamba","Tolata","Colegio Victor Rosales",23,0,0,0,135,1,10,1,1,171,3,17,191,228,0.789,0.838
"12336","Cochabamba","Tolata","Colegio Victor Rosales",30,2,0,0,135,1,11,0,1,180,3,6,189,223,0.75,0.848
"12337","Cochabamba","Tolata","Colegio Victor Rosales",24,1,0,0,131,3,16,0,1,176,2,5,183,226,0.744,0.81
"12338","Cochabamba","Tolata","Colegio Victor Rosales",31,1,0,0,133,5,5,1,0,176,0,0,176,218,0.756,0.807
"12339","Cochabamba","Tolata","Colegio Victor Rosales",15,0,0,0,127,4,12,0,1,159,3,5,167,216,0.799,0.773
"12340","Cochabamba","Tolata","Escuela Santa Maria (Carcaje)",47,2,2,1,103,5,20,0,2,182,3,4,189,231,0.566,0.818
"12341","Cochabamba","Tolata","Escuela Santa Maria (Carcaje)",31,2,0,1,121,4,17,0,0,176,1,5,182,232,0.688,0.784
"12342","Cochabamba","Tolata","Escuela Santa Maria (Carcaje)",22,0,2,2,134,3,16,0,1,180,4,8,192,230,0.744,0.835
"12343","Cochabamba","Tolata","Escuela Santa Maria (Carcaje)",41,1,0,0,126,4,13,1,0,186,3,9,198,230,0.677,0.861
"12344","Cochabamba","Tolata","Escuela Santa Maria (Carcaje)",44,1,2,0,117,2,13,0,1,180,1,4,185,233,0.65,0.794
"12345","Cochabamba","Tolata","Escuela Santa Maria (Carcaje)",40,1,1,1,108,2,24,1,1,179,5,4,188,235,0.603,0.8
"12346","Cochabamba","Tolata","Escuela Santa Maria (Carcaje)",31,0,0,0,120,2,13,0,1,167,2,10,179,233,0.719,0.768
"12347","Cochabamba","Tolata","Escuela Santa Maria (Carcaje)",33,1,2,0,127,1,12,0,0,176,1,4,181,227,0.722,0.797
"12348","Cochabamba","Tolata","Escuela Santa Maria (Carcaje)",52,1,1,0,100,6,11,2,3,176,5,6,187,224,0.568,0.835
"12349","Cochabamba","Tolata","Escuela Santa Maria (Carcaje)",41,1,0,0,111,4,15,0,0,172,3,11,186,229,0.645,0.812
"12350","Cochabamba","Tolata","Escuela Santa Maria (Carcaje)",25,1,1,0,106,4,19,0,2,158,1,6,165,209,0.671,0.789
"12351","Cochabamba","Quillacollo","U.E. 21 de Septiembre",119,0,0,0,75,4,18,1,2,219,0,5,224,239,0.342,0.937
"12352","Cochabamba","Quillacollo","U.E. 21 de Septiembre",96,1,0,0,89,5,24,0,0,215,3,9,227,239,0.414,0.95
"12353","Cochabamba","Quillacollo","U.E. 21 de Septiembre",113,0,0,0,87,3,14,0,3,220,0,10,230,240,0.395,0.958
"12354","Cochabamba","Quillacollo","U.E. 21 de Septiembre",94,0,1,1,87,5,24,0,3,215,0,6,221,238,0.405,0.929
"12355","Cochabamba","Quillacollo","U.E. 21 de Septiembre",92,1,4,1,75,5,18,0,1,197,3,7,207,239,0.381,0.866
"12356","Cochabamba","Quillacollo","U.E. 21 de Septiembre",108,2,3,0,83,4,16,1,1,218,0,9,227,239,0.381,0.95
"12357","Cochabamba","Quillacollo","U.E. 21 de Septiembre",107,1,3,1,82,4,18,1,0,217,1,6,224,237,0.378,0.945
"12358","Cochabamba","Quillacollo","U.E. 1ro. de Mayo",78,0,1,1,103,5,24,0,4,216,1,6,223,238,0.477,0.937
"12359","Cochabamba","Quillacollo","U.E. 1ro. de Mayo",112,0,1,1,79,7,20,1,1,222,1,10,233,238,0.356,0.979
"12360","Cochabamba","Quillacollo","U.E. 12 de Enero B",67,0,0,1,109,5,33,0,1,216,2,6,224,240,0.505,0.933
"12361","Cochabamba","Quillacollo","U.E. 12 de Enero B",82,1,0,1,108,4,27,0,4,227,2,3,232,240,0.476,0.967
"12362","Cochabamba","Quillacollo","U.E. 12 de Enero B",82,0,2,1,102,12,23,2,2,226,1,2,229,239,0.451,0.958
"12363","Cochabamba","Quillacollo","U.E. Villa Asunción",69,1,3,2,128,7,11,0,3,224,1,6,231,238,0.571,0.971
"12364","Cochabamba","Quillacollo","U.E. Villa Asunción",73,2,4,1,107,7,17,1,2,214,6,10,230,235,0.5,0.979
"12365","Cochabamba","Quillacollo","Teofilo Vargas Candia B",78,1,0,1,77,4,18,0,3,182,2,12,196,225,0.423,0.871
"12366","Cochabamba","Quillacollo","Teofilo Vargas Candia B",78,0,0,0,84,5,23,0,2,192,0,10,202,226,0.438,0.894
"12367","Cochabamba","Quillacollo","Teofilo Vargas Candia B",95,2,1,1,78,6,18,0,3,204,2,5,211,232,0.382,0.909
"12368","Cochabamba","Quillacollo","Teofilo Vargas Candia B",104,2,0,1,71,6,12,0,3,199,2,7,208,230,0.357,0.904
"12369","Cochabamba","Quillacollo","Teofilo Vargas Candia B",77,1,2,1,84,5,22,0,0,192,0,15,207,230,0.438,0.9
"12370","Cochabamba","Quillacollo","Teofilo Vargas Candia B",96,4,4,2,69,5,18,1,2,201,1,7,209,230,0.343,0.909
"12371","Cochabamba","Quillacollo","Teofilo Vargas Candia B",100,1,1,2,79,1,10,1,0,195,1,5,201,227,0.405,0.885
"12372","Cochabamba","Quillacollo","Teofilo Vargas Candia B",87,0,1,3,89,3,9,0,2,194,0,13,207,231,0.459,0.896
"12373","Cochabamba","Quillacollo","Teofilo Vargas Candia B",98,0,0,1,79,5,15,0,1,199,1,4,204,231,0.397,0.883
"12374","Cochabamba","Quillacollo","Teofilo Vargas Candia B",101,1,0,2,70,3,15,1,0,193,4,12,209,229,0.363,0.913
"12375","Cochabamba","Quillacollo","Teofilo Vargas Candia B",77,0,1,0,92,4,17,0,4,195,2,8,205,226,0.472,0.907
"12376","Cochabamba","Quillacollo","Teofilo Vargas Candia B",106,1,2,1,72,7,20,0,1,210,1,6,217,231,0.343,0.939
"12377","Cochabamba","Quillacollo","Teofilo Vargas Candia B",97,1,2,0,71,4,17,0,4,196,1,7,204,231,0.362,0.883
"12378","Cochabamba","Quillacollo","Teofilo Vargas Candia B",101,0,2,0,79,4,13,1,1,201,3,3,207,229,0.393,0.904
"12379","Cochabamba","Quillacollo","Teofilo Vargas Candia B",91,3,2,0,74,2,19,1,1,193,3,11,207,224,0.383,0.924
"12380","Cochabamba","Quillacollo","Teofilo Vargas Candia B",75,3,0,1,81,3,25,0,0,188,3,12,203,226,0.431,0.898
"12381","Cochabamba","Quillacollo","Teofilo Vargas Candia B",94,1,2,1,82,6,15,1,2,204,0,4,208,224,0.402,0.929
"12382","Cochabamba","Quillacollo","Teofilo Vargas Candia B",80,1,2,0,75,8,14,0,1,181,1,23,205,224,0.414,0.915
"12383","Cochabamba","Quillacollo","Teofilo Vargas Candia B",112,2,1,1,63,2,20,0,1,202,1,7,210,231,0.312,0.909
"12384","Cochabamba","Quillacollo","Teofilo Vargas Candia B",94,0,0,0,79,7,15,1,3,199,1,8,208,232,0.397,0.897
"12385","Cochabamba","Quillacollo","Teofilo Vargas Candia B",98,0,2,0,77,4,15,0,0,196,0,8,204,228,0.393,0.895
"12386","Cochabamba","Quillacollo","Unidad Educativa Nestor Adriazola (Ex Colegio Nacional Calama)",95,0,1,0,80,5,20,0,1,202,0,8,210,227,0.396,0.925
"12387","Cochabamba","Quillacollo","Unidad Educativa Nestor Adriazola (Ex Colegio Nacional Calama)",90,1,1,0,81,5,17,0,4,199,4,0,203,228,0.407,0.89
"12388","Cochabamba","Quillacollo","Unidad Educativa Nestor Adriazola (Ex Colegio Nacional Calama)",76,0,2,1,92,4,17,1,0,193,1,13,207,225,0.477,0.92
"12389","Cochabamba","Quillacollo","Unidad Educativa Nestor Adriazola (Ex Colegio Nacional Calama)",90,0,0,0,83,5,20,0,1,199,3,9,211,230,0.417,0.917
"12390","Cochabamba","Quillacollo","Unidad Educativa Nestor Adriazola (Ex Colegio Nacional Calama)",80,0,2,0,90,5,21,0,3,201,4,7,212,231,0.448,0.918
"12391","Cochabamba","Quillacollo","Unidad Educativa Nestor Adriazola (Ex Colegio Nacional Calama)",93,0,0,1,88,2,20,0,2,206,2,4,212,229,0.427,0.926
"12392","Cochabamba","Quillacollo","Unidad Educativa Nestor Adriazola (Ex Colegio Nacional Calama)",67,1,2,0,102,2,21,1,1,197,2,11,210,226,0.518,0.929
"12393","Cochabamba","Quillacollo","Unidad Educativa Nestor Adriazola (Ex Colegio Nacional Calama)",70,1,1,3,101,5,19,0,0,200,2,5,207,232,0.505,0.892
"12394","Cochabamba","Quillacollo","Unidad Educativa Nestor Adriazola (Ex Colegio Nacional Calama)",59,1,0,3,95,5,30,0,1,194,2,3,199,225,0.49,0.884
"12395","Cochabamba","Quillacollo","Unidad Educativa Nestor Adriazola (Ex Colegio Nacional Calama)",99,1,1,0,86,4,12,0,0,203,2,4,209,231,0.424,0.905
"12396","Cochabamba","Quillacollo","Unidad Educativa Nestor Adriazola (Ex Colegio Nacional Calama)",73,1,0,0,83,4,25,0,2,188,3,10,201,222,0.441,0.905
"12397","Cochabamba","Quillacollo","Unidad Educativa Nestor Adriazola (Ex Colegio Nacional Calama)",75,2,1,1,90,7,23,0,2,201,3,7,211,233,0.448,0.906
"12398","Cochabamba","Quillacollo","Unidad Educativa Nestor Adriazola (Ex Colegio Nacional Calama)",101,1,0,1,69,3,20,0,2,197,2,7,206,230,0.35,0.896
"12399","Cochabamba","Quillacollo","Unidad Educativa Nestor Adriazola (Ex Colegio Nacional Calama)",93,1,1,0,72,3,26,1,0,197,0,4,201,227,0.365,0.885
"12400","Cochabamba","Quillacollo","Unidad Educativa Nestor Adriazola (Ex Colegio Nacional Calama)",63,0,4,0,100,2,26,0,3,198,1,7,206,228,0.505,0.904
"12401","Cochabamba","Quillacollo","Unidad Educativa Nestor Adriazola (Ex Colegio Nacional Calama)",80,3,2,1,90,1,15,1,0,193,1,9,203,225,0.466,0.902
"12402","Cochabamba","Quillacollo","Unidad Educativa Nestor Adriazola (Ex Colegio Nacional Calama)",90,0,2,0,83,1,18,0,1,195,3,8,206,228,0.426,0.904
"12403","Cochabamba","Quillacollo","Unidad Educativa Nestor Adriazola (Ex Colegio Nacional Calama)",58,0,0,0,108,6,23,0,0,195,1,4,200,221,0.554,0.905
"12404","Cochabamba","Quillacollo","Unidad Educativa Nestor Adriazola (Ex Colegio Nacional Calama)",62,1,1,1,89,2,29,0,2,187,1,11,199,225,0.476,0.884
"12405","Cochabamba","Quillacollo","Unidad Educativa Nestor Adriazola (Ex Colegio Nacional Calama)",84,1,0,0,80,1,24,1,0,191,4,8,203,229,0.419,0.886
"12406","Cochabamba","Quillacollo","Unidad Educativa Nestor Adriazola (Ex Colegio Nacional Calama)",85,1,2,2,79,6,16,2,0,193,3,8,204,229,0.409,0.891
"12407","Cochabamba","Quillacollo","Unidad Educativa Nestor Adriazola (Ex Colegio Nacional Calama)",72,0,1,1,89,2,23,0,4,192,1,5,198,221,0.464,0.896
"12408","Cochabamba","Quillacollo","Unidad Educativa Nestor Adriazola (Ex Colegio Nacional Calama)",74,0,1,0,91,4,28,0,0,198,0,4,202,225,0.46,0.898
"12409","Cochabamba","Quillacollo","Unidad Educativa Nestor Adriazola (Ex Colegio Nacional Calama)",108,0,0,0,77,0,16,0,1,202,1,5,208,229,0.381,0.908
"12410","Cochabamba","Quillacollo","Unidad Educativa Nestor Adriazola (Ex Colegio Nacional Calama)",70,0,1,1,101,4,28,0,2,207,1,6,214,231,0.488,0.926
"12411","Cochabamba","Quillacollo","Unidad Educativa Nestor Adriazola (Ex Colegio Nacional Calama)",60,1,1,1,109,3,26,0,2,203,0,8,211,229,0.537,0.921
"12412","Cochabamba","Quillacollo","Unidad Educativa Nestor Adriazola (Ex Colegio Nacional Calama)",85,0,1,4,79,6,27,0,1,203,1,10,214,230,0.389,0.93
"12413","Cochabamba","Quillacollo","Unidad Educativa Nestor Adriazola (Ex Colegio Nacional Calama)",72,1,0,0,88,4,22,0,0,187,3,7,197,228,0.471,0.864
"12414","Cochabamba","Quillacollo","Unidad Educativa Nestor Adriazola (Ex Colegio Nacional Calama)",86,1,0,1,80,4,24,0,1,197,2,1,200,226,0.406,0.885
"12415","Cochabamba","Quillacollo","Unidad Educativa Nestor Adriazola (Ex Colegio Nacional Calama)",80,0,0,0,94,4,14,0,3,195,2,6,203,227,0.482,0.894
"12416","Cochabamba","Quillacollo","Unidad Educativa Nestor Adriazola (Ex Colegio Nacional Calama)",79,3,1,0,94,0,19,0,4,200,2,8,210,230,0.47,0.913
"12417","Cochabamba","Quillacollo","Unidad Educativa Nestor Adriazola (Ex Colegio Nacional Calama)",71,2,0,0,76,3,21,1,2,176,1,11,188,219,0.432,0.858
"12418","Cochabamba","Quillacollo","Unidad Educativa Nestor Adriazola (Ex Colegio Nacional Calama)",68,1,1,0,88,4,29,0,0,191,2,10,203,224,0.461,0.906
"12419","Cochabamba","Quillacollo","Unidad Educativa Nestor Adriazola (Ex Colegio Nacional Calama)",88,0,2,0,89,1,18,0,0,198,1,4,203,226,0.449,0.898
"12420","Cochabamba","Quillacollo","Unidad Educativa Villa Moderna",66,0,0,1,100,6,31,0,1,205,2,1,208,235,0.488,0.885
"12421","Cochabamba","Quillacollo","Unidad Educativa Villa Moderna",73,2,1,0,93,5,29,0,0,203,1,8,212,235,0.458,0.902
"12422","Cochabamba","Quillacollo","Unidad Educativa Villa Moderna",84,1,0,1,95,4,30,0,1,216,0,4,220,239,0.44,0.921
"12423","Cochabamba","Quillacollo","Unidad Educativa Villa Moderna",63,2,0,0,124,3,24,0,0,216,4,3,223,239,0.574,0.933
"12424","Cochabamba","Quillacollo","Unidad Educativa Villa Moderna",52,0,3,1,111,5,33,0,5,210,0,4,214,238,0.529,0.899
"12425","Cochabamba","Quillacollo","Unidad Educativa Villa Moderna",67,1,1,1,86,5,31,0,1,193,1,5,199,234,0.446,0.85
"12426","Cochabamba","Quillacollo","Unidad Educativa Villa Moderna",70,0,1,0,99,2,30,0,2,204,3,5,212,237,0.485,0.895
"12427","Cochabamba","Quillacollo","Unidad Educativa Villa Moderna",74,1,1,0,104,5,24,0,2,211,0,8,219,239,0.493,0.916
"12428","Cochabamba","Quillacollo","Unidad Educativa Villa Moderna",68,0,1,1,90,10,27,0,3,200,2,8,210,237,0.45,0.886
"12429","Cochabamba","Quillacollo","Unidad Educativa Villa Moderna",42,0,1,1,119,9,24,0,2,198,0,9,207,235,0.601,0.881
"12430","Cochabamba","Quillacollo","Unidad Educativa Villa Moderna",77,0,4,0,97,2,21,0,0,201,3,11,215,235,0.483,0.915
"12431","Cochabamba","Quillacollo","Unidad Educativa Villa Moderna",97,0,0,0,90,5,15,0,2,209,0,6,215,237,0.431,0.907
"12432","Cochabamba","Quillacollo","Unidad Educativa Villa Moderna",74,0,3,1,93,4,28,0,1,204,2,7,213,237,0.456,0.899
"12433","Cochabamba","Quillacollo","Unidad Educativa Villa Moderna",62,2,0,1,111,0,26,1,2,205,2,9,216,237,0.541,0.911
"12434","Cochabamba","Quillacollo","Unidad Educativa Villa Moderna",71,1,1,0,102,2,23,0,2,202,1,5,208,234,0.505,0.889
"12435","Cochabamba","Quillacollo","Unidad Educativa Villa Moderna",81,1,1,1,86,6,20,0,0,196,1,9,206,238,0.439,0.866
"12436","Cochabamba","Quillacollo","Unidad Educativa Villa Moderna",83,0,2,0,98,6,12,1,1,203,1,7,211,236,0.483,0.894
"12437","Cochabamba","Quillacollo","Unidad Educativa Villa Moderna",67,0,1,0,93,3,39,0,3,206,2,4,212,233,0.451,0.91
"12438","Cochabamba","Quillacollo","Colegio Franz Tamayo",107,0,2,0,68,4,13,0,2,196,1,4,201,226,0.347,0.889
"12439","Cochabamba","Quillacollo","Colegio Franz Tamayo",94,1,3,1,67,7,8,1,3,185,1,11,197,222,0.362,0.887
"12440","Cochabamba","Quillacollo","Colegio Franz Tamayo",111,1,2,0,67,3,10,1,2,197,0,3,200,223,0.34,0.897
"12441","Cochabamba","Quillacollo","Colegio Franz Tamayo",92,2,2,6,74,1,14,1,4,196,2,1,199,225,0.378,0.884
"12442","Cochabamba","Quillacollo","Colegio Franz Tamayo",89,0,2,0,74,4,22,0,1,192,0,8,200,225,0.385,0.889
"12443","Cochabamba","Quillacollo","Colegio Franz Tamayo",74,0,1,1,98,5,17,0,2,198,0,5,203,231,0.495,0.879
"12444","Cochabamba","Quillacollo","Colegio Franz Tamayo",106,0,1,2,67,6,17,0,2,201,0,5,206,226,0.333,0.912
"12445","Cochabamba","Quillacollo","Colegio Franz Tamayo",105,0,1,2,75,4,7,0,0,194,1,8,203,227,0.387,0.894
"12446","Cochabamba","Quillacollo","Colegio Franz Tamayo",103,2,1,0,71,5,16,0,1,199,2,5,206,225,0.357,0.916
"12447","Cochabamba","Quillacollo","Colegio Franz Tamayo",118,0,0,2,67,3,9,0,2,201,1,8,210,233,0.333,0.901
"12448","Cochabamba","Quillacollo","Colegio Franz Tamayo",93,1,1,0,93,3,10,0,0,201,1,5,207,231,0.463,0.896
"12449","Cochabamba","Quillacollo","Colegio Franz Tamayo",88,0,0,3,87,2,12,0,2,194,3,4,201,221,0.448,0.91
"12450","Cochabamba","Quillacollo","Colegio Franz Tamayo",85,1,1,2,96,3,16,0,1,205,3,3,211,234,0.468,0.902
"12451","Cochabamba","Quillacollo","Colegio Franz Tamayo",129,2,0,0,59,6,9,1,2,208,0,5,213,230,0.284,0.926
"12452","Cochabamba","Quillacollo","Colegio Franz Tamayo",118,1,0,0,69,3,13,0,0,204,1,6,211,230,0.338,0.917
"12453","Cochabamba","Quillacollo","Colegio Franz Tamayo",108,0,0,0,67,2,15,0,0,192,4,6,202,224,0.349,0.902
"12454","Cochabamba","Quillacollo","Colegio Franz Tamayo",104,0,0,1,74,3,11,1,0,194,3,3,200,226,0.381,0.885
"12455","Cochabamba","Quillacollo","Colegio Franz Tamayo",97,0,0,0,75,4,14,0,2,192,2,6,200,227,0.391,0.881
"12456","Cochabamba","Quillacollo","Colegio Franz Tamayo",96,0,0,0,78,2,14,1,1,192,3,10,205,227,0.406,0.903
"12457","Cochabamba","Quillacollo","Colegio Franz Tamayo",102,1,1,1,68,7,6,0,2,188,0,8,196,223,0.362,0.879
"12458","Cochabamba","Quillacollo","Colegio Franz Tamayo",113,0,0,0,58,3,19,2,1,196,2,9,207,229,0.296,0.904
"12459","Cochabamba","Quillacollo","Colegio Franz Tamayo",85,1,0,1,74,7,14,1,2,185,1,9,195,224,0.4,0.871
"12460","Cochabamba","Quillacollo","Colegio Franz Tamayo",100,0,0,1,68,4,11,0,0,184,1,3,188,222,0.37,0.847
"12461","Cochabamba","Quillacollo","Colegio Franz Tamayo",107,0,0,0,83,7,10,0,4,211,0,0,211,235,0.393,0.898
"12462","Cochabamba","Quillacollo","Colegio Cristina Prada",113,0,0,0,75,8,10,1,2,209,1,3,213,230,0.359,0.926
"12463","Cochabamba","Quillacollo","Colegio Cristina Prada",118,0,2,1,66,0,12,0,0,199,0,8,207,228,0.332,0.908
"12464","Cochabamba","Quillacollo","Colegio Cristina Prada",109,0,0,0,77,2,15,1,4,208,1,5,214,230,0.37,0.93
"12465","Cochabamba","Quillacollo","Colegio Cristina Prada",100,0,0,1,71,6,15,0,1,194,1,4,199,227,0.366,0.877
"12466","Cochabamba","Quillacollo","Colegio Cristina Prada",119,2,1,1,67,3,7,1,1,202,1,6,209,232,0.332,0.901
"12467","Cochabamba","Quillacollo","Colegio Cristina Prada",116,0,0,1,59,7,11,1,2,197,1,5,203,220,0.299,0.923
"12468","Cochabamba","Quillacollo","Colegio Cristina Prada",93,2,1,1,86,3,16,0,1,203,2,8,213,227,0.424,0.938
"12469","Cochabamba","Quillacollo","Colegio Cristina Prada",99,2,0,2,68,4,20,0,0,195,0,8,203,225,0.349,0.902
"12470","Cochabamba","Quillacollo","Colegio Cristina Prada",112,2,1,1,58,3,13,0,2,192,2,8,202,220,0.302,0.918
"12471","Cochabamba","Quillacollo","Colegio Cristina Prada",111,0,1,1,68,3,14,1,1,200,2,5,207,232,0.34,0.892
"12472","Cochabamba","Quillacollo","Colegio Cristina Prada",136,1,1,0,51,4,12,0,1,206,0,6,212,230,0.248,0.922
"12473","Cochabamba","Quillacollo","Colegio Cristina Prada",134,0,0,1,61,1,7,0,2,206,1,3,210,222,0.296,0.946
"12474","Cochabamba","Quillacollo","Colegio Cristina Prada",125,1,0,0,57,5,10,0,0,198,1,4,203,224,0.288,0.906
"12475","Cochabamba","Quillacollo","Escuela Arturo Quitón",53,1,0,1,119,3,18,0,5,200,5,13,218,230,0.595,0.948
"12476","Cochabamba","Quillacollo","Escuela Arturo Quitón",49,3,1,0,124,4,20,0,2,203,1,9,213,233,0.611,0.914
"12477","Cochabamba","Quillacollo","Escuela Arturo Quitón",63,1,2,2,111,3,21,0,2,205,1,1,207,224,0.541,0.924
"12478","Cochabamba","Quillacollo","Escuela Arturo Quitón",52,2,1,0,98,4,28,0,0,185,7,17,209,232,0.53,0.901
"12479","Cochabamba","Quillacollo","Escuela Arturo Quitón",36,0,3,2,132,8,23,0,3,207,1,8,216,235,0.638,0.919
"12480","Cochabamba","Quillacollo","Escuela Arturo Quitón",51,0,1,1,125,2,17,0,2,199,2,2,203,229,0.628,0.886
"12481","Cochabamba","Quillacollo","Escuela Arturo Quitón",51,1,0,0,121,1,24,0,1,199,2,9,210,229,0.608,0.917
"12482","Cochabamba","Quillacollo","Escuela Arturo Quitón",51,0,0,2,122,4,14,0,1,194,1,12,207,224,0.629,0.924
"12483","Cochabamba","Quillacollo","Escuela Arturo Quitón",55,1,2,0,110,1,25,0,3,197,2,6,205,228,0.558,0.899
"12484","Cochabamba","Quillacollo","Escuela Arturo Quitón",47,0,1,1,124,3,18,0,4,198,4,6,208,229,0.626,0.908
"12485","Cochabamba","Quillacollo","Escuela Arturo Quitón",32,0,5,1,127,3,28,2,0,198,4,3,205,234,0.641,0.876
"12486","Cochabamba","Quillacollo","Escuela Arturo Quitón",64,0,2,2,98,9,21,1,2,199,5,9,213,232,0.492,0.918
"12487","Cochabamba","Quillacollo","Escuela Arturo Quitón",64,2,1,1,106,6,22,0,2,204,3,7,214,233,0.52,0.918
"12488","Cochabamba","Quillacollo","Escuela Arturo Quitón",57,1,3,0,111,5,20,1,2,200,5,4,209,226,0.555,0.925
"12489","Cochabamba","Quillacollo","Escuela Arturo Quitón",40,0,1,1,127,2,29,0,1,201,3,3,207,230,0.632,0.9
"12490","Cochabamba","Quillacollo","Escuela Arturo Quitón",55,0,0,0,115,4,24,0,1,199,3,3,205,223,0.578,0.919
"12491","Cochabamba","Quillacollo","Escuela Arturo Quitón",59,0,2,0,101,4,24,1,2,193,3,11,207,232,0.523,0.892
"12492","Cochabamba","Quillacollo","Escuela Arturo Quitón",58,0,0,1,117,4,26,2,0,208,0,3,211,225,0.562,0.938
"12493","Cochabamba","Quillacollo","Escuela Arturo Quitón",63,0,1,0,120,5,20,3,1,213,3,2,218,229,0.563,0.952
"12494","Cochabamba","Quillacollo","Unidad Educativa Ironcollo",39,0,0,1,138,4,22,0,2,206,4,3,213,232,0.67,0.918
"12495","Cochabamba","Quillacollo","Unidad Educativa Ironcollo",43,1,3,1,106,3,24,0,2,183,2,5,190,225,0.579,0.844
"12496","Cochabamba","Quillacollo","Unidad Educativa Ironcollo",37,1,1,1,115,2,27,0,0,184,3,9,196,232,0.625,0.845
"12497","Cochabamba","Quillacollo","Unidad Educativa Ironcollo",30,1,1,1,134,3,22,0,0,192,3,7,202,229,0.698,0.882
"12498","Cochabamba","Quillacollo","Unidad Educativa Ironcollo",30,0,1,1,124,2,39,0,0,197,2,4,203,232,0.629,0.875
"12499","Cochabamba","Quillacollo","Unidad Educativa Ironcollo",38,2,0,0,124,4,39,2,1,210,1,7,218,231,0.59,0.944
"12500","Cochabamba","Quillacollo","Unidad Educativa Ironcollo",25,0,0,2,120,10,44,0,1,202,2,10,214,234,0.594,0.915
"12501","Cochabamba","Quillacollo","Unidad Educativa Ironcollo",42,2,4,0,129,5,21,0,0,203,3,4,210,232,0.635,0.905
"12502","Cochabamba","Quillacollo","Unidad Educativa Ironcollo",37,0,1,2,123,3,34,0,1,201,5,3,209,232,0.612,0.901
"12503","Cochabamba","Quillacollo","Unidad Educativa Ironcollo",35,0,1,1,121,5,28,0,2,193,3,10,206,232,0.627,0.888
"12504","Cochabamba","Quillacollo","Unidad Educativa Ironcollo",30,0,1,0,135,3,27,1,0,197,2,5,204,230,0.685,0.887
"12505","Cochabamba","Quillacollo","Unidad Educativa Ironcollo",20,0,2,0,143,3,23,0,4,195,3,6,204,235,0.733,0.868
"12506","Cochabamba","Quillacollo","Unidad Educativa Ironcollo",49,1,2,1,111,2,23,0,5,194,0,11,205,228,0.572,0.899
"12507","Cochabamba","Quillacollo","Unidad Educativa Ironcollo",39,1,1,1,120,3,30,0,0,195,4,10,209,233,0.615,0.897
"12508","Cochabamba","Quillacollo","Unidad Educativa Ironcollo",40,0,3,1,108,0,44,0,0,196,1,12,209,230,0.551,0.909
"12509","Cochabamba","Quillacollo","Unidad Educativa Ironcollo",35,1,2,0,114,2,35,1,0,190,1,10,201,230,0.6,0.874
"12510","Cochabamba","Quillacollo","Unidad Educativa Ironcollo",37,1,1,0,113,9,31,2,1,195,5,10,210,233,0.579,0.901
"12511","Cochabamba","Quillacollo","Unidad Educativa Ironcollo",46,0,1,1,107,4,29,1,1,190,6,9,205,228,0.563,0.899
"12512","Cochabamba","Quillacollo","Unidad Educativa Ironcollo",44,2,1,0,109,6,29,1,2,194,1,2,197,229,0.562,0.86
"12513","Cochabamba","Quillacollo","Unidad Educativa Ironcollo",35,1,2,1,132,2,20,0,4,197,2,6,205,227,0.67,0.903
"12514","Cochabamba","Quillacollo","Unidad Educativa Marquina",43,0,1,0,130,3,37,1,1,216,0,4,220,234,0.602,0.94
"12515","Cochabamba","Quillacollo","Unidad Educativa Marquina",28,0,1,0,156,3,26,2,0,216,1,8,225,237,0.722,0.949
"12516","Cochabamba","Quillacollo","Unidad Educativa Marquina",39,1,1,0,145,4,18,1,0,209,4,12,225,237,0.694,0.949
"12517","Cochabamba","Quillacollo","Unidad Educativa Marquina",27,1,1,0,141,3,20,0,1,194,5,10,209,233,0.727,0.897
"12518","Cochabamba","Quillacollo","Unidad Educativa Marquina",23,2,0,1,150,1,31,1,2,211,5,6,222,238,0.711,0.933
"12519","Cochabamba","Quillacollo","Unidad Educativa Marquina",33,0,0,0,134,3,22,0,3,195,10,11,216,235,0.687,0.919
"12520","Cochabamba","Quillacollo","Unidad Educativa Marquina",24,0,1,0,128,3,40,0,3,199,2,12,213,235,0.643,0.906
"12521","Cochabamba","Quillacollo","Unidad Educativa Marquina",38,0,1,0,131,3,28,1,3,205,6,6,217,231,0.639,0.939
"12522","Cochabamba","Quillacollo","Unidad Educativa Marquina",37,0,1,1,124,5,35,0,1,204,4,4,212,232,0.608,0.914
"12523","Cochabamba","Quillacollo","Unidad Educativa Marquina",15,0,0,0,139,4,34,0,1,193,8,12,213,231,0.72,0.922
"12524","Cochabamba","Quillacollo","Unidad Educativa Marquina",24,0,3,0,148,2,25,1,2,205,5,7,217,231,0.722,0.939
"12525","Cochabamba","Quillacollo","Unidad Educativa Marquina",40,2,2,1,106,7,31,0,5,194,6,7,207,233,0.546,0.888
"12526","Cochabamba","Quillacollo","Unidad Educativa Marquina",41,1,1,4,114,4,25,1,3,194,2,11,207,232,0.588,0.892
"12527","Cochabamba","Quillacollo","Unidad Educativa Marquina",25,1,2,1,127,3,53,0,0,212,3,8,223,235,0.599,0.949
"12528","Cochabamba","Quillacollo","Unidad Educativa Marquina",27,0,1,0,131,1,30,1,1,192,5,12,209,235,0.682,0.889
"12529","Cochabamba","Quillacollo","Unidad Educativa Marquina",32,1,4,0,138,6,22,0,2,205,3,9,217,233,0.673,0.931
"12530","Cochabamba","Quillacollo","Unidad Educativa Marquina",33,1,1,4,125,2,36,0,2,204,1,9,214,233,0.613,0.918
"12531","Cochabamba","Quillacollo","Unidad Educativa Marquina",33,1,1,1,130,4,24,0,2,196,9,3,208,233,0.663,0.893
"12532","Cochabamba","Quillacollo","Unidad Educativa Marquina",28,1,3,0,105,1,24,0,3,165,2,5,172,191,0.636,0.901
"12533","Cochabamba","Quillacollo","Unidad Educativa Martin Cardenas",85,0,0,0,95,3,23,0,2,208,2,8,218,235,0.457,0.928
"12534","Cochabamba","Quillacollo","Unidad Educativa Martin Cardenas",52,1,2,1,118,8,22,0,3,207,0,7,214,234,0.57,0.915
"12535","Cochabamba","Quillacollo","Unidad Educativa Martin Cardenas",53,0,1,2,116,7,29,0,0,208,4,7,219,238,0.558,0.92
"12536","Cochabamba","Quillacollo","Unidad Educativa Martin Cardenas",74,0,1,2,97,6,32,2,0,214,1,6,221,238,0.453,0.929
"12537","Cochabamba","Quillacollo","Unidad Educativa Martin Cardenas",43,0,2,1,118,4,24,1,2,195,2,8,205,237,0.605,0.865
"12538","Cochabamba","Quillacollo","Unidad Educativa Martin Cardenas",65,0,0,1,128,4,18,1,1,218,1,4,223,236,0.587,0.945
"12539","Cochabamba","Quillacollo","Unidad Educativa Martin Cardenas",61,1,1,2,105,3,27,0,4,204,3,9,216,235,0.515,0.919
"12540","Cochabamba","Quillacollo","Unidad Educativa Martin Cardenas",74,1,1,0,93,7,19,0,3,198,0,7,205,231,0.47,0.887
"12541","Cochabamba","Quillacollo","U. E. Tunari",29,1,1,0,131,2,54,0,1,219,1,4,224,238,0.598,0.941
"12542","Cochabamba","Quillacollo","U. E. Tunari",30,0,1,0,131,8,44,0,4,218,2,4,224,237,0.601,0.945
"12543","Cochabamba","Quillacollo","Escuela Fidelia C. De Sanchez",136,2,0,2,53,4,4,1,4,206,0,4,210,226,0.257,0.929
"12544","Cochabamba","Quillacollo","Escuela Fidelia C. De Sanchez",120,3,0,1,62,5,8,0,1,200,1,7,208,225,0.31,0.924
"12545","Cochabamba","Quillacollo","Escuela Fidelia C. De Sanchez",118,0,1,0,66,4,8,0,1,198,1,8,207,229,0.333,0.904
"12546","Cochabamba","Quillacollo","Escuela Fidelia C. De Sanchez",115,1,0,1,50,5,17,0,1,190,2,4,196,221,0.263,0.887
"12547","Cochabamba","Quillacollo","Escuela Fidelia C. De Sanchez",123,0,0,0,59,3,10,0,0,195,5,9,209,222,0.303,0.941
"12548","Cochabamba","Quillacollo","Escuela Fidelia C. De Sanchez",127,2,0,0,70,4,0,0,0,203,0,3,206,235,0.345,0.877
"12549","Cochabamba","Quillacollo","Escuela Fidelia C. De Sanchez",114,0,0,0,64,5,16,2,1,202,1,3,206,222,0.317,0.928
"12550","Cochabamba","Quillacollo","Escuela Fidelia C. De Sanchez",116,0,2,0,57,2,15,0,2,194,0,10,204,229,0.294,0.891
"12551","Cochabamba","Quillacollo","Escuela Fidelia C. De Sanchez",127,0,2,1,60,6,8,2,4,210,0,8,218,233,0.286,0.936
"12552","Cochabamba","Quillacollo","Escuela Fidelia C. De Sanchez",135,0,0,2,52,4,13,0,1,207,0,3,210,224,0.251,0.938
"12553","Cochabamba","Quillacollo","Escuela Fidelia C. De Sanchez",117,1,1,0,68,2,12,1,0,202,1,2,205,230,0.337,0.891
"12554","Cochabamba","Quillacollo","Escuela Fidelia C. De Sanchez",124,0,2,0,52,8,10,0,1,197,0,6,203,221,0.264,0.919
"12555","Cochabamba","Quillacollo","Instituto Particular Quillacollo",119,0,0,2,79,4,13,0,1,218,2,10,230,236,0.362,0.975
"12556","Cochabamba","Quillacollo","Instituto Particular Quillacollo",105,2,1,1,65,5,17,0,0,196,4,6,206,226,0.332,0.912
"12557","Cochabamba","Quillacollo","Instituto Particular Quillacollo",129,1,0,2,52,3,11,0,1,199,0,5,204,229,0.261,0.891
"12558","Cochabamba","Quillacollo","Instituto Particular Quillacollo",100,0,1,0,70,2,23,0,2,198,2,5,205,227,0.354,0.903
"12559","Cochabamba","Quillacollo","Instituto Particular Quillacollo",118,0,1,0,61,4,15,0,1,200,1,6,207,231,0.305,0.896
"12560","Cochabamba","Quillacollo","Instituto Particular Quillacollo",114,0,2,2,62,2,10,1,1,194,3,15,212,232,0.32,0.914
"12561","Cochabamba","Quillacollo","Instituto Particular Quillacollo",128,0,1,0,63,4,9,1,0,206,0,6,212,232,0.306,0.914
"12562","Cochabamba","Quillacollo","Instituto Particular Quillacollo",115,0,0,2,57,1,10,1,2,188,2,3,193,223,0.303,0.865
"12563","Cochabamba","Quillacollo","Instituto Particular Quillacollo",111,1,0,0,59,4,23,0,0,198,0,7,205,224,0.298,0.915
"12564","Cochabamba","Quillacollo","Instituto Particular Quillacollo",116,1,1,0,61,5,21,0,2,207,1,7,215,234,0.295,0.919
"12565","Cochabamba","Quillacollo","Instituto Particular Quillacollo",115,3,2,2,51,0,19,1,2,195,0,6,201,224,0.262,0.897
"12566","Cochabamba","Quillacollo","Instituto Particular Quillacollo",107,0,1,0,70,5,15,0,1,199,2,4,205,222,0.352,0.923
"12567","Cochabamba","Quillacollo","Instituto Particular Quillacollo",126,0,1,0,63,4,8,1,1,204,3,9,216,228,0.309,0.947
"12568","Cochabamba","Quillacollo","Instituto Particular Quillacollo",108,0,0,0,58,3,13,2,2,186,2,14,202,228,0.312,0.886
"12569","Cochabamba","Quillacollo","Instituto Particular Quillacollo",125,0,0,0,52,3,13,1,1,195,0,3,198,222,0.267,0.892
"12570","Cochabamba","Quillacollo","Instituto Particular Quillacollo",88,0,1,0,76,1,13,0,0,179,1,3,183,200,0.425,0.915
"12571","Cochabamba","Quillacollo","Escuela Simón Bolivar",91,1,1,2,74,2,8,1,2,182,1,6,189,218,0.407,0.867
"12572","Cochabamba","Quillacollo","Escuela Simón Bolivar",83,3,0,1,80,4,12,0,2,185,2,8,195,223,0.432,0.874
"12573","Cochabamba","Quillacollo","Escuela Simón Bolivar",99,0,0,0,81,3,10,5,1,199,1,6,206,227,0.407,0.907
"12574","Cochabamba","Quillacollo","Escuela Simón Bolivar",87,1,3,1,84,4,13,0,3,196,2,5,203,227,0.429,0.894
"12575","Cochabamba","Quillacollo","Escuela Simón Bolivar",95,1,0,1,76,5,12,0,0,190,3,8,201,228,0.4,0.882
"12576","Cochabamba","Quillacollo","Escuela Simón Bolivar",100,0,0,0,73,3,8,1,2,187,5,8,200,226,0.39,0.885
"12577","Cochabamba","Quillacollo","Escuela Simón Bolivar",107,0,1,0,68,1,6,0,2,185,1,3,189,214,0.368,0.883
"12578","Cochabamba","Quillacollo","Escuela Simón Bolivar",80,1,1,1,82,4,14,0,0,183,3,12,198,223,0.448,0.888
"12579","Cochabamba","Quillacollo","Escuela Simón Bolivar",79,0,0,2,87,7,14,1,2,192,2,9,203,230,0.453,0.883
"12580","Cochabamba","Quillacollo","Escuela Simón Bolivar",89,0,0,2,84,6,9,0,1,191,2,6,199,223,0.44,0.892
"12581","Cochabamba","Quillacollo","Escuela Simón Bolivar",90,2,1,2,84,3,12,1,1,196,3,6,205,225,0.429,0.911
"12582","Cochabamba","Quillacollo","Escuela Simón Bolivar",75,1,2,0,81,9,19,1,1,189,1,6,196,225,0.429,0.871
"12583","Cochabamba","Quillacollo","Escuela Simón Bolivar",78,2,0,0,73,2,9,0,1,165,2,10,177,215,0.442,0.823
"12584","Cochabamba","Quillacollo","Escuela Simón Bolivar",92,0,1,0,69,6,9,1,2,180,2,9,191,220,0.383,0.868
"12585","Cochabamba","Quillacollo","Escuela Simón Bolivar",90,0,0,0,94,7,12,1,0,204,0,5,209,228,0.461,0.917
"12586","Cochabamba","Quillacollo","Escuela Simón Bolivar",111,1,1,1,66,3,9,2,2,196,1,2,199,220,0.337,0.905
"12587","Cochabamba","Quillacollo","Escuela Simón Bolivar",100,0,2,0,70,5,17,2,2,198,0,4,202,225,0.354,0.898
"12588","Cochabamba","Quillacollo","Liceo América",132,0,0,0,42,4,9,2,1,190,2,6,198,219,0.221,0.904
"12589","Cochabamba","Quillacollo","Liceo América",134,0,1,1,58,2,10,1,0,207,0,4,211,229,0.28,0.921
"12590","Cochabamba","Quillacollo","Liceo América",132,0,0,0,67,5,10,0,2,216,2,4,222,233,0.31,0.953
"12591","Cochabamba","Quillacollo","Liceo América",112,0,0,1,67,2,11,0,2,195,0,14,209,231,0.344,0.905
"12592","Cochabamba","Quillacollo","Liceo América",116,0,0,2,53,6,15,1,0,193,1,5,199,223,0.275,0.892
"12593","Cochabamba","Quillacollo","Liceo América",98,0,0,2,75,2,17,0,2,196,3,10,209,232,0.383,0.901
"12594","Cochabamba","Quillacollo","Liceo América",125,2,0,1,59,0,16,0,2,205,0,7,212,229,0.288,0.926
"12595","Cochabamba","Quillacollo","Liceo América",118,0,0,0,51,2,9,0,1,181,0,7,188,220,0.282,0.855
"12596","Cochabamba","Quillacollo","Liceo América",104,0,0,0,56,5,19,0,3,187,2,5,194,227,0.299,0.855
"12597","Cochabamba","Quillacollo","Liceo América",111,0,1,2,57,8,12,1,1,193,0,4,197,224,0.295,0.879
"12598","Cochabamba","Quillacollo","Liceo América",110,3,2,0,68,5,11,0,1,200,1,14,215,227,0.34,0.947
"12599","Cochabamba","Quillacollo","Liceo América",102,2,0,1,74,3,18,1,2,203,0,7,210,230,0.365,0.913
"12600","Cochabamba","Quillacollo","Liceo América",82,0,3,1,81,2,18,0,3,190,2,10,202,228,0.426,0.886
"12601","Cochabamba","Quillacollo","Liceo América",111,0,1,0,56,9,17,1,5,200,0,7,207,229,0.28,0.904
"12602","Cochabamba","Quillacollo","Liceo América",137,2,0,1,53,3,7,1,1,205,2,2,209,223,0.259,0.937
"12603","Cochabamba","Quillacollo","Liceo América",128,1,1,0,52,1,15,1,1,200,1,4,205,230,0.26,0.891
"12604","Cochabamba","Quillacollo","Liceo América",108,0,1,3,65,5,14,1,1,198,2,4,204,232,0.328,0.879
"12605","Cochabamba","Quillacollo","Liceo América",123,0,2,3,50,3,15,0,1,197,3,5,205,226,0.254,0.907
"12606","Cochabamba","Quillacollo","Liceo América",134,0,2,0,47,3,9,0,2,197,0,4,201,222,0.239,0.905
"12607","Cochabamba","Quillacollo","Liceo América",143,0,1,0,53,2,10,2,0,211,0,2,213,229,0.251,0.93
"12608","Cochabamba","Quillacollo","Liceo América",124,1,0,0,51,0,10,1,0,187,3,9,199,225,0.273,0.884
"12609","Cochabamba","Quillacollo","Liceo América",127,0,1,0,64,3,8,0,0,203,0,4,207,222,0.315,0.932
"12610","Cochabamba","Quillacollo","Liceo América",137,0,0,0,56,9,12,0,0,214,0,1,215,228,0.262,0.943
"12611","Cochabamba","Quillacollo","Liceo América",105,0,0,1,73,3,10,2,2,196,0,7,203,224,0.372,0.906
"12612","Cochabamba","Quillacollo","Escuela 12 de Septiembre",73,2,0,2,99,1,13,1,0,191,2,10,203,219,0.518,0.927
"12613","Cochabamba","Quillacollo","Escuela 12 de Septiembre",83,0,3,2,85,1,21,0,2,197,1,5,203,227,0.431,0.894
"12614","Cochabamba","Quillacollo","Escuela 12 de Septiembre",81,0,4,0,93,1,10,1,1,191,2,5,198,224,0.487,0.884
"12615","Cochabamba","Quillacollo","Escuela 12 de Septiembre",75,1,1,0,109,1,15,0,1,203,0,5,208,221,0.537,0.941
"12616","Cochabamba","Quillacollo","Escuela 12 de Septiembre",70,1,0,2,89,5,16,2,0,185,4,14,203,224,0.481,0.906
"12617","Cochabamba","Quillacollo","Escuela 12 de Septiembre",61,1,3,1,106,6,14,0,4,196,4,5,205,220,0.541,0.932
"12618","Cochabamba","Quillacollo","Escuela 12 de Septiembre",73,0,1,2,115,3,7,0,0,201,7,6,214,230,0.572,0.93
"12619","Cochabamba","Quillacollo","Escuela 12 de Septiembre",72,1,0,0,105,3,14,0,2,197,6,3,206,230,0.533,0.896
"12620","Cochabamba","Quillacollo","Escuela 12 de Septiembre",92,0,1,0,105,5,10,0,1,214,2,4,220,233,0.491,0.944
"12621","Cochabamba","Quillacollo","Escuela 12 de Septiembre",80,0,5,1,100,8,8,1,0,203,2,1,206,227,0.493,0.907
"12622","Cochabamba","Quillacollo","Escuela 12 de Septiembre",66,4,1,0,110,6,10,1,3,201,2,3,206,230,0.547,0.896
"12623","Cochabamba","Quillacollo","Escuela 12 de Septiembre",83,0,1,2,98,0,9,0,2,195,1,8,204,223,0.503,0.915
"12624","Cochabamba","Quillacollo","Escuela 12 de Septiembre",59,1,1,0,114,6,16,2,0,199,0,2,201,222,0.573,0.905
"12625","Cochabamba","Quillacollo","Escuela 12 de Septiembre",66,0,2,1,109,4,8,4,2,196,0,4,200,226,0.556,0.885
"12626","Cochabamba","Quillacollo","Escuela 12 de Septiembre",57,1,2,0,109,4,9,2,2,186,3,13,202,227,0.586,0.89
"12627","Cochabamba","Quillacollo","Escuela 12 de Septiembre",69,0,1,0,107,4,13,1,0,195,1,6,202,222,0.549,0.91
"12628","Cochabamba","Quillacollo","Escuela 12 de Septiembre",69,1,1,1,100,2,15,0,3,192,2,11,205,226,0.521,0.907
"12629","Cochabamba","Quillacollo","Escuela 12 de Septiembre",70,0,1,2,98,4,12,0,2,189,2,9,200,222,0.519,0.901
"12630","Cochabamba","Quillacollo","Escuela 12 de Septiembre",70,0,1,0,96,2,10,1,2,182,3,9,194,216,0.527,0.898
"12631","Cochabamba","Quillacollo","Escuela 12 de Septiembre",79,0,2,0,93,5,12,0,3,194,0,6,200,228,0.479,0.877
"12632","Cochabamba","Quillacollo","Escuela 12 de Septiembre",84,1,4,1,92,5,11,1,1,200,1,3,204,226,0.46,0.903
"12633","Cochabamba","Quillacollo","Escuela 12 de Septiembre",106,0,1,0,82,1,12,0,0,202,1,8,211,230,0.406,0.917
"12634","Cochabamba","Quillacollo","Escuela Tomas Bata",112,1,1,2,65,6,5,0,3,195,2,5,202,226,0.333,0.894
"12635","Cochabamba","Quillacollo","Escuela Tomas Bata",93,1,0,2,78,4,13,0,0,191,2,6,199,216,0.408,0.921
"12636","Cochabamba","Quillacollo","Escuela Tomas Bata",101,1,1,1,72,7,2,1,0,186,1,11,198,216,0.387,0.917
"12637","Cochabamba","Quillacollo","Escuela Tomas Bata",87,2,2,1,80,9,10,0,2,193,3,5,201,225,0.415,0.893
"12638","Cochabamba","Quillacollo","Escuela Tomas Bata",100,2,0,2,83,6,9,0,2,204,0,5,209,227,0.407,0.921
"12639","Cochabamba","Quillacollo","Escuela Tomas Bata",101,0,2,0,75,1,9,0,3,191,2,8,201,225,0.393,0.893
"12640","Cochabamba","Quillacollo","Escuela Tomas Bata",109,1,0,3,78,7,4,0,2,204,0,8,212,220,0.382,0.964
"12641","Cochabamba","Quillacollo","Escuela Tomas Bata",95,1,0,0,79,6,11,0,1,193,2,9,204,225,0.409,0.907
"12642","Cochabamba","Quillacollo","Escuela Tomas Bata",109,0,0,0,82,5,5,0,2,203,0,8,211,227,0.404,0.93
"12643","Cochabamba","Quillacollo","Escuela Tomas Bata",104,1,0,0,77,5,9,0,1,197,3,8,208,225,0.391,0.924
"12644","Cochabamba","Quillacollo","Escuela Tomas Bata",103,0,0,3,65,4,8,0,0,183,1,11,195,224,0.355,0.871
"12645","Cochabamba","Quillacollo","Escuela Tomas Bata",94,1,0,3,77,4,10,0,1,190,1,14,205,221,0.405,0.928
"12646","Cochabamba","Quillacollo","Escuela Tomas Bata",100,0,0,1,67,5,15,2,0,190,1,8,199,222,0.353,0.896
"12647","Cochabamba","Quillacollo","Escuela Tomas Bata",102,0,0,0,82,7,5,1,0,197,2,10,209,226,0.416,0.925
"12648","Cochabamba","Quillacollo","Escuela Tomas Bata",98,0,0,1,78,1,12,2,0,192,1,10,203,223,0.406,0.91
"12649","Cochabamba","Quillacollo","Escuela Tomas Bata",95,1,1,2,71,4,15,1,2,192,0,6,198,222,0.37,0.892
"12650","Cochabamba","Quillacollo","Escuela Tomas Bata",105,0,1,2,80,2,7,1,1,199,2,6,207,227,0.402,0.912
"12651","Cochabamba","Quillacollo","Unidad Educativa Heroinas",106,2,0,1,71,2,13,2,2,199,0,6,205,221,0.357,0.928
"12652","Cochabamba","Quillacollo","Unidad Educativa Heroinas",93,2,2,1,72,6,13,0,2,191,0,15,206,229,0.377,0.9
"12653","Cochabamba","Quillacollo","Unidad Educativa Heroinas",84,0,2,0,86,4,13,0,1,190,1,5,196,227,0.453,0.863
"12654","Cochabamba","Quillacollo","Unidad Educativa Heroinas",86,0,0,1,89,6,13,0,1,196,3,7,206,223,0.454,0.924
"12655","Cochabamba","Quillacollo","Unidad Educativa Heroinas",93,1,0,1,77,8,7,1,1,189,2,9,200,223,0.407,0.897
"12656","Cochabamba","Quillacollo","Unidad Educativa Heroinas",94,0,2,1,75,5,10,1,3,191,0,10,201,231,0.393,0.87
"12657","Cochabamba","Quillacollo","Unidad Educativa Heroinas",63,0,1,1,101,4,10,1,0,181,0,7,188,215,0.558,0.874
"12658","Cochabamba","Quillacollo","Unidad Educativa Heroinas",101,1,2,0,71,5,14,0,4,198,0,5,203,226,0.359,0.898
"12659","Cochabamba","Quillacollo","Unidad Educativa Heroinas",92,0,1,2,71,4,7,0,1,178,4,10,192,215,0.399,0.893
"12660","Cochabamba","Quillacollo","Unidad Educativa Heroinas",111,2,0,1,76,1,14,1,2,208,2,1,211,228,0.365,0.925
"12661","Cochabamba","Quillacollo","Unidad Educativa Heroinas",100,1,0,1,70,7,17,0,3,199,2,4,205,220,0.352,0.932
"12662","Cochabamba","Quillacollo","Unidad Educativa Heroinas",109,2,1,0,76,6,10,0,3,207,1,3,211,226,0.367,0.934
"12663","Cochabamba","Quillacollo","Unidad Educativa Heroinas",104,0,1,1,68,1,12,1,1,189,1,9,199,218,0.36,0.913
"12664","Cochabamba","Quillacollo","Unidad Educativa Villa De Urkupiña",33,1,0,1,147,9,18,0,2,211,2,5,218,236,0.697,0.924
"12665","Cochabamba","Quillacollo","Unidad Educativa Villa De Urkupiña",43,0,2,0,135,7,20,1,1,209,1,5,215,236,0.646,0.911
"12666","Cochabamba","Quillacollo","Unidad Educativa Villa De Urkupiña",37,1,1,0,134,1,28,0,1,203,3,8,214,237,0.66,0.903
"12667","Cochabamba","Quillacollo","Unidad Educativa Villa De Urkupiña",36,0,0,0,151,3,18,0,0,208,1,6,215,231,0.726,0.931
"12668","Cochabamba","Quillacollo","Unidad Educativa Villa De Urkupiña",23,0,6,0,145,4,20,0,1,199,3,9,211,232,0.729,0.909
"12669","Cochabamba","Quillacollo","Unidad Educativa Villa De Urkupiña",38,1,2,0,147,9,13,0,2,212,3,7,222,233,0.693,0.953
"12670","Cochabamba","Quillacollo","Unidad Educativa Villa De Urkupiña",47,0,0,0,134,2,14,1,0,198,6,10,214,236,0.677,0.907
"12671","Cochabamba","Quillacollo","Unidad Educativa Villa De Urkupiña",47,0,1,1,133,4,20,1,2,209,0,5,214,231,0.636,0.926
"12672","Cochabamba","Quillacollo","Unidad Educativa Villa De Urkupiña",34,0,4,1,136,4,21,0,1,201,4,8,213,235,0.677,0.906
"12673","Cochabamba","Quillacollo","Unidad Educativa Villa De Urkupiña",24,0,1,1,158,4,17,0,1,206,2,8,216,234,0.767,0.923
"12674","Cochabamba","Quillacollo","Unidad Educativa Villa De Urkupiña",17,1,2,1,161,3,15,1,0,201,2,13,216,234,0.801,0.923
"12675","Cochabamba","Quillacollo","Unidad Educativa Villa De Urkupiña",42,0,1,0,124,6,24,0,1,198,6,8,212,232,0.626,0.914
"12676","Cochabamba","Quillacollo","Unidad Educativa Villa De Urkupiña",42,1,0,1,139,0,16,0,3,202,1,7,210,232,0.688,0.905
"12677","Cochabamba","Quillacollo","Unidad Educativa Villa De Urkupiña",39,0,0,0,135,5,28,1,1,209,3,10,222,236,0.646,0.941
"12678","Cochabamba","Quillacollo","Unidad Educativa Villa De Urkupiña",43,0,1,1,148,5,7,0,0,205,3,11,219,233,0.722,0.94
"12679","Cochabamba","Quillacollo","Unidad Educativa Villa De Urkupiña",35,2,4,0,134,2,18,0,3,198,4,7,209,230,0.677,0.909
"12680","Cochabamba","Quillacollo","U. E. Jose Miguel Lanza (Illataco)",41,4,3,1,129,4,15,2,1,200,4,9,213,228,0.645,0.934
"12681","Cochabamba","Quillacollo","U. E. Jose Miguel Lanza (Illataco)",41,2,1,0,137,7,11,0,0,199,3,3,205,228,0.688,0.899
"12682","Cochabamba","Quillacollo","U. E. Jose Miguel Lanza (Illataco)",46,0,0,4,144,3,8,1,0,206,1,6,213,233,0.699,0.914
"12683","Cochabamba","Quillacollo","U. E. Jose Miguel Lanza (Illataco)",49,0,0,0,133,4,11,0,1,198,1,8,207,224,0.672,0.924
"12684","Cochabamba","Quillacollo","U. E. Jose Miguel Lanza (Illataco)",52,1,0,1,130,3,14,1,2,204,4,5,213,224,0.637,0.951
"12685","Cochabamba","Quillacollo","U. E. Jose Miguel Lanza (Illataco)",35,1,2,1,139,6,17,0,1,202,1,14,217,229,0.688,0.948
"12686","Cochabamba","Quillacollo","U. E. Jose Miguel Lanza (Illataco)",53,0,0,0,120,7,15,0,0,195,1,12,208,224,0.615,0.929
"12687","Cochabamba","Quillacollo","Escuela Felix Martinez",85,0,0,0,83,4,12,1,5,190,1,7,198,220,0.437,0.9
"12688","Cochabamba","Quillacollo","Escuela Felix Martinez",88,0,0,0,94,3,8,0,1,194,1,6,201,225,0.485,0.893
"12689","Cochabamba","Quillacollo","Escuela Felix Martinez",102,0,1,0,77,3,12,2,1,198,2,5,205,227,0.389,0.903
"12690","Cochabamba","Quillacollo","Escuela Felix Martinez",93,0,1,1,90,5,6,1,1,198,1,6,205,230,0.455,0.891
"12691","Cochabamba","Quillacollo","Escuela Felix Martinez",113,1,1,0,60,8,14,0,1,198,2,4,204,228,0.303,0.895
"12692","Cochabamba","Quillacollo","Escuela Felix Martinez",81,1,0,0,89,4,8,2,2,187,0,11,198,222,0.476,0.892
"12693","Cochabamba","Quillacollo","Escuela Felix Martinez",92,0,1,1,64,2,24,0,0,184,0,6,190,224,0.348,0.848
"12694","Cochabamba","Quillacollo","Escuela Felix Martinez",78,1,0,0,92,2,18,2,1,194,3,6,203,223,0.474,0.91
"12695","Cochabamba","Quillacollo","Escuela Felix Martinez",87,0,0,0,76,6,18,0,1,188,4,6,198,218,0.404,0.908
"12696","Cochabamba","Quillacollo","Escuela Felix Martinez",68,0,1,0,95,4,14,0,0,182,1,17,200,221,0.522,0.905
"12697","Cochabamba","Quillacollo","Escuela Felix Martinez",58,0,4,1,111,0,12,0,2,188,0,4,192,219,0.59,0.877
"12698","Cochabamba","Quillacollo","Escuela Felix Martinez",74,0,0,0,91,3,18,1,4,191,2,4,197,225,0.476,0.876
"12699","Cochabamba","Quillacollo","Escuela Felix Martinez",91,0,2,0,77,6,12,1,2,191,0,12,203,226,0.403,0.898
"12700","Cochabamba","Quillacollo","Escuela Felix Martinez",101,0,2,0,72,4,6,0,1,186,2,10,198,224,0.387,0.884
"12701","Cochabamba","Quillacollo","Escuela Felix Martinez",106,0,1,0,72,2,8,0,5,194,1,6,201,226,0.371,0.889
"12702","Cochabamba","Quillacollo","Escuela Felix Martinez",90,1,3,0,84,6,3,0,1,188,1,12,201,223,0.447,0.901
"12703","Cochabamba","Quillacollo","Escuela Felix Martinez",109,1,1,0,65,3,16,0,2,197,2,4,203,226,0.33,0.898
"12704","Cochabamba","Quillacollo","Escuela Felix Martinez",93,1,0,3,89,5,8,0,2,201,4,2,207,226,0.443,0.916
"12705","Cochabamba","Quillacollo","Escuela Felix Martinez",81,0,1,1,99,3,6,1,2,194,0,11,205,228,0.51,0.899
"12706","Cochabamba","Quillacollo","Escuela Felix Martinez",91,0,0,0,84,1,7,0,1,184,3,5,192,222,0.457,0.865
"12707","Cochabamba","Quillacollo","Escuela Felix Martinez",85,1,6,0,87,2,13,0,1,195,0,9,204,230,0.446,0.887
"12708","Cochabamba","Quillacollo","Escuela Felix Martinez",76,3,3,0,80,5,12,1,2,182,3,16,201,229,0.44,0.878
"12709","Cochabamba","Quillacollo","Escuela Felix Martinez",73,0,2,0,106,6,10,1,2,200,0,8,208,228,0.53,0.912
"12710","Cochabamba","Quillacollo","Escuela Felix Martinez",91,0,0,0,89,4,9,0,0,193,2,3,198,228,0.461,0.868
"12711","Cochabamba","Quillacollo","Escuela Felix Martinez",101,1,0,0,78,6,10,1,0,197,3,7,207,225,0.396,0.92
"12712","Cochabamba","Quillacollo","Escuela Felix Martinez",96,1,1,0,63,9,11,0,2,183,1,25,209,226,0.344,0.925
"12713","Cochabamba","Quillacollo","Escuela Felix Martinez",87,1,0,1,75,8,17,0,1,190,3,6,199,221,0.395,0.9
"12714","Cochabamba","Quillacollo","Escuela Felix Martinez",96,0,2,0,80,5,12,0,1,196,3,5,204,225,0.408,0.907
"12715","Cochabamba","Quillacollo","Escuela Felix Martinez",89,1,1,1,73,4,22,1,1,193,0,15,208,226,0.378,0.92
"12716","Cochabamba","Quillacollo","Escuela Felix Martinez",86,3,3,0,78,0,18,1,3,192,2,6,200,221,0.406,0.905
"12717","Cochabamba","Quillacollo","Escuela Felix Martinez",105,0,2,2,64,3,15,1,1,193,1,6,200,223,0.332,0.897
"12718","Cochabamba","Quillacollo","Escuela Felix Martinez",82,1,0,0,90,6,14,0,0,193,1,7,201,224,0.466,0.897
"12719","Cochabamba","Quillacollo","Escuela Felix Martinez",109,0,2,0,78,2,7,0,2,200,1,5,206,228,0.39,0.904
"12720","Cochabamba","Quillacollo","Escuela Felix Martinez",98,1,1,0,83,6,10,0,0,199,1,7,207,228,0.417,0.908
"12721","Cochabamba","Quillacollo","Escuela Felix Martinez",90,0,0,1,82,2,10,0,3,188,1,7,196,226,0.436,0.867
"12722","Cochabamba","Quillacollo","Escuela Felix Martinez",101,0,0,0,93,3,9,0,0,206,0,1,207,229,0.451,0.904
"12723","Cochabamba","Quillacollo","Escuela Felix Martinez",84,2,2,1,85,2,19,2,2,199,3,7,209,227,0.427,0.921
"12724","Cochabamba","Quillacollo","Escuela Felix Martinez",109,0,0,0,70,2,14,0,3,198,0,9,207,227,0.354,0.912
"12725","Cochabamba","Quillacollo","Escuela Felix Martinez",89,1,1,1,75,7,11,0,0,185,1,5,191,221,0.405,0.864
"12726","Cochabamba","Quillacollo","Escuela Felix Martinez",104,0,0,3,59,3,7,1,0,177,2,28,207,229,0.333,0.904
"12727","Cochabamba","Quillacollo","Escuela Felix Martinez",81,0,1,0,87,2,12,1,0,184,2,15,201,228,0.473,0.882
"12728","Cochabamba","Quillacollo","Centro Integral Niño Jesus Fe y Alegria",92,0,2,0,74,5,18,1,4,196,3,7,206,239,0.378,0.862
"12729","Cochabamba","Quillacollo","Centro Integral Niño Jesus Fe y Alegria",80,1,3,0,91,3,25,1,3,207,1,3,211,236,0.44,0.894
"12730","Cochabamba","Quillacollo","Centro Integral Niño Jesus Fe y Alegria",87,0,1,0,91,4,18,0,1,202,3,11,216,237,0.45,0.911
"12731","Cochabamba","Quillacollo","Centro Integral Niño Jesus Fe y Alegria",99,0,0,0,86,2,13,0,1,201,0,8,209,235,0.428,0.889
"12732","Cochabamba","Quillacollo","U.E. Oscar Alfaro",41,1,0,3,139,9,11,0,5,209,7,9,225,237,0.665,0.949
"12733","Cochabamba","Quillacollo","U.E. Oscar Alfaro",47,1,2,0,160,4,13,1,0,228,1,7,236,240,0.702,0.983
"12734","Cochabamba","Quillacollo","U.E. Pocpocollo",37,1,1,4,137,11,21,0,4,216,4,9,229,239,0.634,0.958
"12735","Cochabamba","Quillacollo","Normal Simón Rodríguez (Ex Nucleo Escolar Paucarpata)",62,4,1,0,108,5,15,1,3,199,0,4,203,225,0.543,0.902
"12736","Cochabamba","Quillacollo","Normal Simón Rodríguez (Ex Nucleo Escolar Paucarpata)",56,1,1,0,98,4,26,2,3,191,6,13,210,225,0.513,0.933
"12737","Cochabamba","Quillacollo","Normal Simón Rodríguez (Ex Nucleo Escolar Paucarpata)",58,0,1,0,100,3,17,0,0,179,4,10,193,225,0.559,0.858
"12738","Cochabamba","Quillacollo","Normal Simón Rodríguez (Ex Nucleo Escolar Paucarpata)",50,2,2,4,98,4,25,1,0,186,2,9,197,225,0.527,0.876
"12739","Cochabamba","Quillacollo","Normal Simón Rodríguez (Ex Nucleo Escolar Paucarpata)",53,0,1,3,84,6,42,3,0,192,3,6,201,221,0.438,0.91
"12740","Cochabamba","Quillacollo","Normal Simón Rodríguez (Ex Nucleo Escolar Paucarpata)",56,2,0,1,101,6,18,1,2,187,3,7,197,219,0.54,0.9
"12741","Cochabamba","Quillacollo","Normal Simón Rodríguez (Ex Nucleo Escolar Paucarpata)",55,0,0,5,108,6,23,0,2,199,5,7,211,226,0.543,0.934
"12742","Cochabamba","Quillacollo","Normal Simón Rodríguez (Ex Nucleo Escolar Paucarpata)",31,0,0,3,132,4,31,1,2,204,1,2,207,228,0.647,0.908
"12743","Cochabamba","Quillacollo","Normal Simón Rodríguez (Ex Nucleo Escolar Paucarpata)",50,3,1,0,99,7,27,0,2,189,2,13,204,226,0.524,0.903
"12744","Cochabamba","Quillacollo","Normal Simón Rodríguez (Ex Nucleo Escolar Paucarpata)",60,1,0,1,112,3,13,1,1,192,5,10,207,231,0.583,0.896
"12745","Cochabamba","Quillacollo","Normal Simón Rodríguez (Ex Nucleo Escolar Paucarpata)",47,1,1,1,122,6,27,0,1,206,1,6,213,230,0.592,0.926
"12746","Cochabamba","Quillacollo","Normal Simón Rodríguez (Ex Nucleo Escolar Paucarpata)",49,2,0,2,117,5,23,1,0,199,5,6,210,229,0.588,0.917
"12747","Cochabamba","Quillacollo","Normal Simón Rodríguez (Ex Nucleo Escolar Paucarpata)",56,4,1,2,93,1,20,0,5,182,3,15,200,221,0.511,0.905
"12748","Cochabamba","Quillacollo","Kinder Mariscal Jose Ballivian",82,0,1,1,68,6,11,2,2,173,2,9,184,226,0.393,0.814
"12749","Cochabamba","Quillacollo","Kinder Mariscal Jose Ballivian",79,0,1,1,88,3,9,2,1,184,2,5,191,226,0.478,0.845
"12750","Cochabamba","Quillacollo","Kinder Mariscal Jose Ballivian",77,0,1,0,92,1,12,0,1,184,0,4,188,232,0.5,0.81
"12751","Cochabamba","Quillacollo","Kinder Mariscal Jose Ballivian",61,1,0,0,110,2,11,1,1,187,1,6,194,235,0.588,0.826
"12752","Cochabamba","Quillacollo","Kinder Mariscal Jose Ballivian",86,1,0,0,79,4,18,3,0,191,2,6,199,233,0.414,0.854
"12753","Cochabamba","Quillacollo","Kinder Mariscal Jose Ballivian",67,0,0,0,93,3,13,2,2,180,4,6,190,227,0.517,0.837
"12754","Cochabamba","Quillacollo","Kinder Mariscal Jose Ballivian",73,2,1,1,81,4,9,1,1,173,2,4,179,229,0.468,0.782
"12755","Cochabamba","Quillacollo","Kinder Mariscal Jose Ballivian",81,1,0,0,93,2,10,0,4,191,4,6,201,227,0.487,0.885
"12756","Cochabamba","Quillacollo","Kinder Mariscal Jose Ballivian",84,1,2,2,83,0,7,1,2,182,1,13,196,228,0.456,0.86
"12757","Cochabamba","Quillacollo","Kinder Mariscal Jose Ballivian",59,1,0,1,93,3,16,0,3,176,1,7,184,228,0.528,0.807
"12758","Cochabamba","Quillacollo","Kinder Mariscal Jose Ballivian",70,1,0,2,96,7,14,2,1,193,1,7,201,228,0.497,0.882
"12759","Cochabamba","Quillacollo","Kinder Mariscal Jose Ballivian",99,0,0,0,78,1,8,2,1,189,1,6,196,230,0.413,0.852
"12760","Cochabamba","Quillacollo","Kinder Mariscal Jose Ballivian",84,0,0,0,74,10,7,0,1,176,2,8,186,225,0.42,0.827
"12761","Cochabamba","Quillacollo","U. E. Milivoy Eterovic Matenda",116,0,1,0,68,5,24,1,2,217,1,3,221,238,0.313,0.929
"12762","Cochabamba","Quillacollo","U. E. Milivoy Eterovic Matenda",104,1,2,1,80,4,14,0,1,207,1,6,214,238,0.386,0.899
"12763","Cochabamba","Quillacollo","U. E. Milivoy Eterovic Matenda",80,2,1,0,95,2,20,0,1,201,0,6,207,237,0.473,0.873
"12764","Cochabamba","Quillacollo","U. E. Milivoy Eterovic Matenda",105,3,2,1,78,3,14,0,0,206,1,5,212,236,0.379,0.898
"12765","Cochabamba","Quillacollo","U. E. Milivoy Eterovic Matenda",109,0,1,1,73,8,14,3,3,212,2,5,219,238,0.344,0.92
"12766","Cochabamba","Quillacollo","U. E. Milivoy Eterovic Matenda",79,0,4,1,90,4,20,0,4,202,0,6,208,231,0.446,0.9
"12767","Cochabamba","Quillacollo","U. E. Milivoy Eterovic Matenda",108,0,1,1,75,4,13,0,0,202,2,13,217,239,0.371,0.908
"12768","Cochabamba","Quillacollo","U. E. Milivoy Eterovic Matenda",113,0,1,1,67,0,17,1,3,203,1,2,206,237,0.33,0.869
"12769","Cochabamba","Quillacollo","U. E. Milivoy Eterovic Matenda",81,2,0,0,86,5,19,0,0,193,3,7,203,233,0.446,0.871
"12770","Cochabamba","Quillacollo","U. E. Milivoy Eterovic Matenda",110,0,0,0,76,6,13,0,13,218,0,7,225,236,0.349,0.953
"12771","Cochabamba","Quillacollo","U. E. Milivoy Eterovic Matenda",106,0,1,0,78,5,16,1,2,209,1,5,215,237,0.373,0.907
"12772","Cochabamba","Quillacollo","Colegio Nacional Calama (Nueva Infraestructura)",74,1,0,1,79,7,29,1,2,194,0,5,199,239,0.407,0.833
"12773","Cochabamba","Quillacollo","Colegio Nacional Calama (Nueva Infraestructura)",76,0,2,3,85,2,30,0,2,200,0,6,206,240,0.425,0.858
"12774","Cochabamba","Quillacollo","Colegio Nacional Calama (Nueva Infraestructura)",83,0,0,1,88,4,19,1,1,197,0,4,201,232,0.447,0.866
"12775","Cochabamba","Quillacollo","Unidad Educativa El Paso",50,1,2,1,113,2,14,0,2,185,1,3,189,215,0.611,0.879
"12776","Cochabamba","Quillacollo","Unidad Educativa El Paso",65,0,0,0,113,2,16,0,3,199,2,7,208,225,0.568,0.924
"12777","Cochabamba","Quillacollo","Unidad Educativa El Paso",50,0,0,1,116,5,26,1,0,199,1,6,206,231,0.583,0.892
"12778","Cochabamba","Quillacollo","Unidad Educativa El Paso",55,1,2,0,123,3,13,1,3,201,2,5,208,232,0.612,0.897
"12779","Cochabamba","Quillacollo","Unidad Educativa El Paso",36,1,1,0,119,5,22,1,2,187,4,9,200,224,0.636,0.893
"12780","Cochabamba","Quillacollo","Unidad Educativa El Paso",52,0,0,0,115,2,21,0,4,194,3,4,201,223,0.593,0.901
"12781","Cochabamba","Quillacollo","Unidad Educativa El Paso",42,1,0,1,128,4,15,1,2,194,5,5,204,224,0.66,0.911
"12782","Cochabamba","Quillacollo","Unidad Educativa El Paso",45,1,1,1,123,3,22,0,1,197,4,5,206,229,0.624,0.9
"12783","Cochabamba","Quillacollo","Unidad Educativa El Paso",46,1,0,2,118,3,15,0,0,185,4,6,195,220,0.638,0.886
"12784","Cochabamba","Quillacollo","Unidad Educativa El Paso",68,1,3,0,114,3,13,0,1,203,3,6,212,227,0.562,0.934
"12785","Cochabamba","Quillacollo","Unidad Educativa El Paso",69,0,2,0,81,6,17,0,1,176,2,12,190,221,0.46,0.86
"12786","Cochabamba","Quillacollo","Unidad Educativa El Paso",34,0,1,0,130,5,15,1,0,186,0,2,188,218,0.699,0.862
"12787","Cochabamba","Quillacollo","Unidad Educativa El Paso",54,0,1,0,122,2,9,0,2,190,1,7,198,224,0.642,0.884
"12788","Cochabamba","Quillacollo","Unidad Educativa El Paso",52,0,3,0,113,0,20,0,3,191,5,4,200,229,0.592,0.873
"12789","Cochabamba","Quillacollo","Unidad Educativa El Paso",43,0,0,0,124,5,16,0,1,189,3,7,199,222,0.656,0.896
"12790","Cochabamba","Quillacollo","Unidad Educativa El Paso",39,0,2,1,133,6,12,2,1,196,6,4,206,230,0.679,0.896
"12791","Cochabamba","Quillacollo","Unidad Educativa El Paso",67,1,0,1,108,7,13,0,4,201,2,7,210,229,0.537,0.917
"12792","Cochabamba","Quillacollo","Unidad Educativa El Paso",47,1,0,1,126,0,13,0,2,190,6,4,200,223,0.663,0.897
"12793","Cochabamba","Quillacollo","Unidad Educativa El Paso",51,1,1,0,112,2,13,1,2,183,3,11,197,220,0.612,0.895
"12794","Cochabamba","Quillacollo","Unidad Educativa El Paso",54,1,0,2,124,6,13,2,3,205,1,9,215,233,0.605,0.923
"12795","Cochabamba","Quillacollo","Unidad Educativa El Paso",51,1,3,4,116,2,14,0,3,194,2,7,203,220,0.598,0.923
"12796","Cochabamba","Quillacollo","Unidad Educativa El Paso",47,0,1,1,115,5,11,1,0,181,3,6,190,221,0.635,0.86
"12797","Cochabamba","Quillacollo","Unidad Educativa El Paso",51,1,0,2,112,5,10,0,4,185,8,7,200,221,0.605,0.905
"12798","Cochabamba","Quillacollo","Unidad Educativa El Paso",66,0,3,1,94,2,16,0,0,182,3,6,191,219,0.516,0.872
"12799","Cochabamba","Quillacollo","Unidad Educativa El Paso",46,0,1,0,128,2,15,1,2,195,7,3,205,226,0.656,0.907
"12800","Cochabamba","Quillacollo","Unidad Educativa El Paso",37,0,4,0,140,4,18,0,0,203,3,5,211,227,0.69,0.93
"12801","Cochabamba","Quillacollo","Unidad Educativa El Paso",41,2,0,2,108,8,12,2,0,175,4,10,189,216,0.617,0.875
"12802","Cochabamba","Quillacollo","Unidad Educativa El Paso",44,0,0,0,131,3,13,0,1,192,8,6,206,224,0.682,0.92
"12803","Cochabamba","Quillacollo","Unidad Educativa Maria Auxiliadora",51,1,0,0,125,4,21,0,1,203,0,13,216,236,0.616,0.915
"12804","Cochabamba","Quillacollo","Unidad Educativa Maria Auxiliadora",50,1,1,0,134,3,25,1,0,215,3,7,225,235,0.623,0.957
"12805","Cochabamba","Quillacollo","Unidad Educativa Maria Auxiliadora",38,2,1,1,134,4,23,1,1,205,5,8,218,235,0.654,0.928
"12806","Cochabamba","Quillacollo","Unidad Educativa Maria Auxiliadora",56,1,2,0,134,3,7,0,3,206,4,7,217,235,0.65,0.923
"12807","Cochabamba","Quillacollo","Unidad Educativa Maria Auxiliadora",54,0,0,1,114,1,9,1,0,180,7,10,197,226,0.633,0.872
"12808","Cochabamba","Quillacollo","Instituto Tecnologico El Paso",61,0,2,1,109,7,28,0,2,210,1,3,214,237,0.519,0.903
"12809","Cochabamba","Quillacollo","Instituto Tecnologico El Paso",59,0,1,1,117,1,19,1,1,200,3,6,209,236,0.585,0.886
"12810","Cochabamba","Quillacollo","Instituto Tecnologico El Paso",60,0,2,1,128,5,12,0,3,211,6,7,224,238,0.607,0.941
"12811","Cochabamba","Quillacollo","Instituto Tecnologico El Paso",52,0,2,0,109,5,26,0,3,197,3,10,210,235,0.553,0.894
"12812","Cochabamba","Quillacollo","Instituto Tecnologico El Paso",66,1,1,0,109,5,21,0,3,206,1,7,214,236,0.529,0.907
"12813","Cochabamba","Quillacollo","Instituto Tecnologico El Paso",57,1,1,1,110,10,21,2,3,206,3,8,217,236,0.534,0.919
"12814","Cochabamba","Quillacollo","Instituto Tecnologico El Paso",76,0,1,0,105,5,19,3,2,211,3,7,221,237,0.498,0.932
"12815","Cochabamba","Quillacollo","U. E. El Paso ""A""",60,1,1,0,137,7,19,0,0,225,0,5,230,238,0.609,0.966
"12816","Cochabamba","Quillacollo","U. E. El Paso ""A""",45,0,1,1,126,2,28,1,0,204,2,18,224,238,0.618,0.941
"12817","Cochabamba","Quillacollo","U. E. El Paso ""A""",40,2,3,0,146,4,22,0,1,218,1,8,227,236,0.67,0.962
"12818","Cochabamba","Quillacollo","U. E. El Paso ""A""",45,0,2,2,143,7,23,0,2,224,4,4,232,240,0.638,0.967
"12819","Cochabamba","Quillacollo","U. E. El Paso ""A""",46,0,1,1,132,5,32,2,0,219,3,7,229,238,0.603,0.962
"12820","Cochabamba","Quillacollo","U.E. Molle Molle",19,0,1,1,196,5,12,2,0,236,1,7,244,247,0.831,0.988
"12821","Cochabamba","Quillacollo","Unidad Educativa Bella Vista",27,2,1,0,145,2,23,0,2,202,4,7,213,224,0.718,0.951
"12822","Cochabamba","Quillacollo","Unidad Educativa Bella Vista",21,1,0,0,153,2,17,1,1,196,5,7,208,233,0.781,0.893
"12823","Cochabamba","Quillacollo","Unidad Educativa Bella Vista",31,1,1,0,136,1,14,0,0,184,8,8,200,226,0.739,0.885
"12824","Cochabamba","Quillacollo","Unidad Educativa Bella Vista",22,0,0,0,129,0,21,2,2,176,6,9,191,223,0.733,0.857
"12825","Cochabamba","Quillacollo","Unidad Educativa Bella Vista",33,0,0,1,132,3,18,2,1,190,4,14,208,231,0.695,0.9
"12826","Cochabamba","Quillacollo","Unidad Educativa Bella Vista",18,1,0,1,141,0,29,0,0,190,3,6,199,234,0.742,0.85
"12827","Cochabamba","Quillacollo","Unidad Educativa Bella Vista",26,1,2,0,143,4,19,1,1,197,3,11,211,229,0.726,0.921
"12828","Cochabamba","Quillacollo","Unidad Educativa Bella Vista",16,2,2,0,146,1,20,0,1,188,6,10,204,234,0.777,0.872
"12829","Cochabamba","Quillacollo","Unidad Educativa Bella Vista",23,1,3,0,129,1,21,1,3,182,1,10,193,226,0.709,0.854
"12830","Cochabamba","Quillacollo","Unidad Educativa Bella Vista",26,1,1,2,135,2,25,1,1,194,2,6,202,226,0.696,0.894
"12831","Cochabamba","Quillacollo","Unidad Educativa Bella Vista",30,1,0,1,118,1,27,1,1,180,4,9,193,228,0.656,0.846
"12832","Cochabamba","Quillacollo","Unidad Educativa Bella Vista",24,0,1,1,128,4,17,1,1,177,5,12,194,223,0.723,0.87
"12833","Cochabamba","Quillacollo","Unidad Educativa Bella Vista",12,2,1,2,135,2,24,1,1,180,7,9,196,234,0.75,0.838
"12834","Cochabamba","Quillacollo","Unidad Educativa Bella Vista",24,0,1,2,141,2,21,2,0,193,2,5,200,225,0.731,0.889
"12835","Cochabamba","Quillacollo","Unidad Educativa Bella Vista",15,0,2,3,126,3,32,2,0,183,11,8,202,226,0.689,0.894
"12836","Cochabamba","Quillacollo","Unidad Educativa Bella Vista",26,0,2,0,134,4,17,0,3,186,1,1,188,226,0.72,0.832
"12837","Cochabamba","Quillacollo","Unidad Educativa Bella Vista",18,1,1,0,138,4,34,1,0,197,12,3,212,229,0.701,0.926
"12838","Cochabamba","Quillacollo","Unidad Educativa Bella Vista",27,1,0,1,131,3,32,0,0,195,5,5,205,230,0.672,0.891
"12839","Cochabamba","Quillacollo","Unidad Educativa Bella Vista",20,1,0,2,148,2,25,0,1,199,2,11,212,230,0.744,0.922
"12840","Cochabamba","Quillacollo","Unidad Educativa Bella Vista",22,0,0,1,146,2,29,0,1,201,6,7,214,229,0.726,0.934
"12841","Cochabamba","Quillacollo","Unidad Educativa Bella Vista",24,1,0,1,129,2,24,1,0,182,2,9,193,219,0.709,0.881
"12842","Cochabamba","Quillacollo","U. E. Rene Barrienos Ortuño (Misicuni)",10,2,0,1,136,2,25,2,0,178,8,8,194,216,0.764,0.898
"12843","Cochabamba","Quillacollo","U. E. Rene Barrienos Ortuño (Misicuni)",5,2,0,3,139,3,29,0,1,182,6,6,194,215,0.764,0.902
"12844","Cochabamba","Quillacollo","Centro Internado Misicuni",9,3,0,1,167,1,28,0,0,209,9,8,226,234,0.799,0.966
"12845","Cochabamba","Quillacollo","Centro Internado Misicuni",9,2,1,0,156,3,20,0,2,193,2,14,209,213,0.808,0.981
"12846","Cochabamba","Quillacollo","Unidad Educativa Liriuni",4,1,0,4,172,1,21,0,0,203,8,5,216,222,0.847,0.973
"12847","Cochabamba","Quillacollo","U. E. Potrero",16,0,0,2,179,2,20,0,2,221,7,6,234,238,0.81,0.983
"12848","Cochabamba","Quillacollo","U. E. Potrero",12,1,1,3,176,1,20,0,1,215,6,8,229,238,0.819,0.962
"12849","Cochabamba","Quillacollo","U. E. Potrero",11,1,2,0,171,3,28,1,0,217,3,10,230,239,0.788,0.962
"12850","Cochabamba","Quillacollo","U. E. Potrero",12,2,0,0,175,4,18,0,0,211,9,10,230,239,0.829,0.962
"12851","Cochabamba","Sipesipe","Escuela Sucre (Sipe Sipe)",37,0,0,1,135,3,24,0,1,201,2,8,211,220,0.672,0.959
"12852","Cochabamba","Sipesipe","Escuela Sucre (Sipe Sipe)",23,0,0,1,141,0,22,1,3,191,2,11,204,230,0.738,0.887
"12853","Cochabamba","Sipesipe","Escuela Sucre (Sipe Sipe)",45,1,2,0,141,4,12,0,2,207,2,4,213,229,0.681,0.93
"12854","Cochabamba","Sipesipe","Escuela Sucre (Sipe Sipe)",46,1,1,1,129,1,17,1,0,197,4,8,209,226,0.655,0.925
"12855","Cochabamba","Sipesipe","Escuela Sucre (Sipe Sipe)",30,1,0,1,127,3,20,0,1,183,4,10,197,217,0.694,0.908
"12856","Cochabamba","Sipesipe","Escuela Sucre (Sipe Sipe)",45,0,1,1,125,3,14,0,2,191,2,10,203,218,0.654,0.931
"12857","Cochabamba","Sipesipe","Escuela Sucre (Sipe Sipe)",27,0,0,0,145,3,22,0,2,199,2,7,208,223,0.729,0.933
"12858","Cochabamba","Sipesipe","Escuela Sucre (Sipe Sipe)",28,0,1,0,144,0,18,0,0,191,5,10,206,224,0.754,0.92
"12859","Cochabamba","Sipesipe","Escuela Sucre (Sipe Sipe)",41,0,1,0,126,2,19,1,1,191,1,14,206,232,0.66,0.888
"12860","Cochabamba","Sipesipe","Escuela Sucre (Sipe Sipe)",64,0,1,1,109,1,26,0,2,204,2,5,211,226,0.534,0.934
"12861","Cochabamba","Sipesipe","Escuela Sucre (Sipe Sipe)",30,0,3,1,132,4,15,1,3,189,3,9,201,225,0.698,0.893
"12862","Cochabamba","Sipesipe","Escuela Sucre (Sipe Sipe)",57,1,0,1,114,5,10,0,3,191,1,4,196,224,0.597,0.875
"12863","Cochabamba","Sipesipe","Escuela Sucre (Sipe Sipe)",51,1,0,1,128,1,11,0,1,194,1,3,198,223,0.66,0.888
"12864","Cochabamba","Sipesipe","Escuela Sucre (Sipe Sipe)",30,0,1,1,132,9,23,0,0,196,5,9,210,224,0.673,0.938
"12865","Cochabamba","Sipesipe","Escuela Sucre (Sipe Sipe)",46,2,1,1,128,4,16,0,1,199,7,7,213,228,0.643,0.934
"12866","Cochabamba","Sipesipe","Escuela Sucre (Sipe Sipe)",34,1,1,0,145,1,22,0,0,204,4,8,216,231,0.711,0.935
"12867","Cochabamba","Sipesipe","Escuela Sucre (Sipe Sipe)",16,1,1,0,155,5,20,0,0,198,1,8,207,220,0.783,0.941
"12868","Cochabamba","Sipesipe","Escuela Sucre (Sipe Sipe)",24,4,0,0,160,2,20,1,1,212,2,4,218,234,0.755,0.932
"12869","Cochabamba","Sipesipe","Escuela Sucre (Sipe Sipe)",19,0,1,1,158,5,10,0,0,194,0,12,206,222,0.814,0.928
"12870","Cochabamba","Sipesipe","Escuela Sucre (Sipe Sipe)",42,3,0,1,120,7,19,1,1,194,3,10,207,221,0.619,0.937
"12871","Cochabamba","Sipesipe","Escuela Sucre (Sipe Sipe)",43,0,1,0,132,4,17,1,0,198,2,5,205,224,0.667,0.915
"12872","Cochabamba","Sipesipe","Escuela Sucre (Sipe Sipe)",27,1,3,1,150,3,17,0,0,202,1,7,210,228,0.743,0.921
"12873","Cochabamba","Sipesipe","Escuela Sucre (Sipe Sipe)",39,2,0,0,128,6,10,2,1,188,4,11,203,226,0.681,0.898
"12874","Cochabamba","Sipesipe","Escuela Sucre (Sipe Sipe)",39,1,0,2,139,1,15,1,0,198,0,9,207,223,0.702,0.928
"12875","Cochabamba","Sipesipe","Escuela Sucre (Sipe Sipe)",29,0,1,2,154,3,14,0,1,204,1,7,212,230,0.755,0.922
"12876","Cochabamba","Sipesipe","Escuela Sucre (Sipe Sipe)",23,2,1,1,152,4,10,1,0,194,4,6,204,226,0.784,0.903
"12877","Cochabamba","Sipesipe","Escuela Sucre (Sipe Sipe)",28,0,2,1,143,1,15,1,2,193,5,10,208,230,0.741,0.904
"12878","Cochabamba","Sipesipe","Escuela Sucre (Sipe Sipe)",32,1,2,1,141,1,12,0,1,191,2,8,201,225,0.738,0.893
"12879","Cochabamba","Sipesipe","Escuela Sucre (Sipe Sipe)",33,0,1,2,145,1,13,0,1,196,4,6,206,226,0.74,0.912
"12880","Cochabamba","Sipesipe","Escuela Sucre (Sipe Sipe)",57,2,0,1,118,5,13,1,0,197,1,9,207,230,0.599,0.9
"12881","Cochabamba","Sipesipe","Escuela Sucre (Sipe Sipe)",35,2,1,2,129,6,12,0,1,188,3,11,202,225,0.686,0.898
"12882","Cochabamba","Sipesipe","Escuela Sucre (Sipe Sipe)",33,0,0,2,116,4,16,0,1,172,2,9,183,205,0.674,0.893
"12883","Cochabamba","Sipesipe","Unidad Educativa Andres Uzeda Ocampo",28,1,1,1,143,2,25,0,1,202,5,8,215,240,0.708,0.896
"12884","Cochabamba","Sipesipe","Unidad Educativa Andres Uzeda Ocampo",37,0,1,0,158,3,26,0,0,225,2,3,230,240,0.702,0.958
"12885","Cochabamba","Sipesipe","Unidad Educativa Andres Uzeda Ocampo",24,1,4,0,143,3,32,1,2,210,2,6,218,239,0.681,0.912
"12886","Cochabamba","Sipesipe","Unidad Educativa Andres Uzeda Ocampo",30,3,0,0,148,5,24,1,2,213,2,9,224,236,0.695,0.949
"12887","Cochabamba","Sipesipe","Unidad Educativa Andres Uzeda Ocampo",30,1,2,0,145,3,17,1,1,200,3,8,211,238,0.725,0.887
"12888","Cochabamba","Sipesipe","Unidad Educativa Andres Uzeda Ocampo",23,0,1,1,170,2,14,0,0,211,2,12,225,239,0.806,0.941
"12889","Cochabamba","Sipesipe","Unidad Educativa Andres Uzeda Ocampo",22,0,0,0,163,0,31,0,1,217,2,6,225,240,0.751,0.938
"12890","Cochabamba","Sipesipe","Unidad Educativa Andres Uzeda Ocampo",20,0,0,0,163,1,29,0,0,213,0,5,218,238,0.765,0.916
"12891","Cochabamba","Sipesipe","Unidad Educativa Andres Uzeda Ocampo",32,2,1,0,147,4,26,0,3,215,2,1,218,240,0.684,0.908
"12892","Cochabamba","Sipesipe","Unidad Educativa Andres Uzeda Ocampo",34,0,0,1,144,3,29,0,0,211,2,6,219,237,0.682,0.924
"12893","Cochabamba","Sipesipe","Unidad Educativa Suticollo",52,2,0,0,121,2,22,0,1,200,4,4,208,230,0.605,0.904
"12894","Cochabamba","Sipesipe","Unidad Educativa Suticollo",49,3,0,1,113,3,21,1,1,192,0,11,203,225,0.589,0.902
"12895","Cochabamba","Sipesipe","Unidad Educativa Suticollo",55,0,1,0,113,3,14,0,3,189,1,13,203,225,0.598,0.902
"12896","Cochabamba","Sipesipe","Unidad Educativa Suticollo",38,3,0,0,126,5,21,0,1,194,2,13,209,228,0.649,0.917
"12897","Cochabamba","Sipesipe","Unidad Educativa Suticollo",50,0,0,0,111,5,26,1,4,197,2,5,204,229,0.563,0.891
"12898","Cochabamba","Sipesipe","Unidad Educativa Suticollo",48,0,2,3,99,5,20,0,5,182,4,9,195,223,0.544,0.874
"12899","Cochabamba","Sipesipe","Unidad Educativa Suticollo",45,1,1,0,110,5,19,0,0,181,2,9,192,216,0.608,0.889
"12900","Cochabamba","Sipesipe","Unidad Educativa Suticollo",27,2,1,0,137,7,24,0,2,200,1,7,208,222,0.685,0.937
"12901","Cochabamba","Sipesipe","Unidad Educativa Suticollo",65,2,2,1,93,4,25,0,0,192,3,8,203,228,0.484,0.89
"12902","Cochabamba","Sipesipe","Unidad Educativa Suticollo",61,0,1,0,96,11,21,0,2,192,2,13,207,225,0.5,0.92
"12903","Cochabamba","Sipesipe","Unidad Educativa Suticollo",52,2,3,2,110,6,22,0,0,197,1,6,204,225,0.558,0.907
"12904","Cochabamba","Sipesipe","Unidad Educativa Suticollo",60,2,2,0,102,9,26,0,1,202,3,8,213,230,0.505,0.926
"12905","Cochabamba","Sipesipe","Unidad Educativa Suticollo",41,1,0,0,127,5,21,1,0,196,3,5,204,225,0.648,0.907
"12906","Cochabamba","Sipesipe","Unidad Educativa Viloma",14,0,0,0,157,5,12,0,1,189,2,6,197,221,0.831,0.891
"12907","Cochabamba","Sipesipe","Unidad Educativa Viloma",16,0,0,0,170,2,14,0,0,202,2,8,212,226,0.842,0.938
"12908","Cochabamba","Sipesipe","Unidad Educativa Viloma",13,0,0,0,169,0,10,0,0,192,1,6,199,221,0.88,0.9
"12909","Cochabamba","Sipesipe","Unidad Educativa Viloma",13,0,1,0,171,0,16,0,1,202,5,3,210,223,0.847,0.942
"12910","Cochabamba","Sipesipe","Unidad Educativa Viloma",11,0,1,0,162,2,14,0,1,191,2,9,202,219,0.848,0.922
"12911","Cochabamba","Sipesipe","Unidad Educativa Viloma",18,1,0,0,161,1,7,0,1,189,1,6,196,213,0.852,0.92
"12912","Cochabamba","Sipesipe","Unidad Educativa Viloma",20,0,0,0,150,2,8,1,1,182,0,11,193,210,0.824,0.919
"12913","Cochabamba","Sipesipe","Unidad Educativa Sauce Rancho",50,2,2,2,112,3,12,0,2,185,1,8,194,222,0.605,0.874
"12914","Cochabamba","Sipesipe","Unidad Educativa Sauce Rancho",37,0,1,1,108,3,24,0,1,175,4,12,191,217,0.617,0.88
"12915","Cochabamba","Sipesipe","Unidad Educativa Sauce Rancho",47,2,1,1,103,9,22,0,0,185,2,8,195,215,0.557,0.907
"12916","Cochabamba","Sipesipe","Unidad Educativa Sauce Rancho",30,0,3,0,134,4,20,0,0,191,2,5,198,218,0.702,0.908
"12917","Cochabamba","Sipesipe","Unidad Educativa Sauce Rancho",26,1,4,1,125,3,23,0,0,183,3,10,196,225,0.683,0.871
"12918","Cochabamba","Sipesipe","Unidad Educativa Sauce Rancho",34,1,0,3,114,3,23,0,1,179,1,6,186,216,0.637,0.861
"12919","Cochabamba","Sipesipe","Unidad Educativa Sauce Rancho",36,1,1,0,130,0,17,0,2,187,8,12,207,227,0.695,0.912
"12920","Cochabamba","Sipesipe","Unidad Educativa Sauce Rancho",43,2,0,2,105,3,21,0,3,179,3,14,196,226,0.587,0.867
"12921","Cochabamba","Sipesipe","Unidad Educativa Sauce Rancho",29,0,1,0,115,3,28,1,1,178,6,8,192,221,0.646,0.869
"12922","Cochabamba","Sipesipe","Unidad Educativa Sauce Rancho",49,0,2,0,122,3,15,0,2,193,1,7,201,229,0.632,0.878
"12923","Cochabamba","Sipesipe","Unidad Educativa Sauce Rancho",31,0,0,0,142,2,18,0,0,193,0,14,207,225,0.736,0.92
"12924","Cochabamba","Sipesipe","Unidad Educativa Sauce Rancho",36,0,0,0,124,5,19,1,0,185,4,6,195,225,0.67,0.867
"12925","Cochabamba","Sipesipe","Unidad Educativa Sauce Rancho",47,1,4,1,105,3,20,0,1,182,2,8,192,220,0.577,0.873
"12926","Cochabamba","Sipesipe","Unidad Educativa Sauce Rancho",31,1,2,0,117,4,13,0,5,173,2,15,190,216,0.676,0.88
"12927","Cochabamba","Sipesipe","Unidad Educativa Sauce Rancho",54,0,2,1,97,4,15,0,2,175,3,6,184,211,0.554,0.872
"12928","Cochabamba","Sipesipe","Unidad Educativa Sauce Rancho",47,2,4,0,120,4,21,0,0,198,1,11,210,226,0.606,0.929
"12929","Cochabamba","Sipesipe","Unidad Educativa Sauce Rancho",42,1,1,0,107,3,21,1,1,177,1,15,193,222,0.605,0.869
"12930","Cochabamba","Sipesipe","Unidad Educativa Sauce Rancho",43,0,3,0,111,3,13,0,1,174,3,10,187,215,0.638,0.87
"12931","Cochabamba","Sipesipe","Unidad Educativa Sauce Rancho",45,0,0,0,119,4,16,1,2,187,2,14,203,224,0.636,0.906
"12932","Cochabamba","Sipesipe","Unidad Educativa Sauce Rancho",51,0,0,2,107,4,24,0,2,190,3,6,199,222,0.563,0.896
"12933","Cochabamba","Sipesipe","Unidad Educativa Sauce Rancho",36,0,1,3,108,1,19,1,0,169,0,3,172,195,0.639,0.882
"12934","Cochabamba","Sipesipe","U. E. German Busch",44,1,1,0,130,4,37,0,1,218,4,12,234,239,0.596,0.979
"12935","Cochabamba","Sipesipe","U. E. German Busch",32,1,0,0,152,6,36,0,0,227,1,5,233,239,0.67,0.975
"12936","Cochabamba","Sipesipe","U. E. German Busch",27,2,2,1,151,4,30,0,3,220,5,7,232,240,0.686,0.967
"12937","Cochabamba","Sipesipe","U. E. German Busch",33,1,2,1,162,5,35,0,0,239,3,4,246,254,0.678,0.969
"12938","Cochabamba","Sipesipe","U. E. Isidoro Carrasco Olguín",8,0,1,0,207,1,10,0,0,227,2,6,235,240,0.912,0.979
"12939","Cochabamba","Sipesipe","U. E. Isidoro Carrasco Olguín",8,0,1,1,194,3,18,0,0,225,5,4,234,240,0.862,0.975
"12940","Cochabamba","Sipesipe","U. E. Isidoro Carrasco Olguín",14,0,1,0,194,2,17,0,2,230,3,4,237,239,0.843,0.992
"12941","Cochabamba","Sipesipe","U. E. Isidoro Carrasco Olguín",6,0,1,0,147,2,9,0,2,167,6,4,177,180,0.88,0.983
"12942","Cochabamba","Sipesipe","Esc. Rene Barrientos Ortuño (Itapaya)",36,2,0,3,132,1,12,1,0,187,5,7,199,224,0.706,0.888
"12943","Cochabamba","Sipesipe","Esc. Rene Barrientos Ortuño (Itapaya)",20,1,0,0,132,3,22,0,0,178,8,5,191,223,0.742,0.857
"12944","Cochabamba","Sipesipe","Esc. Rene Barrientos Ortuño (Itapaya)",28,1,1,1,136,3,13,0,0,183,6,12,201,224,0.743,0.897
"12945","Cochabamba","Sipesipe","Esc. Rene Barrientos Ortuño (Itapaya)",22,1,1,0,149,5,13,0,1,192,5,6,203,225,0.776,0.902
"12946","Cochabamba","Sipesipe","Esc. Rene Barrientos Ortuño (Itapaya)",27,1,3,1,128,6,18,0,1,185,5,8,198,223,0.692,0.888
"12947","Cochabamba","Sipesipe","Esc. Rene Barrientos Ortuño (Itapaya)",39,1,0,1,113,6,27,1,2,190,3,6,199,221,0.595,0.9
"12948","Cochabamba","Sipesipe","Unidad Educativa Eduardo Abaroa",12,0,0,1,154,3,17,0,0,187,1,7,195,220,0.824,0.886
"12949","Cochabamba","Sipesipe","Unidad Educativa Eduardo Abaroa",13,2,1,1,134,2,17,1,1,172,7,15,194,221,0.779,0.878
"12950","Cochabamba","Sipesipe","Unidad Educativa Eduardo Abaroa",24,1,1,2,126,2,11,0,1,168,9,12,189,223,0.75,0.848
"12951","Cochabamba","Sipesipe","Unidad Educativa Eduardo Abaroa",27,0,1,0,131,3,20,0,2,184,4,11,199,224,0.712,0.888
"12952","Cochabamba","Sipesipe","Unidad Educativa Eduardo Abaroa",16,0,1,2,162,3,11,0,0,195,3,9,207,227,0.831,0.912
"12953","Cochabamba","Sipesipe","Unidad Educativa Eduardo Abaroa",30,1,0,1,133,1,9,1,1,177,10,12,199,219,0.751,0.909
"12954","Cochabamba","Sipesipe","Unidad Educativa Eduardo Abaroa",16,0,0,2,138,6,20,0,1,183,8,13,204,226,0.754,0.903
"12955","Cochabamba","Sipesipe","Unidad Educativa Eduardo Abaroa",11,1,0,0,161,3,16,0,0,192,2,8,202,232,0.839,0.871
"12956","Cochabamba","Sipesipe","Unidad Educativa Eduardo Abaroa",21,0,1,0,154,2,10,0,1,189,4,15,208,225,0.815,0.924
"12957","Cochabamba","Sipesipe","Unidad Educativa Eduardo Abaroa",18,1,0,2,156,2,8,0,0,187,5,11,203,227,0.834,0.894
"12958","Cochabamba","Sipesipe","Unidad Educativa Eduardo Abaroa",17,2,1,2,141,3,14,1,0,181,8,12,201,224,0.779,0.897
"12959","Cochabamba","Sipesipe","Unidad Educativa Eduardo Abaroa",29,0,1,1,120,7,17,1,0,176,3,15,194,222,0.682,0.874
"12960","Cochabamba","Sipesipe","Unidad Educativa Eduardo Abaroa",25,0,1,0,131,2,20,1,1,181,4,11,196,220,0.724,0.891
"12961","Cochabamba","Sipesipe","Escuela Bolviana Americana",27,2,0,0,139,1,22,0,1,192,2,9,203,226,0.724,0.898
"12962","Cochabamba","Sipesipe","Escuela Bolviana Americana",23,0,2,0,141,6,22,1,0,195,4,4,203,229,0.723,0.886
"12963","Cochabamba","Sipesipe","Escuela Bolviana Americana",28,0,0,1,131,5,20,0,1,186,0,12,198,221,0.704,0.896
"12964","Cochabamba","Sipesipe","Escuela Bolviana Americana",25,1,1,0,147,3,24,0,1,202,1,9,212,229,0.728,0.926
"12965","Cochabamba","Sipesipe","Escuela Bolviana Americana",23,0,1,0,147,1,20,0,0,192,3,12,207,229,0.766,0.904
"12966","Cochabamba","Sipesipe","Escuela Bolviana Americana",29,2,1,1,148,3,15,0,1,200,4,8,212,230,0.74,0.922
"12967","Cochabamba","Sipesipe","Escuela Bolviana Americana",12,1,3,0,171,1,21,0,0,209,7,5,221,235,0.818,0.94
"12968","Cochabamba","Sipesipe","Escuela Bolviana Americana",21,1,1,0,149,3,20,0,0,195,5,14,214,227,0.764,0.943
"12969","Cochabamba","Sipesipe","Escuela Bolviana Americana",23,1,1,0,146,4,15,0,1,191,2,5,198,217,0.764,0.912
"12970","Cochabamba","Sipesipe","Escuela Bolviana Americana",31,1,1,2,129,1,34,0,0,199,0,10,209,223,0.648,0.937
"12971","Cochabamba","Sipesipe","Escuela Bolviana Americana",32,1,1,0,143,3,18,1,2,201,2,11,214,226,0.711,0.947
"12972","Cochabamba","Sipesipe","Escuela Bolviana Americana",40,0,0,0,134,0,21,0,1,196,3,5,204,221,0.684,0.923
"12973","Cochabamba","Sipesipe","Escuela Bolviana Americana",29,0,0,0,134,3,24,0,1,191,2,6,199,229,0.702,0.869
"12974","Cochabamba","Sipesipe","Unidad Educativa Uchu Uchu",1,0,3,0,173,1,2,3,0,183,1,30,214,226,0.945,0.947
"12975","Cochabamba","Sipesipe","Unidad Educativa Uchu Uchu",1,1,0,0,211,0,2,1,0,216,5,6,227,234,0.977,0.97
"12976","Cochabamba","Sipesipe","Unidad Educativa Caramarca Collpa",16,0,2,0,161,3,8,0,0,190,6,6,202,231,0.847,0.874
"12977","Cochabamba","Sipesipe","Unidad Educativa Caramarca Collpa",12,0,0,4,147,4,7,1,0,175,13,7,195,223,0.84,0.874
"12978","Cochabamba","Sipesipe","Unidad Educativa Caramarca Collpa",13,2,0,0,153,7,10,2,2,189,7,5,201,230,0.81,0.874
"12979","Cochabamba","Sipesipe","Unidad Educativa 3 de Abril",34,2,2,0,138,6,28,0,0,210,3,8,221,232,0.657,0.953
"12980","Cochabamba","Sipesipe","Unidad Educativa 3 de Abril",54,0,4,0,117,3,31,0,1,210,0,14,224,237,0.557,0.945
"12981","Cochabamba","Sipesipe","Unidad Educativa 3 de Abril",25,4,0,3,141,4,26,0,2,205,6,5,216,233,0.688,0.927
"12982","Cochabamba","Sipesipe","Unidad Educativa 3 de Abril",25,1,2,0,157,2,22,0,0,209,5,11,225,236,0.751,0.953
"12983","Cochabamba","Sipesipe","Unidad Educativa 3 de Abril",41,2,2,0,126,3,30,0,1,205,2,14,221,232,0.615,0.953
"12984","Cochabamba","Sipesipe","Unidad Educativa 3 de Abril",32,1,4,0,128,5,30,2,0,202,2,7,211,236,0.634,0.894
"12985","Cochabamba","Sipesipe","Unidad Educativa 3 de Abril",30,2,0,0,138,7,33,0,0,210,1,8,219,235,0.657,0.932
"12986","Cochabamba","Sipesipe","Unidad Educativa 3 de Abril",43,1,4,0,113,7,30,0,1,199,4,11,214,234,0.568,0.915
"12987","Cochabamba","Sipesipe","Unidad Educativa Toribio Claure",12,0,1,0,187,2,3,0,1,206,0,9,215,230,0.908,0.935
"12988","Cochabamba","Sipesipe","Unidad Educativa Toribio Claure",4,0,0,1,194,0,9,0,0,208,2,3,213,227,0.933,0.938
"12989","Cochabamba","Sipesipe","Unidad Educativa  Caviloma",22,0,1,0,165,2,24,0,0,214,3,9,226,236,0.771,0.958
"12990","Cochabamba","Sipesipe","Unidad Educativa  Caviloma",6,1,0,0,167,1,34,0,1,210,5,11,226,239,0.795,0.946
"12991","Cochabamba","Sipesipe","Unidad Educativa  Caviloma",14,1,0,0,156,4,34,0,3,212,4,10,226,238,0.736,0.95
"12992","Cochabamba","Sipesipe","Unidad Educativa  Caviloma",23,0,0,0,134,6,30,0,1,194,5,12,211,222,0.691,0.95
"12993","Cochabamba","Sipesipe","U. E. Viloma Cala Cala",13,0,0,0,205,3,11,0,1,233,2,4,239,240,0.88,0.996
"12994","Cochabamba","Sipesipe","U. E. Viloma Cala Cala",7,2,3,0,207,1,2,0,3,225,1,9,235,239,0.92,0.983
"12995","Cochabamba","Tiquipaya","Colegio San Miguel (Tiquipaya)",68,1,2,1,99,3,20,1,2,197,4,5,206,230,0.503,0.896
"12996","Cochabamba","Tiquipaya","Colegio San Miguel (Tiquipaya)",80,0,0,0,106,1,7,0,2,196,0,7,203,229,0.541,0.886
"12997","Cochabamba","Tiquipaya","Colegio San Miguel (Tiquipaya)",72,1,1,0,87,6,14,0,1,182,1,8,191,225,0.478,0.849
"12998","Cochabamba","Tiquipaya","Colegio San Miguel (Tiquipaya)",76,0,3,1,103,5,11,2,0,201,5,8,214,233,0.512,0.918
"12999","Cochabamba","Tiquipaya","Colegio San Miguel (Tiquipaya)",78,2,0,0,87,3,19,1,0,190,6,6,202,227,0.458,0.89
"13000","Cochabamba","Tiquipaya","Colegio San Miguel (Tiquipaya)",61,0,1,1,108,0,26,0,5,202,3,9,214,235,0.535,0.911
"13001","Cochabamba","Tiquipaya","Colegio San Miguel (Tiquipaya)",67,0,2,0,112,4,20,0,0,205,0,10,215,233,0.546,0.923
"13002","Cochabamba","Tiquipaya","Colegio San Miguel (Tiquipaya)",75,0,1,0,105,1,12,1,1,196,1,5,202,227,0.536,0.89
"13003","Cochabamba","Tiquipaya","Colegio San Miguel (Tiquipaya)",65,1,2,1,95,2,17,1,0,184,2,16,202,226,0.516,0.894
"13004","Cochabamba","Tiquipaya","Colegio San Miguel (Tiquipaya)",84,0,1,1,106,3,10,0,3,208,0,3,211,233,0.51,0.906
"13005","Cochabamba","Tiquipaya","Colegio San Miguel (Tiquipaya)",71,0,1,0,92,1,17,0,2,184,1,11,196,224,0.5,0.875
"13006","Cochabamba","Tiquipaya","Colegio San Miguel (Tiquipaya)",90,1,3,1,86,4,16,0,1,202,0,2,204,228,0.426,0.895
"13007","Cochabamba","Tiquipaya","Colegio San Miguel (Tiquipaya)",71,2,3,0,98,4,15,0,4,197,1,6,204,222,0.497,0.919
"13008","Cochabamba","Tiquipaya","Colegio San Miguel (Tiquipaya)",69,1,3,0,109,3,16,0,0,201,3,8,212,229,0.542,0.926
"13009","Cochabamba","Tiquipaya","Colegio San Miguel (Tiquipaya)",75,2,1,1,93,4,19,0,2,197,3,9,209,229,0.472,0.913
"13010","Cochabamba","Tiquipaya","Colegio San Miguel (Tiquipaya)",72,1,3,1,110,4,9,0,0,200,1,5,206,223,0.55,0.924
"13011","Cochabamba","Tiquipaya","Colegio San Miguel (Tiquipaya)",67,0,2,0,108,5,13,0,2,197,3,9,209,226,0.548,0.925
"13012","Cochabamba","Tiquipaya","Colegio San Miguel (Tiquipaya)",85,2,3,2,84,5,9,0,2,192,4,7,203,226,0.438,0.898
"13013","Cochabamba","Tiquipaya","Colegio San Miguel (Tiquipaya)",75,1,5,0,101,3,13,0,2,200,2,7,209,233,0.505,0.897
"13014","Cochabamba","Tiquipaya","Colegio San Miguel (Tiquipaya)",60,0,1,0,100,3,17,0,0,181,0,19,200,223,0.552,0.897
"13015","Cochabamba","Tiquipaya","Colegio San Miguel (Tiquipaya)",83,0,1,0,83,6,15,1,1,190,0,7,197,225,0.437,0.876
"13016","Cochabamba","Tiquipaya","Colegio San Miguel (Tiquipaya)",69,1,2,2,101,1,14,2,2,194,1,6,201,230,0.521,0.874
"13017","Cochabamba","Tiquipaya","Colegio San Miguel (Tiquipaya)",91,2,4,0,78,3,15,0,2,195,2,7,204,227,0.4,0.899
"13018","Cochabamba","Tiquipaya","Colegio San Miguel (Tiquipaya)",90,0,1,0,86,8,10,1,1,197,2,7,206,228,0.437,0.904
"13019","Cochabamba","Tiquipaya","Colegio Simon Bolivar (Tiquipaya)",58,0,3,0,114,4,20,0,0,199,1,7,207,236,0.573,0.877
"13020","Cochabamba","Tiquipaya","Colegio Simon Bolivar (Tiquipaya)",66,1,0,0,118,4,10,1,0,200,4,4,208,229,0.59,0.908
"13021","Cochabamba","Tiquipaya","Colegio Simon Bolivar (Tiquipaya)",59,1,1,0,107,5,18,0,2,193,1,7,201,227,0.554,0.885
"13022","Cochabamba","Tiquipaya","Colegio Simon Bolivar (Tiquipaya)",84,0,2,0,97,3,10,0,0,196,0,7,203,229,0.495,0.886
"13023","Cochabamba","Tiquipaya","Colegio Simon Bolivar (Tiquipaya)",78,0,1,0,80,6,24,1,3,193,1,6,200,229,0.415,0.873
"13024","Cochabamba","Tiquipaya","Colegio Simon Bolivar (Tiquipaya)",76,0,0,0,106,5,13,0,0,200,1,9,210,231,0.53,0.909
"13025","Cochabamba","Tiquipaya","Colegio Simon Bolivar (Tiquipaya)",57,0,3,1,103,5,17,1,1,188,4,15,207,231,0.548,0.896
"13026","Cochabamba","Tiquipaya","Colegio Simon Bolivar (Tiquipaya)",65,0,3,0,113,6,10,0,1,198,3,10,211,232,0.571,0.909
"13027","Cochabamba","Tiquipaya","Colegio Simon Bolivar (Tiquipaya)",61,1,1,0,120,2,13,1,2,201,5,9,215,233,0.597,0.923
"13028","Cochabamba","Tiquipaya","Colegio Simon Bolivar (Tiquipaya)",63,1,1,2,114,2,15,0,1,199,2,6,207,228,0.573,0.908
"13029","Cochabamba","Tiquipaya","Colegio Simon Bolivar (Tiquipaya)",75,1,2,0,101,5,9,1,0,194,1,7,202,229,0.521,0.882
"13030","Cochabamba","Tiquipaya","Colegio Simon Bolivar (Tiquipaya)",85,1,0,0,91,2,18,0,0,197,2,11,210,234,0.462,0.897
"13031","Cochabamba","Tiquipaya","Colegio Simon Bolivar (Tiquipaya)",63,0,2,0,106,3,17,0,1,192,0,7,199,227,0.552,0.877
"13032","Cochabamba","Tiquipaya","Colegio Simon Bolivar (Tiquipaya)",60,0,1,1,111,1,16,2,1,193,3,16,212,232,0.575,0.914
"13033","Cochabamba","Tiquipaya","Colegio Simon Bolivar (Tiquipaya)",64,1,1,0,99,3,16,2,1,187,2,9,198,222,0.529,0.892
"13034","Cochabamba","Tiquipaya","Colegio Simon Bolivar (Tiquipaya)",36,1,0,0,133,2,18,2,1,193,8,8,209,227,0.689,0.921
"13035","Cochabamba","Tiquipaya","Colegio Simon Bolivar (Tiquipaya)",53,0,0,1,130,7,14,0,0,205,1,5,211,236,0.634,0.894
"13036","Cochabamba","Tiquipaya","Colegio Simon Bolivar (Tiquipaya)",76,1,2,0,86,8,18,1,1,193,1,10,204,226,0.446,0.903
"13037","Cochabamba","Tiquipaya","Colegio Simon Bolivar (Tiquipaya)",65,0,2,0,113,8,9,0,2,199,3,3,205,227,0.568,0.903
"13038","Cochabamba","Tiquipaya","Colegio Simon Bolivar (Tiquipaya)",75,0,1,0,101,2,12,0,0,191,0,10,201,228,0.529,0.882
"13039","Cochabamba","Tiquipaya","Colegio Simon Bolivar (Tiquipaya)",66,1,0,0,108,1,10,0,2,188,2,10,200,232,0.574,0.862
"13040","Cochabamba","Tiquipaya","Colegio Simon Bolivar (Tiquipaya)",91,1,2,0,87,2,9,0,0,192,2,9,203,227,0.453,0.894
"13041","Cochabamba","Tiquipaya","Colegio Simon Bolivar (Tiquipaya)",65,1,0,1,108,4,19,1,5,204,1,8,213,230,0.529,0.926
"13042","Cochabamba","Tiquipaya","Colegio Simon Bolivar (Tiquipaya)",68,2,2,1,98,5,12,0,0,188,1,10,199,232,0.521,0.858
"13043","Cochabamba","Tiquipaya","Colegio Simon Bolivar (Tiquipaya)",85,0,0,0,106,4,7,0,4,206,1,5,212,226,0.515,0.938
"13044","Cochabamba","Tiquipaya","Colegio Simon Bolivar (Tiquipaya)",68,0,2,0,102,3,9,0,3,187,3,11,201,221,0.545,0.91
"13045","Cochabamba","Tiquipaya","Colegio Simon Bolivar (Tiquipaya)",68,0,0,0,111,2,12,0,2,195,1,1,197,227,0.569,0.868
"13046","Cochabamba","Tiquipaya","Colegio Simon Bolivar (Tiquipaya)",74,1,2,0,101,3,10,1,1,193,3,6,202,227,0.523,0.89
"13047","Cochabamba","Tiquipaya","Colegio Simon Bolivar (Tiquipaya)",83,0,3,1,81,2,15,0,3,188,0,9,197,221,0.431,0.891
"13048","Cochabamba","Tiquipaya","Colegio Simon Bolivar (Tiquipaya)",67,0,1,0,69,2,13,0,1,153,2,4,159,177,0.451,0.898
"13049","Cochabamba","Tiquipaya","U.E. La Floresta",72,0,1,1,113,7,21,1,0,216,3,7,226,240,0.523,0.942
"13050","Cochabamba","Tiquipaya","U.E. La Floresta",80,0,3,0,83,5,21,0,2,194,1,5,200,208,0.428,0.962
"13051","Cochabamba","Tiquipaya","U.E. Monseñor Salomón Romero",99,0,0,0,91,5,20,1,1,217,1,8,226,240,0.419,0.942
"13052","Cochabamba","Tiquipaya","U.E. Monseñor Salomón Romero",99,2,0,0,78,9,30,0,4,222,1,2,225,239,0.351,0.941
"13053","Cochabamba","Tiquipaya","U.E. Monseñor Salomón Romero",105,2,0,0,93,5,14,1,0,220,1,5,226,239,0.423,0.946
"13054","Cochabamba","Tiquipaya","U.E. Monseñor Salomón Romero",94,0,2,0,97,3,19,1,0,216,1,5,222,237,0.449,0.937
"13055","Cochabamba","Tiquipaya","U.E. Monseñor Salomón Romero",102,0,3,0,79,3,22,0,5,214,1,9,224,238,0.369,0.941
"13056","Cochabamba","Tiquipaya","U.E. Monseñor Salomón Romero",103,0,0,0,86,2,19,0,0,210,1,2,213,224,0.41,0.951
"13057","Cochabamba","Tiquipaya","Escuela Toribio Claure",93,0,2,0,90,5,9,0,0,199,2,10,211,229,0.452,0.921
"13058","Cochabamba","Tiquipaya","Escuela Toribio Claure",102,1,1,0,87,4,8,0,1,204,0,6,210,234,0.426,0.897
"13059","Cochabamba","Tiquipaya","Escuela Toribio Claure",90,0,0,0,86,2,14,0,1,193,0,5,198,227,0.446,0.872
"13060","Cochabamba","Tiquipaya","Escuela Toribio Claure",90,1,1,0,89,4,8,1,2,196,2,6,204,233,0.454,0.876
"13061","Cochabamba","Tiquipaya","Escuela Toribio Claure",79,0,0,0,86,3,16,0,3,187,1,9,197,224,0.46,0.879
"13062","Cochabamba","Tiquipaya","Escuela Toribio Claure",93,0,2,2,83,2,8,0,0,190,0,7,197,225,0.437,0.876
"13063","Cochabamba","Tiquipaya","Escuela Toribio Claure",69,0,1,1,105,7,15,1,1,200,0,10,210,230,0.525,0.913
"13064","Cochabamba","Tiquipaya","Escuela Toribio Claure",60,0,3,0,111,6,18,1,1,200,1,10,211,228,0.555,0.925
"13065","Cochabamba","Tiquipaya","Escuela Toribio Claure",63,0,4,0,93,3,19,0,5,187,0,8,195,226,0.497,0.863
"13066","Cochabamba","Tiquipaya","Escuela Toribio Claure",76,0,0,0,97,6,9,0,0,188,2,4,194,222,0.516,0.874
"13067","Cochabamba","Tiquipaya","Escuela Toribio Claure",89,0,2,1,96,6,17,0,0,211,1,3,215,231,0.455,0.931
"13068","Cochabamba","Tiquipaya","Escuela Toribio Claure",76,1,0,0,100,8,11,0,1,197,2,10,209,225,0.508,0.929
"13069","Cochabamba","Tiquipaya","Escuela Toribio Claure",95,2,0,1,78,6,10,0,0,192,0,8,200,224,0.406,0.893
"13070","Cochabamba","Tiquipaya","Escuela Toribio Claure",100,0,1,0,80,3,13,0,0,197,0,10,207,230,0.406,0.9
"13071","Cochabamba","Tiquipaya","Escuela Toribio Claure",90,1,1,1,84,1,19,1,3,201,3,3,207,229,0.418,0.904
"13072","Cochabamba","Tiquipaya","Escuela Toribio Claure",79,0,1,0,99,2,16,0,0,197,1,7,205,227,0.503,0.903
"13073","Cochabamba","Tiquipaya","Escuela Toribio Claure",62,0,0,1,106,4,20,1,2,196,2,8,206,231,0.541,0.892
"13074","Cochabamba","Tiquipaya","Escuela Toribio Claure",93,0,0,0,89,7,7,0,0,196,1,5,202,228,0.454,0.886
"13075","Cochabamba","Tiquipaya","Escuela Toribio Claure",88,2,1,0,77,4,19,0,0,191,4,6,201,227,0.403,0.885
"13076","Cochabamba","Tiquipaya","Escuela Toribio Claure",95,0,2,0,87,4,6,0,2,196,1,10,207,232,0.444,0.892
"13077","Cochabamba","Tiquipaya","Escuela Toribio Claure",97,0,5,0,85,3,12,1,0,203,2,8,213,230,0.419,0.926
"13078","Cochabamba","Tiquipaya","Escuela Toribio Claure",87,0,2,1,93,2,15,0,3,203,2,4,209,229,0.458,0.913
"13079","Cochabamba","Tiquipaya","Escuela Toribio Claure",56,0,0,0,109,4,21,1,2,193,3,6,202,229,0.565,0.882
"13080","Cochabamba","Tiquipaya","Escuela Toribio Claure",78,1,1,0,98,7,9,1,2,197,3,8,208,230,0.497,0.904
"13081","Cochabamba","Tiquipaya","Escuela Toribio Claure",114,1,0,0,77,3,8,0,0,203,0,6,209,232,0.379,0.901
"13082","Cochabamba","Tiquipaya","Escuela Toribio Claure",111,0,1,0,80,2,10,0,1,205,1,4,210,225,0.39,0.933
"13083","Cochabamba","Tiquipaya","Escuela Toribio Claure",107,0,0,0,73,3,14,0,1,198,3,8,209,228,0.369,0.917
"13084","Cochabamba","Tiquipaya","Escuela Toribio Claure",98,2,0,1,96,2,12,0,1,212,0,1,213,229,0.453,0.93
"13085","Cochabamba","Tiquipaya","Escuela Toribio Claure",119,1,1,0,68,5,8,0,0,202,0,8,210,232,0.337,0.905
"13086","Cochabamba","Tiquipaya","Escuela Toribio Claure",101,1,1,1,90,2,5,2,2,205,1,3,209,232,0.439,0.901
"13087","Cochabamba","Tiquipaya","Escuela Toribio Claure",101,1,1,1,98,4,9,0,1,216,0,4,220,234,0.454,0.94
"13088","Cochabamba","Tiquipaya","Unidad Educativa Jesus Maestro",76,1,1,0,107,5,18,0,4,212,3,7,222,237,0.505,0.937
"13089","Cochabamba","Tiquipaya","Unidad Educativa Jesus Maestro",73,1,0,0,120,2,20,0,1,217,2,5,224,238,0.553,0.941
"13090","Cochabamba","Tiquipaya","Unidad Educativa Jesus Maestro",58,0,0,0,146,0,20,0,0,224,1,0,225,236,0.652,0.953
"13091","Cochabamba","Tiquipaya","Unidad Educativa Jesus Maestro",68,0,0,1,127,2,16,0,1,215,0,6,221,235,0.591,0.94
"13092","Cochabamba","Tiquipaya","Unidad Educativa Jesus Maestro",74,1,1,0,109,5,26,1,1,218,3,6,227,236,0.5,0.962
"13093","Cochabamba","Tiquipaya","Unidad Educativa Jesus Maestro",60,1,0,0,122,3,25,1,1,213,0,12,225,238,0.573,0.945
"13094","Cochabamba","Tiquipaya","Unidad Educativa Jesus Maestro",80,0,3,0,100,4,21,2,2,212,1,7,220,232,0.472,0.948
"13095","Cochabamba","Tiquipaya","Unidad Educativa Jesus Maestro",74,1,1,1,111,3,18,0,1,210,2,4,216,236,0.529,0.915
"13096","Cochabamba","Tiquipaya","Unidad Educativa Jesus Maestro",67,0,3,1,123,2,21,0,2,219,2,6,227,238,0.562,0.954
"13097","Cochabamba","Tiquipaya","Unidad Educativa Jesus Maestro",77,0,0,2,110,1,25,0,3,218,0,7,225,238,0.505,0.945
"13098","Cochabamba","Tiquipaya","Unidad Educativa Cuatro Esquinas",88,0,4,1,84,6,9,0,0,192,2,8,202,227,0.438,0.89
"13099","Cochabamba","Tiquipaya","Unidad Educativa Cuatro Esquinas",79,0,0,0,98,3,9,0,1,190,4,8,202,227,0.516,0.89
"13100","Cochabamba","Tiquipaya","Unidad Educativa Cuatro Esquinas",92,3,0,0,96,2,8,1,1,203,0,11,214,228,0.473,0.939
"13101","Cochabamba","Tiquipaya","Unidad Educativa Cuatro Esquinas",65,1,3,0,116,4,7,0,0,196,1,3,200,230,0.592,0.87
"13102","Cochabamba","Tiquipaya","Unidad Educativa Cuatro Esquinas",110,0,3,0,79,6,4,0,2,204,0,3,207,225,0.387,0.92
"13103","Cochabamba","Tiquipaya","Unidad Educativa Cuatro Esquinas",71,1,4,0,98,5,9,1,3,192,2,8,202,228,0.51,0.886
"13104","Cochabamba","Tiquipaya","Unidad Educativa Cuatro Esquinas",91,1,2,0,94,3,10,0,2,203,3,1,207,230,0.463,0.9
"13105","Cochabamba","Tiquipaya","Nucleo Educativo Chapisirca",8,1,0,0,180,0,8,0,1,198,7,3,208,224,0.909,0.929
"13106","Cochabamba","Tiquipaya","Nucleo Educativo Chapisirca",1,1,2,0,192,1,0,0,0,197,5,6,208,227,0.975,0.916
"13107","Cochabamba","Tiquipaya","Nucleo Educativo Chapisirca",0,2,0,0,181,0,6,1,2,192,2,7,201,221,0.943,0.91
"13108","Cochabamba","Tiquipaya","Nucleo Educativo Chapisirca",0,0,1,0,188,2,5,0,0,196,5,9,210,223,0.959,0.942
"13109","Cochabamba","Tiquipaya","Unidad Educativa Libertad",89,0,0,3,87,2,2,0,0,183,1,8,192,233,0.475,0.824
"13110","Cochabamba","Tiquipaya","Unidad Educativa Libertad",89,0,0,0,93,6,7,0,4,199,2,11,212,231,0.467,0.918
"13111","Cochabamba","Tiquipaya","Unidad Educativa Libertad",107,1,0,0,83,1,12,1,2,207,2,6,215,235,0.401,0.915
"13112","Cochabamba","Tiquipaya","Unidad Educativa Libertad",76,0,2,0,92,4,20,0,4,198,0,15,213,231,0.465,0.922
"13113","Cochabamba","Tiquipaya","Unidad Educativa Libertad",92,0,0,0,91,4,11,0,0,198,1,9,208,228,0.46,0.912
"13114","Cochabamba","Tiquipaya","Unidad Educativa Libertad",69,0,3,0,100,7,14,3,3,199,4,7,210,233,0.503,0.901
"13115","Cochabamba","Tiquipaya","Unidad Educativa Libertad",54,0,2,0,119,6,17,0,1,199,2,6,207,229,0.598,0.904
"13116","Cochabamba","Tiquipaya","Unidad Educativa Libertad",92,0,3,0,88,2,11,1,2,199,2,8,209,228,0.442,0.917
"13117","Cochabamba","Tiquipaya","Unidad Educativa Libertad",90,2,0,0,88,3,17,0,0,200,2,7,209,231,0.44,0.905
"13118","Cochabamba","Tiquipaya","Unidad Educativa Libertad",90,1,0,1,97,4,13,1,2,209,2,5,216,234,0.464,0.923
"13119","Cochabamba","Tiquipaya","Unidad Educativa Libertad",92,2,1,2,79,2,18,0,2,198,2,13,213,230,0.399,0.926
"13120","Cochabamba","Tiquipaya","Unidad Educativa Libertad",82,0,1,0,97,4,17,0,1,202,0,10,212,233,0.48,0.91
"13121","Cochabamba","Tiquipaya","Unidad Educativa Libertad",69,1,3,0,101,4,21,2,1,202,1,7,210,226,0.5,0.929
"13122","Cochabamba","Tiquipaya","Unidad Educativa Libertad",85,1,1,1,95,3,15,0,2,203,0,10,213,234,0.468,0.91
"13123","Cochabamba","Tiquipaya","Unidad Educativa Libertad",63,0,1,0,108,6,18,0,1,197,4,8,209,226,0.548,0.925
"13124","Cochabamba","Tiquipaya","Unidad Educativa Libertad",82,1,0,0,102,0,12,0,1,198,0,5,203,226,0.515,0.898
"13125","Cochabamba","Tiquipaya","Unidad Educativa Libertad",82,4,0,1,92,5,19,0,1,204,3,4,211,229,0.451,0.921
"13126","Cochabamba","Tiquipaya","Unidad Educativa Libertad",95,0,0,1,84,3,16,0,2,201,0,8,209,228,0.418,0.917
"13127","Cochabamba","Tiquipaya","Unidad Educativa Libertad",93,1,0,0,87,5,12,0,1,199,1,7,207,224,0.437,0.924
"13128","Cochabamba","Tiquipaya","Unidad Educativa Libertad",96,1,1,0,85,3,14,0,0,200,4,10,214,234,0.425,0.915
"13129","Cochabamba","Tiquipaya","Unidad Educativa Libertad",113,0,1,2,65,5,18,2,2,208,2,5,215,230,0.312,0.935
"13130","Cochabamba","Tiquipaya","Unidad Educativa Libertad",100,3,2,1,71,4,11,1,1,194,1,9,204,229,0.366,0.891
"13131","Cochabamba","Tiquipaya","Unidad Educativa Libertad",78,0,1,2,99,3,21,0,2,206,2,24,232,232,0.481,1
"13132","Cochabamba","Tiquipaya","Unidad Educativa Libertad",97,0,1,0,99,3,10,0,0,210,1,3,214,232,0.471,0.922
"13133","Cochabamba","Tiquipaya","Unidad Educativa Libertad",91,0,0,1,93,2,17,0,0,204,0,2,206,225,0.456,0.916
"13134","Cochabamba","Tiquipaya","Escuela Eugenia Ravasco",111,1,2,0,84,6,8,1,1,214,6,5,225,233,0.393,0.966
"13135","Cochabamba","Tiquipaya","Escuela Eugenia Ravasco",112,1,0,0,80,3,5,1,2,204,1,7,212,227,0.392,0.934
"13136","Cochabamba","Tiquipaya","Escuela Eugenia Ravasco",94,0,2,0,93,6,11,0,1,207,1,10,218,233,0.449,0.936
"13137","Cochabamba","Tiquipaya","Escuela Eugenia Ravasco",113,1,0,0,65,6,13,1,3,202,1,5,208,229,0.322,0.908
"13138","Cochabamba","Tiquipaya","Escuela Eugenia Ravasco",91,1,0,0,94,7,7,0,2,202,3,10,215,231,0.465,0.931
"13139","Cochabamba","Tiquipaya","Escuela Eugenia Ravasco",86,1,0,0,95,6,12,1,1,202,0,8,210,225,0.47,0.933
"13140","Cochabamba","Tiquipaya","Escuela Eugenia Ravasco",103,1,0,0,85,6,5,0,4,204,1,9,214,231,0.417,0.926
"13141","Cochabamba","Tiquipaya","Escuela Eugenia Ravasco",116,0,0,0,70,3,5,0,0,194,2,7,203,223,0.361,0.91
"13142","Cochabamba","Tiquipaya","Escuela Isaac Attie",124,1,2,2,59,4,6,1,1,200,0,7,207,230,0.295,0.9
"13143","Cochabamba","Tiquipaya","Escuela Isaac Attie",111,1,0,1,71,7,13,1,2,207,2,3,212,231,0.343,0.918
"13144","Cochabamba","Tiquipaya","Escuela Isaac Attie",93,1,0,1,94,3,12,1,0,205,0,4,209,234,0.459,0.893
"13145","Cochabamba","Tiquipaya","Escuela Isaac Attie",128,0,1,0,48,5,12,0,3,197,3,7,207,224,0.244,0.924
"13146","Cochabamba","Tiquipaya","Escuela Isaac Attie",130,0,1,0,65,4,2,1,1,204,2,3,209,231,0.319,0.905
"13147","Cochabamba","Tiquipaya","Escuela Isaac Attie",111,1,3,0,57,6,15,0,0,193,3,9,205,228,0.295,0.899
"13148","Cochabamba","Tiquipaya","Escuela Isaac Attie",110,2,0,0,67,5,11,0,2,197,0,5,202,231,0.34,0.874
"13149","Cochabamba","Tiquipaya","Escuela Isaac Attie",126,1,0,1,52,5,7,1,3,196,1,4,201,224,0.265,0.897
"13150","Cochabamba","Tiquipaya","Escuela Isaac Attie",127,0,0,0,70,6,12,2,0,217,1,3,221,237,0.323,0.932
"13151","Cochabamba","Tiquipaya","Escuela Isaac Attie",127,0,1,0,58,6,9,1,0,202,0,6,208,227,0.287,0.916
"13152","Cochabamba","Tiquipaya","Escuela Isaac Attie",123,1,2,1,60,6,11,0,3,207,0,3,210,233,0.29,0.901
"13153","Cochabamba","Tiquipaya","Aldeas S.O.S",119,1,1,1,70,4,10,0,1,207,2,4,213,230,0.338,0.926
"13154","Cochabamba","Tiquipaya","Aldeas S.O.S",104,0,1,0,64,5,17,0,2,193,0,3,196,225,0.332,0.871
"13155","Cochabamba","Tiquipaya","Aldeas S.O.S",73,0,2,2,97,4,9,1,1,189,0,6,195,231,0.513,0.844
"13156","Cochabamba","Tiquipaya","Aldeas S.O.S",97,0,0,0,89,5,4,0,0,195,0,8,203,229,0.456,0.886
"13157","Cochabamba","Tiquipaya","Aldeas S.O.S",92,1,0,1,91,5,7,1,2,200,1,5,206,226,0.455,0.912
"13158","Cochabamba","Tiquipaya","Aldeas S.O.S",82,0,0,1,94,5,14,1,0,197,3,7,207,235,0.477,0.881
"13159","Cochabamba","Tiquipaya","Aldeas S.O.S",100,0,1,0,73,2,7,0,1,184,1,11,196,219,0.397,0.895
"13160","Cochabamba","Tiquipaya","Aldeas S.O.S",109,0,2,1,73,4,15,0,1,205,0,4,209,232,0.356,0.901
"13161","Cochabamba","Tiquipaya","Aldeas S.O.S",96,0,0,0,73,5,19,0,1,194,5,3,202,224,0.376,0.902
"13162","Cochabamba","Tiquipaya","Aldeas S.O.S",96,0,1,0,79,6,10,1,1,194,3,5,202,227,0.407,0.89
"13163","Cochabamba","Tiquipaya","Aldeas S.O.S",106,1,0,1,73,3,12,1,1,198,3,3,204,228,0.369,0.895
"13164","Cochabamba","Tiquipaya","Aldeas S.O.S",116,1,0,0,77,3,9,1,0,207,0,5,212,229,0.372,0.926
"13165","Cochabamba","Tiquipaya","Colegio Cristo Nación (Ue Bolivia Japón)",141,0,1,0,53,2,8,1,0,206,1,5,212,235,0.257,0.902
"13166","Cochabamba","Tiquipaya","Colegio Cristo Nación (Ue Bolivia Japón)",109,0,1,2,37,3,6,2,1,161,0,4,165,180,0.23,0.917
"13167","Cochabamba","Tiquipaya","U. E. Titos Linde",122,0,0,0,58,1,8,0,1,190,2,7,199,207,0.305,0.961
"13168","Cochabamba","Tiquipaya","Unidad Educativa Nuestra Sra. De Altagracia",60,1,0,1,114,2,12,0,3,193,1,6,200,224,0.591,0.893
"13169","Cochabamba","Tiquipaya","Unidad Educativa Nuestra Sra. De Altagracia",64,0,0,0,118,4,12,0,2,200,2,9,211,231,0.59,0.913
"13170","Cochabamba","Tiquipaya","Unidad Educativa Montecillo",0,2,0,3,193,2,7,0,0,207,0,7,214,234,0.932,0.915
"13171","Cochabamba","Tiquipaya","U.E. Rumy Corral",2,2,5,0,188,2,8,0,0,207,7,10,224,233,0.908,0.961
"13172","Cochabamba","Vinto","Escuela Melchor Cuadros",92,0,1,0,82,7,8,0,5,195,5,10,210,225,0.421,0.933
"13173","Cochabamba","Vinto","Escuela Melchor Cuadros",80,0,0,1,89,2,22,0,3,197,2,4,203,220,0.452,0.923
"13174","Cochabamba","Vinto","Escuela Melchor Cuadros",86,2,0,0,80,3,24,1,2,198,2,6,206,230,0.404,0.896
"13175","Cochabamba","Vinto","Escuela Melchor Cuadros",75,0,2,0,106,2,16,0,0,201,0,6,207,226,0.527,0.916
"13176","Cochabamba","Vinto","Escuela Melchor Cuadros",74,2,3,1,92,3,20,0,0,195,3,6,204,228,0.472,0.895
"13177","Cochabamba","Vinto","Escuela Melchor Cuadros",77,0,0,1,102,5,18,0,2,205,2,4,211,228,0.498,0.925
"13178","Cochabamba","Vinto","Escuela Melchor Cuadros",77,1,1,2,92,2,13,0,5,193,2,10,205,225,0.477,0.911
"13179","Cochabamba","Vinto","Escuela Melchor Cuadros",65,0,1,0,88,2,27,1,0,184,2,6,192,221,0.478,0.869
"13180","Cochabamba","Vinto","Escuela Melchor Cuadros",78,1,0,0,83,5,12,0,3,182,3,13,198,223,0.456,0.888
"13181","Cochabamba","Vinto","Escuela Melchor Cuadros",53,1,1,1,114,4,20,1,3,198,2,14,214,224,0.576,0.955
"13182","Cochabamba","Vinto","Escuela Melchor Cuadros",85,2,0,2,86,3,18,0,2,198,1,5,204,232,0.434,0.879
"13183","Cochabamba","Vinto","Escuela Melchor Cuadros",77,0,4,0,93,5,20,0,2,201,5,6,212,231,0.463,0.918
"13184","Cochabamba","Vinto","Escuela Melchor Cuadros",63,0,0,1,98,3,25,2,1,193,3,14,210,227,0.508,0.925
"13185","Cochabamba","Vinto","Escuela Melchor Cuadros",80,0,0,0,85,2,22,1,2,192,0,13,205,228,0.443,0.899
"13186","Cochabamba","Vinto","Escuela Melchor Cuadros",55,0,2,2,105,5,22,0,1,192,1,10,203,228,0.547,0.89
"13187","Cochabamba","Vinto","Escuela Melchor Cuadros",63,1,2,1,103,3,21,0,3,197,1,9,207,223,0.523,0.928
"13188","Cochabamba","Vinto","Escuela Melchor Cuadros",91,0,5,0,78,2,17,1,3,197,2,5,204,227,0.396,0.899
"13189","Cochabamba","Vinto","Escuela Melchor Cuadros",89,2,0,0,88,5,13,0,4,201,4,3,208,222,0.438,0.937
"13190","Cochabamba","Vinto","Escuela Melchor Cuadros",83,0,1,1,73,4,19,0,7,188,4,11,203,231,0.388,0.879
"13191","Cochabamba","Vinto","Escuela Melchor Cuadros",67,0,3,1,87,4,23,0,1,186,2,13,201,221,0.468,0.91
"13192","Cochabamba","Vinto","Escuela Melchor Cuadros",63,1,3,1,90,6,28,0,3,195,1,8,204,228,0.462,0.895
"13193","Cochabamba","Vinto","Escuela Melchor Cuadros",73,1,3,1,94,3,18,1,0,194,3,8,205,227,0.485,0.903
"13194","Cochabamba","Vinto","Escuela Melchor Cuadros",70,1,0,2,103,4,14,1,1,196,7,4,207,222,0.526,0.932
"13195","Cochabamba","Vinto","Escuela Melchor Cuadros",56,1,1,1,102,4,24,1,3,193,2,9,204,231,0.528,0.883
"13196","Cochabamba","Vinto","Escuela Melchor Cuadros",39,1,1,0,127,4,18,2,4,196,4,10,210,226,0.648,0.929
"13197","Cochabamba","Vinto","Escuela Melchor Cuadros",60,1,2,1,100,1,27,0,1,193,1,12,206,223,0.518,0.924
"13198","Cochabamba","Vinto","Escuela Melchor Cuadros",79,2,2,1,90,2,12,0,0,188,1,8,197,227,0.479,0.868
"13199","Cochabamba","Vinto","Escuela Melchor Cuadros",66,1,0,0,95,3,16,0,4,185,1,13,199,219,0.514,0.909
"13200","Cochabamba","Vinto","Escuela Melchor Cuadros",80,0,0,1,84,6,21,0,2,194,3,8,205,226,0.433,0.907
"13201","Cochabamba","Vinto","Escuela Melchor Cuadros",86,1,0,1,79,4,15,0,2,188,3,7,198,222,0.42,0.892
"13202","Cochabamba","Vinto","Escuela Melchor Cuadros",70,0,3,0,90,6,14,0,1,184,1,14,199,221,0.489,0.9
"13203","Cochabamba","Vinto","Escuela Melchor Cuadros",75,1,5,1,98,3,11,0,2,196,2,7,205,222,0.5,0.923
"13204","Cochabamba","Vinto","Escuela Melchor Cuadros",67,0,0,0,83,7,25,0,3,185,1,9,195,227,0.449,0.859
"13205","Cochabamba","Vinto","Escuela Melchor Cuadros",59,1,1,2,90,5,23,0,2,183,3,7,193,217,0.492,0.889
"13206","Cochabamba","Vinto","Escuela Melchor Cuadros",55,0,2,0,117,3,17,0,3,197,2,8,207,228,0.594,0.908
"13207","Cochabamba","Vinto","Escuela Melchor Cuadros",77,1,1,0,93,4,14,0,2,192,2,11,205,226,0.484,0.907
"13208","Cochabamba","Vinto","Escuela Melchor Cuadros",91,1,0,0,97,3,10,1,1,204,1,4,209,230,0.475,0.909
"13209","Cochabamba","Vinto","Escuela Melchor Cuadros",69,0,1,3,98,3,18,0,1,193,2,5,200,221,0.508,0.905
"13210","Cochabamba","Vinto","Escuela Melchor Cuadros",87,0,0,0,74,4,19,0,2,186,0,11,197,223,0.398,0.883
"13211","Cochabamba","Vinto","Escuela Melchor Cuadros",80,0,3,0,84,2,18,2,5,194,2,3,199,227,0.433,0.877
"13212","Cochabamba","Vinto","Escuela Melchor Cuadros",84,1,3,1,99,0,12,0,2,202,3,9,214,221,0.49,0.968
"13213","Cochabamba","Vinto","Escuela Melchor Cuadros",79,0,0,0,87,4,18,2,2,192,2,9,203,222,0.453,0.914
"13214","Cochabamba","Vinto","Escuela Melchor Cuadros",81,0,0,1,77,2,19,0,1,181,3,6,190,217,0.425,0.876
"13215","Cochabamba","Vinto","Escuela Melchor Cuadros",95,2,0,0,81,3,16,1,2,200,2,9,211,228,0.405,0.925
"13216","Cochabamba","Vinto","Escuela Melchor Cuadros",81,0,3,1,80,6,24,0,3,198,6,4,208,229,0.404,0.908
"13217","Cochabamba","Vinto","Escuela Melchor Cuadros",76,3,0,0,85,4,18,0,3,189,4,7,200,218,0.45,0.917
"13218","Cochabamba","Vinto","Escuela Martín Cardenas",65,1,1,0,108,5,19,0,2,201,3,9,213,232,0.537,0.918
"13219","Cochabamba","Vinto","Escuela Martín Cardenas",68,0,2,0,102,2,18,0,3,195,3,10,208,226,0.523,0.92
"13220","Cochabamba","Vinto","Escuela Martín Cardenas",69,0,2,1,97,5,14,0,1,189,3,11,203,227,0.513,0.894
"13221","Cochabamba","Vinto","Escuela Martín Cardenas",58,0,1,1,100,4,19,0,2,185,3,7,195,227,0.541,0.859
"13222","Cochabamba","Vinto","Escuela Martín Cardenas",70,1,1,0,92,1,11,1,3,180,4,9,193,223,0.511,0.865
"13223","Cochabamba","Vinto","Escuela Martín Cardenas",72,1,0,0,99,3,11,1,5,192,3,9,204,231,0.516,0.883
"13224","Cochabamba","Vinto","Escuela Martín Cardenas",37,1,2,0,127,4,22,0,1,194,3,9,206,226,0.655,0.912
"13225","Cochabamba","Vinto","Escuela Martín Cardenas",51,1,0,1,128,2,15,0,2,200,4,6,210,231,0.64,0.909
"13226","Cochabamba","Vinto","Escuela Martín Cardenas",45,1,3,1,124,5,18,1,1,199,2,7,208,231,0.623,0.9
"13227","Cochabamba","Vinto","Escuela Martín Cardenas",63,1,1,1,108,1,16,0,0,191,1,6,198,219,0.565,0.904
"13228","Cochabamba","Vinto","Escuela Martín Cardenas",59,1,1,0,102,1,23,1,3,191,1,12,204,231,0.534,0.883
"13229","Cochabamba","Vinto","Escuela Martín Cardenas",73,2,0,0,101,3,15,0,0,194,2,17,213,229,0.521,0.93
"13230","Cochabamba","Vinto","Escuela Martín Cardenas",71,1,2,1,97,2,15,1,2,192,1,5,198,228,0.505,0.868
"13231","Cochabamba","Vinto","Escuela Martín Cardenas",53,0,2,0,108,6,29,0,0,198,1,12,211,228,0.545,0.925
"13232","Cochabamba","Vinto","Escuela Martín Cardenas",79,0,0,0,103,1,13,1,1,198,0,5,203,230,0.52,0.883
"13233","Cochabamba","Vinto","Escuela Martín Cardenas",50,1,3,1,109,5,28,0,1,198,1,9,208,231,0.551,0.9
"13234","Cochabamba","Vinto","Escuela Martín Cardenas",40,0,2,1,128,1,19,1,1,193,4,6,203,224,0.663,0.906
"13235","Cochabamba","Vinto","Escuela Martín Cardenas",51,0,1,1,109,4,20,1,2,189,2,4,195,230,0.577,0.848
"13236","Cochabamba","Vinto","Escuela Martín Cardenas",79,0,1,0,97,9,15,0,3,204,3,4,211,228,0.475,0.925
"13237","Cochabamba","Vinto","Escuela Martín Cardenas",73,0,2,0,92,3,20,2,2,194,0,9,203,224,0.474,0.906
"13238","Cochabamba","Vinto","Escuela Martín Cardenas",62,0,0,0,105,7,20,0,1,195,5,10,210,224,0.538,0.938
"13239","Cochabamba","Vinto","Escuela Martín Cardenas",70,0,0,0,92,2,21,0,3,188,1,11,200,222,0.489,0.901
"13240","Cochabamba","Vinto","Escuela Martín Cardenas",65,1,3,0,109,6,14,0,3,201,1,5,207,229,0.542,0.904
"13241","Cochabamba","Vinto","Escuela Martín Cardenas",59,0,1,0,108,3,23,0,0,194,4,9,207,232,0.557,0.892
"13242","Cochabamba","Vinto","Escuela Martín Cardenas",52,0,0,2,110,4,18,0,1,187,4,6,197,228,0.588,0.864
"13243","Cochabamba","Vinto","Escuela Martín Cardenas",52,2,2,0,108,4,16,0,2,186,1,6,193,228,0.581,0.846
"13244","Cochabamba","Vinto","Escuela Martín Cardenas",63,0,2,2,98,4,21,0,2,192,3,3,198,229,0.51,0.865
"13245","Cochabamba","Vinto","Escuela Martín Cardenas",68,2,0,0,111,2,19,1,2,205,0,5,210,226,0.541,0.929
"13246","Cochabamba","Vinto","Escuela Martín Cardenas",80,0,1,1,99,1,16,0,1,199,1,5,205,227,0.497,0.903
"13247","Cochabamba","Vinto","Escuela Martín Cardenas",70,1,2,0,104,3,2,0,1,183,1,10,194,227,0.568,0.855
"13248","Cochabamba","Vinto","Escuela Martín Cardenas",69,3,1,0,93,1,25,0,3,195,1,6,202,231,0.477,0.874
"13249","Cochabamba","Vinto","Unidad Educativa Sagrada Familia",65,0,0,0,102,4,29,1,1,202,2,7,211,236,0.505,0.894
"13250","Cochabamba","Vinto","Unidad Educativa Sagrada Familia",71,2,1,0,98,4,26,0,2,204,0,6,210,236,0.48,0.89
"13251","Cochabamba","Vinto","Unidad Educativa Sagrada Familia",62,0,0,0,111,3,33,0,1,210,1,10,221,238,0.529,0.929
"13252","Cochabamba","Vinto","Unidad Educativa Sagrada Familia",57,0,2,0,109,3,32,0,0,203,3,10,216,237,0.537,0.911
"13253","Cochabamba","Vinto","Unidad Educativa Sagrada Familia",61,1,1,3,101,3,28,0,1,199,2,8,209,235,0.508,0.889
"13254","Cochabamba","Vinto","Unidad Educativa Sagrada Familia",66,1,0,1,108,3,27,0,0,206,1,10,217,236,0.524,0.919
"13255","Cochabamba","Vinto","Unidad Educativa Sagrada Familia",59,1,4,1,104,3,28,0,3,203,0,12,215,237,0.512,0.907
"13256","Cochabamba","Vinto","Unidad Educativa Sagrada Familia",77,0,1,1,88,5,34,0,1,207,2,5,214,238,0.425,0.899
"13257","Cochabamba","Vinto","Unidad Educativa Sagrada Familia",83,0,1,1,84,6,30,0,4,209,3,4,216,238,0.402,0.908
"13258","Cochabamba","Vinto","Unidad Educativa Sagrada Familia",62,1,1,0,101,7,29,1,5,207,2,7,216,237,0.488,0.911
"13259","Cochabamba","Vinto","Unidad Educativa Sagrada Familia",78,0,0,0,100,3,27,0,1,209,1,7,217,238,0.478,0.912
"13260","Cochabamba","Vinto","Unidad Educativa Sagrada Familia",78,1,1,1,90,6,25,0,3,205,1,13,219,238,0.439,0.92
"13261","Cochabamba","Vinto","Unidad Educativa David Arzabe",58,1,0,0,117,3,31,0,2,212,2,7,221,236,0.552,0.936
"13262","Cochabamba","Vinto","Unidad Educativa David Arzabe",42,1,3,1,130,3,28,1,1,210,1,5,216,237,0.619,0.911
"13263","Cochabamba","Vinto","Unidad Educativa David Arzabe",47,2,0,1,131,3,23,1,2,210,3,6,219,236,0.624,0.928
"13264","Cochabamba","Vinto","Unidad Educativa David Arzabe",51,0,0,0,124,3,28,0,0,206,2,8,216,239,0.602,0.904
"13265","Cochabamba","Vinto","Unidad Educativa David Arzabe",42,0,1,0,136,1,21,0,1,202,0,9,211,236,0.673,0.894
"13266","Cochabamba","Vinto","Unidad Educativa David Arzabe",63,0,1,0,116,3,25,1,0,209,1,6,216,236,0.555,0.915
"13267","Cochabamba","Vinto","Unidad Educativa David Arzabe",54,1,0,0,126,6,21,0,0,208,3,5,216,238,0.606,0.908
"13268","Cochabamba","Vinto","Unidad Educativa David Arzabe",57,1,0,1,124,2,19,0,3,207,2,8,217,239,0.599,0.908
"13269","Cochabamba","Vinto","U.E. Avelino Mérida Zubieta",65,0,2,1,104,7,34,1,2,216,1,8,225,240,0.481,0.938
"13270","Cochabamba","Vinto","U.E. Avelino Mérida Zubieta",55,0,2,0,123,8,26,0,1,215,4,4,223,240,0.572,0.929
"13271","Cochabamba","Vinto","U.E. Avelino Mérida Zubieta",76,1,2,0,100,5,29,2,2,217,0,8,225,239,0.461,0.941
"13272","Cochabamba","Vinto","U.E. 5 de Septiembre",58,1,2,0,120,4,30,0,0,215,1,7,223,240,0.558,0.929
"13273","Cochabamba","Vinto","U.E. 5 de Septiembre",54,1,1,0,124,4,27,0,2,213,3,7,223,239,0.582,0.933
"13274","Cochabamba","Vinto","U.E. Soledad Rivas",60,1,2,0,112,2,38,5,5,225,1,6,232,238,0.498,0.975
"13275","Cochabamba","Vinto","Unidad Educativa Reino Unido",23,1,0,0,146,2,25,1,3,201,1,11,213,230,0.726,0.926
"13276","Cochabamba","Vinto","Unidad Educativa Reino Unido",18,1,0,0,144,2,37,1,0,203,5,7,215,232,0.709,0.927
"13277","Cochabamba","Vinto","Unidad Educativa Reino Unido",35,0,1,0,135,2,28,1,0,202,2,9,213,226,0.668,0.942
"13278","Cochabamba","Vinto","Unidad Educativa Reino Unido",32,1,1,1,147,5,15,0,2,204,4,5,213,226,0.721,0.942
"13279","Cochabamba","Vinto","Unidad Educativa Reino Unido",19,1,0,1,143,4,23,0,0,191,5,10,206,225,0.749,0.916
"13280","Cochabamba","Vinto","Unidad Educativa Reino Unido",24,0,0,0,153,4,28,0,0,209,1,8,218,231,0.732,0.944
"13281","Cochabamba","Vinto","Unidad Educativa Reino Unido",38,0,1,1,139,2,22,0,1,204,5,14,223,235,0.681,0.949
"13282","Cochabamba","Vinto","Unidad Educativa Reino Unido",26,0,0,0,138,2,36,0,1,203,3,8,214,235,0.68,0.911
"13283","Cochabamba","Vinto","Unidad Educativa Reino Unido",21,0,0,0,158,2,24,0,1,206,1,8,215,230,0.767,0.935
"13284","Cochabamba","Vinto","Unidad Educativa Reino Unido",31,2,0,0,136,5,22,0,2,198,3,11,212,229,0.687,0.926
"13285","Cochabamba","Vinto","Unidad Educativa Reino Unido",37,0,1,2,139,3,24,2,1,209,4,5,218,232,0.665,0.94
"13286","Cochabamba","Vinto","Unidad Educativa Reino Unido",24,1,1,0,163,8,13,0,2,212,3,3,218,233,0.769,0.936
"13287","Cochabamba","Vinto","Unidad Educativa Reino Unido",25,1,0,0,148,2,26,0,0,202,5,9,216,234,0.733,0.923
"13288","Cochabamba","Vinto","Unidad Educativa Reino Unido",22,2,0,0,162,1,16,1,1,205,6,9,220,233,0.79,0.944
"13289","Cochabamba","Vinto","Unidad Educativa Reino Unido",27,1,3,0,143,2,14,0,0,190,4,11,205,223,0.753,0.919
"13290","Cochabamba","Vinto","Unidad Educativa Reino Unido",17,0,1,0,149,4,32,0,1,204,2,7,213,232,0.73,0.918
"13291","Cochabamba","Vinto","Unidad Educativa Reino Unido",34,1,1,1,137,4,18,0,1,197,5,13,215,230,0.695,0.935
"13292","Cochabamba","Vinto","Unidad Educativa Reino Unido",20,0,1,0,156,4,23,0,0,204,2,8,214,232,0.765,0.922
"13293","Cochabamba","Vinto","Unidad Educativa Reino Unido",11,1,0,3,160,6,16,0,2,199,2,16,217,231,0.804,0.939
"13294","Cochabamba","Vinto","Unidad Educativa Reino Unido",30,0,0,1,136,5,21,1,1,195,4,10,209,228,0.697,0.917
"13295","Cochabamba","Vinto","Unidad Educativa Reino Unido",31,0,0,0,146,3,15,0,1,196,7,12,215,232,0.745,0.927
"13296","Cochabamba","Vinto","Unidad Educativa Reino Unido",36,2,2,0,122,7,18,1,0,188,4,8,200,228,0.649,0.877
"13297","Cochabamba","Vinto","Unidad Educativa Reino Unido",19,2,1,0,137,7,37,0,1,204,2,6,212,225,0.672,0.942
"13298","Cochabamba","Vinto","Unidad Educativa Reino Unido",19,0,2,0,159,2,22,0,0,204,2,4,210,231,0.779,0.909
"13299","Cochabamba","Vinto","Escuela Ismael Montes",62,0,1,0,110,6,11,0,3,193,4,9,206,222,0.57,0.928
"13300","Cochabamba","Vinto","Escuela Ismael Montes",52,0,0,0,125,2,20,1,0,200,5,5,210,223,0.625,0.942
"13301","Cochabamba","Vinto","Escuela Ismael Montes",52,0,0,1,128,3,19,0,0,203,0,8,211,231,0.631,0.913
"13302","Cochabamba","Vinto","Escuela Ismael Montes",44,2,2,0,131,3,13,1,0,196,5,8,209,226,0.668,0.925
"13303","Cochabamba","Vinto","Escuela Ismael Montes",54,2,0,0,108,1,13,0,1,179,3,10,192,223,0.603,0.861
"13304","Cochabamba","Vinto","Escuela Ismael Montes",29,2,0,0,122,4,27,1,1,186,3,8,197,218,0.656,0.904
"13305","Cochabamba","Vinto","Escuela Ismael Montes",48,1,0,1,125,4,19,0,2,200,2,8,210,229,0.625,0.917
"13306","Cochabamba","Vinto","Escuela Ismael Montes",35,0,0,1,135,4,24,0,0,199,3,4,206,223,0.678,0.924
"13307","Cochabamba","Vinto","Escuela Ismael Montes",40,1,2,0,119,7,21,1,1,192,3,5,200,221,0.62,0.905
"13308","Cochabamba","Vinto","Escuela Ismael Montes",51,0,0,1,124,3,22,0,3,204,2,9,215,228,0.608,0.943
"13309","Cochabamba","Vinto","Escuela Ismael Montes",69,1,0,0,98,6,19,0,0,193,2,11,206,229,0.508,0.9
"13310","Cochabamba","Vinto","Escuela Ismael Montes",57,2,0,0,103,2,24,0,2,190,4,17,211,227,0.542,0.93
"13311","Cochabamba","Vinto","Escuela Ismael Montes",47,0,0,1,127,7,22,0,0,204,1,5,210,225,0.623,0.933
"13312","Cochabamba","Vinto","Escuela Ismael Montes",45,0,2,0,113,4,26,2,2,194,1,3,198,226,0.582,0.876
"13313","Cochabamba","Vinto","Escuela Ismael Montes",46,2,2,1,115,5,14,0,1,186,2,7,195,216,0.618,0.903
"13314","Cochabamba","Vinto","Unidad Educativa Anocaraire",55,0,0,3,120,7,19,1,1,206,2,3,211,226,0.583,0.934
"13315","Cochabamba","Vinto","Unidad Educativa Anocaraire",45,0,1,0,128,5,18,2,1,200,3,6,209,232,0.64,0.901
"13316","Cochabamba","Vinto","Unidad Educativa Anocaraire",57,3,1,0,112,5,26,0,1,205,4,8,217,234,0.546,0.927
"13317","Cochabamba","Vinto","Unidad Educativa Anocaraire",60,3,2,0,111,4,12,1,3,196,1,10,207,229,0.566,0.904
"13318","Cochabamba","Vinto","Unidad Educativa Anocaraire",61,1,0,2,114,6,22,0,4,210,1,4,215,232,0.543,0.927
"13319","Cochabamba","Vinto","Unidad Educativa Anocaraire",28,0,1,0,146,3,25,1,1,205,4,6,215,230,0.712,0.935
"13320","Cochabamba","Vinto","Unidad Educativa Anocaraire",51,1,1,1,136,0,21,1,2,214,2,9,225,237,0.636,0.949
"13321","Cochabamba","Vinto","Unidad Educativa Anocaraire",29,1,1,1,158,3,17,0,0,210,4,7,221,233,0.752,0.948
"13322","Cochabamba","Vinto","Unidad Educativa Anocaraire",46,1,0,0,127,2,20,0,2,198,4,7,209,225,0.641,0.929
"13323","Cochabamba","Vinto","Unidad Educativa Anocaraire",43,1,0,0,123,4,18,1,3,193,2,11,206,228,0.637,0.904
"13324","Cochabamba","Vinto","Unidad Educativa Anocaraire",33,0,0,0,134,7,17,0,1,192,5,10,207,226,0.698,0.916
"13325","Cochabamba","Vinto","Unidad Educativa Anocaraire",38,0,1,0,134,7,15,0,2,197,4,6,207,228,0.68,0.908
"13326","Cochabamba","Vinto","Unidad Educativa Anocaraire",46,0,2,1,128,1,18,0,1,197,2,14,213,231,0.65,0.922
"13327","Cochabamba","Vinto","Unidad Educativa Anocaraire",40,0,0,0,131,6,17,0,0,194,1,12,207,228,0.675,0.908
"13328","Cochabamba","Vinto","Unidad Educativa Anocaraire",50,1,1,1,121,5,21,0,1,201,2,6,209,231,0.602,0.905
"13329","Cochabamba","Vinto","Unidad Educativa Anocaraire",30,1,1,1,145,2,16,0,1,197,2,5,204,226,0.736,0.903
"13330","Cochabamba","Vinto","Unidad Educativa Anocaraire",49,1,1,1,134,3,10,0,2,201,2,7,210,226,0.667,0.929
"13331","Cochabamba","Vinto","Unidad Educativa Anocaraire",42,1,0,1,148,3,9,0,1,205,4,7,216,224,0.722,0.964
"13332","Cochabamba","Vinto","Unidad Educativa Anocaraire",41,2,1,1,128,3,21,0,2,199,3,3,205,222,0.643,0.923
"13333","Cochabamba","Vinto","Unidad Educativa Anocaraire",24,3,0,0,152,6,16,0,0,201,4,8,213,230,0.756,0.926
"13334","Cochabamba","Vinto","Unidad Educativa Keraya",2,1,1,0,184,2,2,0,0,192,3,6,201,222,0.958,0.905
"13335","Cochabamba","Vinto","Nucleo Escolar Simon Bolivar (Thiomoko)",20,1,4,0,140,6,0,0,0,171,50,3,224,234,0.819,0.957
"13336","Cochabamba","Vinto","Nucleo Escolar Simon Bolivar (Thiomoko)",18,2,0,1,182,1,12,0,1,217,6,4,227,237,0.839,0.958
"13337","Cochabamba","Vinto","Nucleo Escolar Simon Bolivar (Thiomoko)",15,0,3,0,164,3,20,0,1,206,1,9,216,234,0.796,0.923
"13338","Cochabamba","Vinto","Nucleo Escolar Simon Bolivar (Thiomoko)",21,2,1,2,152,4,29,1,0,212,1,10,223,236,0.717,0.945
"13339","Cochabamba","Vinto","Nucleo Escolar Simon Bolivar (Thiomoko)",18,0,2,1,161,3,19,1,1,206,4,6,216,228,0.782,0.947
"13340","Cochabamba","Vinto","Nucleo Escolar Simon Bolivar (Thiomoko)",16,1,0,0,169,6,6,1,0,199,7,17,223,234,0.849,0.953
"13341","Cochabamba","Vinto","U.E. La Llave",1,4,3,1,192,1,11,2,0,215,3,14,232,239,0.893,0.971
"13342","Cochabamba","Colcapirhua","Unidad Educativa Daniel Salamanca",79,0,1,1,110,3,8,0,0,202,2,8,212,226,0.545,0.938
"13343","Cochabamba","Colcapirhua","Unidad Educativa Daniel Salamanca",90,1,4,1,78,5,15,0,0,194,2,8,204,226,0.402,0.903
"13344","Cochabamba","Colcapirhua","Unidad Educativa Daniel Salamanca",93,0,3,0,83,4,10,0,1,194,0,8,202,228,0.428,0.886
"13345","Cochabamba","Colcapirhua","Unidad Educativa Daniel Salamanca",108,1,5,1,76,1,11,0,0,203,3,5,211,226,0.374,0.934
"13346","Cochabamba","Colcapirhua","Unidad Educativa Daniel Salamanca",102,0,3,0,73,2,10,0,0,190,5,8,203,223,0.384,0.91
"13347","Cochabamba","Colcapirhua","Unidad Educativa Daniel Salamanca",79,0,2,2,99,5,18,0,0,205,1,6,212,230,0.483,0.922
"13348","Cochabamba","Colcapirhua","Unidad Educativa Daniel Salamanca",84,0,2,0,87,2,11,1,3,190,4,11,205,225,0.458,0.911
"13349","Cochabamba","Colcapirhua","Unidad Educativa Daniel Salamanca",84,0,1,0,91,5,13,0,2,196,1,7,204,222,0.464,0.919
"13350","Cochabamba","Colcapirhua","Unidad Educativa Daniel Salamanca",93,2,0,1,81,4,15,0,1,197,5,3,205,225,0.411,0.911
"13351","Cochabamba","Colcapirhua","Unidad Educativa Daniel Salamanca",66,0,1,2,117,3,6,0,2,197,3,9,209,228,0.594,0.917
"13352","Cochabamba","Colcapirhua","Unidad Educativa Daniel Salamanca",88,2,1,1,77,8,10,0,1,188,2,5,195,221,0.41,0.882
"13353","Cochabamba","Colcapirhua","Unidad Educativa Daniel Salamanca",94,1,2,1,94,0,8,0,1,201,1,7,209,231,0.468,0.905
"13354","Cochabamba","Colcapirhua","Unidad Educativa Daniel Salamanca",84,0,1,3,75,5,17,2,3,190,5,10,205,226,0.395,0.907
"13355","Cochabamba","Colcapirhua","Unidad Educativa Daniel Salamanca",76,0,1,0,95,5,13,1,0,191,3,8,202,227,0.497,0.89
"13356","Cochabamba","Colcapirhua","Unidad Educativa Daniel Salamanca",107,1,3,0,58,5,13,0,2,189,2,13,204,225,0.307,0.907
"13357","Cochabamba","Colcapirhua","Unidad Educativa Daniel Salamanca",73,1,2,2,95,6,16,0,0,195,1,9,205,227,0.487,0.903
"13358","Cochabamba","Colcapirhua","Unidad Educativa Daniel Salamanca",72,0,1,3,84,3,11,0,3,177,2,11,190,227,0.475,0.837
"13359","Cochabamba","Colcapirhua","Unidad Educativa Daniel Salamanca",92,1,1,1,77,7,17,2,1,199,5,10,214,228,0.387,0.939
"13360","Cochabamba","Colcapirhua","Unidad Educativa Daniel Salamanca",106,0,1,0,61,4,8,2,2,184,0,10,194,222,0.332,0.874
"13361","Cochabamba","Colcapirhua","Unidad Educativa Daniel Salamanca",98,1,1,0,71,5,8,0,3,187,4,9,200,223,0.38,0.897
"13362","Cochabamba","Colcapirhua","Unidad Educativa Daniel Salamanca",90,3,1,2,90,2,6,0,3,197,1,6,204,232,0.457,0.879
"13363","Cochabamba","Colcapirhua","Unidad Educativa Daniel Salamanca",101,1,3,0,69,5,9,1,0,189,1,6,196,215,0.365,0.912
"13364","Cochabamba","Colcapirhua","Unidad Educativa Daniel Salamanca",79,0,2,0,92,5,10,1,4,193,5,8,206,227,0.477,0.907
"13365","Cochabamba","Colcapirhua","Unidad Educativa Daniel Salamanca",91,0,2,0,75,0,12,0,0,180,1,9,190,230,0.417,0.826
"13366","Cochabamba","Colcapirhua","Unidad Educativa Daniel Salamanca",81,2,0,1,103,2,14,0,0,203,6,4,213,227,0.507,0.938
"13367","Cochabamba","Colcapirhua","Unidad Educativa Daniel Salamanca",88,4,1,0,85,1,10,0,1,190,3,7,200,223,0.447,0.897
"13368","Cochabamba","Colcapirhua","Unidad Educativa Daniel Salamanca",106,1,1,1,77,3,12,0,2,203,4,6,213,228,0.379,0.934
"13369","Cochabamba","Colcapirhua","Unidad Educativa Daniel Salamanca",100,1,1,1,70,9,9,2,0,193,6,13,212,229,0.363,0.926
"13370","Cochabamba","Colcapirhua","Unidad Educativa Daniel Salamanca",83,0,2,2,86,6,6,1,1,187,4,8,199,223,0.46,0.892
"13371","Cochabamba","Colcapirhua","Unidad Educativa Daniel Salamanca",90,1,2,0,67,4,10,0,1,175,1,10,186,198,0.383,0.939
"13372","Cochabamba","Colcapirhua","Unidad Educativa San Lorenzo",105,1,1,0,74,3,24,1,3,212,5,3,220,240,0.349,0.917
"13373","Cochabamba","Colcapirhua","Unidad Educativa San Lorenzo",97,0,0,0,80,8,21,1,3,210,3,5,218,238,0.381,0.916
"13374","Cochabamba","Colcapirhua","Unidad Educativa San Lorenzo",89,0,1,0,103,6,16,0,3,218,0,4,222,238,0.472,0.933
"13375","Cochabamba","Colcapirhua","Unidad Educativa San Lorenzo",107,1,0,1,86,4,16,0,3,218,0,5,223,239,0.394,0.933
"13376","Cochabamba","Colcapirhua","Unidad Educativa San Lorenzo",88,0,1,0,96,3,23,1,3,215,1,4,220,237,0.447,0.928
"13377","Cochabamba","Colcapirhua","Unidad Educativa San Lorenzo",95,0,1,2,97,6,18,1,2,222,0,5,227,239,0.437,0.95
"13378","Cochabamba","Colcapirhua","Unidad Educativa San Lorenzo",123,0,0,0,77,4,7,0,3,214,1,13,228,240,0.36,0.95
"13379","Cochabamba","Colcapirhua","Unidad Educativa San Lorenzo",96,0,2,0,85,2,19,0,2,206,2,6,214,236,0.413,0.907
"13380","Cochabamba","Colcapirhua","Unidad Educativa San Lorenzo",85,0,1,1,95,5,12,0,6,205,1,8,214,237,0.463,0.903
"13381","Cochabamba","Colcapirhua","Unidad Educativa San Lorenzo",83,1,1,0,60,5,11,0,1,162,1,6,169,176,0.37,0.96
"13382","Cochabamba","Colcapirhua","U.E. 27 de Mayo",93,0,0,0,94,3,22,0,2,214,1,4,219,237,0.439,0.924
"13383","Cochabamba","Colcapirhua","Unidad Educativa San José de Kami",65,0,0,1,105,2,22,0,3,198,4,6,208,232,0.53,0.897
"13384","Cochabamba","Colcapirhua","Unidad Educativa San José de Kami",82,0,2,2,80,8,24,0,1,199,0,10,209,231,0.402,0.905
"13385","Cochabamba","Colcapirhua","Unidad Educativa San José de Kami",57,1,4,1,104,5,22,1,1,196,2,5,203,235,0.531,0.864
"13386","Cochabamba","Colcapirhua","Unidad Educativa San José de Kami",53,0,4,0,111,2,30,0,2,202,0,3,205,231,0.55,0.887
"13387","Cochabamba","Colcapirhua","Unidad Educativa San José de Kami",73,2,0,2,113,2,15,0,0,207,0,5,212,236,0.546,0.898
"13388","Cochabamba","Colcapirhua","Unidad Educativa San José de Kami",83,2,1,1,107,1,8,0,2,205,2,8,215,234,0.522,0.919
"13389","Cochabamba","Colcapirhua","Unidad Educativa San José de Kami",55,1,2,0,107,4,24,1,0,194,2,10,206,233,0.552,0.884
"13390","Cochabamba","Colcapirhua","Unidad Educativa San José de Kami",63,3,0,0,100,8,22,0,1,197,1,4,202,229,0.508,0.882
"13391","Cochabamba","Colcapirhua","Unidad Educativa San José de Kami",55,1,1,1,117,4,20,0,3,202,1,6,209,227,0.579,0.921
"13392","Cochabamba","Colcapirhua","Unidad Educativa San José de Kami",61,1,2,2,108,7,21,1,2,205,1,5,211,231,0.527,0.913
"13393","Cochabamba","Colcapirhua","Unidad Educativa San José de Kami",70,0,0,0,96,6,26,0,2,200,2,8,210,229,0.48,0.917
"13394","Cochabamba","Colcapirhua","Unidad Educativa San José de Kami",45,1,2,2,102,7,27,0,0,186,3,16,205,226,0.548,0.907
"13395","Cochabamba","Colcapirhua","Unidad Educativa San José de Kami",68,2,4,1,98,6,26,1,5,211,4,5,220,234,0.464,0.94
"13396","Cochabamba","Colcapirhua","Unidad Educativa San José de Kami",61,1,4,1,105,3,29,0,4,208,2,5,215,234,0.505,0.919
"13397","Cochabamba","Colcapirhua","Unidad Educativa San José de Kami",64,0,0,0,111,7,21,0,1,204,1,10,215,235,0.544,0.915
"13398","Cochabamba","Colcapirhua","Unidad Educativa San José de Kami",53,1,0,0,104,3,22,1,2,186,6,9,201,229,0.559,0.878
"13399","Cochabamba","Colcapirhua","Unidad Educativa San José de Kami",70,1,7,1,90,7,25,1,3,205,1,8,214,230,0.439,0.93
"13400","Cochabamba","Colcapirhua","Unidad Educativa San José de Kami",45,0,2,2,116,10,22,1,1,199,1,4,204,224,0.583,0.911
"13401","Cochabamba","Colcapirhua","Unidad Educativa San José de Kami",51,0,0,0,121,5,18,0,2,197,1,3,201,224,0.614,0.897
"13402","Cochabamba","Colcapirhua","Unidad Educativa San José de Kami",84,0,1,1,72,1,27,2,2,190,5,6,201,228,0.379,0.882
"13403","Cochabamba","Colcapirhua","Unidad Educativa San José de Kami",85,0,2,1,87,7,25,1,2,210,2,6,218,230,0.414,0.948
"13404","Cochabamba","Colcapirhua","Unidad Educativa San José de Kami",63,1,3,0,106,2,24,0,2,201,1,7,209,234,0.527,0.893
"13405","Cochabamba","Colcapirhua","Unidad Educativa San José de Kami",69,1,2,0,103,4,20,0,1,200,7,10,217,229,0.515,0.948
"13406","Cochabamba","Colcapirhua","Unidad Educativa San José de Kami",77,0,3,0,108,5,14,0,3,210,2,4,216,228,0.514,0.947
"13407","Cochabamba","Colcapirhua","Unidad Educativa San José de Kami",56,0,1,0,101,3,20,3,3,187,2,6,195,211,0.54,0.924
"13408","Cochabamba","Colcapirhua","Sede Social Callaj Chullpa (Colcapirhua)",55,1,1,1,103,2,13,0,2,178,4,11,193,227,0.579,0.85
"13409","Cochabamba","Colcapirhua","Sede Social Callaj Chullpa (Colcapirhua)",72,3,0,1,92,3,17,0,2,190,3,9,202,228,0.484,0.886
"13410","Cochabamba","Colcapirhua","Colegio Max Fernandez",96,0,1,1,73,4,15,0,0,190,0,8,198,221,0.384,0.896
"13411","Cochabamba","Colcapirhua","Colegio Max Fernandez",111,1,1,0,69,8,15,0,3,208,0,4,212,229,0.332,0.926
"13412","Cochabamba","Colcapirhua","Colegio Max Fernandez",116,0,0,0,67,4,11,0,2,200,0,4,204,223,0.335,0.915
"13413","Cochabamba","Colcapirhua","Colegio Max Fernandez",97,1,0,2,86,4,12,0,0,202,1,10,213,229,0.426,0.93
"13414","Cochabamba","Colcapirhua","Colegio Max Fernandez",103,0,2,0,77,3,12,0,1,198,2,4,204,227,0.389,0.899
"13415","Cochabamba","Colcapirhua","Colegio Max Fernandez",94,1,2,0,76,6,13,2,0,194,0,9,203,230,0.392,0.883
"13416","Cochabamba","Colcapirhua","Colegio Max Fernandez",91,0,2,1,95,5,10,0,0,204,1,8,213,227,0.466,0.938
"13417","Cochabamba","Colcapirhua","Colegio Max Fernandez",103,0,0,0,77,6,13,0,0,199,2,6,207,232,0.387,0.892
"13418","Cochabamba","Colcapirhua","Colegio Max Fernandez",112,1,2,0,62,4,12,0,1,194,1,8,203,224,0.32,0.906
"13419","Cochabamba","Colcapirhua","Colegio Max Fernandez",92,1,3,1,94,4,10,1,1,207,3,3,213,228,0.454,0.934
"13420","Cochabamba","Colcapirhua","Colegio Max Fernandez",76,3,3,2,96,4,11,0,2,197,0,7,204,228,0.487,0.895
"13421","Cochabamba","Colcapirhua","Colegio Max Fernandez",114,0,0,1,69,3,16,0,1,204,1,7,212,229,0.338,0.926
"13422","Cochabamba","Colcapirhua","Colegio Max Fernandez",109,0,2,0,84,4,14,0,0,213,0,4,217,236,0.394,0.919
"13423","Cochabamba","Colcapirhua","Colegio Max Fernandez",85,1,3,0,91,3,17,1,1,202,2,3,207,227,0.45,0.912
"13424","Cochabamba","Colcapirhua","Colegio Max Fernandez",106,0,0,0,85,3,6,1,1,202,1,4,207,226,0.421,0.916
"13425","Cochabamba","Colcapirhua","Colegio Max Fernandez",107,0,0,2,67,2,12,0,0,190,1,6,197,220,0.353,0.895
"13426","Cochabamba","Colcapirhua","Colegio Max Fernandez",111,0,2,0,68,3,7,3,1,195,2,6,203,223,0.349,0.91
"13427","Cochabamba","Colcapirhua","Colegio Max Fernandez",92,0,0,0,86,8,9,0,1,196,4,2,202,218,0.439,0.927
"13428","Cochabamba","Colcapirhua","Colegio Max Fernandez",84,1,2,3,100,3,7,1,0,201,1,7,209,232,0.498,0.901
"13429","Cochabamba","Colcapirhua","Colegio Max Fernandez",101,0,1,1,77,6,12,0,1,199,3,7,209,224,0.387,0.933
"13430","Cochabamba","Colcapirhua","Colegio Max Fernandez",113,1,0,1,71,4,9,0,2,201,3,4,208,227,0.353,0.916
"13431","Cochabamba","Colcapirhua","Colegio Max Fernandez",117,0,0,1,74,0,6,0,1,199,1,5,205,232,0.372,0.884
"13432","Cochabamba","Colcapirhua","Colegio Max Fernandez",119,0,1,0,72,2,9,0,1,204,3,3,210,225,0.353,0.933
"13433","Cochabamba","Colcapirhua","Colegio Max Fernandez",106,0,2,1,63,3,19,1,0,195,1,6,202,233,0.323,0.867
"13434","Cochabamba","Colcapirhua","Colegio Max Fernandez",88,0,1,2,95,2,6,0,5,199,2,5,206,225,0.477,0.916
"13435","Cochabamba","Colcapirhua","Colegio Max Fernandez",80,2,1,3,89,8,11,0,2,196,3,2,201,225,0.454,0.893
"13436","Cochabamba","Colcapirhua","Unidad Educativa Simon Bolivar (Sumunpaya)",51,0,3,0,134,1,22,0,1,212,2,4,218,237,0.632,0.92
"13437","Cochabamba","Colcapirhua","Unidad Educativa Simon Bolivar (Sumunpaya)",69,0,2,0,119,4,17,2,0,213,0,6,219,237,0.559,0.924
"13438","Cochabamba","Colcapirhua","Unidad Educativa Simon Bolivar (Sumunpaya)",75,0,0,0,125,4,15,0,3,222,1,5,228,239,0.563,0.954
"13439","Cochabamba","Colcapirhua","Sede Social de La O.T.B. Martin Cardenas (Ex Complejo El Carmen)",101,1,1,1,81,3,8,0,2,198,2,4,204,221,0.409,0.923
"13440","Cochabamba","Colcapirhua","Unidad Educativa El Sausalito",85,1,1,1,90,1,14,0,4,197,0,4,201,225,0.457,0.893
"13441","Cochabamba","Colcapirhua","Unidad Educativa El Sausalito",114,0,1,0,66,6,13,0,1,201,0,4,205,231,0.328,0.887
"13442","Cochabamba","Colcapirhua","Unidad Educativa El Sausalito",94,1,0,1,76,4,7,0,1,184,2,9,195,223,0.413,0.874
"13443","Cochabamba","Colcapirhua","Unidad Educativa El Sausalito",100,0,0,0,82,6,6,0,5,199,3,5,207,224,0.412,0.924
"13444","Cochabamba","Colcapirhua","Unidad Educativa El Sausalito",79,1,1,0,87,4,13,0,2,187,2,12,201,221,0.465,0.91
"13445","Cochabamba","Colcapirhua","Unidad Educativa El Sausalito",90,0,1,1,101,1,6,0,1,201,7,2,210,227,0.502,0.925
"13446","Cochabamba","Colcapirhua","Unidad Educativa El Sausalito",115,0,1,1,72,9,3,1,0,202,1,5,208,228,0.356,0.912
"13447","Cochabamba","Colcapirhua","Unidad Educativa El Sausalito",97,0,2,0,82,6,10,1,2,200,4,3,207,228,0.41,0.908
"13448","Cochabamba","Colcapirhua","Unidad Educativa El Sausalito",102,0,0,1,76,5,9,1,4,198,3,3,204,225,0.384,0.907
"13449","Cochabamba","Colcapirhua","Unidad Educativa El Sausalito",98,1,1,1,82,6,10,0,1,200,1,7,208,228,0.41,0.912
"13450","Cochabamba","Colcapirhua","Unidad Educativa El Sausalito",96,0,1,1,88,2,11,2,3,204,0,4,208,229,0.431,0.908
"13451","Cochabamba","Colcapirhua","Unidad Educativa El Sausalito",118,1,1,1,77,7,7,0,0,212,0,2,214,226,0.363,0.947
"13452","Cochabamba","Colcapirhua","Unidad Educativa El Sausalito",114,0,1,0,64,4,6,1,1,191,1,7,199,220,0.335,0.905
"13453","Cochabamba","Colcapirhua","Unidad Educativa El Sausalito",94,0,1,2,69,4,7,0,2,179,2,12,193,219,0.385,0.881
"13454","Cochabamba","Colcapirhua","Unidad Educativa El Sausalito",101,1,0,1,78,3,6,0,1,191,0,5,196,225,0.408,0.871
"13455","Cochabamba","Colcapirhua","Unidad Educativa El Sausalito",92,0,2,0,78,3,17,0,2,194,0,14,208,222,0.402,0.937
"13456","Cochabamba","Colcapirhua","Unidad Educativa El Sausalito",116,1,1,0,67,3,7,0,0,195,0,3,198,227,0.344,0.872
"13457","Cochabamba","Colcapirhua","Unidad Educativa El Sausalito",103,1,1,1,68,2,14,0,2,192,1,10,203,223,0.354,0.91
"13458","Cochabamba","Colcapirhua","Unidad Educativa El Sausalito",109,1,2,0,69,6,7,0,2,196,1,5,202,223,0.352,0.906
"13459","Cochabamba","Colcapirhua","Unidad Educativa El Sausalito",102,1,0,3,79,6,5,1,2,199,2,8,209,226,0.397,0.925
"13460","Cochabamba","Colcapirhua","Unidad Educativa El Sausalito",116,0,2,1,60,2,5,1,0,187,0,7,194,217,0.321,0.894
"13461","Cochabamba","Colcapirhua","Unidad Educativa El Sausalito",84,1,1,1,66,4,6,1,0,164,1,4,169,178,0.402,0.949
"13462","Cochabamba","Colcapirhua","Instituto María Cristina",108,0,1,1,68,4,6,0,5,193,1,5,199,226,0.352,0.881
"13463","Cochabamba","Colcapirhua","Instituto María Cristina",108,1,3,0,71,6,7,0,3,199,0,7,206,225,0.357,0.916
"13464","Cochabamba","Colcapirhua","Instituto María Cristina",100,2,0,1,70,5,11,0,1,190,0,5,195,218,0.368,0.894
"13465","Cochabamba","Colcapirhua","Instituto María Cristina",117,1,0,1,53,5,12,0,2,191,1,4,196,225,0.277,0.871
"13466","Cochabamba","Colcapirhua","Instituto María Cristina",97,0,0,2,72,4,11,2,2,190,0,6,196,223,0.379,0.879
"13467","Cochabamba","Colcapirhua","Instituto María Cristina",110,1,3,0,71,3,8,0,4,200,0,2,202,230,0.355,0.878
"13468","Cochabamba","Colcapirhua","Instituto María Cristina",98,1,2,0,76,2,8,0,1,188,2,4,194,225,0.404,0.862
"13469","Cochabamba","Colcapirhua","Unidad Educativa La Sagrada Familia",98,0,2,2,81,9,16,1,1,210,2,8,220,234,0.386,0.94
"13470","Cochabamba","Colcapirhua","Unidad Educativa La Sagrada Familia",111,0,1,2,74,5,15,2,1,211,1,6,218,238,0.351,0.916
"13471","Cochabamba","Colcapirhua","Unidad Educativa La Sagrada Familia",98,1,0,0,90,0,14,0,2,205,1,11,217,237,0.439,0.916
"13472","Cochabamba","Colcapirhua","Unidad Educativa La Sagrada Familia",102,0,0,0,87,4,14,0,4,211,0,5,216,235,0.412,0.919
"13473","Cochabamba","Colcapirhua","Unidad Educativa La Sagrada Familia",118,3,2,0,64,9,11,0,1,208,2,5,215,237,0.308,0.907
"13474","Cochabamba","Colcapirhua","Unidad Educativa La Sagrada Familia",113,1,1,0,79,7,9,0,5,215,0,7,222,236,0.367,0.941
"13475","Cochabamba","Colcapirhua","Unidad Educativa La Sagrada Familia",121,0,2,1,70,3,14,0,0,211,1,6,218,231,0.332,0.944
"13476","Cochabamba","Colcapirhua","Unidad Educativa La Sagrada Familia",114,1,1,0,81,4,14,1,0,216,0,8,224,240,0.375,0.933
"13477","Cochabamba","Colcapirhua","Unidad Educativa La Sagrada Familia",112,1,0,0,75,3,5,0,2,198,5,7,210,235,0.379,0.894
"13478","Cochabamba","Colcapirhua","U.E. San Miguel",104,0,0,2,97,9,12,0,1,225,2,4,231,239,0.431,0.967
"13479","Cochabamba","Colcapirhua","U.E. San Miguel",110,0,1,0,83,5,13,1,0,213,2,11,226,239,0.39,0.946
"13480","Cochabamba","Colcapirhua","U.E. San Miguel",126,0,0,1,79,4,11,0,0,221,2,8,231,239,0.357,0.967
"13481","Cochabamba","Colcapirhua","U.E. San Miguel",108,0,1,3,102,3,10,0,0,227,1,2,230,240,0.449,0.958
"13482","Cochabamba","Colcapirhua","Colegio Padre Andrés Cuschieri",109,1,0,0,95,5,14,0,3,227,0,4,231,239,0.419,0.967
"13483","Cochabamba","Colcapirhua","Escuela Jesus Lara",105,0,2,2,58,4,13,0,1,185,6,5,196,222,0.314,0.883
"13484","Cochabamba","Colcapirhua","Escuela Jesus Lara",110,1,1,0,68,2,9,0,1,192,1,6,199,226,0.354,0.881
"13485","Cochabamba","Colcapirhua","Escuela Jesus Lara",111,0,0,1,66,3,9,0,0,190,0,6,196,217,0.347,0.903
"13486","Cochabamba","Colcapirhua","Escuela Jesus Lara",129,0,1,0,56,5,7,1,1,200,1,4,205,227,0.28,0.903
"13487","Cochabamba","Colcapirhua","Escuela Jesus Lara",113,0,2,0,63,4,18,0,4,204,0,4,208,230,0.309,0.904
"13488","Cochabamba","Colcapirhua","Escuela Jesus Lara",107,0,2,1,64,3,11,0,1,189,0,9,198,229,0.339,0.865
"13489","Cochabamba","Colcapirhua","Escuela Jesus Lara",88,1,2,0,94,8,19,0,1,213,0,3,216,231,0.441,0.935
"13490","Cochabamba","Colcapirhua","Escuela Jesus Lara",108,1,1,1,66,6,10,1,1,195,1,3,199,228,0.338,0.873
"13491","Cochabamba","Colcapirhua","Escuela Jesus Lara",107,0,1,0,72,8,13,0,2,203,1,2,206,224,0.355,0.92
"13492","Cochabamba","Colcapirhua","Escuela Jesus Lara",111,0,1,1,74,5,12,1,2,207,1,2,210,225,0.357,0.933
"13493","Cochabamba","Colcapirhua","Escuela Jesus Lara",97,0,1,1,81,4,11,1,1,197,1,3,201,226,0.411,0.889
"13494","Cochabamba","Colcapirhua","Escuela Jesus Lara",109,0,1,0,88,3,6,0,2,209,3,7,219,232,0.421,0.944
"13495","Cochabamba","Colcapirhua","Escuela Jesus Lara",123,1,2,1,66,6,15,0,1,215,2,2,219,231,0.307,0.948
"13496","Cochabamba","Colcapirhua","Escuela Jesus Lara",101,0,2,1,82,4,12,0,2,204,0,4,208,227,0.402,0.916
"13497","Cochabamba","Colcapirhua","Escuela Jesus Lara",111,0,0,1,63,5,15,3,0,198,0,4,202,228,0.318,0.886
"13498","Cochabamba","Colcapirhua","Escuela Jesus Lara",119,0,1,0,68,0,12,1,1,202,0,11,213,224,0.337,0.951
"13499","Cochabamba","Colcapirhua","Escuela Jesus Lara",131,0,1,0,56,5,14,0,3,210,1,4,215,230,0.267,0.935
"13500","Cochabamba","Colcapirhua","Escuela Jesus Lara",128,0,0,0,55,4,13,2,2,204,3,6,213,224,0.27,0.951
"13501","Cochabamba","Colcapirhua","Escuela Jesus Lara",100,0,0,0,79,3,16,1,1,200,3,4,207,232,0.395,0.892
"13502","Cochabamba","Colcapirhua","Escuela Jesus Lara",115,0,4,1,64,1,17,0,0,202,2,8,212,228,0.317,0.93
"13503","Cochabamba","Colcapirhua","Escuela Jesus Lara",123,0,0,2,69,1,8,0,0,203,2,2,207,230,0.34,0.9
"13504","Cochabamba","Colcapirhua","Escuela Jesus Lara",115,0,0,1,68,5,12,0,1,202,3,4,209,233,0.337,0.897
"13505","Cochabamba","Colcapirhua","Escuela Jesus Lara",118,0,2,1,61,6,11,1,0,200,1,3,204,226,0.305,0.903
"13506","Cochabamba","Colcapirhua","Escuela Jesus Lara",113,1,0,0,72,3,10,0,3,202,1,4,207,222,0.356,0.932
"13507","Cochabamba","Colcapirhua","Escuela Jesus Lara",106,0,1,1,61,4,12,0,2,187,3,4,194,224,0.326,0.866
"13508","Cochabamba","Colcapirhua","Escuela Jesus Lara",107,0,1,1,70,5,11,0,4,199,0,4,203,225,0.352,0.902
"13509","Cochabamba","Colcapirhua","U. E. Prof. Benedicto Durán Ortíz",121,0,0,0,61,3,17,0,1,203,1,6,210,235,0.3,0.894
"13510","Cochabamba","Colcapirhua","U. E. Prof. Benedicto Durán Ortíz",119,1,4,0,72,2,15,0,3,216,0,6,222,236,0.333,0.941
"13511","Cochabamba","Colcapirhua","U. E. Prof. Benedicto Durán Ortíz",92,0,3,0,87,3,13,0,3,201,0,12,213,234,0.433,0.91
"13512","Cochabamba","Colcapirhua","U. E. Prof. Benedicto Durán Ortíz",95,1,1,1,86,5,16,1,0,206,0,8,214,235,0.417,0.911
"13513","Cochabamba","Colcapirhua","U. E. Prof. Benedicto Durán Ortíz",111,0,1,0,74,8,10,0,3,207,1,6,214,236,0.357,0.907
"13514","Cochabamba","Sacaba","Escuela Natalio Arauco",56,1,0,1,103,3,32,2,1,199,5,4,208,228,0.518,0.912
"13515","Cochabamba","Sacaba","Escuela Natalio Arauco",65,1,1,1,95,7,16,1,2,189,1,9,199,228,0.503,0.873
"13516","Cochabamba","Sacaba","Escuela Natalio Arauco",70,0,0,0,99,1,24,0,1,195,3,6,204,229,0.508,0.891
"13517","Cochabamba","Sacaba","Escuela Natalio Arauco",82,0,0,1,74,8,16,0,0,181,3,18,202,225,0.409,0.898
"13518","Cochabamba","Sacaba","Escuela Natalio Arauco",44,0,0,0,117,3,29,0,1,194,4,3,201,225,0.603,0.893
"13519","Cochabamba","Sacaba","Escuela Natalio Arauco",60,0,0,0,95,6,21,0,0,182,6,7,195,225,0.522,0.867
"13520","Cochabamba","Sacaba","Escuela Natalio Arauco",48,0,1,1,108,4,26,2,1,191,0,7,198,224,0.565,0.884
"13521","Cochabamba","Sacaba","Escuela Natalio Arauco",58,0,0,1,94,5,22,0,3,183,0,12,195,225,0.514,0.867
"13522","Cochabamba","Sacaba","Escuela Natalio Arauco",68,0,1,0,98,4,27,0,3,201,1,11,213,233,0.488,0.914
"13523","Cochabamba","Sacaba","Escuela Natalio Arauco",63,1,3,3,96,4,20,0,3,193,2,4,199,223,0.497,0.892
"13524","Cochabamba","Sacaba","Escuela Natalio Arauco",56,1,2,1,103,6,27,0,1,197,1,8,206,227,0.523,0.907
"13525","Cochabamba","Sacaba","Escuela Natalio Arauco",74,0,1,0,90,7,28,0,0,200,2,7,209,227,0.45,0.921
"13526","Cochabamba","Sacaba","Escuela Natalio Arauco",74,0,0,1,87,5,21,1,1,190,0,7,197,224,0.458,0.879
"13527","Cochabamba","Sacaba","Escuela Natalio Arauco",63,1,1,1,89,8,27,0,3,193,5,7,205,230,0.461,0.891
"13528","Cochabamba","Sacaba","Escuela Natalio Arauco",57,1,0,1,100,5,27,2,3,196,3,10,209,230,0.51,0.909
"13529","Cochabamba","Sacaba","Escuela Natalio Arauco",71,0,0,2,95,7,18,0,3,196,1,9,206,225,0.485,0.916
"13530","Cochabamba","Sacaba","Escuela Natalio Arauco",63,1,0,2,88,2,35,2,3,196,3,5,204,230,0.449,0.887
"13531","Cochabamba","Sacaba","Escuela Natalio Arauco",62,0,0,3,89,4,28,0,2,188,3,14,205,229,0.473,0.895
"13532","Cochabamba","Sacaba","Escuela Natalio Arauco",68,0,0,0,99,3,19,1,2,192,0,11,203,230,0.516,0.883
"13533","Cochabamba","Sacaba","Escuela Natalio Arauco",59,0,1,0,94,7,21,0,2,184,1,11,196,219,0.511,0.895
"13534","Cochabamba","Sacaba","Liceo De Señoritas Sacaba",47,0,0,1,113,5,35,0,0,201,3,7,211,232,0.562,0.909
"13535","Cochabamba","Sacaba","Liceo De Señoritas Sacaba",71,0,1,1,86,9,27,1,2,198,0,6,204,229,0.434,0.891
"13536","Cochabamba","Sacaba","Liceo De Señoritas Sacaba",73,0,1,2,90,5,27,2,2,202,0,6,208,233,0.446,0.893
"13537","Cochabamba","Sacaba","Liceo De Señoritas Sacaba",69,0,3,0,96,4,23,1,3,199,0,8,207,235,0.482,0.881
"13538","Cochabamba","Sacaba","Liceo De Señoritas Sacaba",74,1,0,2,103,3,17,0,1,201,2,6,209,232,0.512,0.901
"13539","Cochabamba","Sacaba","Liceo De Señoritas Sacaba",53,2,0,1,117,2,30,1,1,207,1,3,211,232,0.565,0.909
"13540","Cochabamba","Sacaba","Liceo De Señoritas Sacaba",41,0,1,1,112,3,41,1,1,201,0,6,207,229,0.557,0.904
"13541","Cochabamba","Sacaba","Liceo De Señoritas Sacaba",56,1,1,0,111,3,25,0,1,198,2,2,202,229,0.561,0.882
"13542","Cochabamba","Sacaba","Liceo De Señoritas Sacaba",78,0,1,0,85,6,21,1,0,192,1,9,202,227,0.443,0.89
"13543","Cochabamba","Sacaba","Liceo De Señoritas Sacaba",57,1,4,0,98,7,29,0,3,199,6,10,215,232,0.492,0.927
"13544","Cochabamba","Sacaba","Liceo De Señoritas Sacaba",51,3,0,1,108,5,25,1,1,195,0,9,204,233,0.554,0.876
"13545","Cochabamba","Sacaba","Liceo De Señoritas Sacaba",60,0,0,2,110,1,31,0,1,205,0,11,216,233,0.537,0.927
"13546","Cochabamba","Sacaba","Liceo De Señoritas Sacaba",71,0,1,1,98,4,23,0,4,202,0,6,208,230,0.485,0.904
"13547","Cochabamba","Sacaba","Liceo De Señoritas Sacaba",52,1,0,0,111,1,31,0,3,199,2,7,208,230,0.558,0.904
"13548","Cochabamba","Sacaba","Liceo De Señoritas Sacaba",56,0,1,0,99,7,33,0,4,200,2,10,212,229,0.495,0.926
"13549","Cochabamba","Sacaba","Liceo De Señoritas Sacaba",74,1,0,0,88,8,18,0,1,190,2,7,199,231,0.463,0.861
"13550","Cochabamba","Sacaba","Liceo De Señoritas Sacaba",53,0,1,1,105,4,27,0,2,193,3,17,213,233,0.544,0.914
"13551","Cochabamba","Sacaba","Liceo De Señoritas Sacaba",66,0,1,0,104,1,27,0,5,204,2,2,208,234,0.51,0.889
"13552","Cochabamba","Sacaba","Liceo De Señoritas Sacaba",84,2,1,0,100,4,18,0,2,211,3,6,220,237,0.474,0.928
"13553","Cochabamba","Sacaba","Liceo De Señoritas Sacaba",60,0,0,0,101,5,30,0,3,199,4,10,213,235,0.508,0.906
"13554","Cochabamba","Sacaba","Liceo De Señoritas Sacaba",75,0,0,0,102,3,20,1,2,203,2,6,211,232,0.502,0.909
"13555","Cochabamba","Sacaba","Liceo De Señoritas Sacaba",64,0,1,2,89,2,33,1,0,192,2,9,203,231,0.464,0.879
"13556","Cochabamba","Sacaba","Liceo De Señoritas Sacaba",68,0,0,0,108,2,28,0,2,208,0,9,217,234,0.519,0.927
"13557","Cochabamba","Sacaba","Liceo De Señoritas Sacaba",49,0,3,0,121,3,19,0,1,196,3,10,209,230,0.617,0.909
"13558","Cochabamba","Sacaba","Liceo De Señoritas Sacaba",79,0,1,1,87,3,24,1,2,198,3,7,208,229,0.439,0.908
"13559","Cochabamba","Sacaba","Liceo De Señoritas Sacaba",76,1,1,0,94,5,22,2,0,201,2,6,209,233,0.468,0.897
"13560","Cochabamba","Sacaba","Liceo De Señoritas Sacaba",71,0,2,0,92,8,24,0,5,202,2,5,209,232,0.455,0.901
"13561","Cochabamba","Sacaba","Liceo De Señoritas Sacaba",70,4,2,3,104,2,15,0,3,203,1,9,213,232,0.512,0.918
"13562","Cochabamba","Sacaba","Liceo De Señoritas Sacaba",58,2,0,1,98,4,38,1,2,204,3,4,211,237,0.48,0.89
"13563","Cochabamba","Sacaba","Liceo De Señoritas Sacaba",57,0,0,0,124,3,27,0,2,213,2,4,219,234,0.582,0.936
"13564","Cochabamba","Sacaba","Liceo De Señoritas Sacaba",81,0,1,0,95,4,25,2,1,209,2,5,216,231,0.455,0.935
"13565","Cochabamba","Sacaba","Liceo De Señoritas Sacaba",92,2,1,1,81,5,24,0,1,207,1,5,213,235,0.391,0.906
"13566","Cochabamba","Sacaba","Liceo De Señoritas Sacaba",82,1,0,0,98,3,21,0,0,205,3,10,218,233,0.478,0.936
"13567","Cochabamba","Sacaba","Instituto Tecnico Sacaba (ITSA)",66,1,0,0,111,4,37,1,2,222,0,5,227,239,0.5,0.95
"13568","Cochabamba","Sacaba","Instituto Tecnico Sacaba (ITSA)",48,1,0,0,89,0,20,1,2,161,2,9,172,180,0.553,0.956
"13569","Cochabamba","Sacaba","Unidad Educativa 27 de Agosto",30,0,7,1,147,2,28,0,1,216,6,5,227,238,0.681,0.954
"13570","Cochabamba","Sacaba","Unidad Educativa 27 de Agosto",34,1,1,0,148,8,6,0,0,198,4,6,208,240,0.747,0.867
"13571","Cochabamba","Sacaba","Unidad Educativa 27 de Agosto",21,1,4,0,158,4,25,0,1,214,5,5,224,237,0.738,0.945
"13572","Cochabamba","Sacaba","Unidad Educativa 27 de Agosto",21,1,4,1,144,5,35,0,0,211,4,9,224,236,0.682,0.949
"13573","Cochabamba","Sacaba","Unidad Educativa 27 de Agosto",36,1,0,0,152,5,24,0,3,221,3,3,227,236,0.688,0.962
"13574","Cochabamba","Sacaba","Unidad Educativa Republica de Italia",58,0,1,0,117,5,28,2,0,211,3,4,218,238,0.555,0.916
"13575","Cochabamba","Sacaba","Unidad Educativa Republica de Italia",50,0,1,0,117,5,29,1,3,206,0,9,215,235,0.568,0.915
"13576","Cochabamba","Sacaba","Unidad Educativa Republica de Italia",46,0,0,0,111,7,40,0,1,205,1,6,212,237,0.541,0.895
"13577","Cochabamba","Sacaba","Unidad Educativa Republica de Italia",62,0,0,0,107,4,30,0,0,203,0,14,217,240,0.527,0.904
"13578","Cochabamba","Sacaba","Unidad Educativa Republica de Italia",50,0,0,1,107,3,45,0,4,210,0,10,220,237,0.51,0.928
"13579","Cochabamba","Sacaba","Unidad Educativa Republica de Italia",51,0,2,0,116,4,28,0,2,203,2,7,212,238,0.571,0.891
"13580","Cochabamba","Sacaba","Unidad Educativa Republica de Italia",61,1,0,0,103,2,27,1,8,203,3,7,213,237,0.507,0.899
"13581","Cochabamba","Sacaba","Unidad Educativa Republica de Italia",60,1,0,0,100,7,36,0,1,205,1,5,211,239,0.488,0.883
"13582","Cochabamba","Sacaba","Unidad Educativa Republica de Italia",78,0,2,2,90,1,20,1,3,197,2,6,205,236,0.457,0.869
"13583","Cochabamba","Sacaba","Unidad Educativa Republica de Italia",49,1,1,1,92,2,29,0,2,177,2,10,189,204,0.52,0.926
"13584","Cochabamba","Sacaba","Escuela Man Cesped",68,1,0,0,105,7,19,0,1,201,6,2,209,227,0.522,0.921
"13585","Cochabamba","Sacaba","Escuela Man Cesped",78,2,1,0,93,2,18,0,2,196,2,5,203,225,0.474,0.902
"13586","Cochabamba","Sacaba","Escuela Man Cesped",61,0,0,0,104,5,17,1,2,190,4,8,202,215,0.547,0.94
"13587","Cochabamba","Sacaba","Escuela Man Cesped",80,1,1,1,92,7,18,0,1,201,3,7,211,228,0.458,0.925
"13588","Cochabamba","Sacaba","Escuela Man Cesped",53,0,1,0,95,1,22,1,1,174,3,8,185,217,0.546,0.853
"13589","Cochabamba","Sacaba","Escuela Man Cesped",57,0,1,0,107,6,21,0,1,193,5,8,206,226,0.554,0.912
"13590","Cochabamba","Sacaba","Escuela Man Cesped",52,0,0,0,104,2,23,3,3,187,0,9,196,219,0.556,0.895
"13591","Cochabamba","Sacaba","Escuela Man Cesped",61,1,0,0,95,3,20,1,1,182,3,9,194,220,0.522,0.882
"13592","Cochabamba","Sacaba","Escuela Man Cesped",50,0,1,1,119,3,11,0,1,186,0,8,194,223,0.64,0.87
"13593","Cochabamba","Sacaba","Escuela Man Cesped",65,1,2,1,98,2,15,1,3,188,1,9,198,220,0.521,0.9
"13594","Cochabamba","Sacaba","Escuela Man Cesped",63,1,1,0,88,3,16,0,0,172,2,24,198,216,0.512,0.917
"13595","Cochabamba","Sacaba","Escuela Man Cesped",55,1,2,0,101,3,23,0,0,185,3,9,197,225,0.546,0.876
"13596","Cochabamba","Sacaba","Escuela Man Cesped",49,2,0,0,110,8,18,0,2,189,7,5,201,225,0.582,0.893
"13597","Cochabamba","Sacaba","Escuela Man Cesped",53,1,2,0,105,2,17,0,1,181,6,15,202,220,0.58,0.918
"13598","Cochabamba","Sacaba","Escuela Man Cesped",58,0,2,1,107,1,17,1,0,187,2,10,199,226,0.572,0.881
"13599","Cochabamba","Sacaba","Escuela Man Cesped",87,1,0,1,70,5,12,2,0,178,2,10,190,213,0.393,0.892
"13600","Cochabamba","Sacaba","Escuela Man Cesped",61,2,0,1,104,5,21,1,1,196,1,12,209,226,0.531,0.925
"13601","Cochabamba","Sacaba","Escuela Man Cesped",50,0,1,2,103,4,21,1,0,182,3,13,198,221,0.566,0.896
"13602","Cochabamba","Sacaba","Escuela Man Cesped",78,2,1,1,78,3,21,0,5,189,5,11,205,224,0.413,0.915
"13603","Cochabamba","Sacaba","Escuela Man Cesped",54,0,1,2,114,3,20,2,1,197,5,10,212,226,0.579,0.938
"13604","Cochabamba","Sacaba","Escuela Man Cesped",72,0,0,0,92,2,23,3,0,192,2,13,207,226,0.479,0.916
"13605","Cochabamba","Sacaba","Escuela Man Cesped",74,2,2,0,92,2,13,1,1,187,3,4,194,217,0.492,0.894
"13606","Cochabamba","Sacaba","Escuela Man Cesped",84,0,1,0,96,5,13,0,0,199,1,5,205,228,0.482,0.899
"13607","Cochabamba","Sacaba","Escuela Man Cesped",51,4,0,0,105,4,18,1,1,184,2,3,189,215,0.571,0.879
"13608","Cochabamba","Sacaba","Escuela Man Cesped",67,1,0,0,95,7,18,0,1,189,4,6,199,221,0.503,0.9
"13609","Cochabamba","Sacaba","Escuela Man Cesped",65,0,1,1,101,4,13,0,0,185,0,12,197,220,0.546,0.895
"13610","Cochabamba","Sacaba","Escuela Man Cesped",75,0,1,1,83,7,17,4,3,191,1,7,199,227,0.435,0.877
"13611","Cochabamba","Sacaba","Escuela Man Cesped",90,1,2,2,87,6,17,0,2,207,2,12,221,236,0.42,0.936
"13612","Cochabamba","Sacaba","Escuela German Busch",60,0,0,2,100,5,25,1,4,197,3,4,204,225,0.508,0.907
"13613","Cochabamba","Sacaba","Escuela German Busch",53,1,1,0,97,1,25,1,1,180,2,8,190,219,0.539,0.868
"13614","Cochabamba","Sacaba","Escuela German Busch",56,0,0,0,97,5,25,1,2,186,2,7,195,225,0.522,0.867
"13615","Cochabamba","Sacaba","Escuela German Busch",58,3,1,0,111,5,18,0,2,198,4,12,214,230,0.561,0.93
"13616","Cochabamba","Sacaba","Escuela German Busch",67,0,1,2,110,6,14,0,3,203,0,8,211,233,0.542,0.906
"13617","Cochabamba","Sacaba","Escuela German Busch",32,1,1,0,119,2,28,1,3,187,3,8,198,225,0.636,0.88
"13618","Cochabamba","Sacaba","Escuela German Busch",53,1,1,1,103,5,23,1,1,189,5,6,200,227,0.545,0.881
"13619","Cochabamba","Sacaba","Escuela German Busch",64,0,0,2,95,1,22,1,1,186,0,7,193,215,0.511,0.898
"13620","Cochabamba","Sacaba","Escuela German Busch",43,0,0,0,113,6,23,0,2,187,3,8,198,225,0.604,0.88
"13621","Cochabamba","Sacaba","Escuela German Busch",66,3,0,0,106,2,15,0,0,192,4,6,202,224,0.552,0.902
"13622","Cochabamba","Sacaba","Escuela German Busch",57,0,0,0,95,4,19,1,1,177,8,13,198,227,0.537,0.872
"13623","Cochabamba","Sacaba","Escuela German Busch",56,4,2,2,95,10,17,2,2,190,4,10,204,224,0.5,0.911
"13624","Cochabamba","Sacaba","Escuela German Busch",45,0,1,0,112,3,33,0,4,198,1,4,203,228,0.566,0.89
"13625","Cochabamba","Sacaba","Escuela German Busch",67,2,0,0,88,3,28,0,1,189,2,8,199,226,0.466,0.881
"13626","Cochabamba","Sacaba","Escuela German Busch",77,0,1,0,91,2,17,0,0,188,5,8,201,225,0.484,0.893
"13627","Cochabamba","Sacaba","Escuela German Busch",74,0,0,0,89,7,18,2,2,192,1,7,200,223,0.464,0.897
"13628","Cochabamba","Sacaba","Escuela German Busch",75,2,1,0,86,5,19,0,3,191,1,11,203,228,0.45,0.89
"13629","Cochabamba","Sacaba","Escuela German Busch",68,2,1,0,103,4,17,1,2,198,3,4,205,225,0.52,0.911
"13630","Cochabamba","Sacaba","Escuela German Busch",55,0,0,0,106,6,19,1,2,189,2,5,196,223,0.561,0.879
"13631","Cochabamba","Sacaba","Escuela German Busch",56,1,1,1,97,4,20,0,3,183,5,12,200,223,0.53,0.897
"13632","Cochabamba","Sacaba","Escuela German Busch",67,0,0,2,91,5,25,1,1,192,2,6,200,226,0.474,0.885
"13633","Cochabamba","Sacaba","Escuela German Busch",44,0,1,1,113,6,25,0,4,194,0,5,199,222,0.582,0.896
"13634","Cochabamba","Sacaba","Escuela German Busch",55,0,1,0,119,2,18,0,0,195,1,8,204,228,0.61,0.895
"13635","Cochabamba","Sacaba","Escuela German Busch",60,1,0,0,96,6,18,1,0,182,2,9,193,221,0.527,0.873
"13636","Cochabamba","Sacaba","Escuela German Busch",84,0,1,0,90,5,14,0,2,196,2,8,206,218,0.459,0.945
"13637","Cochabamba","Sacaba","Unidad Educativa Ulincate",38,0,0,0,127,6,27,0,2,200,3,15,218,234,0.635,0.932
"13638","Cochabamba","Sacaba","Unidad Educativa Ulincate",29,0,3,1,137,2,32,1,3,208,2,8,218,234,0.659,0.932
"13639","Cochabamba","Sacaba","Unidad Educativa Ulincate",37,1,0,0,135,4,28,2,0,207,5,12,224,236,0.652,0.949
"13640","Cochabamba","Sacaba","Unidad Educativa Ulincate",29,0,2,0,142,6,19,2,3,203,3,9,215,230,0.7,0.935
"13641","Cochabamba","Sacaba","Unidad Educativa Ulincate",29,0,3,1,144,2,31,2,2,214,1,3,218,235,0.673,0.928
"13642","Cochabamba","Sacaba","Unidad Educativa Ulincate",43,1,0,1,143,1,29,1,1,220,3,4,227,235,0.65,0.966
"13643","Cochabamba","Sacaba","Unidad Educativa Boliviano Británico",34,0,0,1,143,6,22,0,3,209,2,5,216,236,0.684,0.915
"13644","Cochabamba","Sacaba","Unidad Educativa Boliviano Británico",36,0,1,0,135,2,32,0,2,208,3,2,213,234,0.649,0.91
"13645","Cochabamba","Sacaba","Unidad Educativa Boliviano Británico",40,0,1,2,120,5,28,1,2,199,5,6,210,237,0.603,0.886
"13646","Cochabamba","Sacaba","Unidad Educativa Boliviano Británico",42,0,0,0,127,6,32,0,2,209,1,6,216,233,0.608,0.927
"13647","Cochabamba","Sacaba","Unidad Educativa Boliviano Británico",42,0,2,0,126,5,32,0,1,208,4,4,216,237,0.606,0.911
"13648","Cochabamba","Sacaba","Unidad Educativa Boliviano Británico",19,2,0,0,135,2,49,1,2,210,2,5,217,237,0.643,0.916
"13649","Cochabamba","Sacaba","Unidad Educativa Boliviano Británico",33,1,2,0,144,7,19,0,0,206,3,4,213,233,0.699,0.914
"13650","Cochabamba","Sacaba","Unidad Educativa Boliviano Británico",32,2,0,0,143,5,26,1,1,210,0,4,214,231,0.681,0.926
"13651","Cochabamba","Sacaba","Unidad Educativa Boliviano Británico",38,0,0,1,133,8,24,0,3,207,5,9,221,236,0.643,0.936
"13652","Cochabamba","Sacaba","Unidad Educativa Boliviano Británico",31,1,1,0,148,0,25,0,1,207,3,9,219,238,0.715,0.92
"13653","Cochabamba","Sacaba","Unidad Educativa Boliviano Británico",31,2,2,1,140,7,28,1,0,212,2,4,218,235,0.66,0.928
"13654","Cochabamba","Sacaba","Unidad Educativa Boliviano Británico",24,1,0,0,150,0,32,0,2,209,1,8,218,234,0.718,0.932
"13655","Cochabamba","Sacaba","Unidad Educativa Boliviano Británico",26,3,2,1,138,5,25,0,4,204,1,13,218,233,0.676,0.936
"13656","Cochabamba","Sacaba","Unidad Educativa Boliviano Británico",32,1,1,0,146,1,26,0,3,210,2,6,218,236,0.695,0.924
"13657","Cochabamba","Sacaba","Unidad Educativa Boliviano Británico",49,0,0,1,114,4,25,0,2,195,4,10,209,231,0.585,0.905
"13658","Cochabamba","Sacaba","Unidad Educativa Boliviano Británico",39,0,0,0,122,1,33,1,0,196,3,5,204,236,0.622,0.864
"13659","Cochabamba","Sacaba","Unidad Educativa Boliviano Británico",29,1,0,0,130,6,37,0,0,203,3,10,216,238,0.64,0.908
"13660","Cochabamba","Sacaba","Unidad Educativa Boliviano Británico",23,0,0,1,146,7,31,0,1,209,4,3,216,234,0.699,0.923
"13661","Cochabamba","Sacaba","Unidad Educativa Boliviano Británico",26,0,0,2,138,5,31,2,0,204,7,5,216,230,0.676,0.939
"13662","Cochabamba","Sacaba","Unidad Educativa Boliviano Británico",36,2,1,0,135,1,29,1,2,207,18,6,231,231,0.652,1
"13663","Cochabamba","Sacaba","Unidad Educativa Boliviano Británico",32,0,2,1,144,5,22,1,1,208,4,9,221,235,0.692,0.94
"13664","Cochabamba","Sacaba","Unidad Educativa Entre Rios",38,2,1,0,134,1,35,1,1,213,4,11,228,238,0.629,0.958
"13665","Cochabamba","Sacaba","Unidad Educativa Entre Rios",43,2,4,0,147,4,34,0,1,235,2,9,246,252,0.626,0.976
"13666","Cochabamba","Sacaba","U.E. 1ro. de Mayo",43,1,1,0,147,6,21,0,0,219,3,10,232,240,0.671,0.967
"13667","Cochabamba","Sacaba","U. E. 27 de Mayo",22,2,2,0,167,3,25,1,0,222,2,5,229,239,0.752,0.958
"13668","Cochabamba","Sacaba","U.E. Antofagasta",34,0,4,0,138,8,39,0,3,226,1,4,231,239,0.611,0.967
"13669","Cochabamba","Sacaba","U.E. Antofagasta",34,0,1,1,132,4,37,1,1,211,0,12,223,239,0.626,0.933
"13670","Cochabamba","Sacaba","U.E. Antofagasta",29,0,1,0,144,3,34,1,0,212,3,9,224,239,0.679,0.937
"13671","Cochabamba","Sacaba","U.E. Antofagasta",55,0,1,0,121,3,40,0,1,221,6,4,231,239,0.548,0.967
"13672","Cochabamba","Sacaba","U. E. Roberto Nicoli Parietti",54,1,0,0,85,2,31,0,2,175,1,4,180,190,0.486,0.947
"13673","Cochabamba","Sacaba","U.E. República del Ecuador",60,0,0,0,122,7,28,0,3,220,3,6,229,240,0.555,0.954
"13674","Cochabamba","Sacaba","U.E. República del Ecuador",39,1,4,2,153,3,26,0,0,228,2,4,234,240,0.671,0.975
"13675","Cochabamba","Sacaba","U.E. República del Ecuador",43,0,1,0,128,3,24,0,2,201,5,18,224,239,0.637,0.937
"13676","Cochabamba","Sacaba","U.E. República del Ecuador",39,2,0,0,147,2,23,4,1,218,3,6,227,239,0.674,0.95
"13677","Cochabamba","Sacaba","U.E. República del Ecuador",50,0,4,1,136,1,28,0,1,221,4,7,232,240,0.615,0.967
"13678","Cochabamba","Sacaba","U.E. República del Ecuador",39,1,1,0,149,3,22,0,1,216,6,7,229,238,0.69,0.962
"13679","Cochabamba","Sacaba","U.E. República del Ecuador",56,0,1,1,135,3,25,1,1,223,3,7,233,240,0.605,0.971
"13680","Cochabamba","Sacaba","U.E. República del Ecuador",47,0,0,1,145,3,20,1,1,218,1,11,230,239,0.665,0.962
"13681","Cochabamba","Sacaba","U.E. República del Ecuador",56,0,0,2,148,3,17,0,2,228,3,3,234,238,0.649,0.983
"13682","Cochabamba","Sacaba","U.E. República del Ecuador",32,1,1,0,121,7,13,0,1,176,1,4,181,191,0.688,0.948
"13683","Cochabamba","Sacaba","U.E. Villa Clotilde",20,0,2,1,160,5,30,2,2,222,2,6,230,240,0.721,0.958
"13684","Cochabamba","Sacaba","U.E. Villa Clotilde",22,1,0,0,159,3,33,0,2,220,4,5,229,237,0.723,0.966
"13685","Cochabamba","Sacaba","U.E. Villa Clotilde",20,0,2,1,167,1,35,1,0,227,1,5,233,239,0.736,0.975
"13686","Cochabamba","Sacaba","Escuela Jesus Terceros",136,0,2,0,45,5,9,1,2,200,1,6,207,230,0.225,0.9
"13687","Cochabamba","Sacaba","Escuela Jesus Terceros",133,0,0,0,49,4,7,1,1,195,0,9,204,223,0.251,0.915
"13688","Cochabamba","Sacaba","Escuela Jesus Terceros",137,0,0,0,43,4,7,0,1,192,1,6,199,225,0.224,0.884
"13689","Cochabamba","Sacaba","Escuela Jesus Terceros",129,0,0,0,53,3,9,0,0,194,2,7,203,226,0.273,0.898
"13690","Cochabamba","Sacaba","Escuela Jesus Terceros",135,0,1,0,45,4,7,0,0,192,0,8,200,226,0.234,0.885
"13691","Cochabamba","Sacaba","Escuela Jesus Terceros",145,0,1,0,49,5,4,1,0,205,0,4,209,226,0.239,0.925
"13692","Cochabamba","Sacaba","Escuela Jesus Terceros",139,1,0,0,51,3,2,1,0,197,2,7,206,230,0.259,0.896
"13693","Cochabamba","Sacaba","Escuela Jesus Terceros",138,0,0,0,43,3,12,1,0,197,0,7,204,229,0.218,0.891
"13694","Cochabamba","Sacaba","Escuela Jesus Terceros",126,0,0,2,57,1,7,1,1,195,0,13,208,227,0.292,0.916
"13695","Cochabamba","Sacaba","Escuela Jesus Terceros",145,0,1,0,46,2,2,0,0,196,1,4,201,227,0.235,0.885
"13696","Cochabamba","Sacaba","Escuela Jesus Terceros",132,0,0,2,42,4,11,1,0,192,1,8,201,221,0.219,0.91
"13697","Cochabamba","Sacaba","Escuela Jesus Terceros",142,0,0,0,48,1,3,0,1,195,1,3,199,230,0.246,0.865
"13698","Cochabamba","Sacaba","Escuela Jesus Terceros",138,1,1,1,48,2,8,0,2,201,0,7,208,232,0.239,0.897
"13699","Cochabamba","Sacaba","Escuela Jesus Terceros",125,1,1,2,52,5,7,0,0,193,0,7,200,226,0.269,0.885
"13700","Cochabamba","Sacaba","Escuela Jesus Terceros",128,0,1,1,55,9,7,0,0,201,2,2,205,232,0.274,0.884
"13701","Cochabamba","Sacaba","Escuela Jesus Terceros",129,0,0,1,64,3,4,0,0,201,1,5,207,223,0.318,0.928
"13702","Cochabamba","Sacaba","Escuela Jesus Terceros",134,0,1,0,41,7,5,0,1,189,0,10,199,223,0.217,0.892
"13703","Cochabamba","Sacaba","Colegio Quintanilla",84,0,4,1,75,2,19,1,0,186,6,7,199,222,0.403,0.896
"13704","Cochabamba","Sacaba","Colegio Quintanilla",93,0,0,0,72,11,8,0,3,187,1,7,195,225,0.385,0.867
"13705","Cochabamba","Sacaba","Colegio Quintanilla",97,0,1,1,70,4,15,1,0,189,0,8,197,220,0.37,0.895
"13706","Cochabamba","Sacaba","Colegio Quintanilla",93,0,1,1,81,7,8,0,3,194,1,3,198,227,0.418,0.872
"13707","Cochabamba","Sacaba","Colegio Quintanilla",103,1,1,0,68,3,12,0,0,188,2,10,200,227,0.362,0.881
"13708","Cochabamba","Sacaba","Colegio Quintanilla",103,0,0,0,60,6,10,0,0,179,1,18,198,225,0.335,0.88
"13709","Cochabamba","Sacaba","Colegio Quintanilla",96,0,0,0,76,7,18,2,3,202,0,7,209,223,0.376,0.937
"13710","Cochabamba","Sacaba","Colegio Quintanilla",99,1,2,1,74,3,10,1,0,191,2,4,197,222,0.387,0.887
"13711","Cochabamba","Sacaba","Colegio Quintanilla",98,0,0,1,73,5,14,0,2,193,2,8,203,229,0.378,0.886
"13712","Cochabamba","Sacaba","Colegio Quintanilla",56,1,0,3,103,0,18,0,5,186,4,5,195,227,0.554,0.859
"13713","Cochabamba","Sacaba","Colegio Quintanilla",77,1,4,1,93,2,9,0,1,188,2,8,198,224,0.495,0.884
"13714","Cochabamba","Sacaba","Colegio Quintanilla",66,1,1,0,95,1,21,1,4,190,2,15,207,228,0.5,0.908
"13715","Cochabamba","Sacaba","Colegio Quintanilla",102,1,0,0,70,5,13,0,3,194,1,6,201,225,0.361,0.893
"13716","Cochabamba","Sacaba","Colegio Quintanilla",92,0,0,0,83,2,18,0,1,196,1,7,204,224,0.423,0.911
"13717","Cochabamba","Sacaba","Colegio Quintanilla",105,0,0,1,73,2,10,0,1,192,1,10,203,227,0.38,0.894
"13718","Cochabamba","Sacaba","Colegio Quintanilla",94,0,1,0,77,2,10,0,2,186,1,5,192,227,0.414,0.846
"13719","Cochabamba","Sacaba","Colegio Quintanilla",94,0,1,0,87,3,11,1,5,202,0,10,212,229,0.431,0.926
"13720","Cochabamba","Sacaba","Colegio Quintanilla",96,0,0,2,72,9,12,0,0,191,3,8,202,228,0.377,0.886
"13721","Cochabamba","Sacaba","Colegio Quintanilla",116,0,0,0,63,2,12,0,3,196,0,6,202,220,0.321,0.918
"13722","Cochabamba","Sacaba","Colegio Quintanilla",87,2,0,0,79,8,11,1,2,190,2,6,198,219,0.416,0.904
"13723","Cochabamba","Sacaba","Colegio Quintanilla",90,1,1,0,85,7,12,0,0,196,2,5,203,225,0.434,0.902
"13724","Cochabamba","Sacaba","Colegio Quintanilla",123,0,1,1,48,4,12,0,0,189,1,5,195,219,0.254,0.89
"13725","Cochabamba","Sacaba","Colegio Quintanilla",86,0,0,0,97,4,13,0,0,200,0,10,210,225,0.485,0.933
"13726","Cochabamba","Sacaba","Colegio Quintanilla",94,0,1,1,87,3,11,0,1,198,2,11,211,228,0.439,0.925
"13727","Cochabamba","Sacaba","Colegio Quintanilla",67,0,3,1,89,1,25,0,3,189,4,11,204,226,0.471,0.903
"13728","Cochabamba","Sacaba","Colegio Quintanilla",96,2,1,1,69,6,13,1,1,190,2,6,198,220,0.363,0.9
"13729","Cochabamba","Sacaba","Colegio Quintanilla",97,2,1,1,68,0,13,1,3,186,1,7,194,228,0.366,0.851
"13730","Cochabamba","Sacaba","Colegio Quintanilla",97,0,0,0,80,5,11,0,3,196,2,2,200,221,0.408,0.905
"13731","Cochabamba","Sacaba","Colegio Quintanilla",105,1,0,0,66,3,10,0,3,188,3,5,196,224,0.351,0.875
"13732","Cochabamba","Sacaba","Colegio Quintanilla",98,0,1,0,79,4,15,0,0,197,0,6,203,225,0.401,0.902
"13733","Cochabamba","Sacaba","Colegio Quintanilla",106,0,0,0,69,2,6,1,2,186,2,5,193,224,0.371,0.862
"13734","Cochabamba","Sacaba","Colegio Quintanilla",85,1,1,0,66,4,20,0,2,179,2,2,183,224,0.369,0.817
"13735","Cochabamba","Sacaba","Colegio Quintanilla",94,0,2,1,87,4,13,0,1,202,1,5,208,233,0.431,0.893
"13736","Cochabamba","Sacaba","Colegio Quintanilla",101,0,0,1,64,4,11,1,1,183,3,7,193,226,0.35,0.854
"13737","Cochabamba","Sacaba","Colegio Quintanilla",95,0,0,1,75,2,12,1,0,186,1,7,194,226,0.403,0.858
"13738","Cochabamba","Sacaba","Colegio Quintanilla",86,3,0,0,92,5,8,0,2,196,2,6,204,227,0.469,0.899
"13739","Cochabamba","Sacaba","Colegio Quintanilla",92,4,0,0,58,2,18,0,1,175,4,3,182,226,0.331,0.805
"13740","Cochabamba","Sacaba","Colegio Quintanilla",93,1,1,0,86,2,11,0,0,194,4,11,209,225,0.443,0.929
"13741","Cochabamba","Sacaba","Colegio Quintanilla",116,0,0,0,66,5,5,0,3,195,3,11,209,233,0.338,0.897
"13742","Cochabamba","Sacaba","Colegio Quintanilla",92,1,1,0,75,5,20,1,2,197,1,6,204,225,0.381,0.907
"13743","Cochabamba","Sacaba","Colegio Quintanilla",90,1,0,1,71,3,14,1,1,182,3,6,191,226,0.39,0.845
"13744","Cochabamba","Sacaba","Colegio Quintanilla",88,1,1,0,74,8,15,0,2,189,0,14,203,226,0.392,0.898
"13745","Cochabamba","Sacaba","Colegio Quintanilla",110,0,1,2,68,7,8,0,4,200,1,5,206,227,0.34,0.907
"13746","Cochabamba","Sacaba","Colegio Quintanilla",104,0,0,1,77,4,9,1,1,197,4,7,208,233,0.391,0.893
"13747","Cochabamba","Sacaba","Colegio Quintanilla",123,0,2,1,52,3,10,0,1,192,0,1,193,222,0.271,0.869
"13748","Cochabamba","Sacaba","Colegio Quintanilla",115,0,3,0,59,3,13,0,2,195,2,3,200,227,0.303,0.881
"13749","Cochabamba","Sacaba","(Cárcel) Penitenciaria El Abra",20,0,1,1,107,3,27,0,2,161,5,3,169,227,0.665,0.744
"13750","Cochabamba","Sacaba","Unidad Educativa Israelí El Abra",48,4,0,0,128,7,19,2,2,210,1,7,218,235,0.61,0.928
"13751","Cochabamba","Sacaba","Unidad Educativa Israelí El Abra",44,0,1,0,129,9,23,0,1,207,3,6,216,229,0.623,0.943
"13752","Cochabamba","Sacaba","Unidad Educativa Israelí El Abra",58,0,0,0,134,0,11,0,0,203,4,16,223,235,0.66,0.949
"13753","Cochabamba","Sacaba","Unidad Educativa Israelí El Abra",48,1,1,0,124,4,16,1,3,198,1,10,209,231,0.626,0.905
"13754","Cochabamba","Sacaba","Unidad Educativa Israelí El Abra",57,0,1,0,107,3,21,1,4,194,2,9,205,230,0.552,0.891
"13755","Cochabamba","Sacaba","Unidad Educativa Israelí El Abra",39,0,1,1,137,3,21,0,5,207,2,8,217,229,0.662,0.948
"13756","Cochabamba","Sacaba","Unidad Educativa Israelí El Abra",31,1,0,1,146,5,17,0,2,203,2,9,214,235,0.719,0.911
"13757","Cochabamba","Sacaba","Unidad Educativa Israelí El Abra",34,1,2,0,135,7,33,0,0,212,2,5,219,233,0.637,0.94
"13758","Cochabamba","Sacaba","Unidad Educativa Israelí El Abra",70,4,0,0,106,9,16,1,0,206,1,5,212,228,0.515,0.93
"13759","Cochabamba","Sacaba","Unidad Educativa Israelí El Abra",52,0,3,0,136,5,17,1,2,216,3,4,223,236,0.63,0.945
"13760","Cochabamba","Sacaba","Unidad Educativa Israelí El Abra",49,0,1,0,117,9,17,0,2,195,3,12,210,232,0.6,0.905
"13761","Cochabamba","Sacaba","Unidad Educativa Israelí El Abra",50,1,0,0,129,4,16,0,2,202,1,10,213,228,0.639,0.934
"13762","Cochabamba","Sacaba","Unidad Educativa Israelí El Abra",34,0,0,0,133,3,24,0,1,195,1,7,203,232,0.682,0.875
"13763","Cochabamba","Sacaba","Unidad Educativa Israelí El Abra",42,1,3,0,131,2,23,1,1,204,2,3,209,232,0.642,0.901
"13764","Cochabamba","Sacaba","Unidad Educativa Israelí El Abra",31,0,2,0,147,4,20,1,0,205,5,3,213,233,0.717,0.914
"13765","Cochabamba","Sacaba","Unidad Educativa Israelí El Abra",45,1,0,0,120,8,18,0,1,193,4,4,201,233,0.622,0.863
"13766","Cochabamba","Sacaba","Unidad Educativa Israelí El Abra",52,0,1,0,132,3,17,0,0,205,0,5,210,230,0.644,0.913
"13767","Cochabamba","Sacaba","Unidad Educativa Israelí El Abra",63,2,0,0,110,2,22,0,1,200,0,8,208,229,0.55,0.908
"13768","Cochabamba","Sacaba","Unidad Educativa Israelí El Abra",39,0,4,0,128,3,18,1,2,195,3,8,206,229,0.656,0.9
"13769","Cochabamba","Sacaba","Unidad Educativa Israelí El Abra",40,1,2,0,132,4,25,0,0,204,1,4,209,232,0.647,0.901
"13770","Cochabamba","Sacaba","Unidad Educativa Israelí El Abra",62,1,1,0,124,8,11,0,0,207,1,7,215,229,0.599,0.939
"13771","Cochabamba","Sacaba","Unidad Educativa Israelí El Abra",44,0,1,2,127,7,15,1,1,198,5,7,210,234,0.641,0.897
"13772","Cochabamba","Sacaba","Unidad Educativa Israelí El Abra",68,2,3,1,101,5,14,0,1,195,1,10,206,227,0.518,0.907
"13773","Cochabamba","Sacaba","Unidad Educativa Israelí El Abra",64,2,1,0,116,3,16,1,1,204,4,4,212,233,0.569,0.91
"13774","Cochabamba","Sacaba","Unidad Educativa Israelí El Abra",65,1,1,0,124,3,12,0,1,207,4,7,218,232,0.599,0.94
"13775","Cochabamba","Sacaba","Unidad Educativa Israelí El Abra",47,0,0,0,129,4,15,0,0,195,3,10,208,231,0.662,0.9
"13776","Cochabamba","Sacaba","Unidad Educativa del Valle",93,1,0,0,79,7,18,1,2,201,4,8,213,237,0.393,0.899
"13777","Cochabamba","Sacaba","Unidad Educativa del Valle",99,0,0,0,86,3,20,0,2,210,2,7,219,239,0.41,0.916
"13778","Cochabamba","Sacaba","Unidad Educativa del Valle",91,0,0,1,80,4,24,0,2,202,2,8,212,235,0.396,0.902
"13779","Cochabamba","Sacaba","Unidad Educativa del Valle",90,0,0,0,94,4,27,1,1,217,2,5,224,237,0.433,0.945
"13780","Cochabamba","Sacaba","Unidad Educativa del Valle",102,0,1,0,81,5,22,1,0,212,2,9,223,239,0.382,0.933
"13781","Cochabamba","Sacaba","Unidad Educativa del Valle",117,1,2,1,60,4,27,1,1,214,1,6,221,236,0.28,0.936
"13782","Cochabamba","Sacaba","Unidad Educativa del Valle",102,0,1,0,87,5,21,0,1,217,1,3,221,237,0.401,0.932
"13783","Cochabamba","Sacaba","Unidad Educativa del Valle",104,0,1,0,68,2,26,2,3,206,2,11,219,237,0.33,0.924
"13784","Cochabamba","Sacaba","Unidad Educativa del Valle",97,0,1,0,78,6,24,1,1,208,1,5,214,237,0.375,0.903
"13785","Cochabamba","Sacaba","Unidad Educativa del Valle",106,1,0,1,74,3,22,0,0,207,2,10,219,239,0.357,0.916
"13786","Cochabamba","Sacaba","Unidad Educativa del Valle",105,0,0,0,88,6,16,0,0,215,2,3,220,240,0.409,0.917
"13787","Cochabamba","Sacaba","Unidad Educativa del Valle",114,0,0,0,78,4,16,1,1,214,0,6,220,234,0.364,0.94
"13788","Cochabamba","Sacaba","Unidad Educativa del Valle",120,0,2,0,80,0,19,0,2,223,1,3,227,239,0.359,0.95
"13789","Cochabamba","Sacaba","Unidad Educativa del Valle",96,1,1,0,82,7,13,1,0,201,0,7,208,236,0.408,0.881
"13790","Cochabamba","Sacaba","Unidad Educativa del Valle",112,0,0,0,80,4,15,1,1,213,1,8,222,237,0.376,0.937
"13791","Cochabamba","Sacaba","Unidad Educativa del Valle",115,0,0,1,68,3,20,0,2,209,2,8,219,240,0.325,0.912
"13792","Cochabamba","Sacaba","Unidad Educativa del Valle",127,0,2,0,60,4,25,0,1,219,2,6,227,239,0.274,0.95
"13793","Cochabamba","Sacaba","Unidad Educativa Kanata",145,0,1,0,45,1,7,1,1,201,1,4,206,236,0.224,0.873
"13794","Cochabamba","Sacaba","Unidad Educativa Kanata",142,0,0,0,58,3,8,0,1,212,0,3,215,237,0.274,0.907
"13795","Cochabamba","Sacaba","Unidad Educativa Kanata",140,1,3,1,42,5,12,4,0,208,0,8,216,236,0.202,0.915
"13796","Cochabamba","Sacaba","Unidad Educativa Kanata",138,0,1,0,54,5,8,1,2,209,1,5,215,235,0.258,0.915
"13797","Cochabamba","Sacaba","Unidad Educativa Kanata",157,0,0,0,39,1,6,0,1,204,0,3,207,235,0.191,0.881
"13798","Cochabamba","Sacaba","Unidad Educativa Kanata",105,0,0,0,32,6,10,2,0,155,1,6,162,178,0.206,0.91
"13799","Cochabamba","Sacaba","U.E. Puntiti Chico",128,1,1,0,71,2,17,0,1,221,0,6,227,240,0.321,0.946
"13800","Cochabamba","Sacaba","U.E. Puntiti Chico",139,0,2,0,69,5,15,0,1,231,0,3,234,240,0.299,0.975
"13801","Cochabamba","Sacaba","U.E. Puntiti Chico",97,0,2,0,56,5,10,0,2,172,0,2,174,182,0.326,0.956
"13802","Cochabamba","Sacaba","U.E. José Vía García",25,1,2,1,99,1,24,0,0,153,3,8,164,165,0.647,0.994
"13803","Cochabamba","Sacaba","Colegio Puerto Mejillones",99,0,0,2,71,3,11,0,2,188,2,7,197,223,0.378,0.883
"13804","Cochabamba","Sacaba","Colegio Puerto Mejillones",126,0,1,1,65,0,3,3,0,199,1,4,204,231,0.327,0.883
"13805","Cochabamba","Sacaba","Colegio Puerto Mejillones",123,0,0,0,55,5,8,1,1,193,0,4,197,223,0.285,0.883
"13806","Cochabamba","Sacaba","Colegio Puerto Mejillones",122,0,0,1,63,4,5,1,0,196,2,1,199,227,0.321,0.877
"13807","Cochabamba","Sacaba","Colegio Puerto Mejillones",92,0,0,1,76,4,9,2,0,184,2,5,191,221,0.413,0.864
"13808","Cochabamba","Sacaba","Colegio Puerto Mejillones",120,0,1,0,57,5,12,0,0,195,1,3,199,226,0.292,0.881
"13809","Cochabamba","Sacaba","Colegio Puerto Mejillones",124,2,0,0,71,0,7,0,0,204,2,3,209,230,0.348,0.909
"13810","Cochabamba","Sacaba","Colegio Puerto Mejillones",114,0,0,1,59,4,11,0,1,190,2,6,198,229,0.311,0.865
"13811","Cochabamba","Sacaba","Colegio Puerto Mejillones",114,1,1,0,72,3,6,0,0,197,2,5,204,224,0.365,0.911
"13812","Cochabamba","Sacaba","Colegio Puerto Mejillones",119,1,0,0,61,0,12,2,0,195,1,4,200,228,0.313,0.877
"13813","Cochabamba","Sacaba","Colegio Puerto Mejillones",102,0,1,0,83,3,7,0,0,196,0,2,198,219,0.423,0.904
"13814","Cochabamba","Sacaba","Colegio Puerto Mejillones",125,0,0,0,47,3,8,0,2,185,2,6,193,218,0.254,0.885
"13815","Cochabamba","Sacaba","Colegio Puerto Mejillones",112,0,0,0,67,2,10,2,0,193,1,5,199,226,0.347,0.881
"13816","Cochabamba","Sacaba","Colegio Puerto Mejillones",123,0,1,0,65,2,15,0,2,208,0,6,214,229,0.312,0.934
"13817","Cochabamba","Sacaba","Colegio Puerto Mejillones",119,0,0,0,53,1,10,1,1,185,1,7,193,226,0.286,0.854
"13818","Cochabamba","Sacaba","Colegio Puerto Mejillones",122,1,0,0,57,1,12,0,2,195,1,4,200,229,0.292,0.873
"13819","Cochabamba","Sacaba","Colegio Puerto Mejillones",122,0,0,0,47,5,3,0,0,177,0,6,183,222,0.266,0.824
"13820","Cochabamba","Sacaba","Colegio Puerto Mejillones",124,0,1,0,60,2,3,0,2,192,2,3,197,218,0.312,0.904
"13821","Cochabamba","Sacaba","Colegio Puerto Mejillones",114,1,0,0,60,4,11,1,0,191,3,9,203,223,0.314,0.91
"13822","Cochabamba","Sacaba","Colegio Puerto Mejillones",127,0,2,0,49,2,12,4,1,197,1,4,202,227,0.249,0.89
"13823","Cochabamba","Sacaba","Unidad Educativa Villa Graciela",129,0,0,2,63,2,9,0,2,207,0,4,211,228,0.304,0.925
"13824","Cochabamba","Sacaba","Unidad Educativa Villa Graciela",114,2,1,0,70,4,13,0,1,205,0,5,210,232,0.341,0.905
"13825","Cochabamba","Sacaba","Unidad Educativa Villa Graciela",103,0,3,1,77,7,12,1,1,205,2,10,217,232,0.376,0.935
"13826","Cochabamba","Sacaba","Unidad Educativa Villa Graciela",122,1,0,1,68,1,12,0,0,205,1,4,210,232,0.332,0.905
"13827","Cochabamba","Sacaba","Unidad Educativa Villa Graciela",123,1,2,0,61,2,6,1,1,197,0,6,203,231,0.31,0.879
"13828","Cochabamba","Sacaba","Unidad Educativa Villa Graciela",115,0,0,0,71,8,11,0,0,205,0,3,208,232,0.346,0.897
"13829","Cochabamba","Sacaba","Unidad Educativa Villa Graciela",117,0,0,2,74,4,14,0,1,212,0,5,217,236,0.349,0.919
"13830","Cochabamba","Sacaba","Unidad Educativa Villa Graciela",110,0,0,2,77,2,13,0,1,205,1,6,212,234,0.376,0.906
"13831","Cochabamba","Sacaba","Unidad Educativa Villa Graciela",126,0,0,0,72,3,11,1,0,213,1,2,216,233,0.338,0.927
"13832","Cochabamba","Sacaba","Unidad Educativa Villa Graciela",110,0,0,0,67,2,20,2,0,201,1,7,209,232,0.333,0.901
"13833","Cochabamba","Sacaba","Unidad Educativa Villa Graciela",124,0,1,1,66,2,6,1,1,202,1,9,212,229,0.327,0.926
"13834","Cochabamba","Sacaba","Unidad Educativa Villa Graciela",119,0,2,0,68,5,8,1,3,206,0,7,213,234,0.33,0.91
"13835","Cochabamba","Sacaba","Unidad Educativa Villa Graciela",120,2,3,0,69,1,6,0,2,203,0,5,208,232,0.34,0.897
"13836","Cochabamba","Sacaba","Unidad Educativa Edmundo Bojanowski",125,1,0,0,71,1,23,0,1,222,0,3,225,238,0.32,0.945
"13837","Cochabamba","Sacaba","Unidad Educativa Edmundo Bojanowski",122,1,4,1,72,1,16,0,0,217,1,4,222,239,0.332,0.929
"13838","Cochabamba","Sacaba","Unidad Educativa Edmundo Bojanowski",141,0,0,0,56,1,21,2,0,221,0,4,225,237,0.253,0.949
"13839","Cochabamba","Sacaba","Unidad Educativa Edmundo Bojanowski",120,1,1,1,75,1,19,0,2,220,0,4,224,237,0.341,0.945
"13840","Cochabamba","Sacaba","Unidad Educativa Edmundo Bojanowski",137,1,0,1,61,1,13,3,2,219,3,4,226,240,0.279,0.942
"13841","Cochabamba","Sacaba","Unidad Educativa Edmundo Bojanowski",153,1,0,0,42,6,22,0,2,226,0,4,230,240,0.186,0.958
"13842","Cochabamba","Sacaba","Unidad Educativa Edmundo Bojanowski",128,0,2,0,70,2,10,1,0,213,0,8,221,236,0.329,0.936
"13843","Cochabamba","Sacaba","Colegio Señor De Mayo",106,1,0,1,64,1,14,0,0,187,3,4,194,224,0.342,0.866
"13844","Cochabamba","Sacaba","Colegio Señor De Mayo",126,1,3,0,54,3,6,0,1,194,0,4,198,222,0.278,0.892
"13845","Cochabamba","Sacaba","Colegio Señor De Mayo",120,0,2,0,64,5,5,0,1,197,0,5,202,220,0.325,0.918
"13846","Cochabamba","Sacaba","Colegio Señor De Mayo",111,1,1,3,57,3,8,1,3,188,2,3,193,226,0.303,0.854
"13847","Cochabamba","Sacaba","Colegio Señor De Mayo",137,0,0,0,44,1,5,0,4,191,1,6,198,228,0.23,0.868
"13848","Cochabamba","Sacaba","Colegio Señor De Mayo",98,0,3,4,74,2,16,0,0,197,1,6,204,222,0.376,0.919
"13849","Cochabamba","Sacaba","Colegio Señor De Mayo",97,0,1,0,75,7,7,0,0,187,2,5,194,226,0.401,0.858
"13850","Cochabamba","Sacaba","Colegio Señor De Mayo",133,0,0,1,53,1,14,0,0,202,1,4,207,229,0.262,0.904
"13851","Cochabamba","Sacaba","Colegio Señor De Mayo",121,0,0,0,57,3,8,0,0,189,1,7,197,229,0.302,0.86
"13852","Cochabamba","Sacaba","Colegio Señor De Mayo",116,0,0,1,66,3,8,1,0,195,2,5,202,230,0.338,0.878
"13853","Cochabamba","Sacaba","Colegio Señor De Mayo",115,0,0,0,73,2,4,2,0,196,0,3,199,223,0.372,0.892
"13854","Cochabamba","Sacaba","Colegio Señor De Mayo",99,1,1,0,71,4,6,0,2,184,2,5,191,227,0.386,0.841
"13855","Cochabamba","Sacaba","Colegio Señor De Mayo",127,0,1,1,56,1,13,0,0,199,3,4,206,232,0.281,0.888
"13856","Cochabamba","Sacaba","Colegio Señor De Mayo",112,1,1,1,70,2,11,0,1,199,2,7,208,233,0.352,0.893
"13857","Cochabamba","Sacaba","Colegio Señor De Mayo",103,1,2,0,45,12,5,4,4,176,1,4,181,222,0.256,0.815
"13858","Cochabamba","Sacaba","Colegio Señor De Mayo",136,0,0,0,56,1,6,1,1,201,1,7,209,229,0.279,0.913
"13859","Cochabamba","Sacaba","Colegio Señor De Mayo",132,0,0,0,51,1,14,0,1,199,2,3,204,224,0.256,0.911
"13860","Cochabamba","Sacaba","Colegio Señor De Mayo",134,0,3,1,48,3,8,1,1,199,0,2,201,221,0.241,0.91
"13861","Cochabamba","Sacaba","Colegio Señor De Mayo",131,1,2,0,60,2,7,0,2,205,1,1,207,234,0.293,0.885
"13862","Cochabamba","Sacaba","Colegio Señor De Mayo",127,0,2,0,63,0,6,1,0,199,0,3,202,229,0.317,0.882
"13863","Cochabamba","Sacaba","Colegio Señor De Mayo",122,0,0,0,51,3,10,0,0,186,0,6,192,225,0.274,0.853
"13864","Cochabamba","Sacaba","Colegio Señor De Mayo",111,0,2,0,62,2,9,0,2,188,1,1,190,225,0.33,0.844
"13865","Cochabamba","Sacaba","Colegio Señor De Mayo",120,1,1,1,61,1,5,1,0,191,1,3,195,220,0.319,0.886
"13866","Cochabamba","Sacaba","Colegio Señor De Mayo",111,0,1,0,73,0,8,0,0,193,2,5,200,228,0.378,0.877
"13867","Cochabamba","Sacaba","Colegio Señor De Mayo",137,0,0,0,39,4,10,1,0,191,0,8,199,227,0.204,0.877
"13868","Cochabamba","Sacaba","Colegio Señor De Mayo",118,0,0,1,64,2,13,0,2,200,2,6,208,228,0.32,0.912
"13869","Cochabamba","Sacaba","Colegio Señor De Mayo",128,0,0,0,53,1,5,0,0,187,1,3,191,224,0.283,0.853
"13870","Cochabamba","Sacaba","Unidad Educativa René Barrientos Ortuño",126,1,1,0,63,7,9,1,2,210,2,4,216,235,0.3,0.919
"13871","Cochabamba","Sacaba","Unidad Educativa René Barrientos Ortuño",112,1,0,0,69,3,18,0,1,204,2,6,212,235,0.338,0.902
"13872","Cochabamba","Sacaba","Unidad Educativa René Barrientos Ortuño",137,0,1,2,49,3,16,0,0,208,1,2,211,234,0.236,0.902
"13873","Cochabamba","Sacaba","Unidad Educativa René Barrientos Ortuño",102,0,0,0,82,3,18,0,0,205,1,8,214,236,0.4,0.907
"13874","Cochabamba","Sacaba","Unidad Educativa René Barrientos Ortuño",127,1,0,0,59,3,16,0,1,207,1,2,210,237,0.285,0.886
"13875","Cochabamba","Sacaba","Unidad Educativa René Barrientos Ortuño",116,0,1,0,73,4,15,2,0,211,0,5,216,234,0.346,0.923
"13876","Cochabamba","Sacaba","Unidad Educativa René Barrientos Ortuño",122,0,0,0,75,4,11,0,0,212,2,3,217,236,0.354,0.919
"13877","Cochabamba","Sacaba","U.E. Marcelo Quiroga Santa Cruz (Pacata)",119,0,3,0,70,5,17,0,1,215,1,7,223,239,0.326,0.933
"13878","Cochabamba","Sacaba","U.E. Marcelo Quiroga Santa Cruz (Pacata)",120,0,0,0,68,6,19,2,4,219,2,5,226,239,0.311,0.946
"13879","Cochabamba","Sacaba","U.E. Marcelo Quiroga Santa Cruz (Pacata)",124,1,2,0,85,4,11,1,2,230,0,0,230,240,0.37,0.958
"13880","Cochabamba","Sacaba","Colegio Boliviano Japones",86,0,1,1,86,5,17,0,1,197,0,9,206,228,0.437,0.904
"13881","Cochabamba","Sacaba","Colegio Boliviano Japones",116,0,1,1,59,5,17,0,1,200,2,12,214,232,0.295,0.922
"13882","Cochabamba","Sacaba","Colegio Boliviano Japones",113,0,0,3,59,3,17,0,0,195,0,6,201,229,0.303,0.878
"13883","Cochabamba","Sacaba","Colegio Boliviano Japones",117,1,1,1,65,2,13,0,1,201,2,11,214,234,0.323,0.915
"13884","Cochabamba","Sacaba","Colegio Boliviano Japones",127,0,1,1,49,3,16,0,0,197,0,6,203,228,0.249,0.89
"13885","Cochabamba","Sacaba","Colegio Boliviano Japones",93,1,3,0,83,7,19,0,1,207,1,5,213,236,0.401,0.903
"13886","Cochabamba","Sacaba","Colegio Boliviano Japones",133,0,0,1,54,4,8,0,0,200,0,4,204,230,0.27,0.887
"13887","Cochabamba","Sacaba","Colegio Boliviano Japones",111,0,1,0,60,7,16,0,0,195,4,6,205,228,0.308,0.899
"13888","Cochabamba","Sacaba","Colegio Boliviano Japones",86,2,1,0,83,6,17,0,2,197,1,2,200,233,0.421,0.858
"13889","Cochabamba","Sacaba","Colegio Boliviano Japones",87,1,3,1,84,2,19,0,3,200,1,5,206,232,0.42,0.888
"13890","Cochabamba","Sacaba","Colegio Boliviano Japones",89,0,1,0,73,3,16,1,3,186,2,11,199,228,0.392,0.873
"13891","Cochabamba","Sacaba","Colegio Boliviano Japones",107,3,0,0,73,1,15,0,0,199,2,3,204,233,0.367,0.876
"13892","Cochabamba","Sacaba","Colegio Boliviano Japones",106,0,1,1,79,4,13,1,1,206,1,4,211,231,0.383,0.913
"13893","Cochabamba","Sacaba","Colegio Boliviano Japones",109,0,2,0,67,1,18,2,2,201,0,10,211,236,0.333,0.894
"13894","Cochabamba","Sacaba","Colegio Boliviano Japones",110,0,1,0,61,7,12,0,3,194,3,8,205,227,0.314,0.903
"13895","Cochabamba","Sacaba","Colegio Boliviano Japones",115,0,0,1,54,3,18,0,0,191,1,13,205,228,0.283,0.899
"13896","Cochabamba","Sacaba","Colegio Boliviano Japones",109,0,1,0,72,2,8,2,0,194,1,4,199,225,0.371,0.884
"13897","Cochabamba","Sacaba","Colegio Boliviano Japones",109,0,3,1,73,7,7,1,4,205,1,4,210,226,0.356,0.929
"13898","Cochabamba","Sacaba","Colegio Boliviano Japones",110,1,1,1,70,4,16,0,0,203,0,9,212,230,0.345,0.922
"13899","Cochabamba","Sacaba","Colegio Boliviano Japones",123,0,1,0,70,1,8,1,1,205,1,9,215,236,0.341,0.911
"13900","Cochabamba","Sacaba","Colegio Boliviano Japones",113,1,0,1,69,5,13,0,5,207,0,7,214,228,0.333,0.939
"13901","Cochabamba","Sacaba","Colegio Boliviano Japones",87,0,1,0,83,0,29,1,4,205,2,4,211,234,0.405,0.902
"13902","Cochabamba","Sacaba","Colegio Boliviano Japones",120,0,0,1,65,1,14,0,3,204,2,5,211,236,0.319,0.894
"13903","Cochabamba","Sacaba","Colegio Boliviano Japones",115,0,0,2,64,2,14,0,2,199,2,3,204,225,0.322,0.907
"13904","Cochabamba","Sacaba","Colegio Boliviano Japones",123,0,0,0,58,2,12,0,0,195,0,5,200,226,0.297,0.885
"13905","Cochabamba","Sacaba","Colegio Boliviano Japones",123,0,1,1,58,2,15,0,1,201,2,8,211,236,0.289,0.894
"13906","Cochabamba","Sacaba","Colegio Boliviano Japones",116,0,0,2,66,1,12,2,4,203,0,4,207,230,0.325,0.9
"13907","Cochabamba","Sacaba","Colegio Boliviano Japones",101,0,1,1,62,2,23,1,0,191,6,6,203,227,0.325,0.894
"13908","Cochabamba","Sacaba","Colegio Boliviano Japones",115,0,0,1,54,4,21,0,0,195,1,4,200,228,0.277,0.877
"13909","Cochabamba","Sacaba","Colegio Boliviano Japones",115,0,1,0,62,6,16,0,4,204,1,6,211,234,0.304,0.902
"13910","Cochabamba","Sacaba","Colegio Boliviano Japones",124,0,2,0,66,3,8,1,1,205,1,3,209,229,0.322,0.913
"13911","Cochabamba","Sacaba","Colegio Boliviano Japones",124,0,1,0,67,2,9,0,2,205,0,10,215,234,0.327,0.919
"13912","Cochabamba","Sacaba","Colegio Boliviano Japones",109,1,0,1,62,2,20,0,1,196,4,10,210,230,0.316,0.913
"13913","Cochabamba","Sacaba","Colegio Boliviano Japones",122,1,0,0,64,2,8,0,1,198,1,10,209,230,0.323,0.909
"13914","Cochabamba","Sacaba","Colegio Boliviano Japones",121,0,0,0,53,0,10,0,5,189,2,3,194,223,0.28,0.87
"13915","Cochabamba","Sacaba","Colegio Boliviano Japones",116,0,1,0,61,5,15,0,0,198,2,5,205,232,0.308,0.884
"13916","Cochabamba","Sacaba","Colegio Boliviano Japones",106,0,0,0,82,3,14,0,2,207,5,4,216,231,0.396,0.935
"13917","Cochabamba","Sacaba","Colegio Boliviano Japones",96,0,1,2,74,5,9,0,0,187,1,15,203,224,0.396,0.906
"13918","Cochabamba","Sacaba","Colegio Boliviano Japones",118,1,2,0,59,4,16,0,0,200,1,7,208,233,0.295,0.893
"13919","Cochabamba","Sacaba","Colegio Boliviano Japones",124,0,1,1,63,6,16,1,1,213,0,3,216,231,0.296,0.935
"13920","Cochabamba","Sacaba","Colegio Boliviano Japones",139,0,1,0,50,2,16,0,2,210,2,6,218,243,0.238,0.897
"13921","Cochabamba","Sacaba","Escuela Guadalupe",88,0,3,1,77,2,25,0,2,198,0,3,201,228,0.389,0.882
"13922","Cochabamba","Sacaba","Escuela Guadalupe",104,0,1,2,75,0,20,1,1,204,2,5,211,232,0.368,0.909
"13923","Cochabamba","Sacaba","Escuela Guadalupe",93,0,0,0,78,3,15,2,4,195,3,8,206,229,0.4,0.9
"13924","Cochabamba","Sacaba","Escuela Guadalupe",84,2,1,0,86,3,19,0,3,198,1,6,205,233,0.434,0.88
"13925","Cochabamba","Sacaba","Escuela Guadalupe",117,1,1,1,63,5,13,0,1,202,1,6,209,224,0.312,0.933
"13926","Cochabamba","Sacaba","Escuela Guadalupe",88,0,1,1,96,0,13,0,3,202,2,6,210,228,0.475,0.921
"13927","Cochabamba","Sacaba","Escuela Guadalupe",66,1,1,1,108,4,17,0,2,200,1,5,206,228,0.54,0.904
"13928","Cochabamba","Sacaba","Escuela Guadalupe",102,0,1,1,74,0,20,0,0,198,1,7,206,224,0.374,0.92
"13929","Cochabamba","Sacaba","Escuela Guadalupe",98,0,0,0,69,5,18,0,1,191,5,0,196,229,0.361,0.856
"13930","Cochabamba","Sacaba","Escuela Guadalupe",91,2,1,0,79,3,20,0,1,197,0,3,200,228,0.401,0.877
"13931","Cochabamba","Sacaba","Escuela Guadalupe",80,0,2,1,94,4,15,2,0,198,0,6,204,229,0.475,0.891
"13932","Cochabamba","Sacaba","Escuela Guadalupe",79,1,0,0,84,9,14,1,3,191,4,6,201,228,0.44,0.882
"13933","Cochabamba","Sacaba","Escuela Guadalupe",84,0,2,1,76,3,14,1,2,183,4,10,197,222,0.415,0.887
"13934","Cochabamba","Sacaba","Escuela Guadalupe",86,0,0,2,87,2,17,0,3,197,1,7,205,229,0.442,0.895
"13935","Cochabamba","Sacaba","Escuela Guadalupe",66,1,3,0,109,2,18,1,2,202,3,5,210,230,0.54,0.913
"13936","Cochabamba","Sacaba","Escuela Guadalupe",100,1,0,1,57,4,23,1,2,189,2,5,196,225,0.302,0.871
"13937","Cochabamba","Sacaba","Escuela Guadalupe",96,0,2,0,92,3,11,0,1,205,2,3,210,228,0.449,0.921
"13938","Cochabamba","Sacaba","Escuela Guadalupe",84,0,2,0,85,5,15,0,3,194,4,10,208,224,0.438,0.929
"13939","Cochabamba","Sacaba","Escuela Guadalupe",101,1,2,0,78,4,15,1,3,205,1,8,214,234,0.38,0.915
"13940","Cochabamba","Sacaba","Escuela Guadalupe",106,1,1,0,66,3,24,0,0,201,2,9,212,232,0.328,0.914
"13941","Cochabamba","Sacaba","Escuela Guadalupe",104,1,0,2,81,2,7,1,4,202,3,4,209,226,0.401,0.925
"13942","Cochabamba","Sacaba","Escuela Guadalupe",95,1,2,1,77,4,20,1,0,201,0,7,208,235,0.383,0.885
"13943","Cochabamba","Sacaba","Escuela Guadalupe",94,1,0,0,78,2,12,0,1,188,4,11,203,227,0.415,0.894
"13944","Cochabamba","Sacaba","Escuela Guadalupe",85,0,0,0,87,3,19,0,1,195,1,9,205,225,0.446,0.911
"13945","Cochabamba","Sacaba","Escuela Guadalupe",107,0,3,0,73,1,19,0,0,203,1,4,208,230,0.36,0.904
"13946","Cochabamba","Sacaba","Escuela Guadalupe",79,0,2,1,90,5,14,0,0,191,2,8,201,228,0.471,0.882
"13947","Cochabamba","Sacaba","Escuela Guadalupe",90,0,2,0,74,8,14,1,2,191,1,8,200,226,0.387,0.885
"13948","Cochabamba","Sacaba","Escuela Guadalupe",106,0,1,0,66,4,19,0,2,198,0,10,208,222,0.333,0.937
"13949","Cochabamba","Sacaba","Unidad Educativa Hernán Rivero Fiorilo",65,1,0,1,110,7,25,0,4,213,5,5,223,234,0.516,0.953
"13950","Cochabamba","Sacaba","Unidad Educativa Hernán Rivero Fiorilo",74,1,0,0,106,6,25,1,0,213,2,11,226,237,0.498,0.954
"13951","Cochabamba","Sacaba","Unidad Educativa Hernán Rivero Fiorilo",50,2,0,0,119,6,31,1,1,210,3,2,215,235,0.567,0.915
"13952","Cochabamba","Sacaba","Unidad Educativa Hernán Rivero Fiorilo",52,1,1,0,126,5,28,1,0,214,4,8,226,236,0.589,0.958
"13953","Cochabamba","Sacaba","Unidad Educativa Hernán Rivero Fiorilo",53,1,1,0,127,3,22,0,0,207,2,13,222,231,0.614,0.961
"13954","Cochabamba","Sacaba","Unidad Educativa Hernán Rivero Fiorilo",57,0,0,2,124,10,15,0,2,210,4,8,222,233,0.59,0.953
"13955","Cochabamba","Sacaba","Unidad Educativa Hernán Rivero Fiorilo",52,2,0,0,123,12,22,1,0,212,2,7,221,233,0.58,0.948
"13956","Cochabamba","Sacaba","Unidad Educativa Hernán Rivero Fiorilo",53,2,1,1,127,11,21,0,0,216,1,6,223,237,0.588,0.941
"13957","Cochabamba","Sacaba","Unidad Educativa Hernán Rivero Fiorilo",64,1,1,0,121,3,24,1,0,215,1,5,221,236,0.563,0.936
"13958","Cochabamba","Sacaba","Unidad Educativa Hernán Rivero Fiorilo",67,1,0,0,110,5,17,0,1,201,2,12,215,235,0.547,0.915
"13959","Cochabamba","Sacaba","Unidad Educativa Hernán Rivero Fiorilo",67,0,2,0,98,5,33,1,1,207,2,6,215,237,0.473,0.907
"13960","Cochabamba","Sacaba","Unidad Educativa Hernán Rivero Fiorilo",52,0,0,0,129,10,24,0,0,215,1,12,228,239,0.6,0.954
"13961","Cochabamba","Sacaba","Unidad Educativa Ceilab",119,0,1,0,78,2,17,0,3,220,0,9,229,239,0.355,0.958
"13962","Cochabamba","Sacaba","Unidad Educativa Ceilab",108,0,1,1,80,4,25,1,2,222,3,3,228,236,0.36,0.966
"13963","Cochabamba","Sacaba","Unidad Educativa Ceilab",124,0,0,0,64,5,23,0,1,217,2,6,225,240,0.295,0.938
"13964","Cochabamba","Sacaba","Unidad Educativa Ceilab",107,0,3,0,82,2,21,0,3,218,1,9,228,238,0.376,0.958
"13965","Cochabamba","Sacaba","Unidad Educativa Ceilab",131,0,0,0,73,6,13,0,2,225,1,3,229,237,0.324,0.966
"13966","Cochabamba","Sacaba","Unidad Educativa Ceilab",118,1,1,0,72,7,22,1,0,222,3,4,229,239,0.324,0.958
"13967","Cochabamba","Sacaba","Escuela Carlos Peredo Sandoval",59,0,0,0,97,5,27,0,1,189,4,8,201,231,0.513,0.87
"13968","Cochabamba","Sacaba","Escuela Carlos Peredo Sandoval",51,0,0,2,108,4,31,1,0,197,2,9,208,225,0.548,0.924
"13969","Cochabamba","Sacaba","Escuela Carlos Peredo Sandoval",47,1,1,3,112,6,26,0,0,196,2,5,203,230,0.571,0.883
"13970","Cochabamba","Sacaba","Escuela Carlos Peredo Sandoval",46,2,1,0,111,5,24,0,1,190,4,8,202,229,0.584,0.882
"13971","Cochabamba","Sacaba","Escuela Carlos Peredo Sandoval",58,0,1,0,101,0,19,0,1,180,2,10,192,225,0.561,0.853
"13972","Cochabamba","Sacaba","Escuela Carlos Peredo Sandoval",62,4,2,0,101,3,17,0,2,191,0,10,201,226,0.529,0.889
"13973","Cochabamba","Sacaba","Escuela Carlos Peredo Sandoval",51,0,1,3,113,4,21,2,0,195,1,6,202,230,0.579,0.878
"13974","Cochabamba","Sacaba","Escuela Carlos Peredo Sandoval",51,2,0,1,107,3,31,1,1,197,4,9,210,232,0.543,0.905
"13975","Cochabamba","Sacaba","Escuela Carlos Peredo Sandoval",43,1,1,0,118,2,26,0,1,192,3,15,210,230,0.615,0.913
"13976","Cochabamba","Sacaba","Escuela Carlos Peredo Sandoval",41,1,3,0,115,7,32,0,1,200,4,6,210,233,0.575,0.901
"13977","Cochabamba","Sacaba","Escuela Carlos Peredo Sandoval",43,1,2,0,115,5,29,0,0,195,3,4,202,226,0.59,0.894
"13978","Cochabamba","Sacaba","Escuela Carlos Peredo Sandoval",59,1,1,1,94,7,19,0,2,184,2,15,201,226,0.511,0.889
"13979","Cochabamba","Sacaba","Escuela Carlos Peredo Sandoval",73,1,0,0,98,4,26,1,2,205,0,6,211,229,0.478,0.921
"13980","Cochabamba","Sacaba","Escuela Carlos Peredo Sandoval",41,1,0,2,115,5,24,3,2,193,0,7,200,225,0.596,0.889
"13981","Cochabamba","Sacaba","Escuela Carlos Peredo Sandoval",53,1,0,0,101,5,38,0,2,200,0,2,202,230,0.505,0.878
"13982","Cochabamba","Sacaba","Escuela Carlos Peredo Sandoval",71,0,1,1,100,3,13,0,2,191,3,3,197,229,0.524,0.86
"13983","Cochabamba","Sacaba","Escuela Carlos Peredo Sandoval",39,1,0,0,124,5,27,1,2,199,2,7,208,231,0.623,0.9
"13984","Cochabamba","Sacaba","Escuela Carlos Peredo Sandoval",47,1,0,0,105,3,32,0,3,191,3,8,202,228,0.55,0.886
"13985","Cochabamba","Sacaba","Escuela Carlos Peredo Sandoval",51,1,0,3,102,4,16,0,1,178,2,11,191,222,0.573,0.86
"13986","Cochabamba","Sacaba","Escuela Carlos Peredo Sandoval",51,0,1,2,93,7,44,0,2,200,3,12,215,234,0.465,0.919
"13987","Cochabamba","Sacaba","Escuela Carlos Peredo Sandoval",41,1,1,0,122,5,26,1,3,200,3,10,213,231,0.61,0.922
"13988","Cochabamba","Sacaba","Escuela Carlos Peredo Sandoval",51,0,0,1,99,6,22,0,2,181,5,10,196,225,0.547,0.871
"13989","Cochabamba","Sacaba","Escuela Carlos Peredo Sandoval",48,1,1,0,98,7,31,1,2,189,4,8,201,224,0.519,0.897
"13990","Cochabamba","Sacaba","Escuela Carlos Peredo Sandoval",57,0,1,0,117,7,16,1,1,200,1,7,208,226,0.585,0.92
"13991","Cochabamba","Sacaba","Escuela Carlos Peredo Sandoval",47,1,0,2,101,5,35,2,2,195,1,10,206,232,0.518,0.888
"13992","Cochabamba","Sacaba","Escuela Carlos Peredo Sandoval",48,0,1,0,98,3,23,0,4,177,3,4,184,221,0.554,0.833
"13993","Cochabamba","Sacaba","Escuela Carlos Peredo Sandoval",56,1,2,1,92,4,30,2,1,189,5,9,203,226,0.487,0.898
"13994","Cochabamba","Sacaba","Escuela Carlos Peredo Sandoval",69,1,0,0,94,4,25,1,4,198,1,3,202,226,0.475,0.894
"13995","Cochabamba","Sacaba","Escuela Carlos Peredo Sandoval",39,0,1,2,109,4,32,0,0,187,2,6,195,224,0.583,0.871
"13996","Cochabamba","Sacaba","Escuela Carlos Peredo Sandoval",44,1,1,2,112,4,17,1,1,183,2,6,191,225,0.612,0.849
"13997","Cochabamba","Sacaba","Escuela Carlos Peredo Sandoval",68,1,0,0,82,7,22,0,3,183,2,7,192,228,0.448,0.842
"13998","Cochabamba","Sacaba","Escuela Carlos Peredo Sandoval",48,0,0,0,119,4,28,2,0,201,3,9,213,232,0.592,0.918
"13999","Cochabamba","Sacaba","Escuela Carlos Peredo Sandoval",36,1,0,0,92,5,35,0,2,171,1,19,191,227,0.538,0.841
"14000","Cochabamba","Sacaba","Escuela Carlos Peredo Sandoval",50,0,0,1,104,3,26,0,0,184,1,11,196,228,0.565,0.86
"14001","Cochabamba","Sacaba","Escuela Carlos Peredo Sandoval",50,0,1,1,107,2,30,0,5,196,4,7,207,230,0.546,0.9
"14002","Cochabamba","Sacaba","Escuela Carlos Peredo Sandoval",48,0,0,0,117,3,14,0,3,185,4,7,196,228,0.632,0.86
"14003","Cochabamba","Sacaba","Escuela Carlos Peredo Sandoval",57,1,0,1,100,2,32,0,4,197,4,8,209,231,0.508,0.905
"14004","Cochabamba","Sacaba","Escuela Carlos Peredo Sandoval",64,0,1,0,97,3,27,1,0,193,2,6,201,231,0.503,0.87
"14005","Cochabamba","Sacaba","Escuela Carlos Peredo Sandoval",61,2,1,1,112,7,19,1,1,205,3,2,210,228,0.546,0.921
"14006","Cochabamba","Sacaba","Unidad Educativa Larati",3,1,0,0,192,0,8,0,1,205,1,6,212,223,0.937,0.951
"14007","Cochabamba","Sacaba","Unidad Educativa Larati",1,0,0,0,200,2,4,0,0,207,2,6,215,224,0.966,0.96
"14008","Cochabamba","Sacaba","Unidad Educativa Larati",1,0,0,0,200,2,10,0,0,213,1,7,221,226,0.939,0.978
"14009","Cochabamba","Sacaba","Unidad Educativa Larati",0,0,0,0,187,0,2,0,0,189,0,8,197,204,0.989,0.966
"14010","Cochabamba","Sacaba","Escuela 6 de Junio - Tacopoca",29,1,0,1,130,8,17,1,0,187,3,15,205,227,0.695,0.903
"14011","Cochabamba","Sacaba","Escuela 6 de Junio - Tacopoca",26,2,1,0,136,5,17,0,1,188,7,10,205,227,0.723,0.903
"14012","Cochabamba","Sacaba","Escuela 6 de Junio - Tacopoca",18,2,3,1,146,2,25,1,1,199,2,6,207,228,0.734,0.908
"14013","Cochabamba","Sacaba","Escuela 6 de Junio - Tacopoca",27,0,1,0,146,7,24,0,1,206,2,6,214,231,0.709,0.926
"14014","Cochabamba","Sacaba","Escuela 6 de Junio - Tacopoca",18,0,0,0,143,3,28,0,1,193,2,13,208,227,0.741,0.916
"14015","Cochabamba","Sacaba","Escuela 6 de Junio - Tacopoca",25,0,1,0,138,6,18,4,0,192,1,5,198,224,0.719,0.884
"14016","Cochabamba","Sacaba","Escuela 6 de Junio - Tacopoca",24,1,0,0,136,3,28,0,1,193,2,9,204,229,0.705,0.891
"14017","Cochabamba","Sacaba","Escuela 6 de Junio - Tacopoca",15,1,2,1,131,4,25,1,3,183,1,17,201,227,0.716,0.885
"14018","Cochabamba","Sacaba","Escuela 6 de Junio - Tacopoca",20,0,4,1,137,3,19,1,2,187,2,11,200,220,0.733,0.909
"14019","Cochabamba","Sacaba","Escuela 6 de Junio - Tacopoca",20,1,0,0,131,4,25,0,2,183,3,11,197,227,0.716,0.868
"14020","Cochabamba","Sacaba","Escuela 6 de Junio - Tacopoca",27,0,3,1,130,2,21,1,0,185,3,5,193,219,0.703,0.881
"14021","Cochabamba","Sacaba","Escuela 6 de Junio - Tacopoca",18,0,3,1,140,3,24,0,0,189,4,11,204,226,0.741,0.903
"14022","Cochabamba","Sacaba","Escuela 6 de Junio - Tacopoca",26,1,0,0,132,4,23,1,2,189,0,11,200,224,0.698,0.893
"14023","Cochabamba","Sacaba","Escuela 6 de Junio - Tacopoca",41,1,0,1,132,2,24,1,0,202,0,9,211,232,0.653,0.909
"14024","Cochabamba","Sacaba","Escuela 6 de Junio - Tacopoca",28,0,0,0,137,2,24,2,2,195,4,3,202,226,0.703,0.894
"14025","Cochabamba","Sacaba","Escuela 6 de Junio - Tacopoca",53,2,1,1,110,9,21,1,5,203,2,6,211,230,0.542,0.917
"14026","Cochabamba","Sacaba","U.E. Hugo Chavez Frias",10,0,0,0,179,2,34,0,2,227,1,3,231,239,0.789,0.967
"14027","Cochabamba","Sacaba","U.E. Hugo Chavez Frias",5,0,0,1,181,1,0,0,0,188,6,8,202,236,0.963,0.856
"14028","Cochabamba","Sacaba","U.E. Hugo Chavez Frias",20,0,0,0,177,1,20,1,1,220,4,12,236,238,0.805,0.992
"14029","Cochabamba","Sacaba","U.E. Hugo Chavez Frias",12,1,1,0,178,3,25,2,0,222,5,5,232,238,0.802,0.975
"14030","Cochabamba","Sacaba","U.E. Hugo Chavez Frias",9,2,0,0,176,2,30,1,1,221,6,9,236,240,0.796,0.983
"14031","Cochabamba","Sacaba","U. E. Plurinacional",13,0,0,0,184,1,18,1,0,217,4,13,234,238,0.848,0.983
"14032","Cochabamba","Sacaba","Unidad Educativa Pampilla",2,0,0,1,161,0,17,0,0,181,6,13,200,224,0.89,0.893
"14033","Cochabamba","Sacaba","Unidad Educativa Pampilla",1,2,0,0,177,2,15,0,0,197,5,4,206,228,0.898,0.904
"14034","Cochabamba","Sacaba","Unidad Educativa Pampilla",2,1,1,3,163,1,29,3,0,203,3,9,215,230,0.803,0.935
"14035","Cochabamba","Sacaba","Unidad Educativa Pampilla",1,0,0,0,154,4,30,1,0,190,9,7,206,226,0.811,0.912
"14036","Cochabamba","Sacaba","Unidad Educativa Pampilla",6,1,0,0,162,1,18,0,1,189,5,21,215,230,0.857,0.935
"14037","Cochabamba","Sacaba","Unidad Educativa Pampilla",2,3,2,0,172,1,17,0,0,197,5,14,216,234,0.873,0.923
"14038","Cochabamba","Sacaba","Unidad Educativa Pampilla",5,1,1,0,162,4,13,1,0,187,3,14,204,223,0.866,0.915
"14039","Cochabamba","Sacaba","Unidad Educativa Pampilla",1,3,0,2,162,1,14,0,0,183,9,13,205,230,0.885,0.891
"14040","Cochabamba","Sacaba","Unidad Educativa Pampilla",2,2,2,0,180,1,10,0,0,197,6,8,211,228,0.914,0.925
"14041","Cochabamba","Sacaba","Colegio Franz Tamayo (Chiñata)",29,1,0,1,155,2,13,0,0,201,4,9,214,231,0.771,0.926
"14042","Cochabamba","Sacaba","Colegio Franz Tamayo (Chiñata)",33,0,0,0,126,7,25,1,2,194,3,11,208,235,0.649,0.885
"14043","Cochabamba","Sacaba","Colegio Franz Tamayo (Chiñata)",19,1,2,0,145,4,24,0,1,196,4,4,204,227,0.74,0.899
"14044","Cochabamba","Sacaba","Colegio Franz Tamayo (Chiñata)",27,0,0,1,131,4,18,1,1,183,1,9,193,222,0.716,0.869
"14045","Cochabamba","Sacaba","Colegio Franz Tamayo (Chiñata)",30,2,0,1,142,5,20,1,1,202,2,8,212,230,0.703,0.922
"14046","Cochabamba","Sacaba","Colegio Franz Tamayo (Chiñata)",23,0,0,0,139,5,25,0,1,193,3,9,205,228,0.72,0.899
"14047","Cochabamba","Sacaba","Colegio Franz Tamayo (Chiñata)",27,1,1,0,140,3,23,1,0,196,2,5,203,225,0.714,0.902
"14048","Cochabamba","Sacaba","Colegio Franz Tamayo (Chiñata)",15,1,0,0,154,3,17,0,0,190,2,9,201,221,0.811,0.91
"14049","Cochabamba","Sacaba","Colegio Franz Tamayo (Chiñata)",35,0,0,0,137,2,22,0,2,198,1,8,207,228,0.692,0.908
"14050","Cochabamba","Sacaba","Colegio Franz Tamayo (Chiñata)",28,0,0,0,148,3,20,1,2,202,1,6,209,224,0.733,0.933
"14051","Cochabamba","Sacaba","Colegio Franz Tamayo (Chiñata)",28,1,4,0,137,6,14,1,0,191,2,11,204,225,0.717,0.907
"14052","Cochabamba","Sacaba","Colegio Franz Tamayo (Chiñata)",24,1,0,1,156,1,13,1,0,197,2,10,209,228,0.792,0.917
"14053","Cochabamba","Sacaba","Colegio Franz Tamayo (Chiñata)",20,0,1,0,164,1,15,0,1,202,2,9,213,228,0.812,0.934
"14054","Cochabamba","Sacaba","Colegio Franz Tamayo (Chiñata)",39,1,0,0,137,3,12,0,1,193,4,3,200,222,0.71,0.901
"14055","Cochabamba","Sacaba","Colegio Franz Tamayo (Chiñata)",22,0,0,0,147,2,19,0,1,191,1,8,200,228,0.77,0.877
"14056","Cochabamba","Sacaba","Colegio Franz Tamayo (Chiñata)",38,0,0,0,134,2,8,0,2,184,6,7,197,219,0.728,0.9
"14057","Cochabamba","Sacaba","Colegio Franz Tamayo (Chiñata)",20,1,0,1,138,6,18,1,0,185,2,5,192,216,0.746,0.889
"14058","Cochabamba","Sacaba","Colegio Franz Tamayo (Chiñata)",34,1,2,3,129,4,13,1,1,188,5,5,198,226,0.686,0.876
"14059","Cochabamba","Sacaba","Colegio Franz Tamayo (Chiñata)",27,0,0,0,134,5,27,0,0,193,1,6,200,225,0.694,0.889
"14060","Cochabamba","Sacaba","Colegio Franz Tamayo (Chiñata)",28,0,0,1,131,2,15,1,1,179,3,7,189,205,0.732,0.922
"14061","Cochabamba","Sacaba","Escuela Rene Barrientos Ortuño (Ucuchi)",13,2,0,0,160,1,6,0,0,182,3,6,191,210,0.879,0.91
"14062","Cochabamba","Sacaba","Escuela Rene Barrientos Ortuño (Ucuchi)",13,3,2,0,149,3,6,0,0,176,8,7,191,207,0.847,0.923
"14063","Cochabamba","Sacaba","Escuela Rene Barrientos Ortuño (Ucuchi)",9,1,1,0,152,3,7,1,1,175,5,6,186,201,0.869,0.925
"14064","Cochabamba","Sacaba","Colegio Rene Fernandez Becerra",12,3,0,0,175,1,2,0,0,193,2,4,199,214,0.907,0.93
"14065","Cochabamba","Sacaba","Colegio Rene Fernandez Becerra",6,1,0,0,155,3,9,2,0,176,4,3,183,208,0.881,0.88
"14066","Cochabamba","Sacaba","Colegio Rene Fernandez Becerra",3,2,1,1,176,0,7,1,1,192,6,6,204,220,0.917,0.927
"14067","Cochabamba","Sacaba","Colegio Rene Fernandez Becerra",7,1,1,0,173,2,4,0,3,191,0,6,197,207,0.906,0.952
"14068","Cochabamba","Sacaba","Colegio Rene Fernandez Becerra",12,0,0,0,169,0,12,0,1,194,1,3,198,214,0.871,0.925
"14069","Cochabamba","Sacaba","Colegio Nataniel Aguirre",6,0,1,0,186,0,2,2,0,197,2,9,208,223,0.944,0.933
"14070","Cochabamba","Sacaba","Colegio Nataniel Aguirre",4,0,1,0,178,1,12,0,0,196,2,5,203,222,0.908,0.914
"14071","Cochabamba","Sacaba","Colegio Nataniel Aguirre",10,1,0,0,185,1,8,0,0,205,1,4,210,230,0.902,0.913
"14072","Cochabamba","Sacaba","Colegio Nataniel Aguirre",1,0,0,0,190,2,0,1,0,194,1,15,210,230,0.979,0.913
"14073","Cochabamba","Sacaba","Colegio Nataniel Aguirre",2,0,0,0,188,0,7,0,0,197,0,9,206,223,0.954,0.924
"14074","Cochabamba","Sacaba","Colegio Nataniel Aguirre",2,0,0,1,177,1,14,0,1,196,2,12,210,221,0.903,0.95
"14075","Cochabamba","Sacaba","Escuela Copacabana",78,1,0,0,94,4,12,3,1,193,0,9,202,230,0.487,0.878
"14076","Cochabamba","Sacaba","Escuela Copacabana",113,0,0,0,71,0,15,0,2,201,1,6,208,230,0.353,0.904
"14077","Cochabamba","Sacaba","Escuela Copacabana",91,0,0,0,92,3,10,0,7,203,1,4,208,233,0.453,0.893
"14078","Cochabamba","Sacaba","Escuela Copacabana",85,0,0,0,93,2,18,0,0,198,1,4,203,227,0.47,0.894
"14079","Cochabamba","Sacaba","Escuela Copacabana",89,1,1,0,90,2,13,0,4,200,2,9,211,235,0.45,0.898
"14080","Cochabamba","Sacaba","Escuela Copacabana",83,2,0,0,90,2,13,1,1,192,2,6,200,224,0.469,0.893
"14081","Cochabamba","Sacaba","Escuela Copacabana",101,0,0,0,89,2,12,0,0,204,3,5,212,231,0.436,0.918
"14082","Cochabamba","Sacaba","Escuela Copacabana",91,1,1,1,84,5,12,0,3,198,1,9,208,231,0.424,0.9
"14083","Cochabamba","Sacaba","Escuela Copacabana",94,1,1,0,89,4,10,0,1,200,1,7,208,224,0.445,0.929
"14084","Cochabamba","Sacaba","Escuela Copacabana",79,1,2,1,97,6,17,3,0,206,2,5,213,230,0.471,0.926
"14085","Cochabamba","Sacaba","Escuela Copacabana",96,1,0,0,79,3,16,0,0,195,1,4,200,220,0.405,0.909
"14086","Cochabamba","Sacaba","Escuela Copacabana",90,0,1,0,75,1,12,0,2,181,2,10,193,222,0.414,0.869
"14087","Cochabamba","Sacaba","Escuela Copacabana",102,0,0,0,90,3,11,0,2,208,2,5,215,227,0.433,0.947
"14088","Cochabamba","Sacaba","Escuela Copacabana",92,0,2,1,87,4,16,1,1,204,0,4,208,228,0.426,0.912
"14089","Cochabamba","Sacaba","Escuela Copacabana",83,1,0,1,79,3,20,0,1,188,3,3,194,224,0.42,0.866
"14090","Cochabamba","Sacaba","Escuela Copacabana",102,3,0,3,71,3,6,0,1,189,2,6,197,220,0.376,0.895
"14091","Cochabamba","Sacaba","Escuela Copacabana",98,0,1,0,81,2,15,0,1,198,2,10,210,231,0.409,0.909
"14092","Cochabamba","Sacaba","Escuela Copacabana",114,0,1,1,64,5,18,1,0,204,1,8,213,232,0.314,0.918
"14093","Cochabamba","Sacaba","Escuela Copacabana",91,1,1,0,95,6,11,0,2,207,0,5,212,227,0.459,0.934
"14094","Cochabamba","Sacaba","U.E. Nuevo Amanecer",13,0,1,0,165,1,29,0,1,210,5,9,224,237,0.786,0.945
"14095","Cochabamba","Sacaba","U.E. Nuevo Amanecer",18,2,0,1,176,2,18,0,0,217,2,7,226,235,0.811,0.962
"14096","Cochabamba","Sacaba","U.E. Nuevo Amanecer",11,0,4,0,180,1,22,0,0,218,4,8,230,238,0.826,0.966
"14097","Cochabamba","Sacaba","U.E. Nuevo Amanecer",17,0,1,0,169,1,27,0,0,215,3,12,230,238,0.786,0.966
"14098","Cochabamba","Sacaba","U.E. Nuevo Amanecer",13,1,2,0,168,2,27,0,2,215,5,4,224,238,0.781,0.941
"14099","Cochabamba","Sacaba","U.E. Tutimayu",22,2,1,0,168,4,11,0,1,209,5,7,221,235,0.804,0.94
"14100","Cochabamba","Sacaba","U.E. Tutimayu",19,0,0,2,173,5,9,1,4,213,4,3,220,235,0.812,0.936
"14101","Cochabamba","Sacaba","U.E. Tutimayu",27,2,0,0,166,0,8,0,0,203,5,5,213,231,0.818,0.922
"14102","Cochabamba","Sacaba","U.E. Tutimayu",24,2,1,0,164,3,14,0,0,208,4,7,219,234,0.788,0.936
"14103","Cochabamba","Sacaba","U.E. Tutimayu",21,0,0,0,125,5,12,2,2,167,3,4,174,186,0.749,0.935
"14104","Cochabamba","Sacaba","U.E. Emiliano Villazón",17,0,2,1,160,4,29,1,1,215,8,8,231,238,0.744,0.971
"14105","Cochabamba","Sacaba","U.E. Emiliano Villazón",12,1,0,1,119,5,35,0,4,177,4,15,196,204,0.672,0.961
"14106","Cochabamba","Sacaba","U.E. 2 de Agosto",7,0,0,0,176,2,17,3,1,206,7,11,224,238,0.854,0.941
"14107","Cochabamba","Sacaba","U.E. 2 de Agosto",1,1,0,1,136,2,9,0,1,151,4,5,160,169,0.901,0.947
"14108","Cochabamba","Sacaba","U. E. Challviri",4,1,0,0,204,1,7,0,0,217,4,9,230,238,0.94,0.966
"14109","Cochabamba","Sacaba","U. E. Challviri",5,0,1,1,216,1,6,0,0,230,4,3,237,241,0.939,0.983
"14110","Cochabamba","Colomi","Unidad Educativa Samuel Fina Savio",8,2,1,0,147,1,23,0,0,182,5,12,199,223,0.808,0.892
"14111","Cochabamba","Colomi","Unidad Educativa Samuel Fina Savio",15,3,0,0,140,3,19,1,2,183,5,12,200,218,0.765,0.917
"14112","Cochabamba","Colomi","Unidad Educativa Samuel Fina Savio",12,0,1,0,155,4,22,0,3,197,6,9,212,226,0.787,0.938
"14113","Cochabamba","Colomi","Unidad Educativa Samuel Fina Savio",24,1,0,2,121,4,23,1,1,177,7,8,192,220,0.684,0.873
"14114","Cochabamba","Colomi","Unidad Educativa Samuel Fina Savio",15,1,1,0,111,4,27,1,2,162,7,11,180,213,0.685,0.845
"14115","Cochabamba","Colomi","Unidad Educativa Samuel Fina Savio",17,0,1,0,129,1,24,1,0,173,2,13,188,213,0.746,0.883
"14116","Cochabamba","Colomi","Unidad Educativa Samuel Fina Savio",16,1,0,0,146,0,20,0,1,184,4,4,192,225,0.793,0.853
"14117","Cochabamba","Colomi","Unidad Educativa Samuel Fina Savio",15,0,0,0,145,1,28,0,0,189,7,9,205,227,0.767,0.903
"14118","Cochabamba","Colomi","Unidad Educativa Samuel Fina Savio",19,1,0,0,138,1,30,0,0,189,2,14,205,224,0.73,0.915
"14119","Cochabamba","Colomi","Unidad Educativa Samuel Fina Savio",11,1,0,0,152,1,22,0,0,187,2,12,201,222,0.813,0.905
"14120","Cochabamba","Colomi","Unidad Educativa Samuel Fina Savio",7,2,0,1,165,0,21,1,0,197,6,4,207,227,0.838,0.912
"14121","Cochabamba","Colomi","Unidad Educativa Samuel Fina Savio",25,0,2,1,130,4,27,2,0,191,2,16,209,228,0.681,0.917
"14122","Cochabamba","Colomi","Unidad Educativa Samuel Fina Savio",21,0,1,1,128,2,31,1,2,187,3,11,201,221,0.684,0.91
"14123","Cochabamba","Colomi","Unidad Educativa Samuel Fina Savio",17,2,0,0,133,0,29,0,2,183,2,16,201,226,0.727,0.889
"14124","Cochabamba","Colomi","Unidad Educativa Samuel Fina Savio",16,0,0,0,143,2,18,1,2,182,2,8,192,220,0.786,0.873
"14125","Cochabamba","Colomi","Unidad Educativa Samuel Fina Savio",13,1,0,0,154,2,26,0,0,196,1,10,207,221,0.786,0.937
"14126","Cochabamba","Colomi","Unidad Educativa Samuel Fina Savio",21,0,0,0,127,2,39,1,1,191,4,12,207,224,0.665,0.924
"14127","Cochabamba","Colomi","Unidad Educativa Samuel Fina Savio",25,5,0,2,122,3,24,1,2,184,2,9,195,228,0.663,0.855
"14128","Cochabamba","Colomi","Unidad Educativa Samuel Fina Savio",6,0,1,0,158,4,26,2,0,197,3,13,213,227,0.802,0.938
"14129","Cochabamba","Colomi","Unidad Educativa Samuel Fina Savio",29,1,1,2,126,4,26,0,2,191,2,7,200,232,0.66,0.862
"14130","Cochabamba","Colomi","Unidad Educativa Samuel Fina Savio",13,1,1,0,139,1,24,0,3,182,3,7,192,223,0.764,0.861
"14131","Cochabamba","Colomi","Unidad Educativa Samuel Fina Savio",8,0,1,0,143,1,20,0,0,173,4,17,194,222,0.827,0.874
"14132","Cochabamba","Colomi","Unidad Educativa Samuel Fina Savio",22,0,0,0,136,5,22,0,2,187,0,12,199,227,0.727,0.877
"14133","Cochabamba","Colomi","Unidad Educativa Samuel Fina Savio",21,1,4,0,140,1,24,0,0,191,3,9,203,226,0.733,0.898
"14134","Cochabamba","Colomi","Unidad Educativa Samuel Fina Savio",18,1,0,1,153,4,13,1,0,191,4,8,203,225,0.801,0.902
"14135","Cochabamba","Colomi","Unidad Educativa Samuel Fina Savio",20,1,0,0,134,1,18,0,1,175,4,21,200,221,0.766,0.905
"14136","Cochabamba","Colomi","Unidad Educativa Samuel Fina Savio",17,0,0,0,152,2,23,2,0,196,1,9,206,221,0.776,0.932
"14137","Cochabamba","Colomi","Unidad Educativa Samuel Fina Savio",27,0,0,2,127,3,24,0,0,183,3,16,202,227,0.694,0.89
"14138","Cochabamba","Colomi","Unidad Educativa Samuel Fina Savio",34,3,1,1,123,2,25,1,1,191,3,8,202,222,0.644,0.91
"14139","Cochabamba","Colomi","Unidad Educativa Samuel Fina Savio",19,1,1,0,121,2,29,1,3,177,10,16,203,233,0.684,0.871
"14140","Cochabamba","Colomi","U.E. Sócrates Villazón",22,0,1,0,151,4,31,1,3,213,2,6,221,240,0.709,0.921
"14141","Cochabamba","Colomi","U.E. Sócrates Villazón",34,1,0,0,147,4,33,0,0,219,4,6,229,240,0.671,0.954
"14142","Cochabamba","Colomi","U.E. Sócrates Villazón",21,1,2,0,155,2,35,0,0,216,2,6,224,239,0.718,0.937
"14143","Cochabamba","Colomi","Nucleo Escolar Candelaria",3,0,1,0,190,1,5,1,0,201,0,8,209,226,0.945,0.925
"14144","Cochabamba","Colomi","Nucleo Escolar Candelaria",2,0,2,0,184,0,14,1,0,203,3,4,210,224,0.906,0.938
"14145","Cochabamba","Colomi","Nucleo Escolar Candelaria",2,4,0,0,190,0,2,0,0,198,2,7,207,230,0.96,0.9
"14146","Cochabamba","Colomi","Nucleo Escolar Candelaria",4,0,0,0,178,0,6,3,1,192,4,9,205,220,0.927,0.932
"14147","Cochabamba","Colomi","Nucleo Escolar Candelaria",1,0,1,1,198,1,12,0,1,215,1,2,218,224,0.921,0.973
"14148","Cochabamba","Colomi","Nucleo Escolar Candelaria",4,0,1,0,182,1,4,0,2,194,0,8,202,215,0.938,0.94
"14149","Cochabamba","Colomi","Nucleo Escolar Candelaria",1,0,0,0,166,1,11,1,0,180,7,10,197,226,0.922,0.872
"14150","Cochabamba","Colomi","Nucleo Escolar Candelaria",1,0,2,0,183,1,12,3,0,202,1,8,211,227,0.906,0.93
"14151","Cochabamba","Colomi","Nucleo Escolar Candelaria",1,1,0,0,183,0,13,0,0,198,3,10,211,227,0.924,0.93
"14152","Cochabamba","Colomi","Nucleo Escolar Candelaria",0,2,0,0,158,0,7,0,0,167,1,7,175,186,0.946,0.941
"14153","Cochabamba","Colomi","Nucleo Escolar Tablas Monte",1,0,1,0,193,2,13,0,0,210,1,6,217,235,0.919,0.923
"14154","Cochabamba","Colomi","Nucleo Escolar Tablas Monte",8,2,1,1,167,4,24,2,0,209,6,6,221,234,0.799,0.944
"14155","Cochabamba","Colomi","Nucleo Escolar Tablas Monte",9,2,1,0,180,0,20,0,0,212,5,6,223,234,0.849,0.953
"14156","Cochabamba","Colomi","Nucleo Escolar Tablas Monte",10,0,0,1,178,2,13,0,0,204,2,5,211,230,0.873,0.917
"14157","Cochabamba","Colomi","Unidad Educativa El Palmar",19,1,1,0,149,2,12,3,0,187,5,13,205,224,0.797,0.915
"14158","Cochabamba","Colomi","Unidad Educativa Corani Pampa",6,1,3,1,176,0,25,1,0,213,3,4,220,233,0.826,0.944
"14159","Cochabamba","Colomi","Unidad Educativa Corani Pampa",2,1,0,0,176,1,25,0,0,205,6,5,216,232,0.859,0.931
"14160","Cochabamba","Colomi","Unidad Educativa Corani Pampa",5,1,0,3,173,1,18,0,1,202,4,6,212,235,0.856,0.902
"14161","Cochabamba","Colomi","Unidad Educativa Corani Pampa",6,0,0,0,189,1,16,1,0,213,1,6,220,231,0.887,0.952
"14162","Cochabamba","Colomi","Unidad Educativa Corani Pampa",8,4,2,1,163,2,20,0,0,200,6,8,214,230,0.815,0.93
"14163","Cochabamba","Colomi","Unidad Educativa Corani Pampa",5,3,1,1,176,2,15,2,1,206,4,3,213,233,0.854,0.914
"14164","Cochabamba","Colomi","Unidad Educativa Paracti (Colomi)",28,1,1,0,128,1,25,0,0,184,4,16,204,227,0.696,0.899
"14165","Cochabamba","Colomi","Unidad Educativa Paracti (Colomi)",28,0,1,1,123,4,27,0,0,184,3,11,198,223,0.668,0.888
"14166","Cochabamba","Villa Tunari","Escuela San Antonio de Villa Tunari",27,0,1,1,149,5,10,0,3,196,2,1,199,226,0.76,0.881
"14167","Cochabamba","Villa Tunari","Escuela San Antonio de Villa Tunari",33,2,0,0,146,1,11,0,1,194,1,4,199,228,0.753,0.873
"14168","Cochabamba","Villa Tunari","Escuela San Antonio de Villa Tunari",31,1,0,0,152,0,12,0,0,196,3,3,202,224,0.776,0.902
"14169","Cochabamba","Villa Tunari","Escuela San Antonio de Villa Tunari",42,0,1,1,135,1,10,2,0,192,2,5,199,221,0.703,0.9
"14170","Cochabamba","Villa Tunari","Escuela San Antonio de Villa Tunari",28,0,1,2,136,0,19,0,0,186,3,7,196,219,0.731,0.895
"14171","Cochabamba","Villa Tunari","Escuela San Antonio de Villa Tunari",39,0,0,0,148,3,10,0,1,201,1,4,206,230,0.736,0.896
"14172","Cochabamba","Villa Tunari","Escuela San Antonio de Villa Tunari",43,0,0,0,134,2,11,1,2,193,2,6,201,222,0.694,0.905
"14173","Cochabamba","Villa Tunari","Escuela San Antonio de Villa Tunari",39,1,1,0,147,4,5,0,0,197,2,4,203,221,0.746,0.919
"14174","Cochabamba","Villa Tunari","Escuela San Antonio de Villa Tunari",39,2,0,5,144,1,9,0,0,200,5,7,212,228,0.72,0.93
"14175","Cochabamba","Villa Tunari","Escuela San Antonio de Villa Tunari",47,0,0,0,139,1,12,0,2,201,6,2,209,231,0.692,0.905
"14176","Cochabamba","Villa Tunari","Colegio Francisco Vignaud",39,0,0,0,146,2,21,1,2,211,3,3,217,236,0.692,0.919
"14177","Cochabamba","Villa Tunari","Colegio Francisco Vignaud",34,1,0,1,154,1,17,0,1,209,0,5,214,233,0.737,0.918
"14178","Cochabamba","Villa Tunari","Colegio Francisco Vignaud",26,0,0,0,175,0,10,0,0,211,2,3,216,235,0.829,0.919
"14179","Cochabamba","Villa Tunari","Escuela Cristal Mayu",4,1,0,0,200,1,6,0,0,212,3,2,217,228,0.943,0.952
"14180","Cochabamba","Villa Tunari","Escuela Cristal Mayu",4,0,0,0,207,0,7,0,0,218,0,3,221,233,0.95,0.948
"14181","Cochabamba","Villa Tunari","Escuela Cristal Mayu",1,0,0,0,207,0,4,1,0,213,0,1,214,230,0.972,0.93
"14182","Cochabamba","Villa Tunari","Escuela Cristal Mayu",1,0,0,0,202,0,2,0,0,205,0,2,207,229,0.985,0.904
"14183","Cochabamba","Villa Tunari","Escuela Cristal Mayu",5,0,0,0,201,0,2,0,1,209,1,4,214,229,0.962,0.934
"14184","Cochabamba","Villa Tunari","Escuela Cristal Mayu",5,1,1,0,209,0,5,0,0,221,1,0,222,227,0.946,0.978
"14185","Cochabamba","Villa Tunari","Escuela Cristal Mayu",4,0,0,0,192,0,9,0,0,205,1,5,211,226,0.937,0.934
"14186","Cochabamba","Villa Tunari","Escuela Cristal Mayu",0,0,0,0,200,0,6,0,1,207,4,3,214,224,0.966,0.955
"14187","Cochabamba","Villa Tunari","Escuela Cristal Mayu",4,0,1,0,199,0,9,1,0,214,2,6,222,229,0.93,0.969
"14188","Cochabamba","Villa Tunari","Unidad Educativa Jatun Pampa",8,1,0,0,185,0,9,0,0,203,0,7,210,231,0.911,0.909
"14189","Cochabamba","Villa Tunari","Unidad Educativa Jatun Pampa",4,0,0,0,205,2,4,0,0,215,0,4,219,233,0.953,0.94
"14190","Cochabamba","Villa Tunari","Unidad Educativa Jatun Pampa",5,0,0,0,204,0,7,0,0,216,1,4,221,234,0.944,0.944
"14191","Cochabamba","Villa Tunari","Unidad Educativa Jatun Pampa",6,0,0,0,193,0,10,0,1,210,2,1,213,229,0.919,0.93
"14192","Cochabamba","Villa Tunari","Unidad Educativa Jatun Pampa",10,0,1,2,182,0,5,0,0,200,2,3,205,223,0.91,0.919
"14193","Cochabamba","Villa Tunari","Unidad Educativa Paractito",8,1,0,0,184,1,10,0,0,204,5,2,211,228,0.902,0.925
"14194","Cochabamba","Villa Tunari","Unidad Educativa Paractito",13,0,1,0,185,2,4,1,0,206,1,6,213,227,0.898,0.938
"14195","Cochabamba","Villa Tunari","Unidad Educativa Paractito",5,0,0,0,188,1,6,1,0,201,2,7,210,226,0.935,0.929
"14196","Cochabamba","Villa Tunari","Unidad Educativa Paractito",3,1,1,0,171,0,18,0,1,195,2,4,201,220,0.877,0.914
"14197","Cochabamba","Villa Tunari","Unidad Educativa Paractito",6,2,0,0,181,2,11,0,2,204,1,4,209,225,0.887,0.929
"14198","Cochabamba","Villa Tunari","Unidad Educativa Paractito",11,0,0,0,177,0,8,0,1,197,1,5,203,217,0.898,0.935
"14199","Cochabamba","Villa Tunari","Unidad Educativa Paractito",8,0,0,0,170,0,6,0,0,184,3,7,194,222,0.924,0.874
"14200","Cochabamba","Villa Tunari","Unidad Educativa Paractito",9,2,0,2,184,0,7,0,0,204,1,4,209,223,0.902,0.937
"14201","Cochabamba","Villa Tunari","Unidad Educativa Paractito",22,1,0,0,172,0,5,0,0,200,4,3,207,222,0.86,0.932
"14202","Cochabamba","Villa Tunari","Unidad Educativa Paractito",4,0,0,0,173,0,4,0,1,182,0,1,183,189,0.951,0.968
"14203","Cochabamba","Villa Tunari","Unidad Educativa 27 de Mayo",0,0,0,0,225,0,1,0,0,226,0,2,228,238,0.996,0.958
"14204","Cochabamba","Villa Tunari","Unidad Educativa 27 de Mayo",0,0,0,0,166,0,3,0,0,169,1,4,174,182,0.982,0.956
"14205","Cochabamba","Villa Tunari","Unidad Educativa Mixta Eterazama",4,1,0,0,190,0,9,0,0,204,0,3,207,231,0.931,0.896
"14206","Cochabamba","Villa Tunari","Unidad Educativa Mixta Eterazama",1,0,1,0,193,2,8,0,0,205,1,1,207,226,0.941,0.916
"14207","Cochabamba","Villa Tunari","Unidad Educativa Mixta Eterazama",4,0,3,0,198,1,6,0,0,212,2,4,218,231,0.934,0.944
"14208","Cochabamba","Villa Tunari","Unidad Educativa Mixta Eterazama",3,1,0,1,191,1,7,0,1,205,2,5,212,228,0.932,0.93
"14209","Cochabamba","Villa Tunari","Unidad Educativa Mixta Eterazama",6,1,0,0,190,0,9,1,1,208,2,2,212,228,0.913,0.93
"14210","Cochabamba","Villa Tunari","Unidad Educativa Mixta Eterazama",4,0,0,1,205,0,7,0,0,217,1,2,220,238,0.945,0.924
"14211","Cochabamba","Villa Tunari","Unidad Educativa Mixta Eterazama",3,0,2,0,196,0,7,0,0,208,2,3,213,233,0.942,0.914
"14212","Cochabamba","Villa Tunari","Unidad Educativa Mixta Eterazama",4,0,0,0,189,1,7,0,0,201,1,4,206,231,0.94,0.892
"14213","Cochabamba","Villa Tunari","Unidad Educativa Mixta Eterazama",4,1,0,0,198,1,7,1,0,212,0,4,216,233,0.934,0.927
"14214","Cochabamba","Villa Tunari","Unidad Educativa Mixta Eterazama",6,0,0,0,194,1,7,0,0,208,0,4,212,228,0.933,0.93
"14215","Cochabamba","Villa Tunari","Unidad Educativa Mixta Eterazama",1,0,0,1,205,0,5,0,1,213,1,4,218,231,0.962,0.944
"14216","Cochabamba","Villa Tunari","Unidad Educativa Mixta Eterazama",5,0,0,0,193,0,9,0,1,208,0,10,218,236,0.928,0.924
"14217","Cochabamba","Villa Tunari","Unidad Educativa Mixta Eterazama",0,0,1,0,204,0,8,0,0,213,2,1,216,234,0.958,0.923
"14218","Cochabamba","Villa Tunari","Unidad Educativa Mixta Eterazama",3,0,0,0,198,1,7,0,0,209,1,2,212,230,0.947,0.922
"14219","Cochabamba","Villa Tunari","Unidad Educativa Mixta Eterazama",1,0,1,0,201,0,7,0,0,210,1,3,214,232,0.957,0.922
"14220","Cochabamba","Villa Tunari","Unidad Educativa Mixta Eterazama",5,0,0,0,183,0,8,0,0,196,2,2,200,220,0.934,0.909
"14221","Cochabamba","Villa Tunari","Unidad Educativa Mixta Eterazama",8,1,0,0,196,1,19,0,0,225,0,2,227,239,0.871,0.95
"14222","Cochabamba","Villa Tunari","Unidad Educativa Mixta Eterazama",7,0,0,0,199,0,11,0,0,217,0,1,218,236,0.917,0.924
"14223","Cochabamba","Villa Tunari","Unidad Educativa Mixta Eterazama",2,0,0,0,203,0,7,1,0,213,0,3,216,226,0.953,0.956
"14224","Cochabamba","Villa Tunari","Unidad Educativa Mixta Eterazama",4,0,0,0,206,0,3,0,0,213,0,6,219,234,0.967,0.936
"14225","Cochabamba","Villa Tunari","Unidad Educativa Mixta Eterazama",3,1,1,0,201,1,8,0,0,215,3,3,221,235,0.935,0.94
"14226","Cochabamba","Villa Tunari","Unidad Educativa Mixta Eterazama",6,0,0,0,188,1,1,0,0,196,0,16,212,226,0.959,0.938
"14227","Cochabamba","Villa Tunari","Unidad Educativa Mixta Eterazama",4,0,0,0,198,1,5,1,0,209,0,5,214,230,0.947,0.93
"14228","Cochabamba","Villa Tunari","Unidad Educativa Mixta Eterazama",7,0,0,0,188,1,7,0,0,203,2,4,209,227,0.926,0.921
"14229","Cochabamba","Villa Tunari","Unidad Educativa Mixta Eterazama",1,0,0,0,194,1,8,0,1,205,2,7,214,242,0.946,0.884
"14230","Cochabamba","Villa Tunari","Escuela San Jose (V. Tunari)",3,1,0,0,205,0,5,1,0,215,0,0,215,228,0.953,0.943
"14231","Cochabamba","Villa Tunari","Escuela San Jose (V. Tunari)",2,0,0,0,206,0,3,0,0,211,0,0,211,221,0.976,0.955
"14232","Cochabamba","Villa Tunari","Escuela San Jose (V. Tunari)",0,1,0,0,215,0,3,0,0,219,1,0,220,231,0.982,0.952
"14233","Cochabamba","Villa Tunari","Escuela San Jose (V. Tunari)",1,0,0,1,217,0,2,0,0,221,0,3,224,231,0.982,0.97
"14234","Cochabamba","Villa Tunari","Escuela San Jose (V. Tunari)",1,0,0,0,213,0,2,0,0,216,0,0,216,230,0.986,0.939
"14235","Cochabamba","Villa Tunari","Escuela San Jose (V. Tunari)",1,1,1,0,217,0,0,0,0,220,0,0,220,230,0.986,0.957
"14236","Cochabamba","Villa Tunari","Escuela San Jose (V. Tunari)",0,0,0,0,208,1,0,0,0,209,0,0,209,218,0.995,0.959
"14237","Cochabamba","Villa Tunari","Escuela Samuzabeti",6,0,0,0,206,0,8,0,0,220,1,2,223,233,0.936,0.957
"14238","Cochabamba","Villa Tunari","Escuela Samuzabeti",0,0,0,0,210,0,4,0,0,214,0,6,220,229,0.981,0.961
"14239","Cochabamba","Villa Tunari","Escuela Samuzabeti",0,0,0,0,210,0,4,0,0,214,1,6,221,229,0.981,0.965
"14240","Cochabamba","Villa Tunari","Escuela Samuzabeti",1,0,0,0,212,0,9,0,0,222,0,3,225,232,0.955,0.97
"14241","Cochabamba","Villa Tunari","Escuela Samuzabeti",2,0,0,0,214,0,3,0,0,219,0,1,220,229,0.977,0.961
"14242","Cochabamba","Villa Tunari","Escuela Samuzabeti",1,0,0,0,214,0,1,0,0,216,0,5,221,233,0.991,0.948
"14243","Cochabamba","Villa Tunari","Escuela Samuzabeti",0,0,0,0,208,0,0,0,0,208,0,12,220,228,1,0.965
"14244","Cochabamba","Villa Tunari","Escuela Samuzabeti",0,0,0,0,214,0,0,0,0,214,0,4,218,226,1,0.965
"14245","Cochabamba","Villa Tunari","Escuela Samuzabeti",0,0,0,0,217,0,2,0,0,219,0,10,229,234,0.991,0.979
"14246","Cochabamba","Villa Tunari","Escuela Samuzabeti",3,3,0,0,213,0,3,0,0,222,0,2,224,231,0.959,0.97
"14247","Cochabamba","Villa Tunari","Escuela Samuzabeti",4,0,0,0,203,2,4,0,0,213,0,2,215,229,0.953,0.939
"14248","Cochabamba","Villa Tunari","Escuela Samuzabeti",1,0,0,0,214,0,3,0,0,218,0,6,224,235,0.982,0.953
"14249","Cochabamba","Villa Tunari","Colegio Fe y Alegria",4,0,0,2,193,0,7,0,0,206,5,2,213,224,0.937,0.951
"14250","Cochabamba","Villa Tunari","Colegio Fe y Alegria",2,0,0,0,205,1,6,0,0,214,0,5,219,232,0.958,0.944
"14251","Cochabamba","Villa Tunari","Colegio Fe y Alegria",5,1,1,0,197,1,5,1,0,211,0,1,212,222,0.934,0.955
"14252","Cochabamba","Villa Tunari","Colegio Fe y Alegria",9,0,0,1,191,0,5,0,0,206,1,5,212,223,0.927,0.951
"14253","Cochabamba","Villa Tunari","Colegio Fe y Alegria",12,0,1,0,188,1,8,0,0,210,2,3,215,223,0.895,0.964
"14254","Cochabamba","Villa Tunari","Colegio Fe y Alegria",4,0,0,1,194,1,10,0,0,210,1,1,212,223,0.924,0.951
"14255","Cochabamba","Villa Tunari","Colegio Fe y Alegria",3,0,0,0,189,1,9,0,0,202,2,7,211,228,0.936,0.925
"14256","Cochabamba","Villa Tunari","Colegio Fe y Alegria",7,0,0,0,179,0,15,0,0,201,3,4,208,225,0.891,0.924
"14257","Cochabamba","Villa Tunari","Colegio Fe y Alegria",7,0,0,0,198,1,7,0,1,214,5,1,220,236,0.925,0.932
"14258","Cochabamba","Villa Tunari","Escuela 27 de Mayo",10,1,0,0,163,1,1,0,2,178,6,9,193,210,0.916,0.919
"14259","Cochabamba","Villa Tunari","Escuela 27 de Mayo",11,2,0,2,159,2,12,2,0,190,3,3,196,217,0.837,0.903
"14260","Cochabamba","Villa Tunari","Unidad Educativa San Francisco Km 21",1,0,0,0,213,1,2,0,0,217,2,7,226,237,0.982,0.954
"14261","Cochabamba","Villa Tunari","Unidad Educativa San Francisco Km 21",5,1,0,0,210,0,6,0,0,222,0,6,228,238,0.946,0.958
"14262","Cochabamba","Villa Tunari","Unidad Educativa San Francisco Km 21",1,0,0,0,226,0,4,0,0,231,0,1,232,238,0.978,0.975
"14263","Cochabamba","Villa Tunari","Escuela Elizardo Perez",5,0,0,1,196,1,8,0,0,211,0,3,214,227,0.929,0.943
"14264","Cochabamba","Villa Tunari","Escuela Elizardo Perez",1,0,0,0,198,0,8,0,1,208,0,3,211,228,0.952,0.925
"14265","Cochabamba","Villa Tunari","Escuela Elizardo Perez",2,0,0,0,197,0,7,0,0,206,2,3,211,227,0.956,0.93
"14266","Cochabamba","Villa Tunari","Escuela Elizardo Perez",7,1,0,0,187,1,2,0,1,199,2,2,203,223,0.94,0.91
"14267","Cochabamba","Villa Tunari","Escuela Elizardo Perez",6,1,0,0,196,0,3,0,0,206,4,4,214,230,0.951,0.93
"14268","Cochabamba","Villa Tunari","Escuela Elizardo Perez",7,0,0,0,196,0,2,0,0,205,4,3,212,232,0.956,0.914
"14269","Cochabamba","Villa Tunari","Escuela Elizardo Perez",3,0,1,1,199,1,4,0,0,209,1,3,213,227,0.952,0.938
"14270","Cochabamba","Villa Tunari","Escuela Elizardo Perez",1,0,0,0,197,0,1,0,0,199,0,8,207,219,0.99,0.945
"14271","Cochabamba","Villa Tunari","Escuela Elizardo Perez",3,0,0,0,201,0,2,0,0,206,0,5,211,231,0.976,0.913
"14272","Cochabamba","Villa Tunari","Escuela Villa 14 de Septiembre",6,1,0,0,189,0,11,0,1,208,1,0,209,226,0.909,0.925
"14273","Cochabamba","Villa Tunari","Escuela Villa 14 de Septiembre",4,0,0,0,182,0,7,0,2,195,2,2,199,227,0.933,0.877
"14274","Cochabamba","Villa Tunari","Escuela Villa 14 de Septiembre",12,1,0,0,167,0,10,3,0,193,3,6,202,223,0.865,0.906
"14275","Cochabamba","Villa Tunari","Escuela Villa 14 de Septiembre",7,0,0,1,193,0,7,0,1,209,2,5,216,232,0.923,0.931
"14276","Cochabamba","Villa Tunari","Escuela Villa 14 de Septiembre",8,0,1,1,175,1,9,0,0,195,2,2,199,221,0.897,0.9
"14277","Cochabamba","Villa Tunari","Escuela Villa 14 de Septiembre",20,0,1,2,167,0,15,0,0,205,1,6,212,230,0.815,0.922
"14278","Cochabamba","Villa Tunari","Escuela Villa 14 de Septiembre",2,0,0,0,199,1,3,0,0,205,1,2,208,231,0.971,0.9
"14279","Cochabamba","Villa Tunari","Escuela Villa 14 de Septiembre",7,0,0,0,182,0,7,1,0,197,3,4,204,226,0.924,0.903
"14280","Cochabamba","Villa Tunari","Escuela Villa 14 de Septiembre",9,0,0,0,180,0,4,0,1,194,0,8,202,221,0.928,0.914
"14281","Cochabamba","Villa Tunari","Escuela Villa 14 de Septiembre",3,0,0,0,205,1,7,0,1,217,2,5,224,228,0.945,0.982
"14282","Cochabamba","Villa Tunari","Escuela Villa 14 de Septiembre",6,0,2,0,187,0,9,0,0,204,2,5,211,223,0.917,0.946
"14283","Cochabamba","Villa Tunari","Escuela Villa 14 de Septiembre",4,0,0,2,194,3,6,0,0,209,0,4,213,229,0.928,0.93
"14284","Cochabamba","Villa Tunari","Escuela Villa 14 de Septiembre",6,0,0,0,182,2,8,1,0,199,3,1,203,222,0.915,0.914
"14285","Cochabamba","Villa Tunari","Escuela Villa 14 de Septiembre",5,0,0,0,200,2,6,0,1,214,5,3,222,234,0.935,0.949
"14286","Cochabamba","Villa Tunari","Escuela Villa 14 de Septiembre",9,0,0,0,180,2,11,0,1,203,1,2,206,221,0.887,0.932
"14287","Cochabamba","Villa Tunari","Escuela Villa 14 de Septiembre",6,1,0,0,197,1,3,0,1,209,2,2,213,229,0.943,0.93
"14288","Cochabamba","Villa Tunari","Escuela Villa 14 de Septiembre",6,0,0,0,195,0,0,5,0,206,1,1,208,226,0.947,0.92
"14289","Cochabamba","Villa Tunari","Escuela Villa 14 de Septiembre",6,0,0,0,201,0,1,0,0,208,1,3,212,228,0.966,0.93
"14290","Cochabamba","Villa Tunari","Escuela Villa 14 de Septiembre",4,0,0,0,200,0,2,0,0,206,3,5,214,233,0.971,0.918
"14291","Cochabamba","Villa Tunari","Escuela Villa 14 de Septiembre",4,0,0,2,189,0,6,0,0,201,2,4,207,227,0.94,0.912
"14292","Cochabamba","Villa Tunari","Escuela Villa 14 de Septiembre",7,0,0,0,178,1,4,0,0,190,3,2,195,225,0.937,0.867
"14293","Cochabamba","Villa Tunari","Escuela Villa 14 de Septiembre",3,1,0,1,183,1,11,0,3,203,0,4,207,227,0.901,0.912
"14294","Cochabamba","Villa Tunari","Escuela Villa 14 de Septiembre",5,0,0,1,180,0,10,0,0,196,2,2,200,218,0.918,0.917
"14295","Cochabamba","Villa Tunari","Escuela Villa 14 de Septiembre",4,1,0,0,177,0,11,0,0,193,4,6,203,224,0.917,0.906
"14296","Cochabamba","Villa Tunari","Escuela Villa 14 de Septiembre",1,0,0,0,195,0,5,0,0,201,2,3,206,222,0.97,0.928
"14297","Cochabamba","Villa Tunari","Escuela Villa 14 de Septiembre",1,0,0,0,196,1,4,1,1,204,0,3,207,225,0.961,0.92
"14298","Cochabamba","Villa Tunari","Escuela Villa 14 de Septiembre",5,1,2,0,186,0,5,0,1,200,4,5,209,228,0.93,0.917
"14299","Cochabamba","Villa Tunari","Escuela La Estrella (San Gabriel)",0,0,0,0,208,0,0,0,0,208,0,7,215,227,1,0.947
"14300","Cochabamba","Villa Tunari","Escuela La Estrella (San Gabriel)",1,0,0,0,213,0,2,0,0,216,0,1,217,227,0.986,0.956
"14301","Cochabamba","Villa Tunari","Escuela La Estrella (San Gabriel)",1,0,0,1,198,0,3,0,0,203,0,8,211,223,0.975,0.946
"14302","Cochabamba","Villa Tunari","Escuela La Estrella (San Gabriel)",0,1,0,0,209,0,4,0,0,214,0,6,220,230,0.977,0.957
"14303","Cochabamba","Villa Tunari","Escuela La Estrella (San Gabriel)",0,0,0,0,217,0,0,0,0,217,0,1,218,229,1,0.952
"14304","Cochabamba","Villa Tunari","Escuela La Estrella (San Gabriel)",0,0,0,0,208,1,6,0,0,215,2,3,220,232,0.967,0.948
"14305","Cochabamba","Villa Tunari","Escuela La Estrella (San Gabriel)",0,0,0,0,205,0,0,0,0,205,0,8,213,227,1,0.938
"14306","Cochabamba","Villa Tunari","Escuela La Estrella (San Gabriel)",1,1,2,0,206,0,4,0,0,214,3,3,220,231,0.963,0.952
"14307","Cochabamba","Villa Tunari","Escuela La Estrella (San Gabriel)",0,0,0,0,207,0,1,0,0,208,0,3,211,227,0.995,0.93
"14308","Cochabamba","Villa Tunari","Escuela La Estrella (San Gabriel)",0,0,0,0,208,0,0,0,0,208,0,4,212,226,1,0.938
"14309","Cochabamba","Villa Tunari","Escuela La Estrella (San Gabriel)",0,0,0,0,207,0,0,0,0,207,0,5,212,225,1,0.942
"14310","Cochabamba","Villa Tunari","Escuela La Estrella",0,0,0,0,209,0,4,0,0,213,0,3,216,223,0.981,0.969
"14311","Cochabamba","Villa Tunari","Escuela La Estrella",2,0,0,0,213,0,3,0,1,219,0,1,220,227,0.973,0.969
"14312","Cochabamba","Villa Tunari","Escuela La Estrella",1,0,0,0,170,0,1,0,0,172,0,0,172,181,0.988,0.95
"14313","Cochabamba","Villa Tunari","Unidad Educativa Moleto Icoya (V.Tunari)",2,1,0,0,223,0,1,0,0,227,0,1,228,232,0.982,0.983
"14314","Cochabamba","Villa Tunari","Unidad Educativa Moleto Icoya (V.Tunari)",0,0,0,0,224,0,3,0,0,227,0,0,227,234,0.987,0.97
"14315","Cochabamba","Villa Tunari","Unidad Educativa Moleto Icoya (V.Tunari)",0,0,0,0,227,0,3,0,0,230,1,1,232,238,0.987,0.975
"14316","Cochabamba","Villa Tunari","Nucleo Escolar Nueva Aroma",2,0,0,0,215,0,4,0,0,221,0,3,224,232,0.973,0.966
"14317","Cochabamba","Villa Tunari","Nucleo Escolar Nueva Aroma",0,0,0,1,221,1,2,0,0,225,0,1,226,236,0.982,0.958
"14318","Cochabamba","Villa Tunari","Nucleo Escolar Nueva Aroma",1,0,1,0,210,2,5,0,0,219,1,2,222,237,0.959,0.937
"14319","Cochabamba","Villa Tunari","Nucleo Escolar Nueva Aroma",2,0,0,0,210,0,6,0,0,218,0,2,220,230,0.963,0.957
"14320","Cochabamba","Villa Tunari","Nucleo Escolar Nueva Aroma",0,0,0,0,187,2,3,0,0,192,0,0,192,207,0.974,0.928
"14321","Cochabamba","Villa Tunari","Colegio Mixto Tecnico Hum. Villa Bolivar",1,0,0,0,215,0,4,0,0,220,1,3,224,230,0.977,0.974
"14322","Cochabamba","Villa Tunari","Colegio Mixto Tecnico Hum. Villa Bolivar",0,0,0,0,215,0,0,0,1,216,0,3,219,227,0.995,0.965
"14323","Cochabamba","Villa Tunari","Colegio Mixto Tecnico Hum. Villa Bolivar",1,0,0,0,220,1,0,0,0,222,3,1,226,233,0.991,0.97
"14324","Cochabamba","Villa Tunari","Unidad Educativa Paraiso-Todo Santos",2,2,0,1,199,0,7,1,0,212,1,7,220,235,0.939,0.936
"14325","Cochabamba","Villa Tunari","Unidad Educativa Paraiso-Todo Santos",5,0,1,0,193,0,11,0,0,210,2,6,218,229,0.919,0.952
"14326","Cochabamba","Villa Tunari","Unidad Educativa Paraiso-Todo Santos",1,0,0,0,210,0,5,0,0,216,0,3,219,229,0.972,0.956
"14327","Cochabamba","Villa Tunari","Unidad Educativa Paraiso-Todo Santos",2,0,0,0,201,1,9,0,0,213,1,2,216,230,0.944,0.939
"14328","Cochabamba","Villa Tunari","Unidad Educativa Paraiso-Todo Santos",0,0,0,0,212,1,4,0,0,217,0,9,226,234,0.977,0.966
"14329","Cochabamba","Villa Tunari","Unidad Educativa Paraiso-Todo Santos",0,0,0,0,203,0,2,0,0,205,0,10,215,228,0.99,0.943
"14330","Cochabamba","Villa Tunari","Unidad Educativa Paraiso-Todo Santos",1,0,0,0,199,0,13,0,1,214,1,5,220,227,0.93,0.969
"14331","Cochabamba","Villa Tunari","Unidad Educativa Paraiso-Todo Santos",4,2,0,1,200,0,6,0,2,215,2,2,219,234,0.93,0.936
"14332","Cochabamba","Villa Tunari","Unidad Educativa Paraiso-Todo Santos",0,0,0,0,203,0,8,1,0,212,4,2,218,237,0.958,0.92
"14333","Cochabamba","Villa Tunari","Unidad Educativa Simon Rodriguez (Ex Puca Mayu V. Tunari)",0,0,0,0,190,1,9,1,2,203,1,6,210,229,0.936,0.917
"14334","Cochabamba","Villa Tunari","Unidad Educativa Simon Rodriguez (Ex Puca Mayu V. Tunari)",5,1,0,0,185,1,14,0,0,206,1,6,213,226,0.898,0.942
"14335","Cochabamba","Villa Tunari","Unidad Educativa Paracti (Villa Tunari)",13,2,0,0,169,0,11,0,1,196,4,12,212,235,0.862,0.902
"14336","Cochabamba","Villa Tunari","Unidad Educativa Paracti (Villa Tunari)",4,0,2,0,182,1,10,0,0,199,1,8,208,233,0.915,0.893
"14337","Cochabamba","Villa Tunari","Colegio Nueva Tacopaya",4,0,0,0,204,1,10,1,0,220,0,1,221,232,0.927,0.953
"14338","Cochabamba","Villa Tunari","Colegio Nueva Tacopaya",0,1,1,0,221,0,0,0,1,224,0,3,227,233,0.987,0.974
"14339","Cochabamba","Villa Tunari","Colegio Nueva Tacopaya",0,0,0,0,216,0,4,0,0,220,1,4,225,233,0.982,0.966
"14340","Cochabamba","Villa Tunari","Colegio Nueva Tacopaya",0,0,0,0,218,1,4,0,0,223,0,8,231,231,0.978,1
"14341","Cochabamba","Villa Tunari","Colegio Nueva Tacopaya",4,0,0,0,205,1,5,0,0,215,2,4,221,234,0.953,0.944
"14342","Cochabamba","Villa Tunari","Colegio Nueva Tacopaya",0,1,0,0,215,1,2,0,0,219,0,4,223,234,0.982,0.953
"14343","Cochabamba","Villa Tunari","Colegio Nueva Tacopaya",0,0,0,0,223,0,0,0,0,223,0,10,233,233,1,1
"14344","Cochabamba","Villa Tunari","Unidad Educativa San Jose de Angosta",5,1,1,2,181,1,0,0,1,192,3,5,200,240,0.943,0.833
"14345","Cochabamba","Villa Tunari","U. E. Independencia (Villa Tunari)",0,0,0,0,229,0,2,0,0,231,2,1,234,237,0.991,0.987
"14346","Cochabamba","Villa Tunari","U. E. Independencia (Villa Tunari)",0,0,0,0,220,0,2,0,1,223,2,1,226,235,0.987,0.962
"14347","Cochabamba","Villa Tunari","U. E. Independencia (Villa Tunari)",1,1,1,0,220,0,0,0,0,223,4,1,228,235,0.987,0.97
"14348","Cochabamba","Villa Tunari","U. E. Independencia (Villa Tunari)",0,0,1,0,224,0,3,0,1,229,0,1,230,238,0.978,0.966
"14349","Cochabamba","Villa Tunari","U. E. Independencia (Villa Tunari)",0,0,0,0,167,0,0,0,1,168,0,2,170,174,0.994,0.977
"14350","Cochabamba","Villa Tunari","Unidad Educativa Villa Nueva",4,0,0,0,202,0,5,0,0,211,2,2,215,230,0.957,0.935
"14351","Cochabamba","Villa Tunari","Unidad Educativa Tocopilla",3,1,0,0,210,0,1,0,0,215,1,4,220,237,0.977,0.928
"14352","Cochabamba","Villa Tunari","Unidad Educativa Tocopilla",1,0,0,0,218,0,3,1,1,224,1,6,231,236,0.973,0.979
"14353","Cochabamba","Villa Tunari","Unidad Educativa 1ro de Mayo",0,0,0,0,217,0,0,0,0,217,0,7,224,234,1,0.957
"14354","Cochabamba","Villa Tunari","Unidad Educativa 1ro de Mayo",1,0,0,0,215,0,0,0,0,216,1,12,229,236,0.995,0.97
"14355","Cochabamba","Villa Tunari","Unidad Educativa 1ro de Mayo",0,0,0,0,220,0,1,0,0,221,0,9,230,235,0.995,0.979
"14356","Cochabamba","Villa Tunari","Unidad Educativa Uncia",0,0,0,0,232,0,1,0,0,233,0,4,237,238,0.996,0.996
"14357","Cochabamba","Villa Tunari","Unidad Educativa Uncia",0,0,0,0,222,0,4,0,0,226,3,3,232,236,0.982,0.983
"14358","Cochabamba","Villa Tunari","Unidad Educativa Uncia",0,0,0,0,232,1,0,0,0,233,0,1,234,237,0.996,0.987
"14359","Cochabamba","Villa Tunari","U.E. Puerto Patiño",0,0,1,1,222,1,3,0,0,228,1,2,231,238,0.974,0.971
"14360","Cochabamba","Villa Tunari","U.E. Puerto Patiño",0,0,0,0,225,0,1,0,0,226,0,2,228,238,0.996,0.958
"14361","Cochabamba","Villa Tunari","U.E. Rodolfo Illanes",0,0,0,0,227,0,2,0,0,229,1,1,231,238,0.991,0.971
"14362","Cochabamba","Villa Tunari","U.E. Rodolfo Illanes",0,0,0,0,215,0,2,0,0,217,1,2,220,224,0.991,0.982
"14363","Cochabamba","Tapacarí","Unidad Educativa Sucre",0,0,0,0,165,0,0,0,0,165,0,16,181,215,1,0.842
"14364","Cochabamba","Tapacarí","Unidad Educativa Sucre",0,0,0,0,180,0,0,0,0,180,0,16,196,218,1,0.899
"14365","Cochabamba","Tapacarí","Unidad Educativa Sucre",1,0,1,2,177,1,0,0,0,182,1,13,196,224,0.973,0.875
"14366","Cochabamba","Tapacarí","Unidad Educativa Sucre",3,0,0,0,171,1,2,1,0,178,9,2,189,216,0.961,0.875
"14367","Cochabamba","Tapacarí","Unidad Educativa Sucre",0,0,0,0,186,0,0,0,0,186,0,16,202,220,1,0.918
"14368","Cochabamba","Tapacarí","Unidad Educativa Sucre",0,0,0,0,179,0,0,0,0,179,0,19,198,220,1,0.9
"14369","Cochabamba","Tapacarí","Unidad Educativa Sucre",0,0,0,0,170,0,0,0,0,170,0,20,190,213,1,0.892
"14370","Cochabamba","Tapacarí","U.E. Tunas Vinto",1,2,0,0,169,0,3,0,0,175,7,5,187,213,0.966,0.878
"14371","Cochabamba","Tapacarí","U.E. Tunas Vinto",0,0,0,2,178,1,5,0,0,186,5,7,198,226,0.957,0.876
"14372","Cochabamba","Tapacarí","Unidad Educativa Apharumiri",0,1,0,1,174,2,2,0,0,180,4,10,194,212,0.967,0.915
"14373","Cochabamba","Tapacarí","Unidad Educativa Ramadas",6,4,0,1,161,2,3,2,0,179,3,19,201,216,0.899,0.931
"14374","Cochabamba","Tapacarí","Unidad Educativa Ramadas",7,1,1,1,166,3,4,1,0,184,3,8,195,220,0.902,0.886
"14375","Cochabamba","Tapacarí","Unidad Educativa Ramadas",16,2,1,0,161,3,1,0,0,184,0,8,192,209,0.875,0.919
"14376","Cochabamba","Tapacarí","Unidad Educativa Chullpa K'Asa",4,4,2,0,144,4,11,0,0,169,2,6,177,199,0.852,0.889
"14377","Cochabamba","Tapacarí","Unidad Educativa Llavini",11,0,1,0,157,5,12,0,1,187,11,10,208,222,0.84,0.937
"14378","Cochabamba","Tapacarí","Unidad Educativa Norberto Jimenez",4,1,1,1,143,5,14,1,1,171,4,14,189,223,0.836,0.848
"14379","Cochabamba","Tapacarí","Unidad Educativa Norberto Jimenez",0,1,1,4,151,1,9,1,0,168,7,7,182,211,0.899,0.863
"14380","Cochabamba","Tapacarí","U.E. Lacuyo",2,3,6,0,170,3,5,0,0,189,9,15,213,227,0.899,0.938
"14381","Cochabamba","Tapacarí","U.E. Lacuyo",0,0,4,2,184,0,9,1,0,200,1,13,214,229,0.92,0.934
"14382","Cochabamba","Tapacarí","Nucleo Escolar Confital",1,2,1,1,160,5,24,0,1,195,7,11,213,219,0.821,0.973
"14383","Cochabamba","Tapacarí","Nucleo Escolar Confital",1,2,2,1,161,2,21,0,3,193,5,11,209,222,0.834,0.941
"14384","Cochabamba","Tapacarí","Unidad Educativa Waca Playa",3,0,0,1,187,0,2,1,0,194,3,6,203,223,0.964,0.91
"14385","Cochabamba","Tapacarí","Unidad Educativa Waca Playa",0,0,0,0,185,0,0,0,0,185,0,10,195,213,1,0.915
"14386","Cochabamba","Tapacarí","Unidad Educativa Waca Playa",0,0,0,0,188,0,0,0,0,188,0,13,201,218,1,0.922
"14387","Cochabamba","Tapacarí","Unidad Educativa Waca Playa",0,0,0,0,184,0,2,0,0,186,2,5,193,205,0.989,0.941
"14388","Cochabamba","Tapacarí","Unidad Educativa Japo K'Asa",0,2,0,0,178,1,12,1,1,195,2,11,208,217,0.913,0.959
"14389","Cochabamba","Tapacarí","Unidad Educativa Japo K'Asa",2,0,1,1,186,1,4,0,0,195,1,5,201,215,0.954,0.935
"14390","Cochabamba","Tapacarí","Unidad Educativa Japo K'Asa",2,2,0,0,169,3,5,1,0,182,2,11,195,214,0.929,0.911
"14391","Cochabamba","Tapacarí","Unidad Educativa Central Villa Pereira",2,2,5,1,148,1,3,0,0,162,18,8,188,216,0.914,0.87
"14392","Cochabamba","Tapacarí","Unidad Educativa Central Villa Pereira",2,0,1,2,173,0,3,0,0,181,1,13,195,222,0.956,0.878
"14393","Cochabamba","Tapacarí","Unidad Educativa San Antonio",8,0,3,0,141,1,30,1,1,185,6,9,200,227,0.762,0.881
"14394","Cochabamba","Tapacarí","Escuela Chuñu Chuñini",0,0,0,0,207,0,3,0,0,210,0,9,219,228,0.986,0.961
"14395","Cochabamba","Tapacarí","Escuela Chuñu Chuñini",0,0,0,0,214,1,2,0,0,217,0,8,225,239,0.986,0.941
"14396","Cochabamba","Tapacarí","Escuela  Challa Grande",4,3,1,0,155,0,18,1,0,182,7,13,202,221,0.852,0.914
"14397","Cochabamba","Tapacarí","Escuela Monseñor Angel Gelmi",2,0,1,0,188,0,0,0,0,191,1,7,199,223,0.984,0.892
"14398","Cochabamba","Tapacarí","Escuela Monseñor Angel Gelmi",1,1,1,0,180,2,1,1,0,187,12,3,202,222,0.963,0.91
"14399","Cochabamba","Tapacarí","Unidad Educativa Katariri",0,0,0,0,212,0,0,0,0,212,0,6,218,228,1,0.956
"14400","Cochabamba","Tapacarí","Unidad Educativa Katariri",0,0,0,0,214,0,0,0,0,214,0,7,221,227,1,0.974
"14401","Cochabamba","Tapacarí","Unidad Educativa Kjarkas",12,0,2,0,150,2,19,0,1,186,3,16,205,222,0.806,0.923
"14402","Cochabamba","Tapacarí","U.E. Lacolaconi",3,2,0,0,193,1,7,0,1,207,3,8,218,228,0.932,0.956
"14403","Cochabamba","Tapacarí","U.E. Chillca Grande",2,0,2,1,181,1,1,0,0,188,4,11,203,214,0.963,0.949
"14404","Cochabamba","Tapacarí","U.E. Arasaya",0,0,0,0,227,0,0,0,0,227,0,1,228,237,1,0.962
"14405","Cochabamba","Totora","U.E. La Paz",19,1,0,0,145,7,6,0,0,178,2,13,193,219,0.815,0.881
"14406","Cochabamba","Totora","U.E. La Paz",9,1,0,0,166,1,5,0,1,183,4,5,192,217,0.907,0.885
"14407","Cochabamba","Totora","U.E. La Paz",19,0,2,0,160,3,12,0,0,196,6,7,209,218,0.816,0.959
"14408","Cochabamba","Totora","U.E. La Paz",18,2,1,2,147,2,10,0,0,182,3,5,190,215,0.808,0.884
"14409","Cochabamba","Totora","U.E. La Paz",14,0,0,0,171,1,5,0,0,191,1,12,204,220,0.895,0.927
"14410","Cochabamba","Totora","U.E. La Paz",10,0,1,0,160,2,8,0,0,181,7,10,198,218,0.884,0.908
"14411","Cochabamba","Totora","U.E. La Paz",13,1,1,2,164,4,12,0,0,197,2,10,209,222,0.832,0.941
"14412","Cochabamba","Totora","U.E. La Paz",10,1,0,1,172,0,9,0,0,193,2,8,203,226,0.891,0.898
"14413","Cochabamba","Totora","U.E. La Paz",9,1,0,1,172,3,3,0,1,190,1,7,198,214,0.905,0.925
"14414","Cochabamba","Totora","U.E. La Paz",15,4,1,3,139,2,9,1,1,175,7,12,194,220,0.794,0.882
"14415","Cochabamba","Totora","U.E. La Paz",18,1,1,0,159,3,7,1,0,190,1,14,205,219,0.837,0.936
"14416","Cochabamba","Totora","U.E. La Paz",8,0,2,0,148,2,5,1,1,167,4,5,176,216,0.886,0.815
"14417","Cochabamba","Totora","U.E. La Paz",13,0,0,1,155,5,6,0,3,183,3,5,191,217,0.847,0.88
"14418","Cochabamba","Totora","U.E. La Paz",19,0,1,1,152,5,7,0,0,185,3,11,199,219,0.822,0.909
"14419","Cochabamba","Totora","U.E. La Paz",15,1,1,0,123,3,6,1,1,151,2,7,160,178,0.815,0.899
"14420","Cochabamba","Totora","Sede De La Junta Vecinal De Epizana",10,1,0,0,181,2,7,1,0,202,4,7,213,225,0.896,0.947
"14421","Cochabamba","Totora","Sede De La Junta Vecinal De Epizana",6,4,0,0,169,1,12,2,0,194,6,9,209,223,0.871,0.937
"14422","Cochabamba","Totora","Sede De La Junta Vecinal De Epizana",2,0,0,0,178,0,14,0,0,194,4,7,205,224,0.918,0.915
"14423","Cochabamba","Totora","Sede De La Junta Vecinal De Epizana",11,0,0,0,183,0,13,0,0,207,5,6,218,230,0.884,0.948
"14424","Cochabamba","Totora","Unidad Educativa Tiraque C",0,0,0,0,193,1,3,1,1,199,3,7,209,224,0.97,0.933
"14425","Cochabamba","Totora","U.E. Eduardo Abaroa",3,2,0,0,203,0,2,0,0,210,2,4,216,229,0.967,0.943
"14426","Cochabamba","Totora","U.E. Eduardo Abaroa",0,0,0,0,194,0,10,0,0,204,4,4,212,224,0.951,0.946
"14427","Cochabamba","Totora","U.E. Eduardo Abaroa",0,0,0,0,194,0,9,1,0,204,0,3,207,219,0.951,0.945
"14428","Cochabamba","Totora","Unidad Educativa Rodeo Grande",1,1,0,0,201,0,4,0,0,207,5,9,221,234,0.971,0.944
"14429","Cochabamba","Totora","Unidad Educativa Rodeo Grande",1,1,0,0,201,0,5,0,0,208,3,5,216,225,0.966,0.96
"14430","Cochabamba","Totora","Unidad Educativa Rodeo Grande",0,1,0,0,187,0,8,1,1,198,3,10,211,231,0.944,0.913
"14431","Cochabamba","Totora","Unidad Educativa Rodeo Grande",2,1,1,0,187,2,6,1,0,200,5,10,215,225,0.935,0.956
"14432","Cochabamba","Totora","Colegio 8 de Septiembre",1,0,3,0,192,1,8,1,0,206,7,5,218,225,0.932,0.969
"14433","Cochabamba","Totora","Colegio 8 de Septiembre",0,2,0,0,195,0,3,1,0,201,2,8,211,223,0.97,0.946
"14434","Cochabamba","Totora","Colegio 8 de Septiembre",1,2,1,2,190,1,8,2,0,207,3,5,215,224,0.918,0.96
"14435","Cochabamba","Totora","Sede Social Yungas de Vandiola",16,0,0,0,185,2,8,0,1,212,2,6,220,238,0.873,0.924
"14436","Cochabamba","Totora","Sede Social Yungas de Vandiola",17,2,0,2,184,3,6,0,0,214,0,5,219,236,0.86,0.928
"14437","Cochabamba","Totora","Sede Social Yungas de Vandiola",9,0,0,2,155,3,6,1,0,176,2,6,184,193,0.881,0.953
"14438","Cochabamba","Pojo","Colegio Venancio Loss",4,2,0,1,157,3,21,1,1,190,3,4,197,223,0.826,0.883
"14439","Cochabamba","Pojo","Colegio Venancio Loss",14,3,0,1,153,4,18,0,0,193,1,4,198,221,0.793,0.896
"14440","Cochabamba","Pojo","Colegio Venancio Loss",7,0,0,0,161,1,22,1,0,192,5,12,209,219,0.839,0.954
"14441","Cochabamba","Pojo","Colegio Venancio Loss",8,2,0,0,154,4,16,1,2,187,3,5,195,215,0.824,0.907
"14442","Cochabamba","Pojo","Colegio Venancio Loss",9,0,1,1,157,4,15,0,0,187,4,8,199,217,0.84,0.917
"14443","Cochabamba","Pojo","Colegio Venancio Loss",14,1,3,1,157,1,25,0,0,202,7,10,219,230,0.777,0.952
"14444","Cochabamba","Pojo","Colegio Venancio Loss",18,2,1,1,144,1,18,0,2,187,4,2,193,217,0.77,0.889
"14445","Cochabamba","Pojo","Colegio Venancio Loss",17,1,1,1,143,1,29,1,0,194,5,8,207,227,0.737,0.912
"14446","Cochabamba","Pojo","Unidad Educativa Kara Huasi - Pojo",2,0,1,1,191,0,6,0,0,201,2,3,206,229,0.95,0.9
"14447","Cochabamba","Pojo","Unidad Educativa Challhuani",3,2,1,0,188,3,14,2,0,213,2,1,216,227,0.883,0.952
"14448","Cochabamba","Pojo","Unidad Educativa Challhuani",2,2,0,0,176,2,8,0,0,190,1,8,199,226,0.926,0.881
"14449","Cochabamba","Pojo","Unidad Educativa Challhuani",1,1,1,0,173,1,20,0,0,197,2,5,204,217,0.878,0.94
"14450","Cochabamba","Pojo","Nucleo Escolar Duraznillo",0,0,0,0,140,1,12,0,0,153,0,6,159,182,0.915,0.874
"14451","Cochabamba","Pojo","Unidad Educativa Yuthupampa",1,0,0,0,201,0,7,0,0,209,0,0,209,228,0.962,0.917
"14452","Cochabamba","Pojo","Unidad Educativa Yuthupampa",2,0,0,0,199,0,5,0,1,207,0,4,211,226,0.961,0.934
"14453","Cochabamba","Pojo","Unidad Educativa Palca C",4,1,0,0,193,0,9,0,1,208,0,3,211,226,0.928,0.934
"14454","Cochabamba","Pojo","Unidad Educativa Palca C",1,0,1,0,203,0,7,0,0,212,2,1,215,222,0.958,0.968
"14455","Cochabamba","Pojo","Unidad Educativa Rodeo C",1,1,1,1,172,3,11,3,1,194,10,5,209,222,0.887,0.941
"14456","Cochabamba","Pojo","Unidad Educativa Rodeo C",1,1,0,1,169,2,20,0,0,194,1,1,196,196,0.871,1
"14457","Cochabamba","Pojo","Unidad Educativa Dian Pampa",4,1,0,1,191,1,13,0,2,213,3,9,225,236,0.897,0.953
"14458","Cochabamba","Pojo","Unidad Educativa La Habana",4,0,1,0,208,1,4,0,0,218,1,1,220,230,0.954,0.957
"14459","Cochabamba","Pocona","Unidad Educativa Pocona",10,2,2,0,139,2,4,0,0,159,7,8,174,204,0.874,0.853
"14460","Cochabamba","Pocona","Unidad Educativa Pocona",11,1,1,0,137,6,10,3,0,169,7,7,183,215,0.811,0.851
"14461","Cochabamba","Pocona","Unidad Educativa Monte Puncu",8,2,0,0,176,2,11,0,0,199,4,6,209,227,0.884,0.921
"14462","Cochabamba","Pocona","Unidad Educativa Monte Puncu",4,2,0,1,173,1,16,0,0,197,3,11,211,223,0.878,0.946
"14463","Cochabamba","Pocona","Escuela Ladislao Cabrera",4,0,1,0,143,4,0,0,0,152,34,0,186,207,0.941,0.899
"14464","Cochabamba","Pocona","Unidad Educativa Huayapacha",1,0,1,2,174,1,5,0,1,185,6,12,203,223,0.941,0.91
"14465","Cochabamba","Pocona","Unidad Educativa Huayapacha",2,1,0,0,184,0,6,0,0,193,1,5,199,218,0.953,0.913
"14466","Cochabamba","Pocona","Unidad Educativa Huayapacha",4,1,2,0,172,0,8,0,4,191,4,6,201,220,0.901,0.914
"14467","Cochabamba","Pocona","Unidad Educativa Huayapacha",1,1,0,0,182,0,12,0,1,197,16,5,218,228,0.924,0.956
"14468","Cochabamba","Pocona","Unidad Educativa 6 de Agosto",7,1,0,0,177,1,10,0,0,196,1,8,205,220,0.903,0.932
"14469","Cochabamba","Pocona","Unidad Educativa 6 de Agosto",2,0,0,1,178,0,8,2,0,191,1,6,198,225,0.932,0.88
"14470","Cochabamba","Pocona","Unidad Educativa 6 de Agosto",3,0,1,0,146,4,5,0,0,159,48,6,213,225,0.918,0.947
"14471","Cochabamba","Pocona","Unidad Educativa 6 de Agosto",3,2,1,2,172,2,8,0,0,190,4,6,200,221,0.905,0.905
"14472","Cochabamba","Pocona","Unidad Educativa 6 de Agosto",3,3,0,0,184,1,6,0,0,197,1,9,207,223,0.934,0.928
"14473","Cochabamba","Pocona","Nucleo Escolar Ismael Montes",6,1,1,0,203,0,3,0,0,214,1,11,226,229,0.949,0.987
"14474","Cochabamba","Pocona","Nucleo Escolar Ismael Montes",4,1,0,1,183,0,6,0,1,196,2,3,201,218,0.934,0.922
"14475","Cochabamba","Pocona","Nucleo Escolar Ismael Montes",3,1,2,1,192,0,6,0,1,206,5,5,216,227,0.932,0.952
"14476","Cochabamba","Pocona","Nucleo Escolar Ismael Montes",1,1,0,0,191,1,7,1,1,203,6,6,215,229,0.941,0.939
"14477","Cochabamba","Pocona","Unidad Educativa Chimboata",3,1,0,0,183,1,10,0,0,198,3,13,214,226,0.924,0.947
"14478","Cochabamba","Pocona","Unidad Educativa Chimboata",3,1,0,0,163,3,16,3,0,189,1,8,198,216,0.862,0.917
"14479","Cochabamba","Pocona","Centro de Atencion Al Turista",2,0,0,0,207,0,6,0,0,215,3,5,223,230,0.963,0.97
"14480","Cochabamba","Pocona","U.E. Julio Guardia Sandoval",11,0,1,0,162,6,15,0,0,195,3,11,209,236,0.831,0.886
"14481","Cochabamba","Pocona","U.E. Julio Guardia Sandoval",5,1,1,0,177,5,27,2,1,219,8,3,230,247,0.808,0.931
"14482","Cochabamba","Pocona","U.E. Pedro Domingo Murillo",2,0,0,1,150,3,8,1,0,165,4,3,172,174,0.909,0.989
"14483","Cochabamba","Chimoré","Escuela Gerónimo Uzeda Fe y Alegria",17,0,1,0,168,4,11,0,0,201,1,5,207,231,0.836,0.896
"14484","Cochabamba","Chimoré","Escuela Gerónimo Uzeda Fe y Alegria",16,1,0,0,156,3,15,0,0,191,4,8,203,229,0.817,0.886
"14485","Cochabamba","Chimoré","Escuela Gerónimo Uzeda Fe y Alegria",16,0,0,0,162,1,13,0,2,194,1,6,201,225,0.835,0.893
"14486","Cochabamba","Chimoré","Escuela Gerónimo Uzeda Fe y Alegria",17,0,1,0,158,1,14,0,0,191,4,7,202,230,0.827,0.878
"14487","Cochabamba","Chimoré","Escuela Gerónimo Uzeda Fe y Alegria",13,0,1,1,151,0,16,0,1,183,2,5,190,226,0.825,0.841
"14488","Cochabamba","Chimoré","Escuela Gerónimo Uzeda Fe y Alegria",20,1,1,0,162,3,17,1,2,207,1,3,211,229,0.783,0.921
"14489","Cochabamba","Chimoré","Escuela Gerónimo Uzeda Fe y Alegria",15,1,0,0,165,0,19,0,1,201,1,4,206,232,0.821,0.888
"14490","Cochabamba","Chimoré","Escuela Gerónimo Uzeda Fe y Alegria",17,0,0,0,154,5,11,0,0,187,4,4,195,223,0.824,0.874
"14491","Cochabamba","Chimoré","Escuela Gerónimo Uzeda Fe y Alegria",16,1,0,0,166,0,16,0,2,201,0,5,206,229,0.826,0.9
"14492","Cochabamba","Chimoré","Escuela Gerónimo Uzeda Fe y Alegria",21,0,0,0,152,1,15,0,2,191,2,3,196,226,0.796,0.867
"14493","Cochabamba","Chimoré","Escuela Gerónimo Uzeda Fe y Alegria",19,0,3,0,148,3,18,0,0,191,1,7,199,219,0.775,0.909
"14494","Cochabamba","Chimoré","Escuela Gerónimo Uzeda Fe y Alegria",13,0,0,0,179,0,15,0,2,209,2,3,214,230,0.856,0.93
"14495","Cochabamba","Chimoré","Escuela Gerónimo Uzeda Fe y Alegria",18,0,0,0,164,0,11,0,1,194,0,4,198,224,0.845,0.884
"14496","Cochabamba","Chimoré","Escuela Gerónimo Uzeda Fe y Alegria",25,0,0,1,153,0,13,0,2,194,3,5,202,226,0.789,0.894
"14497","Cochabamba","Chimoré","Escuela Gerónimo Uzeda Fe y Alegria",23,0,0,0,150,2,25,2,0,202,4,4,210,231,0.743,0.909
"14498","Cochabamba","Chimoré","Escuela Gerónimo Uzeda Fe y Alegria",13,0,3,1,161,0,14,0,0,192,3,3,198,228,0.839,0.868
"14499","Cochabamba","Chimoré","Escuela Gerónimo Uzeda Fe y Alegria",24,0,1,0,154,4,10,1,0,194,3,4,201,223,0.794,0.901
"14500","Cochabamba","Chimoré","Escuela Gerónimo Uzeda Fe y Alegria",18,0,1,0,152,1,0,0,2,174,4,6,184,229,0.874,0.803
"14501","Cochabamba","Chimoré","Escuela Gerónimo Uzeda Fe y Alegria",18,1,2,0,168,0,12,0,0,201,4,6,211,231,0.836,0.913
"14502","Cochabamba","Chimoré","Escuela Gerónimo Uzeda Fe y Alegria",25,0,1,0,149,1,13,0,1,190,0,8,198,227,0.784,0.872
"14503","Cochabamba","Chimoré","Escuela Gerónimo Uzeda Fe y Alegria",20,0,0,1,146,6,16,0,0,189,1,5,195,226,0.772,0.863
"14504","Cochabamba","Chimoré","Escuela Gerónimo Uzeda Fe y Alegria",23,0,0,0,156,1,12,1,0,193,2,4,199,228,0.808,0.873
"14505","Cochabamba","Chimoré","Escuela Gerónimo Uzeda Fe y Alegria",23,0,2,0,154,2,11,0,0,192,28,6,226,226,0.802,1
"14506","Cochabamba","Chimoré","Escuela Gerónimo Uzeda Fe y Alegria",17,1,0,1,160,2,9,0,1,191,5,3,199,226,0.838,0.881
"14507","Cochabamba","Chimoré","Escuela Gerónimo Uzeda Fe y Alegria",19,0,1,0,175,1,10,0,2,208,6,4,218,230,0.841,0.948
"14508","Cochabamba","Chimoré","Escuela Gerónimo Uzeda Fe y Alegria",23,1,2,0,144,2,19,0,0,191,5,7,203,226,0.754,0.898
"14509","Cochabamba","Chimoré","Escuela Gerónimo Uzeda Fe y Alegria",14,0,0,0,184,0,11,0,1,210,2,1,213,237,0.876,0.899
"14510","Cochabamba","Chimoré","Escuela Gerónimo Uzeda Fe y Alegria",17,1,0,0,162,0,11,0,0,191,0,2,193,227,0.848,0.85
"14511","Cochabamba","Chimoré","Escuela Gerónimo Uzeda Fe y Alegria",11,0,0,1,162,0,12,0,1,187,1,8,196,226,0.866,0.867
"14512","Cochabamba","Chimoré","Escuela Gerónimo Uzeda Fe y Alegria",17,0,0,1,157,1,21,0,1,198,2,6,206,228,0.793,0.904
"14513","Cochabamba","Chimoré","Escuela Gerónimo Uzeda Fe y Alegria",21,0,1,0,142,3,16,0,2,185,5,7,197,226,0.768,0.872
"14514","Cochabamba","Chimoré","Escuela Gerónimo Uzeda Fe y Alegria",20,1,0,0,162,2,8,0,2,195,0,4,199,225,0.831,0.884
"14515","Cochabamba","Chimoré","Escuela Gerónimo Uzeda Fe y Alegria",12,0,0,0,157,1,11,0,0,181,4,8,193,223,0.867,0.865
"14516","Cochabamba","Chimoré","Escuela Gerónimo Uzeda Fe y Alegria",9,0,1,0,137,0,8,0,0,155,0,6,161,179,0.884,0.899
"14517","Cochabamba","Chimoré","U. E. Ernesto Che Guevara",21,2,1,0,173,0,15,0,3,215,2,9,226,240,0.805,0.942
"14518","Cochabamba","Chimoré","U. E. Ernesto Che Guevara",19,0,1,0,175,2,20,1,3,221,2,8,231,240,0.792,0.963
"14519","Cochabamba","Chimoré","U. E. Ernesto Che Guevara",24,0,0,0,167,3,19,0,0,213,6,2,221,238,0.784,0.929
"14520","Cochabamba","Chimoré","U. E. Ernesto Che Guevara",22,0,0,1,172,0,22,1,0,218,4,2,224,240,0.789,0.933
"14521","Cochabamba","Chimoré","U. E. Ernesto Che Guevara",26,1,1,0,165,2,20,1,3,219,4,4,227,238,0.753,0.954
"14522","Cochabamba","Chimoré","U. E. Ernesto Che Guevara",15,2,0,1,169,3,23,0,1,214,3,9,226,238,0.79,0.95
"14523","Cochabamba","Chimoré","U. E. Ernesto Che Guevara",20,0,1,0,186,0,16,0,2,225,1,6,232,240,0.827,0.967
"14524","Cochabamba","Chimoré","U. E. Ernesto Che Guevara",12,0,0,0,152,3,12,0,0,179,1,6,186,198,0.849,0.939
"14525","Cochabamba","Chimoré","Nucleo Educativo Entre Rios Tacuaral",1,0,1,0,213,0,8,0,0,223,2,2,227,239,0.955,0.95
"14526","Cochabamba","Chimoré","Nucleo Educativo Entre Rios Tacuaral",1,0,0,0,211,0,4,0,0,216,3,1,220,228,0.977,0.965
"14527","Cochabamba","Chimoré","Nucleo Educativo Entre Rios Tacuaral",2,1,0,0,187,1,15,0,0,206,1,2,209,224,0.908,0.933
"14528","Cochabamba","Chimoré","Nucleo Escolar Puerto Aurora",9,0,0,0,185,0,12,0,0,206,3,1,210,226,0.898,0.929
"14529","Cochabamba","Chimoré","Nucleo Escolar Puerto Aurora",2,0,0,1,199,0,3,0,0,205,2,5,212,225,0.971,0.942
"14530","Cochabamba","Chimoré","Unidad Educativa Cesar Zama (Chimore)",5,1,0,0,199,0,4,0,0,209,3,3,215,229,0.952,0.939
"14531","Cochabamba","Chimoré","Unidad Educativa Cesar Zama (Chimore)",2,0,0,0,206,0,9,0,0,217,1,0,218,228,0.949,0.956
"14532","Cochabamba","Chimoré","Unidad Educativa Cesar Zama (Chimore)",0,2,0,0,198,0,5,0,0,205,4,2,211,223,0.966,0.946
"14533","Cochabamba","Chimoré","Unidad Educativa Cesar Zama (Chimore)",0,0,0,0,200,2,7,0,1,210,1,4,215,224,0.952,0.96
"14534","Cochabamba","Chimoré","Unidad Educativa Cesar Zama (Chimore)",4,0,0,0,215,0,4,0,1,224,0,4,228,233,0.96,0.979
"14535","Cochabamba","Chimoré","Unidad Educativa Cesar Zama (Chimore)",0,0,0,0,224,1,1,0,0,226,0,0,226,237,0.991,0.954
"14536","Cochabamba","Chimoré","Unidad Educativa Cesar Zama (Chimore)",5,0,0,0,200,0,9,0,0,214,1,2,217,230,0.935,0.943
"14537","Cochabamba","Chimoré","Unidad Educativa Cesar Zama (Chimore)",3,0,0,0,207,0,2,0,0,212,0,3,215,227,0.976,0.947
"14538","Cochabamba","Chimoré","Unidad Educativa Cesar Zama (Chimore)",4,1,0,0,201,0,8,0,0,214,1,2,217,230,0.939,0.943
"14539","Cochabamba","Chimoré","Escuela La Mision",4,2,0,1,181,2,13,0,0,203,6,5,214,238,0.892,0.899
"14540","Cochabamba","Chimoré","Escuela La Mision",5,0,1,1,152,0,11,0,1,171,10,26,207,224,0.889,0.924
"14541","Cochabamba","Chimoré","Unidad Educativa San Andrés",0,0,0,0,214,0,1,0,0,215,1,1,217,227,0.995,0.956
"14542","Cochabamba","Chimoré","Unidad Educativa San Andrés",0,0,0,0,218,0,1,0,0,219,1,2,222,230,0.995,0.965
"14543","Cochabamba","Chimoré","Unidad Educativa Tres Islas",2,2,1,0,142,3,13,1,2,166,5,4,175,201,0.855,0.871
"14544","Cochabamba","Chimoré","U.E. Bolivia",3,1,1,0,218,1,5,0,0,229,3,2,234,237,0.952,0.987
"14545","Cochabamba","Chimoré","U.E. Senda III",13,0,0,0,190,1,13,3,1,221,3,4,228,237,0.86,0.962
"14546","Cochabamba","Chimoré","U.E. Senda III",14,1,0,2,200,1,6,0,2,226,4,3,233,239,0.885,0.975
"14547","Cochabamba","Chimoré","U.E. Senda III",16,2,0,1,187,3,7,0,0,216,1,5,222,226,0.866,0.982
"14548","Cochabamba","Puerto Villarroel","Colegio Eduardo Avaroa (P.Villarroel)",26,0,0,0,139,5,21,0,2,193,1,5,199,228,0.72,0.873
"14549","Cochabamba","Puerto Villarroel","Colegio Eduardo Avaroa (P.Villarroel)",24,0,0,1,151,4,12,0,1,193,4,4,201,230,0.782,0.874
"14550","Cochabamba","Puerto Villarroel","Colegio Eduardo Avaroa (P.Villarroel)",21,0,0,1,141,8,18,1,0,190,2,9,201,233,0.742,0.863
"14551","Cochabamba","Puerto Villarroel","Colegio Eduardo Avaroa (P.Villarroel)",34,1,0,0,115,10,17,0,3,180,0,6,186,230,0.639,0.809
"14552","Cochabamba","Puerto Villarroel","Colegio Eduardo Avaroa (P.Villarroel)",28,0,0,0,139,14,12,2,3,198,1,4,203,232,0.702,0.875
"14553","Cochabamba","Puerto Villarroel","Colegio Eduardo Avaroa (P.Villarroel)",23,1,1,2,124,11,16,1,1,180,5,10,195,229,0.689,0.852
"14554","Cochabamba","Puerto Villarroel","Colegio Eduardo Avaroa (P.Villarroel)",28,1,0,3,121,11,10,2,0,176,5,5,186,227,0.688,0.819
"14555","Cochabamba","Puerto Villarroel","Unidad Educativa San Francisco De Asis",17,0,0,0,186,0,8,0,1,212,3,1,216,233,0.877,0.927
"14556","Cochabamba","Puerto Villarroel","Unidad Educativa San Francisco De Asis",11,0,0,0,184,1,8,0,1,205,2,4,211,228,0.898,0.925
"14557","Cochabamba","Puerto Villarroel","Unidad Educativa San Francisco De Asis",16,1,0,0,160,2,13,0,0,192,0,6,198,225,0.833,0.88
"14558","Cochabamba","Puerto Villarroel","Unidad Educativa San Francisco De Asis",18,0,2,1,149,0,11,0,1,182,2,14,198,226,0.819,0.876
"14559","Cochabamba","Puerto Villarroel","Unidad Educativa San Francisco De Asis",7,0,0,0,169,0,15,0,0,191,0,14,205,227,0.885,0.903
"14560","Cochabamba","Puerto Villarroel","Unidad Educativa San Francisco De Asis",17,0,1,0,170,1,13,0,0,202,1,9,212,227,0.842,0.934
"14561","Cochabamba","Puerto Villarroel","Unidad Educativa San Francisco De Asis",8,0,0,0,182,0,15,0,1,206,2,3,211,234,0.883,0.902
"14562","Cochabamba","Puerto Villarroel","Unidad Educativa San Francisco De Asis",10,0,0,0,168,0,19,0,1,198,1,5,204,229,0.848,0.891
"14563","Cochabamba","Puerto Villarroel","Unidad Educativa San Francisco De Asis",16,0,0,0,174,1,11,1,0,203,1,6,210,230,0.857,0.913
"14564","Cochabamba","Puerto Villarroel","Unidad Educativa San Francisco De Asis",13,0,0,0,180,1,10,0,1,205,1,1,207,229,0.878,0.904
"14565","Cochabamba","Puerto Villarroel","Unidad Educativa San Francisco De Asis",3,0,0,0,171,1,17,0,1,193,3,4,200,227,0.886,0.881
"14566","Cochabamba","Puerto Villarroel","Unidad Educativa San Francisco De Asis",16,0,0,1,174,2,11,0,0,204,1,2,207,230,0.853,0.9
"14567","Cochabamba","Puerto Villarroel","Unidad Educativa San Francisco De Asis",10,1,0,1,186,2,11,0,1,212,1,4,217,234,0.877,0.927
"14568","Cochabamba","Puerto Villarroel","Unidad Educativa San Francisco De Asis",13,0,1,1,167,0,16,0,2,200,2,3,205,227,0.835,0.903
"14569","Cochabamba","Puerto Villarroel","Unidad Educativa San Francisco De Asis",18,0,0,0,170,1,18,1,1,209,0,5,214,228,0.813,0.939
"14570","Cochabamba","Puerto Villarroel","Unidad Educativa San Francisco De Asis",6,0,1,0,178,0,14,1,0,200,2,5,207,223,0.89,0.928
"14571","Cochabamba","Puerto Villarroel","Unidad Educativa San Francisco De Asis",12,0,2,0,176,1,7,0,1,199,1,6,206,230,0.884,0.896
"14572","Cochabamba","Puerto Villarroel","Unidad Educativa San Francisco De Asis",12,0,0,0,173,2,6,0,1,194,3,8,205,228,0.892,0.899
"14573","Cochabamba","Puerto Villarroel","Unidad Educativa San Francisco De Asis",14,0,1,0,181,0,11,0,0,207,2,5,214,231,0.874,0.926
"14574","Cochabamba","Puerto Villarroel","Unidad Educativa San Francisco De Asis",9,0,0,0,198,2,9,0,0,218,0,1,219,229,0.908,0.956
"14575","Cochabamba","Puerto Villarroel","Unidad Educativa San Francisco De Asis",10,0,0,0,177,2,7,0,2,198,3,7,208,230,0.894,0.904
"14576","Cochabamba","Puerto Villarroel","Unidad Educativa San Francisco De Asis",10,0,0,0,182,0,7,1,0,200,1,6,207,230,0.91,0.9
"14577","Cochabamba","Puerto Villarroel","Unidad Educativa San Francisco De Asis",9,0,0,0,176,0,11,1,0,197,1,7,205,226,0.893,0.907
"14578","Cochabamba","Puerto Villarroel","Unidad Educativa San Francisco De Asis",12,1,0,0,182,1,9,0,0,205,2,9,216,230,0.888,0.939
"14579","Cochabamba","Puerto Villarroel","Unidad Educativa San Francisco De Asis",8,0,2,0,184,1,11,0,0,206,1,6,213,228,0.893,0.934
"14580","Cochabamba","Puerto Villarroel","Unidad Educativa San Francisco De Asis",19,0,0,0,181,0,7,0,0,207,1,6,214,229,0.874,0.934
"14581","Cochabamba","Puerto Villarroel","Unidad Educativa San Francisco De Asis",11,0,0,1,182,0,11,0,0,205,0,3,208,232,0.888,0.897
"14582","Cochabamba","Puerto Villarroel","Unidad Educativa San Francisco De Asis",15,0,0,0,179,1,3,0,0,198,4,5,207,230,0.904,0.9
"14583","Cochabamba","Puerto Villarroel","Unidad Educativa San Francisco De Asis",16,1,2,0,164,0,13,0,1,197,1,8,206,223,0.832,0.924
"14584","Cochabamba","Puerto Villarroel","Unidad Educativa San Francisco De Asis",11,1,0,0,183,1,8,0,1,205,0,4,209,233,0.893,0.897
"14585","Cochabamba","Puerto Villarroel","Unidad Educativa San Francisco De Asis",5,0,0,0,177,1,19,0,1,203,1,1,205,229,0.872,0.895
"14586","Cochabamba","Puerto Villarroel","Unidad Educativa San Francisco De Asis",6,0,0,0,177,1,9,1,2,196,1,5,202,227,0.903,0.89
"14587","Cochabamba","Puerto Villarroel","Unidad Educativa San Francisco De Asis",12,0,0,0,182,0,6,0,0,200,5,5,210,228,0.91,0.921
"14588","Cochabamba","Puerto Villarroel","Unidad Educativa San Francisco De Asis",12,1,0,0,186,1,11,0,0,211,0,6,217,230,0.882,0.943
"14589","Cochabamba","Puerto Villarroel","Unidad Educativa San Francisco De Asis",10,0,0,0,173,1,20,0,2,206,0,5,211,230,0.84,0.917
"14590","Cochabamba","Puerto Villarroel","Unidad Educativa San Francisco De Asis",7,0,0,0,177,0,0,0,2,186,3,5,194,224,0.952,0.866
"14591","Cochabamba","Puerto Villarroel","Unidad Educativa San Francisco De Asis",11,2,0,0,189,1,5,0,1,209,1,4,214,228,0.904,0.939
"14592","Cochabamba","Puerto Villarroel","Unidad Educativa San Francisco De Asis",13,0,0,1,175,1,7,0,1,198,4,5,207,231,0.884,0.896
"14593","Cochabamba","Puerto Villarroel","Unidad Educativa San Francisco De Asis",11,0,1,0,191,0,8,0,0,211,0,2,213,229,0.905,0.93
"14594","Cochabamba","Puerto Villarroel","Unidad Educativa San Francisco De Asis",17,0,0,0,169,1,19,1,1,208,2,1,211,228,0.812,0.925
"14595","Cochabamba","Puerto Villarroel","Unidad Educativa San Francisco De Asis",10,1,0,0,166,2,18,0,1,198,0,11,209,227,0.838,0.921
"14596","Cochabamba","Puerto Villarroel","Unidad Educativa San Francisco De Asis",16,0,2,1,182,0,9,0,1,211,0,3,214,234,0.863,0.915
"14597","Cochabamba","Puerto Villarroel","Unidad Educativa Juana Azurduy De Padilla",12,0,0,0,188,0,11,0,2,213,1,3,217,236,0.883,0.919
"14598","Cochabamba","Puerto Villarroel","Unidad Educativa Juana Azurduy De Padilla",4,0,0,0,181,1,16,0,1,203,4,10,217,239,0.892,0.908
"14599","Cochabamba","Puerto Villarroel","Unidad Educativa Juana Azurduy De Padilla",10,0,1,0,189,0,13,0,1,214,2,4,220,237,0.883,0.928
"14600","Cochabamba","Puerto Villarroel","Unidad Educativa Juana Azurduy De Padilla",3,0,0,0,195,1,13,0,0,212,3,5,220,238,0.92,0.924
"14601","Cochabamba","Puerto Villarroel","Unidad Educativa Juana Azurduy De Padilla",4,0,1,0,195,0,17,1,0,218,1,4,223,239,0.894,0.933
"14602","Cochabamba","Puerto Villarroel","Unidad Educativa Juana Azurduy De Padilla",10,0,0,0,181,1,11,0,0,203,2,6,211,232,0.892,0.909
"14603","Cochabamba","Puerto Villarroel","U. E. San Antonio de Padua",9,1,0,0,195,2,11,0,0,218,3,4,225,240,0.894,0.938
"14604","Cochabamba","Puerto Villarroel","U. E. San Antonio de Padua",10,0,2,0,191,0,16,0,1,220,0,1,221,238,0.868,0.929
"14605","Cochabamba","Puerto Villarroel","U. E. San Antonio de Padua",8,0,0,0,201,0,13,0,0,222,5,3,230,240,0.905,0.958
"14606","Cochabamba","Puerto Villarroel","U. E. San Antonio de Padua",10,0,0,0,192,2,11,0,0,215,1,3,219,239,0.893,0.916
"14607","Cochabamba","Puerto Villarroel","U. E. San Antonio de Padua",11,0,0,0,186,0,16,0,0,213,3,7,223,236,0.873,0.945
"14608","Cochabamba","Puerto Villarroel","U. E. San Antonio de Padua",8,1,1,0,185,0,19,0,1,215,0,2,217,238,0.86,0.912
"14609","Cochabamba","Puerto Villarroel","U. E. San Antonio de Padua",17,0,0,0,181,3,8,0,0,209,5,6,220,238,0.866,0.924
"14610","Cochabamba","Puerto Villarroel","U. E. San Antonio de Padua",12,0,0,0,195,0,13,0,0,220,0,4,224,238,0.886,0.941
"14611","Cochabamba","Puerto Villarroel","U. E. San Antonio de Padua",14,0,1,0,183,0,11,0,0,209,2,10,221,239,0.876,0.925
"14612","Cochabamba","Puerto Villarroel","U. E. San Antonio de Padua",5,1,0,2,187,1,11,0,2,209,1,4,214,227,0.895,0.943
"14613","Cochabamba","Puerto Villarroel","Colegio Libertad",2,0,0,0,207,1,6,0,0,216,1,3,220,231,0.958,0.952
"14614","Cochabamba","Puerto Villarroel","Colegio Libertad",6,1,0,0,196,1,8,0,0,212,1,3,216,229,0.925,0.943
"14615","Cochabamba","Puerto Villarroel","Colegio Libertad",4,0,0,1,194,1,7,0,1,208,3,4,215,231,0.933,0.931
"14616","Cochabamba","Puerto Villarroel","Colegio Libertad",3,0,0,0,201,1,9,0,0,214,0,2,216,230,0.939,0.939
"14617","Cochabamba","Puerto Villarroel","Colegio Libertad",4,0,0,0,197,0,15,0,0,216,2,7,225,231,0.912,0.974
"14618","Cochabamba","Puerto Villarroel","Escuela Buenas Nuevas (Valle Ivirza)",1,0,0,0,212,0,6,0,0,219,0,2,221,230,0.968,0.961
"14619","Cochabamba","Puerto Villarroel","Escuela Buenas Nuevas (Valle Ivirza)",5,0,0,0,197,0,6,0,0,208,2,0,210,226,0.947,0.929
"14620","Cochabamba","Puerto Villarroel","Escuela Buenas Nuevas (Valle Ivirza)",3,0,0,0,208,0,5,0,0,216,1,5,222,229,0.963,0.969
"14621","Cochabamba","Puerto Villarroel","Escuela Buenas Nuevas (Valle Ivirza)",5,0,0,1,197,0,2,0,0,205,1,5,211,230,0.961,0.917
"14622","Cochabamba","Puerto Villarroel","Escuela Buenas Nuevas (Valle Ivirza)",1,0,0,0,201,0,3,0,0,205,3,2,210,225,0.98,0.933
"14623","Cochabamba","Puerto Villarroel","Escuela Buenas Nuevas (Valle Ivirza)",5,0,1,0,190,2,5,0,0,203,3,4,210,229,0.936,0.917
"14624","Cochabamba","Puerto Villarroel","Escuela Buenas Nuevas (Valle Ivirza)",5,1,1,1,196,2,5,0,0,211,0,8,219,232,0.929,0.944
"14625","Cochabamba","Puerto Villarroel","Colegio Juan Pablo II (Sacta)",6,1,0,1,205,0,4,1,0,218,3,0,221,232,0.94,0.953
"14626","Cochabamba","Puerto Villarroel","Colegio Juan Pablo II (Sacta)",3,0,0,0,173,0,0,0,0,176,44,0,220,228,0.983,0.965
"14627","Cochabamba","Puerto Villarroel","Colegio Juan Pablo II (Sacta)",2,0,0,0,221,0,4,0,0,227,1,2,230,237,0.974,0.97
"14628","Cochabamba","Puerto Villarroel","Colegio Juan Pablo II (Sacta)",1,0,0,0,206,0,5,0,0,212,2,3,217,225,0.972,0.964
"14629","Cochabamba","Puerto Villarroel","Colegio Juan Pablo II (Sacta)",4,0,0,0,197,0,6,0,0,207,2,2,211,227,0.952,0.93
"14630","Cochabamba","Puerto Villarroel","Colegio Juan Pablo II (Sacta)",5,0,0,1,200,0,4,0,0,210,0,11,221,230,0.952,0.961
"14631","Cochabamba","Puerto Villarroel","Colegio Juan Pablo II (Sacta)",1,0,0,0,211,0,5,0,0,217,1,5,223,230,0.972,0.97
"14632","Cochabamba","Puerto Villarroel","Colegio Juan Pablo II (Sacta)",3,0,0,0,204,0,4,0,0,211,2,1,214,223,0.967,0.96
"14633","Cochabamba","Puerto Villarroel","Colegio Juan Pablo II (Sacta)",2,0,0,0,210,1,6,0,0,219,0,4,223,231,0.959,0.965
"14634","Cochabamba","Puerto Villarroel","Colegio Juan Pablo II (Sacta)",5,0,1,0,203,0,7,0,0,216,0,4,220,229,0.94,0.961
"14635","Cochabamba","Puerto Villarroel","Colegio Juan Pablo II (Sacta)",3,0,0,0,209,0,4,0,0,216,1,6,223,236,0.968,0.945
"14636","Cochabamba","Puerto Villarroel","Colegio Juan Pablo II (Sacta)",4,0,0,0,205,0,6,0,0,215,0,4,219,228,0.953,0.961
"14637","Cochabamba","Puerto Villarroel","Colegio Juan Pablo II (Sacta)",2,0,0,0,207,0,9,0,0,218,0,0,218,226,0.95,0.965
"14638","Cochabamba","Puerto Villarroel","Colegio Juan Pablo II (Sacta)",2,1,0,0,192,1,8,0,0,204,2,6,212,225,0.941,0.942
"14639","Cochabamba","Puerto Villarroel","Colegio Juan Pablo II (Sacta)",4,0,0,0,197,1,7,0,0,209,0,2,211,226,0.943,0.934
"14640","Cochabamba","Puerto Villarroel","Colegio Juan Pablo II (Sacta)",2,0,2,1,212,0,2,0,0,219,2,0,221,233,0.968,0.948
"14641","Cochabamba","Puerto Villarroel","Colegio Juan Pablo II (Sacta)",1,0,0,0,210,0,3,0,1,215,1,1,217,228,0.977,0.952
"14642","Cochabamba","Puerto Villarroel","Colegio Juan Pablo II (Sacta)",5,0,0,0,202,0,10,0,1,218,1,3,222,231,0.927,0.961
"14643","Cochabamba","Puerto Villarroel","Colegio Juan Pablo II (Sacta)",4,0,0,0,202,0,7,0,0,213,0,5,218,233,0.948,0.936
"14644","Cochabamba","Puerto Villarroel","Colegio Juan Pablo II (Sacta)",3,0,0,0,212,0,4,0,0,219,1,2,222,227,0.968,0.978
"14645","Cochabamba","Puerto Villarroel","Colegio Juan Pablo II (Sacta)",5,0,0,0,200,0,6,0,0,211,2,5,218,228,0.948,0.956
"14646","Cochabamba","Puerto Villarroel","Escuela Toribio Claure (V. Hermoso)",7,0,0,0,206,1,3,0,0,217,1,1,219,233,0.949,0.94
"14647","Cochabamba","Puerto Villarroel","Escuela Toribio Claure (V. Hermoso)",3,0,0,0,207,2,5,0,0,217,0,3,220,227,0.954,0.969
"14648","Cochabamba","Puerto Villarroel","Escuela Toribio Claure (V. Hermoso)",2,1,0,0,207,1,5,0,0,216,1,0,217,230,0.958,0.943
"14649","Cochabamba","Puerto Villarroel","Escuela Toribio Claure (V. Hermoso)",2,0,0,0,207,0,4,0,0,213,0,1,214,227,0.972,0.943
"14650","Cochabamba","Puerto Villarroel","Escuela Toribio Claure (V. Hermoso)",2,2,0,1,198,1,5,0,0,209,2,3,214,231,0.947,0.926
"14651","Cochabamba","Puerto Villarroel","Escuela Toribio Claure (V. Hermoso)",2,0,0,0,215,0,1,0,0,218,0,2,220,226,0.986,0.973
"14652","Cochabamba","Puerto Villarroel","Escuela Toribio Claure (V. Hermoso)",5,1,0,2,205,1,2,0,0,216,1,2,219,234,0.949,0.936
"14653","Cochabamba","Puerto Villarroel","Escuela Toribio Claure (V. Hermoso)",5,0,0,0,211,0,5,0,0,221,1,3,225,235,0.955,0.957
"14654","Cochabamba","Puerto Villarroel","Escuela Central Villa Nueva",2,0,0,0,203,0,7,0,0,212,0,3,215,228,0.958,0.943
"14655","Cochabamba","Puerto Villarroel","Escuela Central Villa Nueva",5,0,0,0,206,1,4,0,0,216,1,1,218,231,0.954,0.944
"14656","Cochabamba","Puerto Villarroel","Escuela Central Villa Nueva",0,0,0,0,215,0,6,0,0,221,0,2,223,234,0.973,0.953
"14657","Cochabamba","Puerto Villarroel","Escuela Central Villa Nueva",3,0,0,0,200,0,7,1,0,211,1,1,213,223,0.948,0.955
"14658","Cochabamba","Puerto Villarroel","Colegio Marcelo Quiroga Santa Cruz",5,2,0,0,198,1,4,0,1,211,0,2,213,228,0.938,0.934
"14659","Cochabamba","Puerto Villarroel","Colegio Marcelo Quiroga Santa Cruz",6,1,0,0,200,0,6,0,0,213,3,3,219,233,0.939,0.94
"14660","Cochabamba","Puerto Villarroel","Colegio Marcelo Quiroga Santa Cruz",7,0,0,0,203,0,10,0,0,220,0,1,221,233,0.923,0.948
"14661","Cochabamba","Puerto Villarroel","Colegio Marcelo Quiroga Santa Cruz",2,0,0,0,204,0,5,0,0,211,3,4,218,227,0.967,0.96
"14662","Cochabamba","Puerto Villarroel","Colegio Marcelo Quiroga Santa Cruz",7,0,0,0,197,0,5,0,0,209,1,4,214,227,0.943,0.943
"14663","Cochabamba","Puerto Villarroel","Colegio Marcelo Quiroga Santa Cruz",4,0,0,0,199,2,8,0,0,213,5,5,223,233,0.934,0.957
"14664","Cochabamba","Puerto Villarroel","Colegio Marcelo Quiroga Santa Cruz",5,0,1,0,193,1,10,0,1,211,1,1,213,223,0.915,0.955
"14665","Cochabamba","Puerto Villarroel","Colegio Marcelo Quiroga Santa Cruz",8,0,0,0,195,0,9,1,0,213,2,3,218,232,0.915,0.94
"14666","Cochabamba","Puerto Villarroel","Colegio Marcelo Quiroga Santa Cruz",1,0,0,1,199,2,9,0,0,212,0,3,215,230,0.939,0.935
"14667","Cochabamba","Puerto Villarroel","Colegio Marcelo Quiroga Santa Cruz",2,0,0,0,204,0,8,0,0,214,2,0,216,232,0.953,0.931
"14668","Cochabamba","Puerto Villarroel","Colegio Marcelo Quiroga Santa Cruz",3,0,0,0,199,1,10,0,0,213,2,4,219,231,0.934,0.948
"14669","Cochabamba","Puerto Villarroel","Colegio Marcelo Quiroga Santa Cruz",5,0,0,0,204,0,5,0,0,214,0,2,216,226,0.953,0.956
"14670","Cochabamba","Puerto Villarroel","Escuela Ayopaya (P.Villaroel)",0,0,1,0,194,1,7,1,0,204,1,2,207,229,0.951,0.904
"14671","Cochabamba","Puerto Villarroel","Escuela Ayopaya (P.Villaroel)",1,0,0,0,210,0,4,0,0,215,1,3,219,226,0.977,0.969
"14672","Cochabamba","Puerto Villarroel","Escuela Ayopaya (P.Villaroel)",3,1,0,0,209,0,8,0,0,221,1,2,224,233,0.946,0.961
"14673","Cochabamba","Puerto Villarroel","Escuela Ayopaya (P.Villaroel)",1,0,0,2,209,2,3,0,0,217,0,4,221,232,0.963,0.953
"14674","Cochabamba","Puerto Villarroel","Escuela Ayopaya (P.Villaroel)",4,1,0,0,195,0,9,0,2,211,3,3,217,229,0.924,0.948
"14675","Cochabamba","Puerto Villarroel","Centro Polifuncional Cesarzama",1,2,0,0,218,0,6,1,0,228,2,3,233,233,0.956,1
"14676","Cochabamba","Puerto Villarroel","Escuela Senda 6",1,2,0,0,205,0,8,0,0,216,0,2,218,226,0.949,0.965
"14677","Cochabamba","Puerto Villarroel","Escuela Senda 6",4,1,1,0,201,0,5,0,0,212,2,3,217,228,0.948,0.952
"14678","Cochabamba","Puerto Villarroel","Escuela Senda 6",0,0,0,0,209,0,7,0,0,216,0,2,218,233,0.968,0.936
"14679","Cochabamba","Puerto Villarroel","Escuela Senda 6",3,0,0,0,204,0,2,0,2,211,1,3,215,226,0.967,0.951
"14680","Cochabamba","Puerto Villarroel","Escuela Senda 6",1,0,0,0,211,0,6,0,1,219,0,3,222,233,0.963,0.953
"14681","Cochabamba","Puerto Villarroel","Escuela Senda 6",3,0,0,0,211,1,6,0,0,221,0,1,222,229,0.955,0.969
"14682","Cochabamba","Puerto Villarroel","Escuela Senda 6",6,1,0,0,205,0,1,0,0,213,1,4,218,231,0.962,0.944
"14683","Cochabamba","Puerto Villarroel","Unidad Educativa Valle Tunari",1,0,0,0,220,0,6,0,1,228,0,2,230,235,0.965,0.979
"14684","Cochabamba","Puerto Villarroel","Unidad Educativa Valle Tunari",1,0,0,0,213,0,3,0,0,217,1,6,224,229,0.982,0.978
"14685","Cochabamba","Puerto Villarroel","Unidad Educativa Valle Tunari",2,0,0,0,210,2,2,0,0,216,1,4,221,230,0.972,0.961
"14686","Cochabamba","Puerto Villarroel","Unidad Educativa Valle Tunari",2,0,0,0,210,0,4,0,0,216,1,3,220,233,0.972,0.944
"14687","Cochabamba","Puerto Villarroel","Unidad Educativa Valle Tunari",1,0,0,0,208,0,2,0,0,211,1,1,213,223,0.986,0.955
"14688","Cochabamba","Puerto Villarroel","Unidad Educativa Valle Tunari",3,0,0,0,209,0,5,0,0,217,0,1,218,232,0.963,0.94
"14689","Cochabamba","Puerto Villarroel","Unidad Educativa Valle Tunari",2,0,0,0,205,0,3,0,1,211,0,1,212,226,0.972,0.938
"14690","Cochabamba","Puerto Villarroel","Unidad Educativa Valle Tunari",1,1,0,0,212,0,4,0,0,218,1,0,219,231,0.972,0.948
"14691","Cochabamba","Puerto Villarroel","Unidad Educativa Valle Tunari",2,0,0,0,163,0,5,0,0,170,1,1,172,179,0.959,0.961
"14692","Cochabamba","Puerto Villarroel","Unidad Educativa 2 de Marzo",0,0,0,0,223,0,2,0,0,225,0,0,225,232,0.991,0.97
"14693","Cochabamba","Puerto Villarroel","Unidad Educativa 2 de Marzo",1,0,0,0,222,0,7,0,0,230,1,2,233,236,0.965,0.987
"14694","Cochabamba","Puerto Villarroel","Unidad Educativa 2 de Marzo",1,0,0,0,210,0,3,0,1,215,3,1,219,232,0.977,0.944
"14695","Cochabamba","Puerto Villarroel","Unidad Educativa 2 de Marzo",0,0,0,1,159,0,1,0,0,161,3,0,164,169,0.988,0.97
"14696","Cochabamba","Puerto Villarroel","Unidad Educativa Israel",3,1,0,0,211,0,8,0,0,223,4,1,228,233,0.946,0.979
"14697","Cochabamba","Puerto Villarroel","Unidad Educativa Israel",0,0,0,0,222,0,6,0,0,228,2,2,232,236,0.974,0.983
"14698","Cochabamba","Puerto Villarroel","Unidad Educativa Israel",2,0,0,0,213,0,9,0,0,224,1,4,229,238,0.951,0.962
"14699","Cochabamba","Entre Ríos","Unidad Educativa Rio Blanco",17,0,1,0,158,1,12,0,0,189,3,4,196,232,0.836,0.845
"14700","Cochabamba","Entre Ríos","Unidad Educativa Rio Blanco",7,1,0,0,148,1,18,2,3,180,2,3,185,228,0.822,0.811
"14701","Cochabamba","Entre Ríos","Unidad Educativa Rio Blanco",4,0,1,1,182,1,7,0,0,196,3,4,203,236,0.929,0.86
"14702","Cochabamba","Entre Ríos","Unidad Educativa Rio Blanco",6,0,1,0,183,0,10,0,1,201,1,5,207,235,0.91,0.881
"14703","Cochabamba","Entre Ríos","Unidad Educativa Rio Blanco",1,0,0,0,186,2,7,0,0,196,4,2,202,235,0.949,0.86
"14704","Cochabamba","Entre Ríos","Unidad Educativa Rio Blanco",5,1,0,1,180,0,6,1,1,195,2,2,199,230,0.923,0.865
"14705","Cochabamba","Entre Ríos","Unidad Educativa Rio Blanco",8,0,0,0,184,1,11,0,0,204,3,6,213,233,0.902,0.914
"14706","Cochabamba","Entre Ríos","Unidad Educativa Rio Blanco",14,0,0,0,179,0,6,0,0,199,1,4,204,228,0.899,0.895
"14707","Cochabamba","Entre Ríos","Unidad Educativa Rio Blanco",5,0,0,0,155,0,14,0,1,175,2,10,187,210,0.886,0.89
"14708","Cochabamba","Entre Ríos","U.E. San Marcos",7,0,0,1,191,1,5,0,1,206,3,0,209,230,0.927,0.909
"14709","Cochabamba","Entre Ríos","U.E. San Marcos",8,1,1,0,183,1,14,0,1,209,3,6,218,229,0.876,0.952
"14710","Cochabamba","Entre Ríos","U.E. San Marcos",9,1,0,0,188,0,10,0,0,208,1,2,211,230,0.904,0.917
"14711","Cochabamba","Entre Ríos","U.E. San Marcos",6,0,0,0,189,1,11,0,1,208,1,5,214,225,0.909,0.951
"14712","Cochabamba","Entre Ríos","U.E. San Marcos",6,0,3,0,199,0,10,0,0,218,1,2,221,231,0.913,0.957
"14713","Cochabamba","Entre Ríos","U.E. San Marcos",10,1,0,0,179,1,11,0,0,202,1,4,207,232,0.886,0.892
"14714","Cochabamba","Entre Ríos","U.E. San Marcos",4,0,0,0,188,0,10,0,0,202,2,6,210,227,0.931,0.925
"14715","Cochabamba","Entre Ríos","U.E. San Marcos",10,1,0,0,178,2,10,0,1,202,2,3,207,229,0.881,0.904
"14716","Cochabamba","Entre Ríos","U.E. San Marcos",5,0,0,0,200,1,11,0,1,218,1,5,224,235,0.917,0.953
"14717","Cochabamba","Entre Ríos","U.E. San Marcos",11,0,0,1,180,1,12,0,0,205,3,2,210,231,0.878,0.909
"14718","Cochabamba","Entre Ríos","U.E. San Marcos",10,1,0,0,184,0,15,0,1,211,2,3,216,227,0.872,0.952
"14719","Cochabamba","Entre Ríos","U.E. San Marcos",11,1,0,0,179,0,11,0,0,202,3,7,212,225,0.886,0.942
"14720","Cochabamba","Entre Ríos","U.E. San Marcos",14,0,0,0,182,1,1,0,2,200,1,5,206,231,0.91,0.892
"14721","Cochabamba","Entre Ríos","U.E. San Marcos",10,0,0,0,193,1,4,0,0,208,1,4,213,227,0.928,0.938
"14722","Cochabamba","Entre Ríos","U.E. San Marcos",5,0,1,0,192,2,7,0,1,208,2,3,213,229,0.923,0.93
"14723","Cochabamba","Entre Ríos","U.E. San Marcos",10,1,0,0,180,0,10,0,1,202,2,9,213,224,0.891,0.951
"14724","Cochabamba","Entre Ríos","U.E. San Marcos",11,0,1,0,182,1,10,0,1,206,2,7,215,230,0.883,0.935
"14725","Cochabamba","Entre Ríos","U.E. San Marcos",12,0,2,0,188,1,9,0,1,213,2,3,218,232,0.883,0.94
"14726","Cochabamba","Entre Ríos","U.E. San Marcos",6,0,0,1,177,5,11,0,0,200,5,3,208,229,0.885,0.908
"14727","Cochabamba","Entre Ríos","U.E. San Marcos",6,1,2,0,194,0,6,1,1,211,1,4,216,230,0.919,0.939
"14728","Cochabamba","Entre Ríos","U.E. San Marcos",7,1,1,0,203,0,5,0,0,217,7,2,226,239,0.935,0.946
"14729","Cochabamba","Entre Ríos","Escuela Eduardo Avaroa (Isarzama)",3,0,0,0,202,1,5,0,1,212,1,0,213,225,0.953,0.947
"14730","Cochabamba","Entre Ríos","Escuela Eduardo Avaroa (Isarzama)",1,0,0,0,210,0,2,0,0,213,0,0,213,230,0.986,0.926
"14731","Cochabamba","Entre Ríos","Escuela Eduardo Avaroa (Isarzama)",2,0,1,0,211,1,6,0,0,221,1,1,223,229,0.955,0.974
"14732","Cochabamba","Entre Ríos","Escuela Eduardo Avaroa (Isarzama)",1,0,0,0,206,0,5,0,0,212,2,1,215,225,0.972,0.956
"14733","Cochabamba","Entre Ríos","Escuela Eduardo Avaroa (Isarzama)",5,0,1,0,207,0,3,0,1,217,0,2,219,231,0.954,0.948
"14734","Cochabamba","Entre Ríos","Escuela Eduardo Avaroa (Isarzama)",2,0,1,1,213,2,2,0,0,221,1,3,225,232,0.964,0.97
"14735","Cochabamba","Entre Ríos","Escuela Eduardo Avaroa (Isarzama)",2,0,0,0,210,0,2,0,1,215,0,1,216,229,0.977,0.943
"14736","Cochabamba","Entre Ríos","Escuela Eduardo Avaroa (Isarzama)",1,0,0,0,213,0,2,0,0,216,1,1,218,229,0.986,0.952
"14737","Cochabamba","Entre Ríos","Escuela Eduardo Avaroa (Isarzama)",1,0,1,0,201,2,4,0,0,209,2,2,213,225,0.962,0.947
"14738","Cochabamba","Entre Ríos","Escuela Eduardo Avaroa (Isarzama)",3,0,0,0,204,0,3,0,1,211,0,4,215,230,0.967,0.935
"14739","Cochabamba","Entre Ríos","Colegio Franz Tamayo",7,0,1,0,189,1,14,0,0,212,1,6,219,230,0.892,0.952
"14740","Cochabamba","Entre Ríos","Colegio Franz Tamayo",4,1,0,0,194,1,8,0,0,208,1,2,211,228,0.933,0.925
"14741","Cochabamba","Entre Ríos","Colegio Franz Tamayo",7,1,1,0,181,3,15,1,0,209,3,3,215,228,0.866,0.943
"14742","Cochabamba","Entre Ríos","Colegio Franz Tamayo",13,0,1,0,188,3,4,0,0,209,1,4,214,231,0.9,0.926
"14743","Cochabamba","Entre Ríos","Colegio Franz Tamayo",13,0,0,0,187,0,12,0,0,212,1,5,218,233,0.882,0.936
"14744","Cochabamba","Entre Ríos","Colegio Franz Tamayo",4,1,0,1,181,0,14,0,0,201,5,3,209,231,0.9,0.905
"14745","Cochabamba","Entre Ríos","Colegio Franz Tamayo",6,0,0,0,182,1,22,0,0,211,2,3,216,230,0.863,0.939
"14746","Cochabamba","Entre Ríos","Colegio Franz Tamayo",5,1,1,0,186,2,8,0,0,203,2,5,210,232,0.916,0.905
"14747","Cochabamba","Entre Ríos","Colegio Franz Tamayo",4,0,1,0,198,2,6,1,2,214,2,3,219,231,0.925,0.948
"14748","Cochabamba","Entre Ríos","Colegio Franz Tamayo",4,1,0,0,176,1,16,0,0,198,1,6,205,228,0.889,0.899
"14749","Cochabamba","Entre Ríos","Colegio Franz Tamayo",10,0,0,0,188,3,13,0,0,214,3,2,219,231,0.879,0.948
"14750","Cochabamba","Entre Ríos","Colegio Franz Tamayo",3,1,0,0,203,3,6,0,1,217,0,0,217,227,0.935,0.956
"14751","Cochabamba","Entre Ríos","Colegio Franz Tamayo",2,0,0,1,189,2,18,0,0,212,0,3,215,228,0.892,0.943
"14752","Cochabamba","Entre Ríos","Colegio Franz Tamayo",6,1,0,0,186,1,12,0,1,207,2,4,213,234,0.899,0.91
"14753","Cochabamba","Entre Ríos","Colegio Franz Tamayo",6,1,0,0,177,1,18,0,0,203,3,2,208,230,0.872,0.904
"14754","Cochabamba","Entre Ríos","Colegio Franz Tamayo",4,1,0,0,189,2,13,0,0,209,1,1,211,226,0.904,0.934
"14755","Cochabamba","Entre Ríos","Colegio Franz Tamayo",8,0,0,1,180,1,16,0,0,206,2,6,214,227,0.874,0.943
"14756","Cochabamba","Entre Ríos","Colegio Franz Tamayo",6,0,0,0,199,1,9,0,0,215,1,2,218,229,0.926,0.952
"14757","Cochabamba","Entre Ríos","Colegio Franz Tamayo",2,1,0,0,195,2,10,0,1,211,1,3,215,234,0.924,0.919
"14758","Cochabamba","Entre Ríos","Colegio Franz Tamayo",8,0,0,0,173,2,23,0,0,206,0,4,210,225,0.84,0.933
"14759","Cochabamba","Entre Ríos","Colegio Franz Tamayo",9,0,0,0,184,0,8,1,0,202,3,5,210,231,0.911,0.909
"14760","Cochabamba","Entre Ríos","Colegio Franz Tamayo",6,1,1,0,189,0,18,0,1,216,0,5,221,236,0.875,0.936
"14761","Cochabamba","Entre Ríos","Colegio Franz Tamayo",2,0,1,0,192,1,12,0,0,208,3,4,215,232,0.923,0.927
"14762","Cochabamba","Entre Ríos","Colegio Franz Tamayo",8,2,0,0,175,4,8,0,0,197,3,8,208,231,0.888,0.9
"14763","Cochabamba","Entre Ríos","Colegio Franz Tamayo",9,0,0,0,184,0,8,0,1,202,4,3,209,230,0.911,0.909
"14764","Cochabamba","Entre Ríos","Colegio Franz Tamayo",11,0,2,0,178,1,7,0,0,199,2,3,204,224,0.894,0.911
"14765","Cochabamba","Entre Ríos","Colegio Franz Tamayo",8,0,0,0,194,1,7,0,0,210,1,0,211,230,0.924,0.917
"14766","Cochabamba","Entre Ríos","Colegio Franz Tamayo",15,1,1,0,178,1,9,0,1,206,1,5,212,228,0.864,0.93
"14767","Cochabamba","Entre Ríos","Colegio Franz Tamayo",12,0,0,0,175,1,12,1,0,201,3,7,211,226,0.871,0.934
"14768","Cochabamba","Entre Ríos","Colegio Franz Tamayo",8,0,0,0,180,1,15,0,0,204,3,4,211,230,0.882,0.917
"14769","Cochabamba","Entre Ríos","Colegio Franz Tamayo",10,0,1,1,186,1,9,0,2,210,1,4,215,236,0.886,0.911
"14770","Cochabamba","Entre Ríos","Colegio Franz Tamayo",12,1,1,0,184,0,11,0,0,209,0,4,213,230,0.88,0.926
"14771","Cochabamba","Entre Ríos","Colegio Franz Tamayo",12,1,0,0,197,1,4,0,0,215,0,1,216,230,0.916,0.939
"14772","Cochabamba","Entre Ríos","Colegio Franz Tamayo",4,0,0,0,176,1,12,0,1,194,2,6,202,232,0.907,0.871
"14773","Cochabamba","Entre Ríos","Colegio Franz Tamayo",4,1,1,1,195,1,5,0,0,208,1,8,217,235,0.938,0.923
"14774","Cochabamba","Entre Ríos","Colegio Franz Tamayo",7,0,0,0,187,1,9,0,0,204,4,2,210,227,0.917,0.925
"14775","Cochabamba","Entre Ríos","Colegio Franz Tamayo",11,0,2,0,185,1,7,0,0,206,1,7,214,230,0.898,0.93
"14776","Cochabamba","Entre Ríos","Colegio Franz Tamayo",4,0,0,0,186,1,19,0,2,212,1,5,218,229,0.877,0.952
"14777","Cochabamba","Entre Ríos","Colegio Franz Tamayo",6,0,0,1,196,0,8,0,1,212,0,6,218,234,0.925,0.932
"14778","Cochabamba","Entre Ríos","Colegio Franz Tamayo",7,0,0,0,190,2,9,0,1,209,2,3,214,235,0.909,0.911
"14779","Cochabamba","Entre Ríos","Colegio Franz Tamayo",8,1,0,0,184,0,12,0,0,205,4,1,210,233,0.898,0.901
"14780","Cochabamba","Entre Ríos","Colegio Franz Tamayo",8,0,0,0,178,3,8,0,0,197,0,3,200,224,0.904,0.893
"14781","Cochabamba","Entre Ríos","Colegio Franz Tamayo",4,0,0,0,190,0,12,0,1,207,1,7,215,235,0.918,0.915
"14782","Cochabamba","Entre Ríos","U. E. José Carrasco (Manco Kapac)",0,0,0,0,215,2,4,0,0,221,1,2,224,235,0.973,0.953
"14783","Cochabamba","Entre Ríos","U. E. José Carrasco (Manco Kapac)",2,0,1,0,217,0,5,0,0,225,0,2,227,234,0.964,0.97
"14784","Cochabamba","Entre Ríos","U. E. José Carrasco (Manco Kapac)",5,0,1,0,210,0,8,2,0,226,1,0,227,235,0.929,0.966
"14785","Cochabamba","Entre Ríos","U. E. José Carrasco (Manco Kapac)",4,0,0,0,209,0,5,0,0,218,1,3,222,235,0.959,0.945
"14786","Cochabamba","Entre Ríos","U. E. José Carrasco (Manco Kapac)",1,0,0,0,216,1,2,0,0,220,2,2,224,233,0.982,0.961
"14787","Cochabamba","Entre Ríos","U. E. José Carrasco (Manco Kapac)",5,0,0,0,201,0,10,0,1,217,3,4,224,231,0.926,0.97
"14788","Cochabamba","Entre Ríos","U. E. José Carrasco (Manco Kapac)",3,1,0,0,212,1,8,0,0,225,0,1,226,234,0.942,0.966
"14789","Cochabamba","Entre Ríos","U. E. José Carrasco (Manco Kapac)",6,0,0,0,205,0,3,0,0,214,3,5,222,234,0.958,0.949
"14790","Cochabamba","Entre Ríos","U. E. José Carrasco (Manco Kapac)",1,0,0,0,207,1,3,0,0,212,2,3,217,233,0.976,0.931
"14791","Cochabamba","Entre Ríos","U. E. José Carrasco (Manco Kapac)",4,0,1,0,214,1,4,0,0,224,2,3,229,240,0.955,0.954
"14792","Cochabamba","Entre Ríos","U. E. José Carrasco (Manco Kapac)",3,0,1,0,212,0,2,0,0,218,1,3,222,233,0.972,0.953
"14793","Cochabamba","Entre Ríos","U. E. José Carrasco (Manco Kapac)",4,0,0,0,206,0,3,2,0,215,2,6,223,236,0.958,0.945
"14794","Cochabamba","Entre Ríos","U. E. José Carrasco (Manco Kapac)",1,0,0,0,215,0,3,0,0,219,1,1,221,233,0.982,0.948
"14795","Cochabamba","Entre Ríos","U. E. José Carrasco (Manco Kapac)",4,0,1,0,211,0,8,0,0,224,1,2,227,234,0.942,0.97
"14796","Cochabamba","Entre Ríos","U. E. José Carrasco (Manco Kapac)",3,0,0,0,214,0,4,0,0,221,2,4,227,236,0.968,0.962
"14797","Cochabamba","Entre Ríos","U. E. José Carrasco (Manco Kapac)",3,1,0,1,205,1,4,0,1,216,2,5,223,231,0.949,0.965
"14798","Cochabamba","Entre Ríos","U. E. José Carrasco (Manco Kapac)",4,0,0,0,199,2,7,0,0,212,0,7,219,227,0.939,0.965
"14799","Cochabamba","Entre Ríos","U.E. Nacional Ayacucho",18,0,0,0,183,2,12,0,4,219,2,6,227,239,0.836,0.95
"14800","Cochabamba","Entre Ríos","U.E. Nacional Ayacucho",12,0,0,0,186,3,13,0,0,214,1,4,219,239,0.869,0.916
"14801","Cochabamba","Entre Ríos","U.E. Nacional Ayacucho",18,0,0,0,171,1,25,0,0,215,0,7,222,237,0.795,0.937
"14802","Cochabamba","Entre Ríos","U.E. Nacional Ayacucho",22,0,1,1,182,4,7,0,2,219,0,1,220,239,0.831,0.921
"14803","Cochabamba","Entre Ríos","U.E. Esteban Arce",1,1,1,0,223,0,3,0,0,229,0,1,230,237,0.974,0.97
"14804","Cochabamba","Entre Ríos","U.E. Chancadora",1,0,0,0,220,0,7,1,0,229,2,1,232,238,0.961,0.975
"14805","Cochabamba","Entre Ríos","U.E. Chancadora",3,0,0,0,224,1,3,0,0,231,1,2,234,239,0.97,0.979
"14806","Cochabamba","Entre Ríos","U.E. Chancadora",2,0,0,1,170,1,3,0,0,177,1,1,179,184,0.96,0.973
"14807","Cochabamba","Mizque","Colegio Pedro Ignacio Rivero",35,2,0,1,128,8,7,0,0,181,6,8,195,222,0.707,0.878
"14808","Cochabamba","Mizque","Colegio Pedro Ignacio Rivero",15,4,0,0,148,3,17,0,0,187,5,8,200,230,0.791,0.87
"14809","Cochabamba","Mizque","Colegio Pedro Ignacio Rivero",25,1,1,1,128,4,13,0,1,174,5,7,186,221,0.736,0.842
"14810","Cochabamba","Mizque","Colegio Pedro Ignacio Rivero",42,1,1,0,124,3,13,0,0,184,9,6,199,225,0.674,0.884
"14811","Cochabamba","Mizque","Colegio Pedro Ignacio Rivero",41,0,1,0,114,3,21,0,0,180,4,11,195,227,0.633,0.859
"14812","Cochabamba","Mizque","Colegio Pedro Ignacio Rivero",28,0,1,0,136,2,15,0,0,182,6,6,194,219,0.747,0.886
"14813","Cochabamba","Mizque","Colegio Pedro Ignacio Rivero",34,2,1,0,129,2,12,1,1,182,4,17,203,227,0.709,0.894
"14814","Cochabamba","Mizque","Colegio Pedro Ignacio Rivero",33,0,0,0,129,2,13,2,0,179,5,8,192,222,0.721,0.865
"14815","Cochabamba","Mizque","Colegio Pedro Ignacio Rivero",22,1,3,0,141,2,14,0,1,184,3,12,199,223,0.766,0.892
"14816","Cochabamba","Mizque","Colegio Pedro Ignacio Rivero",46,3,0,0,112,4,9,1,0,175,5,11,191,220,0.64,0.868
"14817","Cochabamba","Mizque","Colegio Pedro Ignacio Rivero",57,2,1,0,109,2,15,1,0,187,8,5,200,225,0.583,0.889
"14818","Cochabamba","Mizque","Colegio Pedro Ignacio Rivero",31,2,0,0,140,1,8,0,0,182,2,10,194,218,0.769,0.89
"14819","Cochabamba","Mizque","Colegio Pedro Ignacio Rivero",52,2,1,0,114,4,11,1,1,186,4,9,199,228,0.613,0.873
"14820","Cochabamba","Mizque","Colegio Pedro Ignacio Rivero",39,1,2,1,126,3,13,2,1,188,3,12,203,222,0.67,0.914
"14821","Cochabamba","Mizque","Colegio Pedro Ignacio Rivero",38,0,1,0,123,2,12,0,0,176,5,11,192,216,0.699,0.889
"14822","Cochabamba","Mizque","Colegio Pedro Ignacio Rivero",40,2,2,1,107,1,15,2,0,170,2,17,189,219,0.629,0.863
"14823","Cochabamba","Mizque","Colegio Pedro Ignacio Rivero",31,0,0,0,118,3,18,0,0,170,5,9,184,215,0.694,0.856
"14824","Cochabamba","Mizque","Colegio Pedro Ignacio Rivero",29,0,0,0,143,5,8,0,0,185,3,6,194,222,0.773,0.874
"14825","Cochabamba","Mizque","Colegio Pedro Ignacio Rivero",36,1,0,1,123,3,12,0,1,177,1,14,192,222,0.695,0.865
"14826","Cochabamba","Mizque","Colegio Pedro Ignacio Rivero",44,0,2,1,120,3,11,0,1,182,4,6,192,219,0.659,0.877
"14827","Cochabamba","Mizque","Colegio Pedro Ignacio Rivero",44,2,0,0,118,2,16,1,1,184,1,15,200,227,0.641,0.881
"14828","Cochabamba","Mizque","Colegio Pedro Ignacio Rivero",41,0,1,0,117,5,15,0,3,182,5,12,199,224,0.643,0.888
"14829","Cochabamba","Mizque","Colegio Pedro Ignacio Rivero",49,1,0,0,149,0,7,2,0,208,2,10,220,223,0.716,0.987
"14830","Cochabamba","Mizque","Colegio Pedro Ignacio Rivero",40,0,0,1,116,2,14,0,0,173,5,7,185,215,0.671,0.86
"14831","Cochabamba","Mizque","Colegio Pedro Ignacio Rivero",29,1,1,2,130,3,11,0,0,177,7,11,195,221,0.734,0.882
"14832","Cochabamba","Mizque","Sede Social De Tipa Tipa",11,0,1,0,159,0,6,1,1,179,8,6,193,220,0.888,0.877
"14833","Cochabamba","Mizque","Sede Social De Tipa Tipa",6,1,1,0,149,4,3,0,0,164,10,3,177,204,0.909,0.868
"14834","Cochabamba","Mizque","Escuela Mixta Dr. Martin Cardenas",14,1,1,2,133,2,36,4,2,195,9,10,214,232,0.682,0.922
"14835","Cochabamba","Mizque","Escuela Mixta Dr. Martin Cardenas",10,1,1,1,148,1,38,0,0,200,4,13,217,229,0.74,0.948
"14836","Cochabamba","Mizque","Escuela Mixta Dr. Martin Cardenas",12,4,1,1,134,2,47,0,1,202,7,6,215,232,0.663,0.927
"14837","Cochabamba","Mizque","Escuela Mixta Dr. Martin Cardenas",11,0,1,0,132,3,51,0,1,199,8,12,219,233,0.663,0.94
"14838","Cochabamba","Mizque","Escuela Mixta Dr. Martin Cardenas",19,2,0,2,133,6,39,0,0,201,4,7,212,232,0.662,0.914
"14839","Cochabamba","Mizque","Escuela Guillermo Viscarra",7,1,0,0,198,0,5,0,0,211,1,3,215,228,0.938,0.943
"14840","Cochabamba","Mizque","Escuela Guillermo Viscarra",4,0,0,1,183,3,5,0,0,196,2,2,200,218,0.934,0.917
"14841","Cochabamba","Mizque","Escuela Guillermo Viscarra",2,0,0,0,167,1,6,0,0,176,2,10,188,204,0.949,0.922
"14842","Cochabamba","Mizque","Unidad Educativa Tin Tin",19,2,1,0,142,0,16,0,0,180,8,4,192,215,0.789,0.893
"14843","Cochabamba","Mizque","Unidad Educativa Tin Tin",16,1,1,1,121,1,14,1,0,156,9,6,171,207,0.776,0.826
"14844","Cochabamba","Mizque","Unidad Educativa Tin Tin",17,3,0,0,128,2,12,2,0,164,7,3,174,202,0.78,0.861
"14845","Cochabamba","Mizque","Nucleo José Claure (U. E. San Vicente)",4,3,2,0,160,2,3,0,0,174,14,6,194,218,0.92,0.89
"14846","Cochabamba","Mizque","Escuela Aguada",5,1,0,0,159,0,4,1,1,171,2,8,181,205,0.93,0.883
"14847","Cochabamba","Mizque","Escuela Aguada",6,1,0,1,166,0,4,0,1,179,5,3,187,217,0.927,0.862
"14848","Cochabamba","Mizque","Escuela Aguada",2,0,0,0,168,0,6,0,0,176,7,7,190,223,0.955,0.852
"14849","Cochabamba","Mizque","Unidad Educativa Cauta",3,3,0,1,154,1,1,0,0,163,6,6,175,179,0.945,0.978
"14850","Cochabamba","Mizque","Sede Central Campesina (Kuri)",5,0,0,0,186,1,8,2,0,202,3,5,210,226,0.921,0.929
"14851","Cochabamba","Mizque","Unidad Educativa Thago Thago",8,0,1,0,180,1,0,0,1,191,3,4,198,228,0.942,0.868
"14852","Cochabamba","Mizque","Unidad Educativa Thago Thago",5,3,0,0,185,2,3,1,1,200,9,6,215,228,0.925,0.943
"14853","Cochabamba","Mizque","Sede Sindical De Chahuarani Chico",3,0,2,0,188,1,3,0,0,197,3,10,210,231,0.954,0.909
"14854","Cochabamba","Vila Vila","Escuela Humberto Nogales",6,0,0,1,161,1,1,2,0,172,8,12,192,210,0.936,0.914
"14855","Cochabamba","Vila Vila","Escuela Humberto Nogales",4,0,0,1,183,1,2,0,0,191,4,11,206,215,0.958,0.958
"14856","Cochabamba","Vila Vila","Escuela Humberto Nogales",7,0,2,0,179,0,4,0,0,192,4,12,208,214,0.932,0.972
"14857","Cochabamba","Vila Vila","Nucleo Escolar Siquimira",0,0,2,0,209,1,2,0,0,214,0,2,216,227,0.977,0.952
"14858","Cochabamba","Vila Vila","Nucleo Escolar Siquimira",0,0,1,0,192,1,6,0,0,200,0,18,218,238,0.96,0.916
"14859","Cochabamba","Vila Vila","Nucleo Escolar Sivingani",7,3,0,0,155,0,1,2,0,168,13,15,196,216,0.923,0.907
"14860","Cochabamba","Alalay","U. E. Abraham Flores Velasquez",3,0,1,1,164,3,9,0,0,181,0,4,185,214,0.906,0.864
"14861","Cochabamba","Alalay","U. E. Abraham Flores Velasquez",3,0,0,0,172,1,6,0,0,182,0,4,186,204,0.945,0.912
"14862","Cochabamba","Alalay","Unidad Educativa Yana Khakha",0,1,0,2,166,0,0,0,0,169,6,11,186,219,0.982,0.849
"14863","Cochabamba","Alalay","Escuela Dr. Demetrio Canelas",7,1,1,0,163,2,9,0,0,183,2,11,196,218,0.891,0.899
"14864","Cochabamba","Alalay","Escuela Dr. Demetrio Canelas",7,2,0,0,146,1,10,2,0,168,8,10,186,211,0.869,0.882
"14865","Cochabamba","Alalay","Unidad Educativa Quturi",3,0,0,0,176,2,7,0,0,188,3,7,198,215,0.936,0.921
"14866","Cochabamba","Raqaypampa","Unidad Educativa Molinero",3,2,0,0,148,0,6,1,0,160,26,13,199,231,0.925,0.861
"14867","Cochabamba","Raqaypampa","Nucleo Escolar Laguna Grande",4,3,1,0,180,1,1,1,0,191,4,6,201,225,0.942,0.893
"14868","Cochabamba","Raqaypampa","Nucleo Escolar Laguna Grande",4,4,2,1,177,0,0,1,0,189,4,10,203,230,0.937,0.883
"14869","Cochabamba","Raqaypampa","Nucleo Escolar Laguna Grande",2,2,0,0,160,1,1,2,2,170,10,17,197,225,0.941,0.876
"14870","Cochabamba","Raqaypampa","Nucleo Escolar Laguna Grande",2,4,2,1,168,2,2,3,1,185,7,15,207,229,0.908,0.904
"14871","Cochabamba","Raqaypampa","Nucleo Escolar Beta Raqay Pampa",3,1,1,0,184,0,0,1,0,190,4,5,199,216,0.968,0.921
"14872","Cochabamba","Raqaypampa","Nucleo Escolar Beta Raqay Pampa",2,2,1,1,179,1,4,1,0,191,0,6,197,221,0.937,0.891
"14873","Cochabamba","Raqaypampa","Nucleo Escolar Beta Raqay Pampa",0,1,1,1,190,0,2,0,0,195,0,7,202,225,0.974,0.898
"14874","Cochabamba","Raqaypampa","Nucleo Escolar Beta Raqay Pampa",1,1,1,0,192,0,2,1,0,198,4,2,204,223,0.97,0.915
"14875","Cochabamba","Raqaypampa","Nucleo Escolar Beta Raqay Pampa",1,2,0,0,186,0,2,2,0,193,2,6,201,223,0.964,0.901
"14876","Cochabamba","Raqaypampa","Nucleo Escolar Beta Raqay Pampa",0,0,0,0,191,0,0,0,0,191,0,15,206,223,1,0.924
"14877","Cochabamba","Raqaypampa","Nucleo Centro Salvia",0,0,0,2,179,1,1,1,0,184,4,5,193,218,0.973,0.885
"14878","Cochabamba","Raqaypampa","Unidad Educativa Santiago",0,0,0,0,215,1,0,0,0,216,0,2,218,231,0.995,0.944
"14879","Cochabamba","Punata","Escuela Adela Zamudio",49,0,1,0,113,2,9,0,0,174,3,13,190,218,0.649,0.872
"14880","Cochabamba","Punata","Escuela Adela Zamudio",57,0,0,0,96,2,6,0,4,165,6,8,179,215,0.582,0.833
"14881","Cochabamba","Punata","Escuela Adela Zamudio",41,2,1,2,118,0,7,0,1,172,1,8,181,222,0.686,0.815
"14882","Cochabamba","Punata","Escuela Adela Zamudio",53,1,0,0,105,3,15,1,0,178,5,8,191,219,0.59,0.872
"14883","Cochabamba","Punata","Escuela Adela Zamudio",47,0,0,1,131,4,21,0,1,205,0,11,216,231,0.639,0.935
"14884","Cochabamba","Punata","Escuela Adela Zamudio",49,0,0,0,117,2,21,1,0,190,4,7,201,226,0.616,0.889
"14885","Cochabamba","Punata","Escuela Adela Zamudio",53,0,0,0,104,2,19,0,0,178,4,15,197,218,0.584,0.904
"14886","Cochabamba","Punata","Escuela Adela Zamudio",65,0,1,0,88,0,17,0,1,172,3,8,183,221,0.512,0.828
"14887","Cochabamba","Punata","Escuela Adela Zamudio",46,0,0,0,133,0,15,0,2,196,2,9,207,233,0.679,0.888
"14888","Cochabamba","Punata","Escuela Adela Zamudio",59,0,0,0,111,4,17,0,4,195,3,4,202,228,0.569,0.886
"14889","Cochabamba","Punata","Escuela Adela Zamudio",56,1,0,0,107,3,22,1,0,190,0,12,202,222,0.563,0.91
"14890","Cochabamba","Punata","Escuela Adela Zamudio",44,0,1,0,117,1,18,1,1,183,6,10,199,225,0.639,0.884
"14891","Cochabamba","Punata","Escuela Adela Zamudio",52,0,0,0,112,4,19,0,1,188,2,4,194,220,0.596,0.882
"14892","Cochabamba","Punata","Escuela Adela Zamudio",61,0,1,2,106,4,11,0,1,186,2,7,195,225,0.57,0.867
"14893","Cochabamba","Punata","Escuela Adela Zamudio",64,0,1,0,96,2,6,3,2,174,4,11,189,219,0.552,0.863
"14894","Cochabamba","Punata","Escuela Adela Zamudio",48,0,0,0,110,3,15,1,3,180,1,16,197,224,0.611,0.879
"14895","Cochabamba","Punata","Escuela Adela Zamudio",62,1,2,1,115,1,11,1,1,195,3,5,203,227,0.59,0.894
"14896","Cochabamba","Punata","Escuela Adela Zamudio",58,1,0,0,116,2,8,0,1,186,1,7,194,224,0.624,0.866
"14897","Cochabamba","Punata","Escuela Adela Zamudio",43,1,0,0,125,3,16,0,2,190,2,9,201,221,0.658,0.91
"14898","Cochabamba","Punata","Escuela Adela Zamudio",41,0,0,0,128,3,15,0,2,189,2,8,199,229,0.677,0.869
"14899","Cochabamba","Punata","Escuela Adela Zamudio",44,3,1,0,122,1,16,1,1,189,4,6,199,229,0.646,0.869
"14900","Cochabamba","Punata","Escuela Adela Zamudio",46,1,0,1,112,5,17,0,1,183,1,7,191,222,0.612,0.86
"14901","Cochabamba","Punata","Escuela Adela Zamudio",77,1,0,0,89,1,12,0,1,181,1,6,188,212,0.492,0.887
"14902","Cochabamba","Punata","Escuela Adela Zamudio",53,0,0,0,88,2,16,0,2,161,3,32,196,222,0.547,0.883
"14903","Cochabamba","Punata","Escuela Adela Zamudio",47,1,1,0,118,1,15,0,1,184,4,8,196,228,0.641,0.86
"14904","Cochabamba","Punata","Escuela Adela Zamudio",52,2,0,2,111,4,19,0,1,191,2,7,200,226,0.581,0.885
"14905","Cochabamba","Punata","Escuela Andres Maria Torrico",43,0,0,0,117,3,22,0,1,186,2,8,196,221,0.629,0.887
"14906","Cochabamba","Punata","Escuela Andres Maria Torrico",46,0,0,0,117,3,20,0,0,186,4,10,200,223,0.629,0.897
"14907","Cochabamba","Punata","Escuela Andres Maria Torrico",52,0,1,0,113,3,16,1,1,187,1,6,194,222,0.604,0.874
"14908","Cochabamba","Punata","Escuela Andres Maria Torrico",41,1,1,0,126,3,20,1,2,195,1,6,202,229,0.646,0.882
"14909","Cochabamba","Punata","Escuela Andres Maria Torrico",60,0,1,0,108,3,24,0,0,196,1,9,206,226,0.551,0.912
"14910","Cochabamba","Punata","Escuela Andres Maria Torrico",36,0,1,0,126,2,24,0,1,190,3,8,201,232,0.663,0.866
"14911","Cochabamba","Punata","Escuela Andres Maria Torrico",60,0,0,0,97,2,13,0,1,173,4,19,196,227,0.561,0.863
"14912","Cochabamba","Punata","Escuela Andres Maria Torrico",51,3,0,0,118,1,25,0,1,199,2,5,206,226,0.593,0.912
"14913","Cochabamba","Punata","Escuela Andres Maria Torrico",43,1,0,0,117,2,21,0,1,185,3,10,198,223,0.632,0.888
"14914","Cochabamba","Punata","Escuela Andres Maria Torrico",38,0,0,0,118,2,25,0,1,184,1,5,190,225,0.641,0.844
"14915","Cochabamba","Punata","Escuela Andres Maria Torrico",51,1,2,0,115,1,23,1,0,194,5,3,202,229,0.593,0.882
"14916","Cochabamba","Punata","Escuela Andres Maria Torrico",49,0,0,1,113,4,14,0,3,184,6,2,192,226,0.614,0.85
"14917","Cochabamba","Punata","Escuela Andres Maria Torrico",39,2,0,0,119,2,18,0,1,181,2,6,189,227,0.657,0.833
"14918","Cochabamba","Punata","Escuela Andres Maria Torrico",31,0,0,0,131,1,29,0,1,193,1,11,205,230,0.679,0.891
"14919","Cochabamba","Punata","Escuela Andres Maria Torrico",34,0,0,0,137,2,16,0,0,189,2,10,201,224,0.725,0.897
"14920","Cochabamba","Punata","Escuela Andres Maria Torrico",38,1,0,1,116,2,37,0,1,196,2,7,205,230,0.592,0.891
"14921","Cochabamba","Punata","Escuela Andres Maria Torrico",45,0,0,0,112,3,18,0,1,179,0,11,190,226,0.626,0.841
"14922","Cochabamba","Punata","Escuela Andres Maria Torrico",60,0,0,1,97,0,20,0,0,178,2,18,198,228,0.545,0.868
"14923","Cochabamba","Punata","Escuela Andres Maria Torrico",37,1,1,0,140,1,18,0,0,198,4,11,213,232,0.707,0.918
"14924","Cochabamba","Punata","Escuela Andres Maria Torrico",45,0,1,0,119,0,23,0,0,188,2,6,196,223,0.633,0.879
"14925","Cochabamba","Punata","U. E. Manuel A. Villarroel (Ex Bolivar)",43,0,0,0,113,2,12,0,3,173,5,14,192,217,0.653,0.885
"14926","Cochabamba","Punata","U. E. Manuel A. Villarroel (Ex Bolivar)",58,1,0,0,117,2,11,0,1,190,1,4,195,217,0.616,0.899
"14927","Cochabamba","Punata","U. E. Manuel A. Villarroel (Ex Bolivar)",48,2,1,0,108,1,16,1,1,178,4,11,193,218,0.607,0.885
"14928","Cochabamba","Punata","U. E. Manuel A. Villarroel (Ex Bolivar)",53,0,1,0,110,1,17,0,1,183,2,11,196,221,0.601,0.887
"14929","Cochabamba","Punata","U. E. Manuel A. Villarroel (Ex Bolivar)",45,1,2,0,108,4,14,0,1,175,3,9,187,223,0.617,0.839
"14930","Cochabamba","Punata","U. E. Manuel A. Villarroel (Ex Bolivar)",49,1,0,1,117,0,14,0,0,182,1,9,192,217,0.643,0.885
"14931","Cochabamba","Punata","U. E. Manuel A. Villarroel (Ex Bolivar)",42,0,0,1,106,0,21,0,0,170,3,10,183,218,0.624,0.839
"14932","Cochabamba","Punata","U. E. Manuel A. Villarroel (Ex Bolivar)",54,0,1,0,108,2,12,1,0,178,5,8,191,220,0.607,0.868
"14933","Cochabamba","Punata","U. E. Manuel A. Villarroel (Ex Bolivar)",52,1,0,1,114,3,19,0,0,190,1,6,197,230,0.6,0.857
"14934","Cochabamba","Punata","U. E. Manuel A. Villarroel (Ex Bolivar)",50,1,2,1,107,2,17,0,0,180,1,13,194,226,0.594,0.858
"14935","Cochabamba","Punata","U. E. Manuel A. Villarroel (Ex Bolivar)",58,0,1,0,108,1,12,0,3,183,1,11,195,229,0.59,0.852
"14936","Cochabamba","Punata","U. E. Manuel A. Villarroel (Ex Bolivar)",54,0,0,0,110,3,15,1,1,184,1,8,193,218,0.598,0.885
"14937","Cochabamba","Punata","U. E. Manuel A. Villarroel (Ex Bolivar)",55,1,0,0,106,0,22,0,2,186,1,6,193,214,0.57,0.902
"14938","Cochabamba","Punata","U. E. Manuel A. Villarroel (Ex Bolivar)",64,0,1,0,98,0,13,0,1,177,2,15,194,223,0.554,0.87
"14939","Cochabamba","Punata","U. E. Manuel A. Villarroel (Ex Bolivar)",42,0,0,1,122,1,15,0,0,181,3,9,193,223,0.674,0.865
"14940","Cochabamba","Punata","U. E. Manuel A. Villarroel (Ex Bolivar)",44,0,0,0,129,1,8,0,1,183,0,10,193,218,0.705,0.885
"14941","Cochabamba","Punata","U. E. Manuel A. Villarroel (Ex Bolivar)",54,0,1,0,125,4,11,0,1,196,1,9,206,224,0.638,0.92
"14942","Cochabamba","Punata","U. E. Manuel A. Villarroel (Ex Bolivar)",61,0,0,0,104,2,19,0,1,187,2,8,197,228,0.556,0.864
"14943","Cochabamba","Punata","U. E. Manuel A. Villarroel (Ex Bolivar)",91,0,1,1,74,4,16,0,2,189,0,7,196,220,0.392,0.891
"14944","Cochabamba","Punata","U. E. Manuel A. Villarroel (Ex Bolivar)",43,0,0,1,108,0,19,0,2,173,8,15,196,225,0.624,0.871
"14945","Cochabamba","Punata","U. E. Manuel A. Villarroel (Ex Bolivar)",69,1,1,0,89,2,16,1,3,182,6,14,202,224,0.489,0.902
"14946","Cochabamba","Punata","U. E. Ruben Ferrufino (Camacho Rancho)",27,0,0,0,134,2,9,2,1,175,5,8,188,213,0.766,0.883
"14947","Cochabamba","Punata","U. E. Ruben Ferrufino (Camacho Rancho)",25,0,0,0,142,2,17,0,2,188,3,5,196,217,0.755,0.903
"14948","Cochabamba","Punata","U. E. Ruben Ferrufino (Camacho Rancho)",27,0,3,1,142,2,11,0,0,186,5,9,200,225,0.763,0.889
"14949","Cochabamba","Punata","U. E. Ruben Ferrufino (Camacho Rancho)",27,0,0,1,145,4,6,1,0,184,8,9,201,222,0.788,0.905
"14950","Cochabamba","Punata","Unidad Educativa Tajamar",38,0,0,2,109,3,8,1,1,162,8,11,181,216,0.673,0.838
"14951","Cochabamba","Punata","Unidad Educativa Tajamar",48,0,0,1,125,1,5,1,1,182,6,15,203,227,0.687,0.894
"14952","Cochabamba","Punata","Unidad Educativa Tajamar",36,1,0,1,116,8,7,1,0,170,11,14,195,223,0.682,0.874
"14953","Cochabamba","Punata","Unidad Educativa Tajamar",38,0,1,0,126,1,7,0,2,175,3,15,193,218,0.72,0.885
"14954","Cochabamba","Punata","Unidad Educativa Mayor Rocha (Yacanahuyo",32,1,0,0,137,2,8,0,0,180,7,17,204,226,0.761,0.903
"14955","Cochabamba","Punata","Unidad Educativa Mayor Rocha (Yacanahuyo",42,0,0,0,112,1,17,0,1,173,7,12,192,220,0.647,0.873
"14956","Cochabamba","Punata","Unidad Educativa Mayor Rocha (Yacanahuyo",33,0,0,0,140,1,8,0,0,182,6,10,198,223,0.769,0.888
"14957","Cochabamba","Punata","Unidad Educativa Mayor Rocha (Yacanahuyo",22,0,1,0,142,0,9,2,1,177,11,18,206,228,0.802,0.904
"14958","Cochabamba","Punata","Sede Sindical Thaco",15,0,4,0,147,2,21,1,1,191,7,6,204,228,0.77,0.895
"14959","Cochabamba","Punata","Sede Sindical Thaco",13,2,0,0,156,3,10,0,1,185,9,5,199,225,0.843,0.884
"14960","Cochabamba","Punata","Sede Sindical Thaco",20,0,2,0,151,4,14,0,1,192,3,9,204,227,0.786,0.899
"14961","Cochabamba","Punata","Liceo Josefa M. Gandarillas (Ex Sucre)",44,0,1,0,123,2,13,0,1,184,4,7,195,227,0.668,0.859
"14962","Cochabamba","Punata","Liceo Josefa M. Gandarillas (Ex Sucre)",60,0,1,1,100,3,16,0,2,183,4,12,199,228,0.546,0.873
"14963","Cochabamba","Punata","Liceo Josefa M. Gandarillas (Ex Sucre)",66,0,3,0,101,1,18,0,1,190,2,15,207,227,0.532,0.912
"14964","Cochabamba","Punata","Liceo Josefa M. Gandarillas (Ex Sucre)",45,0,0,0,124,0,23,0,2,194,6,7,207,232,0.639,0.892
"14965","Cochabamba","Punata","Liceo Josefa M. Gandarillas (Ex Sucre)",66,2,1,1,104,0,12,1,1,188,9,14,211,233,0.553,0.906
"14966","Cochabamba","Punata","Liceo Josefa M. Gandarillas (Ex Sucre)",57,1,0,1,100,6,20,0,2,187,1,10,198,232,0.535,0.853
"14967","Cochabamba","Punata","Liceo Josefa M. Gandarillas (Ex Sucre)",59,1,0,0,115,1,10,1,2,189,1,10,200,228,0.608,0.877
"14968","Cochabamba","Punata","Liceo Josefa M. Gandarillas (Ex Sucre)",67,1,1,0,100,3,14,0,2,188,0,9,197,224,0.532,0.879
"14969","Cochabamba","Punata","Liceo Josefa M. Gandarillas (Ex Sucre)",50,0,0,0,108,4,20,1,0,183,1,15,199,232,0.59,0.858
"14970","Cochabamba","Punata","Liceo Josefa M. Gandarillas (Ex Sucre)",39,0,1,0,128,1,23,0,1,193,3,10,206,230,0.663,0.896
"14971","Cochabamba","Punata","Liceo Josefa M. Gandarillas (Ex Sucre)",64,0,0,0,99,2,16,0,5,186,2,11,199,223,0.532,0.892
"14972","Cochabamba","Punata","Liceo Josefa M. Gandarillas (Ex Sucre)",52,0,1,0,101,4,22,0,4,184,2,10,196,230,0.549,0.852
"14973","Cochabamba","Punata","Liceo Josefa M. Gandarillas (Ex Sucre)",61,1,1,0,90,1,30,0,1,185,1,12,198,227,0.486,0.872
"14974","Cochabamba","Punata","Liceo Josefa M. Gandarillas (Ex Sucre)",57,0,0,0,110,2,22,1,2,194,2,10,206,230,0.567,0.896
"14975","Cochabamba","Punata","Liceo Josefa M. Gandarillas (Ex Sucre)",44,1,0,1,123,5,11,1,1,187,2,17,206,234,0.658,0.88
"14976","Cochabamba","Punata","Liceo Josefa M. Gandarillas (Ex Sucre)",50,2,2,0,115,0,21,0,1,191,4,8,203,232,0.602,0.875
"14977","Cochabamba","Punata","Liceo Josefa M. Gandarillas (Ex Sucre)",58,0,0,0,121,1,15,0,1,196,3,5,204,230,0.617,0.887
"14978","Cochabamba","Punata","Liceo Josefa M. Gandarillas (Ex Sucre)",66,2,1,0,103,2,9,0,0,183,2,9,194,225,0.563,0.862
"14979","Cochabamba","Punata","Liceo Josefa M. Gandarillas (Ex Sucre)",55,0,0,1,111,1,17,1,3,189,0,8,197,232,0.587,0.849
"14980","Cochabamba","Punata","Liceo Josefa M. Gandarillas (Ex Sucre)",60,1,0,0,105,3,10,0,1,180,7,7,194,228,0.583,0.851
"14981","Cochabamba","Punata","Unidad Educativa Tambillo Chico",17,1,0,0,160,1,19,0,2,200,1,4,205,233,0.8,0.88
"14982","Cochabamba","Punata","Unidad Educativa Tambillo Chico",18,1,1,0,149,3,10,0,1,183,6,16,205,229,0.814,0.895
"14983","Cochabamba","Punata","U. E. Rene Barrientos O. - La Villa",10,0,0,1,137,1,11,1,0,161,4,8,173,203,0.851,0.852
"14984","Cochabamba","Punata","Unidad Educativa Molle Huma",9,3,0,1,162,4,10,0,2,191,3,6,200,226,0.848,0.885
"14985","Cochabamba","Punata","Unidad Educativa Molle Huma",4,1,2,1,168,0,8,0,0,184,4,5,193,214,0.913,0.902
"14986","Cochabamba","Punata","Unidad Educativa Molle Huma",12,2,4,1,153,3,7,1,1,184,7,8,199,224,0.832,0.888
"14987","Cochabamba","Villa Rivero","Escuela Gualberto Villarroel (V. Rivero)",36,0,0,0,131,1,8,0,2,178,5,6,189,217,0.736,0.871
"14988","Cochabamba","Villa Rivero","Escuela Gualberto Villarroel (V. Rivero)",37,2,1,0,127,0,5,0,2,174,2,11,187,217,0.73,0.862
"14989","Cochabamba","Villa Rivero","Escuela Gualberto Villarroel (V. Rivero)",47,0,1,1,114,3,12,5,1,184,3,6,193,218,0.62,0.885
"14990","Cochabamba","Villa Rivero","Escuela Gualberto Villarroel (V. Rivero)",40,3,0,0,109,4,18,1,1,176,2,5,183,212,0.619,0.863
"14991","Cochabamba","Villa Rivero","Escuela Gualberto Villarroel (V. Rivero)",32,1,0,0,125,3,11,0,0,172,6,6,184,215,0.727,0.856
"14992","Cochabamba","Villa Rivero","Escuela Gualberto Villarroel (V. Rivero)",38,1,0,0,121,3,12,0,1,176,2,2,180,218,0.688,0.826
"14993","Cochabamba","Villa Rivero","Escuela Gualberto Villarroel (V. Rivero)",24,1,2,2,122,0,14,3,0,168,6,11,185,220,0.726,0.841
"14994","Cochabamba","Villa Rivero","Col. Tec. Ind. Comunitario Marcelo Quiroga",6,1,0,0,159,1,11,0,0,178,0,15,193,224,0.893,0.862
"14995","Cochabamba","Villa Rivero","Col. Tec. Ind. Comunitario Marcelo Quiroga",7,1,0,0,142,1,21,0,0,172,4,5,181,222,0.826,0.815
"14996","Cochabamba","Villa Rivero","Col. Tec. Ind. Comunitario Marcelo Quiroga",10,0,1,0,160,1,20,0,1,193,3,7,203,225,0.829,0.902
"14997","Cochabamba","Villa Rivero","Col. Tec. Ind. Comunitario Marcelo Quiroga",7,0,0,0,170,1,13,0,0,191,5,6,202,232,0.89,0.871
"14998","Cochabamba","Villa Rivero","Col. Tec. Ind. Comunitario Marcelo Quiroga",5,0,0,0,158,1,14,1,1,180,1,2,183,222,0.878,0.824
"14999","Cochabamba","Villa Rivero","Col. Tec. Ind. Comunitario Marcelo Quiroga",3,1,1,0,145,2,8,0,1,161,5,11,177,214,0.901,0.827
"15000","Cochabamba","Villa Rivero","Col. Tec. Ind. Comunitario Marcelo Quiroga",9,0,1,0,146,2,17,0,1,176,1,3,180,217,0.83,0.829
"15001","Cochabamba","Villa Rivero","Col. Tec. Ind. Comunitario Marcelo Quiroga",8,0,3,0,150,0,12,0,0,173,2,3,178,215,0.867,0.828
"15002","Cochabamba","Villa Rivero","Col. Tec. Ind. Comunitario Marcelo Quiroga",6,0,1,0,149,4,9,0,0,169,5,3,177,218,0.882,0.812
"15003","Cochabamba","Villa Rivero","Col. Tec. Ind. Comunitario Marcelo Quiroga",7,0,1,0,158,1,8,0,0,175,3,6,184,214,0.903,0.86
"15004","Cochabamba","Villa Rivero","Col. Tec. Ind. Comunitario Marcelo Quiroga",6,1,1,0,171,1,6,1,0,187,1,5,193,225,0.914,0.858
"15005","Cochabamba","Villa Rivero","Unidad Educativa Martín Cárdenas Hermoso",6,1,0,0,182,1,4,2,0,196,5,12,213,235,0.929,0.906
"15006","Cochabamba","Villa Rivero","Unidad Educativa Martín Cárdenas Hermoso",11,1,0,0,174,0,10,0,0,196,5,7,208,231,0.888,0.9
"15007","Cochabamba","San Benito (Villa José Quintín Mendoza)","U. E. 27 de Mayo (Ex Jose B. Pereira)",26,0,0,1,136,4,10,1,0,178,5,11,194,224,0.764,0.866
"15008","Cochabamba","San Benito (Villa José Quintín Mendoza)","U. E. 27 de Mayo (Ex Jose B. Pereira)",57,0,1,1,107,2,17,1,3,189,4,9,202,227,0.566,0.89
"15009","Cochabamba","San Benito (Villa José Quintín Mendoza)","U. E. 27 de Mayo (Ex Jose B. Pereira)",30,2,0,0,123,3,17,0,0,175,2,7,184,222,0.703,0.829
"15010","Cochabamba","San Benito (Villa José Quintín Mendoza)","U. E. 27 de Mayo (Ex Jose B. Pereira)",25,0,1,1,140,0,14,0,2,183,2,13,198,232,0.765,0.853
"15011","Cochabamba","San Benito (Villa José Quintín Mendoza)","U. E. 27 de Mayo (Ex Jose B. Pereira)",43,1,1,0,126,1,17,0,0,189,3,4,196,225,0.667,0.871
"15012","Cochabamba","San Benito (Villa José Quintín Mendoza)","U. E. 27 de Mayo (Ex Jose B. Pereira)",31,0,0,0,121,3,23,0,0,178,4,6,188,215,0.68,0.874
"15013","Cochabamba","San Benito (Villa José Quintín Mendoza)","U. E. 27 de Mayo (Ex Jose B. Pereira)",24,0,1,1,150,2,18,0,1,197,1,7,205,230,0.761,0.891
"15014","Cochabamba","San Benito (Villa José Quintín Mendoza)","U. E. 27 de Mayo (Ex Jose B. Pereira)",41,1,0,0,123,2,14,0,1,182,8,12,202,227,0.676,0.89
"15015","Cochabamba","San Benito (Villa José Quintín Mendoza)","U. E. 27 de Mayo (Ex Jose B. Pereira)",38,0,1,0,132,0,23,0,1,195,1,6,202,229,0.677,0.882
"15016","Cochabamba","San Benito (Villa José Quintín Mendoza)","U. E. 27 de Mayo (Ex Jose B. Pereira)",49,0,3,2,122,2,16,0,0,194,1,5,200,228,0.629,0.877
"15017","Cochabamba","San Benito (Villa José Quintín Mendoza)","U. E. 27 de Mayo (Ex Jose B. Pereira)",39,1,0,1,108,5,17,0,3,174,6,6,186,219,0.621,0.849
"15018","Cochabamba","San Benito (Villa José Quintín Mendoza)","U. E. 27 de Mayo (Ex Jose B. Pereira)",36,0,0,0,134,2,14,1,1,188,3,5,196,224,0.713,0.875
"15019","Cochabamba","San Benito (Villa José Quintín Mendoza)","U. E. 27 de Mayo (Ex Jose B. Pereira)",35,1,0,0,115,1,20,0,1,173,1,14,188,224,0.665,0.839
"15020","Cochabamba","San Benito (Villa José Quintín Mendoza)","U. E. 27 de Mayo (Ex Jose B. Pereira)",31,0,1,0,126,4,25,1,2,190,0,9,199,221,0.663,0.9
"15021","Cochabamba","San Benito (Villa José Quintín Mendoza)","U. E. 27 de Mayo (Ex Jose B. Pereira)",47,0,0,3,102,2,16,0,0,170,4,5,179,217,0.6,0.825
"15022","Cochabamba","San Benito (Villa José Quintín Mendoza)","U. E. 27 de Mayo (Ex Jose B. Pereira)",34,0,0,0,141,2,18,0,0,195,1,9,205,216,0.723,0.949
"15023","Cochabamba","San Benito (Villa José Quintín Mendoza)","U. E. 27 de Mayo (Ex Jose B. Pereira)",44,1,0,1,117,2,10,1,0,176,0,15,191,217,0.665,0.88
"15024","Cochabamba","San Benito (Villa José Quintín Mendoza)","Colegio Simon Bolivar (Huaricaya)",44,1,0,2,120,2,12,0,0,181,3,10,194,222,0.663,0.874
"15025","Cochabamba","San Benito (Villa José Quintín Mendoza)","Colegio Simon Bolivar (Huaricaya)",47,2,2,0,133,1,9,0,3,197,1,3,201,220,0.675,0.914
"15026","Cochabamba","San Benito (Villa José Quintín Mendoza)","Colegio Simon Bolivar (Huaricaya)",39,1,0,0,139,1,11,1,0,192,3,6,201,226,0.724,0.889
"15027","Cochabamba","San Benito (Villa José Quintín Mendoza)","Colegio Simon Bolivar (Huaricaya)",30,1,1,2,153,0,10,1,1,199,3,4,206,227,0.769,0.907
"15028","Cochabamba","San Benito (Villa José Quintín Mendoza)","Colegio Simon Bolivar (Huaricaya)",37,1,2,0,130,8,12,1,1,192,3,5,200,220,0.677,0.909
"15029","Cochabamba","San Benito (Villa José Quintín Mendoza)","Unidad Educativa Sunchu Pampa",10,1,0,0,172,0,4,1,0,188,3,2,193,218,0.915,0.885
"15030","Cochabamba","San Benito (Villa José Quintín Mendoza)","Unidad Educativa Sunchu Pampa",19,1,1,0,146,1,12,0,0,180,5,4,189,213,0.811,0.887
"15031","Cochabamba","San Benito (Villa José Quintín Mendoza)","Unidad Educativa Sunchu Pampa",32,1,0,1,135,1,3,1,2,176,3,4,183,220,0.767,0.832
"15032","Cochabamba","San Benito (Villa José Quintín Mendoza)","Unidad Educativa Sunchu Pampa",17,1,2,0,139,2,7,1,1,170,2,3,175,206,0.818,0.85
"15033","Cochabamba","San Benito (Villa José Quintín Mendoza)","Escuela Experimental Paracaya",35,1,0,0,124,1,32,0,2,195,6,3,204,227,0.636,0.899
"15034","Cochabamba","San Benito (Villa José Quintín Mendoza)","Escuela Experimental Paracaya",31,1,0,0,148,0,20,1,0,201,1,6,208,226,0.736,0.92
"15035","Cochabamba","San Benito (Villa José Quintín Mendoza)","Escuela Experimental Paracaya",15,1,0,1,166,5,17,0,0,205,3,5,213,230,0.81,0.926
"15036","Cochabamba","San Benito (Villa José Quintín Mendoza)","Escuela Experimental Paracaya",24,0,2,0,158,4,6,0,0,194,3,8,205,223,0.814,0.919
"15037","Cochabamba","San Benito (Villa José Quintín Mendoza)","Escuela Experimental Paracaya",21,0,0,0,135,1,20,0,0,177,2,9,188,217,0.763,0.866
"15038","Cochabamba","San Benito (Villa José Quintín Mendoza)","Escuela Experimental Paracaya",30,0,0,0,137,6,14,0,1,188,4,7,199,223,0.729,0.892
"15039","Cochabamba","San Benito (Villa José Quintín Mendoza)","Escuela Experimental Paracaya",38,4,0,2,130,2,22,0,0,198,1,7,206,227,0.657,0.907
"15040","Cochabamba","San Benito (Villa José Quintín Mendoza)","Escuela Experimental Paracaya",19,0,0,1,166,3,8,1,0,198,3,4,205,222,0.838,0.923
"15041","Cochabamba","San Benito (Villa José Quintín Mendoza)","Escuela Experimental Paracaya",37,0,0,0,139,2,12,0,1,191,2,5,198,223,0.728,0.888
"15042","Cochabamba","San Benito (Villa José Quintín Mendoza)","Escuela Experimental Paracaya",30,4,1,0,136,3,26,0,0,200,2,7,209,231,0.68,0.905
"15043","Cochabamba","San Benito (Villa José Quintín Mendoza)","Escuela Experimental Paracaya",36,2,4,0,139,0,21,0,4,206,1,4,211,229,0.675,0.921
"15044","Cochabamba","San Benito (Villa José Quintín Mendoza)","Escuela Experimental Paracaya",39,0,2,0,136,1,21,0,1,200,1,3,204,224,0.68,0.911
"15045","Cochabamba","San Benito (Villa José Quintín Mendoza)","Escuela Experimental Paracaya",28,0,0,0,154,1,14,1,1,199,3,4,206,222,0.774,0.928
"15046","Cochabamba","San Benito (Villa José Quintín Mendoza)","Unidad Educativa Wañakahua",20,3,0,1,146,3,20,0,1,194,6,8,208,226,0.753,0.92
"15047","Cochabamba","San Benito (Villa José Quintín Mendoza)","Unidad Educativa Wañakahua",24,1,0,0,166,0,14,0,1,206,6,8,220,241,0.806,0.913
"15048","Cochabamba","Tacachi","Unidad Educativa Tacachi",30,0,0,2,133,2,13,1,1,182,2,6,190,215,0.731,0.884
"15049","Cochabamba","Tacachi","Unidad Educativa Tacachi",40,4,0,0,114,2,15,1,0,176,6,9,191,219,0.648,0.872
"15050","Cochabamba","Villa Gualberto Villarroel","Escuela Cuchu Muela",22,1,0,1,151,3,12,0,0,190,3,9,202,219,0.795,0.922
"15051","Cochabamba","Villa Gualberto Villarroel","Escuela Cuchu Muela",26,0,1,0,152,1,13,2,0,195,5,7,207,217,0.779,0.954
"15052","Cochabamba","Villa Gualberto Villarroel","Escuela Cuchu Muela",32,0,0,0,136,6,10,1,0,185,5,8,198,218,0.735,0.908
"15053","Cochabamba","Villa Gualberto Villarroel","Nucleo Escolar Yana Rumi",0,1,2,0,174,1,8,0,0,186,4,6,196,212,0.935,0.925
"15054","Cochabamba","Bolivar","Escuela Simon Bolivar",19,3,2,0,141,4,7,3,1,180,9,8,197,221,0.783,0.891
"15055","Cochabamba","Bolivar","Escuela Simon Bolivar",23,2,0,1,120,3,16,4,3,172,12,7,191,216,0.698,0.884
"15056","Cochabamba","Bolivar","Escuela Simon Bolivar",19,2,0,0,122,2,10,0,3,158,13,13,184,206,0.772,0.893
"15057","Cochabamba","Bolivar","Unidad Educativa Challoma",5,0,2,1,122,2,32,1,0,165,2,6,173,199,0.739,0.869
"15058","Cochabamba","Bolivar","Escuela Vilacayma",4,3,3,1,147,2,18,1,2,181,5,14,200,219,0.812,0.913
"15059","Cochabamba","Bolivar","Escuela Mejillones",8,3,2,2,136,5,16,2,1,175,2,22,199,216,0.777,0.921
"15060","Cochabamba","Bolivar","Escuela Mejillones",6,4,3,1,140,5,13,2,1,175,8,16,199,225,0.8,0.884
"15061","Cochabamba","Bolivar","Nucleo Escolar Carpani",3,3,2,1,151,2,20,0,2,184,7,22,213,219,0.821,0.973
"15062","Cochabamba","Bolivar","Nucleo Escolar Carpani",7,1,1,0,159,3,9,1,2,183,9,10,202,221,0.869,0.914
"15063","Cochabamba","Bolivar","Escuela Yarvicoya",1,0,3,0,166,1,2,0,2,175,7,6,188,212,0.949,0.887
"15064","Cochabamba","Bolivar","Escuela Tangalique",3,1,0,2,185,3,12,0,1,207,1,12,220,223,0.894,0.987
"15065","Cochabamba","Bolivar","Unidad Educativa Vilapampa",3,5,6,1,157,4,24,3,0,203,4,11,218,225,0.773,0.969
"15066","Cochabamba","Bolivar","Escuela Jorenko Villa Verde",3,4,1,2,154,1,19,2,1,187,8,20,215,223,0.824,0.964
"15067","Cochabamba","Bolivar","Escuela Jorenko Villa Verde",2,0,3,2,145,3,16,0,3,174,4,7,185,198,0.833,0.934
"15068","Cochabamba","Tiraque","Colegio Juan Jose Carrasco",16,2,0,0,143,1,20,1,0,183,4,10,197,220,0.781,0.895
"15069","Cochabamba","Tiraque","Colegio Juan Jose Carrasco",13,0,1,0,149,4,15,0,2,184,3,5,192,224,0.81,0.857
"15070","Cochabamba","Tiraque","Colegio Juan Jose Carrasco",9,2,2,0,160,1,15,2,1,192,5,7,204,222,0.833,0.919
"15071","Cochabamba","Tiraque","Colegio Juan Jose Carrasco",14,1,0,0,165,0,22,0,2,204,6,3,213,232,0.809,0.918
"15072","Cochabamba","Tiraque","Colegio Juan Jose Carrasco",9,0,0,0,156,2,17,1,1,186,4,8,198,222,0.839,0.892
"15073","Cochabamba","Tiraque","Colegio Juan Jose Carrasco",16,0,1,1,145,3,26,0,0,192,1,13,206,228,0.755,0.904
"15074","Cochabamba","Tiraque","Colegio Juan Jose Carrasco",6,3,1,0,155,2,12,1,1,181,11,6,198,221,0.856,0.896
"15075","Cochabamba","Tiraque","Colegio Juan Jose Carrasco",7,1,1,1,156,8,15,0,0,189,2,4,195,220,0.825,0.886
"15076","Cochabamba","Tiraque","Colegio Juan Jose Carrasco",8,1,0,0,163,2,16,0,0,190,1,8,199,225,0.858,0.884
"15077","Cochabamba","Tiraque","Colegio Juan Jose Carrasco",5,0,0,0,169,1,16,1,1,193,6,4,203,225,0.876,0.902
"15078","Cochabamba","Tiraque","Colegio Juan Jose Carrasco",11,3,1,1,144,2,21,0,3,186,6,14,206,224,0.774,0.92
"15079","Cochabamba","Tiraque","Colegio Juan Jose Carrasco",8,3,0,1,147,3,10,1,1,174,2,14,190,215,0.845,0.884
"15080","Cochabamba","Tiraque","Colegio Juan Jose Carrasco",6,1,0,0,157,5,15,1,0,185,6,10,201,224,0.849,0.897
"15081","Cochabamba","Tiraque","Colegio Juan Jose Carrasco",7,2,0,0,160,3,15,1,0,188,6,13,207,227,0.851,0.912
"15082","Cochabamba","Tiraque","Colegio Juan Jose Carrasco",5,2,0,0,175,2,14,1,0,199,4,7,210,227,0.879,0.925
"15083","Cochabamba","Tiraque","Colegio Juan Jose Carrasco",2,3,1,0,163,5,16,0,0,190,12,7,209,226,0.858,0.925
"15084","Cochabamba","Tiraque","Colegio Juan Jose Carrasco",6,2,0,0,161,0,18,0,2,189,11,6,206,225,0.852,0.916
"15085","Cochabamba","Tiraque","Colegio Juan Jose Carrasco",10,0,0,0,154,1,14,3,0,182,4,6,192,224,0.846,0.857
"15086","Cochabamba","Tiraque","Colegio Juan Jose Carrasco",11,0,0,0,168,2,13,0,0,194,2,9,205,225,0.866,0.911
"15087","Cochabamba","Tiraque","Colegio Juan Jose Carrasco",20,3,1,1,136,4,15,1,1,182,5,7,194,223,0.747,0.87
"15088","Cochabamba","Tiraque","Colegio Juan Jose Carrasco",14,1,0,0,144,5,21,0,1,186,6,7,199,224,0.774,0.888
"15089","Cochabamba","Tiraque","Colegio Juan Jose Carrasco",7,0,0,1,155,4,13,0,0,180,3,7,190,218,0.861,0.872
"15090","Cochabamba","Tiraque","Colegio Juan Jose Carrasco",8,0,0,0,154,1,23,0,3,189,2,11,202,224,0.815,0.902
"15091","Cochabamba","Tiraque","Colegio Juan Jose Carrasco",18,1,0,0,163,2,20,2,0,206,2,4,212,227,0.791,0.934
"15092","Cochabamba","Tiraque","Colegio Juan Jose Carrasco",14,2,0,2,172,3,7,0,0,200,2,5,207,224,0.86,0.924
"15093","Cochabamba","Tiraque","Colegio Juan Jose Carrasco",8,1,0,0,149,3,21,0,3,185,8,9,202,223,0.805,0.906
"15094","Cochabamba","Tiraque","Colegio Juan Jose Carrasco",13,2,0,1,146,3,16,1,0,182,7,6,195,217,0.802,0.899
"15095","Cochabamba","Tiraque","Colegio Juan Jose Carrasco",15,0,2,1,147,5,13,2,2,187,3,10,200,224,0.786,0.893
"15096","Cochabamba","Tiraque","Escuela Koari (Nucleo Esc. S. Bolivar)",1,1,1,0,170,0,4,0,1,178,4,5,187,212,0.955,0.882
"15097","Cochabamba","Tiraque","Escuela Koari (Nucleo Esc. S. Bolivar)",1,1,0,0,170,1,4,0,0,177,1,7,185,215,0.96,0.86
"15098","Cochabamba","Tiraque","Escuela Koari (Nucleo Esc. S. Bolivar)",0,0,0,1,168,0,6,0,0,175,8,5,188,218,0.96,0.862
"15099","Cochabamba","Tiraque","Escuela Koari (Nucleo Esc. S. Bolivar)",0,0,0,0,175,0,5,0,0,180,1,6,187,219,0.972,0.854
"15100","Cochabamba","Tiraque","Escuela Seccional Sacabambilla",3,1,0,1,171,3,8,1,1,189,3,9,201,223,0.905,0.901
"15101","Cochabamba","Tiraque","Escuela Seccional Sacabambilla",5,0,0,1,183,3,5,0,0,197,0,6,203,222,0.929,0.914
"15102","Cochabamba","Tiraque","Nucleo Escolar Iluri Grande",3,0,0,0,173,1,8,1,0,186,4,8,198,221,0.93,0.896
"15103","Cochabamba","Tiraque","Nucleo Escolar Iluri Grande",1,2,1,0,166,1,3,2,0,176,2,8,186,210,0.943,0.886
"15104","Cochabamba","Tiraque","Nucleo Escolar Iluri Grande",2,0,0,0,197,0,3,0,0,202,5,5,212,216,0.975,0.981
"15105","Cochabamba","Tiraque","Escuela Seccional Pairumani",1,2,1,1,188,0,7,0,0,200,3,3,206,225,0.94,0.916
"15106","Cochabamba","Tiraque","Escuela Seccional Pairumani",0,1,0,0,182,0,5,0,0,188,2,4,194,222,0.968,0.874
"15107","Cochabamba","Tiraque","Escuela Seccional Pairumani",4,1,1,0,177,1,10,1,0,195,3,12,210,227,0.908,0.925
"15108","Cochabamba","Tiraque","Escuela Seccional Pairumani",1,1,1,0,154,0,2,1,0,160,5,1,166,179,0.963,0.927
"15109","Cochabamba","Tiraque","Escuela Cotani Bajo",8,0,0,0,177,1,14,0,1,201,2,4,207,223,0.881,0.928
"15110","Cochabamba","Tiraque","Escuela Cotani Bajo",1,0,0,1,178,1,7,0,1,189,5,11,205,219,0.942,0.936
"15111","Cochabamba","Tiraque","Escuela Cotani Bajo",1,0,1,0,184,2,6,0,0,194,0,8,202,218,0.948,0.927
"15112","Cochabamba","Tiraque","Escuela Cotani Bajo",2,1,0,0,198,0,13,1,1,216,9,4,229,244,0.917,0.939
"15113","Cochabamba","Tiraque","Unidad Educativa 3 de Agosto",2,0,0,0,194,1,7,0,0,204,0,1,205,220,0.951,0.932
"15114","Cochabamba","Tiraque","Unidad Educativa 3 de Agosto",0,0,0,0,170,1,4,0,1,176,0,6,182,189,0.966,0.963
"15115","Cochabamba","Tiraque","Unidad Educativa Rodeo",3,0,2,2,175,2,13,0,0,197,4,13,214,224,0.888,0.955
"15116","Cochabamba","Tiraque","U.E. Boqueron K`Asa",0,1,0,0,203,0,6,0,0,210,6,7,223,239,0.967,0.933
"15117","Cochabamba","Tiraque","U.E. Boqueron K`Asa",1,1,0,0,179,1,7,1,1,191,16,11,218,236,0.937,0.924
"15118","Cochabamba","Tiraque","U.E. Boqueron K`Asa",0,2,1,2,201,2,3,1,0,212,6,6,224,238,0.948,0.941
"15119","Cochabamba","Tiraque","U. E. Luis Espinal Camps",3,4,1,0,194,0,8,1,0,211,8,5,224,230,0.919,0.974
"15120","Cochabamba","Shinahota","Escuela German Busch",18,0,0,0,156,0,13,0,0,187,5,5,197,219,0.834,0.9
"15121","Cochabamba","Shinahota","Escuela German Busch",20,1,1,1,150,1,19,0,2,195,2,7,204,225,0.769,0.907
"15122","Cochabamba","Shinahota","Escuela German Busch",14,0,1,0,157,1,13,1,0,187,1,5,193,223,0.84,0.865
"15123","Cochabamba","Shinahota","Escuela German Busch",18,2,1,1,152,2,13,0,1,190,3,12,205,227,0.8,0.903
"15124","Cochabamba","Shinahota","Escuela German Busch",22,0,1,0,165,1,11,1,1,202,2,2,206,230,0.817,0.896
"15125","Cochabamba","Shinahota","Escuela German Busch",14,1,0,0,159,0,22,0,1,197,1,4,202,224,0.807,0.902
"15126","Cochabamba","Shinahota","Escuela German Busch",13,0,0,0,165,1,16,0,4,199,5,3,207,223,0.829,0.928
"15127","Cochabamba","Shinahota","Escuela German Busch",12,0,1,0,163,1,14,0,0,191,2,10,203,224,0.853,0.906
"15128","Cochabamba","Shinahota","Escuela German Busch",16,0,0,3,164,1,10,0,2,196,2,6,204,226,0.837,0.903
"15129","Cochabamba","Shinahota","Escuela German Busch",12,0,0,0,162,1,26,0,0,201,0,3,204,222,0.806,0.919
"15130","Cochabamba","Shinahota","Escuela German Busch",22,0,0,1,161,1,16,0,3,204,2,5,211,227,0.789,0.93
"15131","Cochabamba","Shinahota","Escuela German Busch",22,1,0,1,154,1,10,0,0,189,1,9,199,221,0.815,0.9
"15132","Cochabamba","Shinahota","Escuela German Busch",25,0,1,0,144,5,26,0,2,203,0,6,209,225,0.709,0.929
"15133","Cochabamba","Shinahota","Escuela German Busch",27,0,0,0,147,1,9,0,0,184,3,7,194,221,0.799,0.878
"15134","Cochabamba","Shinahota","Escuela German Busch",27,1,0,0,152,3,14,1,1,199,1,5,205,224,0.764,0.915
"15135","Cochabamba","Shinahota","Escuela German Busch",11,1,0,0,168,1,19,0,1,201,1,1,203,227,0.836,0.894
"15136","Cochabamba","Shinahota","Escuela German Busch",14,0,1,0,145,3,21,0,0,184,3,3,190,215,0.788,0.884
"15137","Cochabamba","Shinahota","Escuela German Busch",21,1,0,0,152,1,10,2,0,187,5,6,198,220,0.813,0.9
"15138","Cochabamba","Shinahota","Escuela German Busch",24,0,0,0,151,0,16,2,0,193,0,6,199,223,0.782,0.892
"15139","Cochabamba","Shinahota","Escuela German Busch",25,3,0,0,146,1,14,0,1,190,0,6,196,225,0.768,0.871
"15140","Cochabamba","Shinahota","Escuela German Busch",9,0,1,1,167,0,10,0,3,191,2,9,202,221,0.874,0.914
"15141","Cochabamba","Shinahota","Escuela German Busch",12,1,1,0,163,3,10,0,1,191,2,7,200,220,0.853,0.909
"15142","Cochabamba","Shinahota","Escuela German Busch",14,2,0,0,162,2,13,1,0,194,2,5,201,222,0.835,0.905
"15143","Cochabamba","Shinahota","Escuela German Busch",24,0,0,0,140,3,11,1,0,179,3,16,198,228,0.782,0.868
"15144","Cochabamba","Shinahota","Escuela German Busch",19,1,0,1,154,3,15,0,0,193,2,4,199,222,0.798,0.896
"15145","Cochabamba","Shinahota","Escuela German Busch",22,0,0,0,166,0,12,0,0,200,1,4,205,227,0.83,0.903
"15146","Cochabamba","Shinahota","Escuela German Busch",16,0,0,0,157,1,10,1,1,186,1,5,192,222,0.844,0.865
"15147","Cochabamba","Shinahota","Escuela German Busch",6,0,0,2,158,1,10,0,1,178,2,5,185,210,0.888,0.881
"15148","Cochabamba","Shinahota","U.E. Mariscal Sucre",14,0,0,0,175,0,19,0,0,208,0,9,217,237,0.841,0.916
"15149","Cochabamba","Shinahota","U.E. Mariscal Sucre",10,1,1,0,187,0,15,0,2,216,3,2,221,237,0.866,0.932
"15150","Cochabamba","Shinahota","U.E. Mariscal Sucre",12,1,1,0,169,3,17,0,0,203,4,8,215,238,0.833,0.903
"15151","Cochabamba","Shinahota","U.E. Mariscal Sucre",12,0,0,0,141,1,9,0,1,164,0,4,168,181,0.86,0.928
"15152","Cochabamba","Shinahota","U. E. Evo Morales Ayma",6,0,1,0,179,1,25,0,2,214,3,12,229,239,0.836,0.958
"15153","Cochabamba","Shinahota","U. E. Evo Morales Ayma",9,0,1,1,196,3,16,0,0,226,1,4,231,240,0.867,0.963
"15154","Cochabamba","Shinahota","U. E. Evo Morales Ayma",14,0,0,0,175,2,26,0,0,217,3,5,225,237,0.806,0.949
"15155","Cochabamba","Shinahota","U. E. Evo Morales Ayma",22,0,1,0,176,1,18,0,0,218,1,6,225,238,0.807,0.945
"15156","Cochabamba","Shinahota","Unidad Educativa Ibuelo",10,0,0,0,164,0,15,1,0,190,1,4,195,237,0.863,0.823
"15157","Cochabamba","Shinahota","Unidad Educativa Ibuelo",10,0,1,0,162,0,10,0,2,185,2,3,190,232,0.876,0.819
"15158","Cochabamba","Shinahota","Unidad Educativa Ibuelo",15,0,0,0,169,1,13,0,1,199,2,3,204,229,0.849,0.891
"15159","Cochabamba","Shinahota","Unidad Educativa Ibuelo",12,0,1,0,160,1,5,0,0,179,4,7,190,226,0.894,0.841
"15160","Cochabamba","Shinahota","Unidad Educativa Ibuelo",16,0,0,0,150,0,20,0,0,186,1,4,191,231,0.806,0.827
"15161","Cochabamba","Shinahota","Unidad Educativa Ibuelo",6,1,0,0,169,1,11,0,1,189,2,5,196,227,0.894,0.863
"15162","Cochabamba","Shinahota","Unidad Educativa Ibuelo",10,2,0,0,173,0,7,0,1,193,2,4,199,233,0.896,0.854
"15163","Cochabamba","Shinahota","Unidad Educativa Ibuelo",9,1,0,0,155,1,16,0,0,182,1,0,183,224,0.852,0.817
"15164","Cochabamba","Shinahota","Unidad Educativa Ibuelo",12,1,1,1,178,0,11,0,0,204,1,3,208,236,0.873,0.881
"15165","Cochabamba","Shinahota","Unidad Educativa Ibuelo",14,0,2,0,156,1,15,0,0,188,1,1,190,231,0.83,0.823
"15166","Cochabamba","Shinahota","U. E. Marcelo Quiroga Santa Cruz",13,0,0,1,195,1,6,0,0,216,4,4,224,230,0.903,0.974
"15167","Cochabamba","Shinahota","U. E. Marcelo Quiroga Santa Cruz",2,0,0,0,206,1,8,0,0,217,1,3,221,229,0.949,0.965
"15168","Cochabamba","Shinahota","U. E. Marcelo Quiroga Santa Cruz",1,0,0,0,200,0,9,1,1,212,2,4,218,230,0.943,0.948
"15169","Cochabamba","Shinahota","Unidad Educativa Ivirizu Vandiola",2,1,0,0,198,0,9,1,0,211,1,2,214,227,0.938,0.943
"15170","Cochabamba","Shinahota","Unidad Educativa Ivirizu Vandiola",10,1,1,0,212,0,6,0,0,230,1,5,236,248,0.922,0.952
"15171","Cochabamba","Shinahota","Unidad Educativa San Isidro",2,0,0,0,212,0,8,0,1,223,1,4,228,234,0.951,0.974
"15172","Cochabamba","Shinahota","Unidad Educativa San Isidro",2,0,1,0,221,0,0,0,0,224,0,3,227,234,0.987,0.97
"15173","Cochabamba","Shinahota","Unidad Educativa San Isidro",2,0,0,1,212,0,6,0,2,223,2,0,225,234,0.951,0.962
"15174","Cochabamba","Shinahota","Unidad Educativa San Isidro",2,0,0,0,216,0,8,1,0,227,3,0,230,237,0.952,0.97
"15175","Cochabamba","Shinahota","Unidad Educativa San Isidro",1,0,0,0,201,0,3,0,0,205,0,2,207,210,0.98,0.986
"15176","Cochabamba","Shinahota","Unidad Educativa 4 de Abril",0,0,0,0,220,0,2,0,1,223,0,0,223,231,0.987,0.965
"15177","Cochabamba","Shinahota","Unidad Educativa Churo Grande",0,0,0,0,215,0,3,0,1,219,1,6,226,236,0.982,0.958
"15178","Cochabamba","Shinahota","Unidad Educativa Majo Pampa A",1,3,0,0,219,0,5,0,0,228,0,1,229,237,0.961,0.966
"15179","Cochabamba","Shinahota","U.E. San Luis",0,1,0,0,213,0,4,0,0,218,1,6,225,237,0.977,0.949
"15180","Cochabamba","Shinahota","U.E. San Luis",1,0,0,0,211,0,8,0,1,221,1,2,224,235,0.955,0.953
"15181","Cochabamba","Shinahota","U.E. Demetrio Canelas",8,1,0,0,201,1,13,0,0,224,0,4,228,236,0.897,0.966
"15182","Cochabamba","Shinahota","U.E. Demetrio Canelas",14,1,0,0,201,0,10,0,0,226,2,2,230,235,0.889,0.979
"15183","Cochabamba","Shinahota","U.E. Agrigento B",1,0,0,0,215,0,9,0,0,225,2,6,233,239,0.956,0.975
"15184","Oruro","Oruro","Liceo Antofagasta",126,0,2,2,50,5,15,1,1,202,0,2,204,220,0.248,0.927
"15185","Oruro","Oruro","Liceo Antofagasta",124,0,0,0,54,6,14,1,4,203,0,1,204,219,0.266,0.932
"15186","Oruro","Oruro","Liceo Antofagasta",104,0,2,1,54,6,11,0,5,183,1,5,189,216,0.295,0.875
"15187","Oruro","Oruro","Liceo Antofagasta",119,1,3,3,42,3,16,1,6,194,1,6,201,224,0.216,0.897
"15188","Oruro","Oruro","Liceo Antofagasta",139,0,1,1,42,3,14,1,1,202,3,6,211,230,0.208,0.917
"15189","Oruro","Oruro","Colegio Jesus Maria Fe y Alegria",168,0,0,0,33,1,5,0,1,208,0,5,213,224,0.159,0.951
"15190","Oruro","Oruro","Colegio Jesus Maria Fe y Alegria",156,0,0,0,31,3,16,2,0,208,1,2,211,229,0.149,0.921
"15191","Oruro","Oruro","Colegio Jesus Maria Fe y Alegria",153,0,1,0,35,3,8,1,1,202,3,1,206,225,0.173,0.916
"15192","Oruro","Oruro","Colegio Jesus Maria Fe y Alegria",154,2,0,1,37,3,8,0,0,205,2,2,209,226,0.18,0.925
"15193","Oruro","Oruro","Colegio Jesus Maria Fe y Alegria",164,0,0,0,28,1,9,0,0,202,3,3,208,225,0.139,0.924
"15194","Oruro","Oruro","Col. Aniceto Arce",133,0,0,0,54,0,8,0,3,198,1,4,203,223,0.273,0.91
"15195","Oruro","Oruro","Col. Aniceto Arce",129,1,1,2,42,8,11,2,2,198,1,4,203,231,0.212,0.879
"15196","Oruro","Oruro","Col. Aniceto Arce",107,1,1,0,66,1,18,1,1,196,0,5,201,226,0.337,0.889
"15197","Oruro","Oruro","Col. Aniceto Arce",134,0,1,0,48,3,8,0,2,196,4,8,208,226,0.245,0.92
"15198","Oruro","Oruro","Col. Aniceto Arce",115,0,1,1,62,3,16,1,2,201,0,5,206,228,0.308,0.904
"15199","Oruro","Oruro","Col. Aniceto Arce",114,1,0,0,54,4,22,2,1,198,0,3,201,229,0.273,0.878
"15200","Oruro","Oruro","Col. Aniceto Arce",123,0,1,0,52,2,7,0,3,188,1,6,195,222,0.277,0.878
"15201","Oruro","Oruro","Col. Aniceto Arce",128,1,0,1,44,2,26,1,2,205,0,4,209,228,0.215,0.917
"15202","Oruro","Oruro","Col. Aniceto Arce",129,1,4,0,42,3,7,2,1,189,2,8,199,221,0.222,0.9
"15203","Oruro","Oruro","Col. Aniceto Arce",101,0,0,1,43,1,10,0,1,157,1,4,162,182,0.274,0.89
"15204","Oruro","Oruro","U. E. Jose Maria Sierra Galvarro",108,0,0,1,75,2,17,0,5,208,1,4,213,227,0.361,0.938
"15205","Oruro","Oruro","U. E. Jose Maria Sierra Galvarro",102,0,1,2,59,3,19,1,2,189,3,8,200,220,0.312,0.909
"15206","Oruro","Oruro","U. E. Jose Maria Sierra Galvarro",108,1,1,0,60,4,21,0,0,195,0,5,200,222,0.308,0.901
"15207","Oruro","Oruro","U. E. Jose Maria Sierra Galvarro",124,1,2,2,40,3,26,1,2,201,2,3,206,223,0.199,0.924
"15208","Oruro","Oruro","U. E. Jose Maria Sierra Galvarro",102,3,2,0,65,6,22,0,5,205,1,2,208,224,0.317,0.929
"15209","Oruro","Oruro","U. E. Jose Maria Sierra Galvarro",114,0,0,1,57,3,20,1,3,199,1,4,204,221,0.286,0.923
"15210","Oruro","Oruro","U. E. Jose Maria Sierra Galvarro",124,1,1,1,46,6,20,0,2,201,1,10,212,227,0.229,0.934
"15211","Oruro","Oruro","U. E. Jose Maria Sierra Galvarro",116,0,1,1,75,1,9,0,0,203,1,3,207,226,0.369,0.916
"15212","Oruro","Oruro","U. E. Jose Maria Sierra Galvarro",111,0,0,2,64,3,22,0,1,203,1,2,206,229,0.315,0.9
"15213","Oruro","Oruro","U. E. Jose Maria Sierra Galvarro",106,1,4,1,63,3,18,0,1,197,1,4,202,225,0.32,0.898
"15214","Oruro","Oruro","U. E. Jose Maria Sierra Galvarro",105,1,1,1,62,6,26,2,0,204,2,4,210,231,0.304,0.909
"15215","Oruro","Oruro","U. E. Jose Maria Sierra Galvarro",94,2,1,1,67,3,29,2,1,200,2,6,208,225,0.335,0.924
"15216","Oruro","Oruro","U. E. Jose Maria Sierra Galvarro",107,1,1,0,51,6,24,1,2,193,2,5,200,224,0.264,0.893
"15217","Oruro","Oruro","U. E. Jose Maria Sierra Galvarro",109,0,1,0,69,3,14,0,1,197,1,4,202,226,0.35,0.894
"15218","Oruro","Oruro","U. E. Jose Maria Sierra Galvarro",125,2,0,0,52,2,16,1,0,198,0,7,205,222,0.263,0.923
"15219","Oruro","Oruro","U. E. Jose Maria Sierra Galvarro",117,0,1,1,48,2,19,3,1,192,3,3,198,224,0.25,0.884
"15220","Oruro","Oruro","U. E. Jose Maria Sierra Galvarro",95,1,0,1,66,4,17,1,0,185,3,9,197,220,0.357,0.895
"15221","Oruro","Oruro","U. E. Jose Maria Sierra Galvarro",113,2,2,0,53,4,14,0,3,191,0,10,201,218,0.277,0.922
"15222","Oruro","Oruro","U. E. Jose Maria Sierra Galvarro",123,1,0,2,50,2,11,0,3,192,2,4,198,227,0.26,0.872
"15223","Oruro","Oruro","Col. Mixto San Jose",122,0,2,1,45,4,16,0,2,192,2,2,196,221,0.234,0.887
"15224","Oruro","Oruro","Col. Mixto San Jose",123,0,1,0,45,0,23,0,2,194,0,10,204,227,0.232,0.899
"15225","Oruro","Oruro","Col. Mixto San Jose",116,1,0,2,51,1,12,1,3,187,1,6,194,223,0.273,0.87
"15226","Oruro","Oruro","Col. Mixto San Jose",138,0,2,2,32,1,13,1,0,189,4,2,195,219,0.169,0.89
"15227","Oruro","Oruro","Col. Mixto San Jose",103,2,0,0,31,3,10,0,2,151,0,2,153,167,0.205,0.916
"15228","Oruro","Oruro","U. E. Jose Ignacio De Sanjinez",122,1,4,0,59,5,14,0,4,209,0,3,212,228,0.282,0.93
"15229","Oruro","Oruro","U. E. Jose Ignacio De Sanjinez",102,1,1,3,57,2,15,1,2,184,6,8,198,228,0.31,0.868
"15230","Oruro","Oruro","U. E. Jose Ignacio De Sanjinez",114,0,0,0,57,3,24,0,2,200,2,4,206,229,0.285,0.9
"15231","Oruro","Oruro","U. E. Jose Ignacio De Sanjinez",107,0,1,0,56,5,24,0,2,195,0,8,203,226,0.287,0.898
"15232","Oruro","Oruro","U. E. Jose Ignacio De Sanjinez",93,0,2,3,64,2,25,1,1,191,4,6,201,225,0.335,0.893
"15233","Oruro","Oruro","U. E. Jose Ignacio De Sanjinez",106,1,0,0,63,4,15,2,1,192,0,9,201,225,0.328,0.893
"15234","Oruro","Oruro","U. E. Jose Ignacio De Sanjinez",103,1,0,1,66,4,24,0,1,200,0,5,205,232,0.33,0.884
"15235","Oruro","Oruro","U. E. Jose Ignacio De Sanjinez",126,1,3,1,53,1,21,2,3,211,1,6,218,234,0.251,0.932
"15236","Oruro","Oruro","U. E. Jose Ignacio De Sanjinez",88,0,3,3,76,6,22,0,3,201,2,8,211,231,0.378,0.913
"15237","Oruro","Oruro","U. E. Jose Ignacio De Sanjinez",102,1,1,1,58,5,22,2,3,195,1,8,204,223,0.297,0.915
"15238","Oruro","Oruro","U. E. Jose Ignacio De Sanjinez",114,0,5,0,58,4,23,2,0,206,3,4,213,234,0.282,0.91
"15239","Oruro","Oruro","U. E. Jose Ignacio De Sanjinez",102,0,2,1,61,2,15,2,1,186,0,7,193,223,0.328,0.865
"15240","Oruro","Oruro","U. E. Jose Ignacio De Sanjinez",103,0,1,0,57,10,14,1,2,188,2,6,196,220,0.303,0.891
"15241","Oruro","Oruro","U. E. Jose Ignacio De Sanjinez",129,2,0,2,45,2,16,2,0,198,1,10,209,228,0.227,0.917
"15242","Oruro","Oruro","U. E. Jose Ignacio De Sanjinez",120,1,0,1,50,3,13,0,0,188,2,9,199,228,0.266,0.873
"15243","Oruro","Oruro","U. E. Jose Ignacio De Sanjinez",94,1,0,0,61,2,19,1,4,182,3,4,189,227,0.335,0.833
"15244","Oruro","Oruro","U. E. Jose Ignacio De Sanjinez",103,1,1,0,58,1,16,0,1,181,5,7,193,217,0.32,0.889
"15245","Oruro","Oruro","Col. Nal. Antonio Jose De Sainz",126,0,1,1,48,0,16,0,3,195,0,5,200,225,0.246,0.889
"15246","Oruro","Oruro","Col. Nal. Antonio Jose De Sainz",104,3,1,0,65,5,18,0,2,198,1,4,203,224,0.328,0.906
"15247","Oruro","Oruro","Col. Nal. Antonio Jose De Sainz",101,0,1,0,63,1,24,2,1,193,0,6,199,218,0.326,0.913
"15248","Oruro","Oruro","Col. Nal. Antonio Jose De Sainz",130,0,0,2,48,3,21,2,1,207,0,4,211,225,0.232,0.938
"15249","Oruro","Oruro","Col. Nal. Antonio Jose De Sainz",107,2,1,2,52,5,24,1,2,196,0,4,200,226,0.265,0.885
"15250","Oruro","Oruro","Col. Nal. Antonio Jose De Sainz",92,0,5,0,61,7,22,2,0,189,1,7,197,223,0.323,0.883
"15251","Oruro","Oruro","Col. Nal. Antonio Jose De Sainz",91,2,0,2,55,5,29,1,8,193,2,5,200,228,0.285,0.877
"15252","Oruro","Oruro","Col. Nal. Antonio Jose De Sainz",114,0,1,3,49,3,22,1,2,195,2,3,200,219,0.251,0.913
"15253","Oruro","Oruro","Col. Nal. Antonio Jose De Sainz",110,0,2,1,52,4,19,0,1,189,1,4,194,224,0.275,0.866
"15254","Oruro","Oruro","Col. Nal. Antonio Jose De Sainz",112,0,0,1,57,7,14,0,3,194,1,3,198,219,0.294,0.904
"15255","Oruro","Oruro","Col. Particular Reekie",147,1,0,1,32,2,15,4,3,205,2,4,211,225,0.156,0.938
"15256","Oruro","Oruro","Col. Particular Reekie",120,0,1,1,49,6,18,2,1,198,2,5,205,226,0.247,0.907
"15257","Oruro","Oruro","Col. Particular Reekie",131,0,2,1,41,4,17,1,0,197,0,7,204,226,0.208,0.903
"15258","Oruro","Oruro","Col. Particular Reekie",163,1,0,1,29,3,9,0,3,209,1,4,214,232,0.139,0.922
"15259","Oruro","Oruro","Col. Particular Reekie",143,0,1,0,40,5,8,1,1,199,2,3,204,222,0.201,0.919
"15260","Oruro","Oruro","Col. Particular Reekie",144,0,1,0,30,3,13,2,1,194,2,5,201,223,0.155,0.901
"15261","Oruro","Oruro","Col. Particular Reekie",139,0,0,0,45,4,12,0,0,200,1,4,205,232,0.225,0.884
"15262","Oruro","Oruro","Col. Particular Reekie",133,0,1,0,33,2,7,2,0,178,2,8,188,210,0.185,0.895
"15263","Oruro","Oruro","U. E. Alto Oruro",68,0,2,2,87,5,32,0,3,199,0,12,211,228,0.437,0.925
"15264","Oruro","Oruro","U. E. Alto Oruro",61,1,4,1,106,5,26,0,3,207,1,5,213,228,0.512,0.934
"15265","Oruro","Oruro","U. E. Alto Oruro",69,1,2,1,86,4,31,0,3,197,3,5,205,231,0.437,0.887
"15266","Oruro","Oruro","Liceo Tec. Humanistico Adolfo Ballivian",128,0,0,1,40,3,16,2,3,193,1,4,198,225,0.207,0.88
"15267","Oruro","Oruro","Liceo Tec. Humanistico Adolfo Ballivian",125,0,1,1,49,5,13,3,2,199,0,6,205,226,0.246,0.907
"15268","Oruro","Oruro","Liceo Tec. Humanistico Adolfo Ballivian",113,1,2,1,47,2,15,3,2,186,1,9,196,220,0.253,0.891
"15269","Oruro","Oruro","Liceo Tec. Humanistico Adolfo Ballivian",112,0,0,0,56,1,13,2,0,184,5,6,195,219,0.304,0.89
"15270","Oruro","Oruro","Col. Nal. Simon Bolivar",128,0,1,2,54,2,18,2,3,210,2,3,215,233,0.257,0.923
"15271","Oruro","Oruro","Col. Nal. Simon Bolivar",148,1,1,0,39,3,13,1,0,206,1,5,212,233,0.189,0.91
"15272","Oruro","Oruro","Col. Nal. Simon Bolivar",123,1,1,1,46,4,22,1,2,201,1,7,209,231,0.229,0.905
"15273","Oruro","Oruro","Col. Nal. Simon Bolivar",123,1,3,3,47,3,24,0,2,206,1,3,210,236,0.228,0.89
"15274","Oruro","Oruro","Col. Nal. Simon Bolivar",141,0,2,0,46,4,10,2,0,205,1,1,207,226,0.224,0.916
"15275","Oruro","Oruro","Col. Nal. Simon Bolivar",131,1,2,0,39,6,10,2,4,195,0,2,197,228,0.2,0.864
"15276","Oruro","Oruro","Col. Nal. Simon Bolivar",111,0,3,1,51,2,26,0,2,196,0,3,199,232,0.26,0.858
"15277","Oruro","Oruro","Col. Nal. Simon Bolivar",132,2,2,1,46,3,10,3,3,202,0,4,206,227,0.228,0.907
"15278","Oruro","Oruro","Col. Nal. Simon Bolivar",145,0,0,0,35,2,12,3,1,198,0,3,201,223,0.177,0.901
"15279","Oruro","Oruro","Col. Nal. Simon Bolivar",128,0,0,0,38,2,16,1,1,186,0,3,189,226,0.204,0.836
"15280","Oruro","Oruro","Col. Nal. Simon Bolivar",140,0,0,0,37,4,11,3,1,196,0,7,203,225,0.189,0.902
"15281","Oruro","Oruro","Col. Nal. Simon Bolivar",140,0,0,0,41,3,14,0,1,199,0,1,200,229,0.206,0.873
"15282","Oruro","Oruro","Col. Ignacio Leon",150,0,1,0,31,3,19,0,0,204,1,2,207,225,0.152,0.92
"15283","Oruro","Oruro","Col. Ignacio Leon",140,0,1,1,39,5,14,0,0,200,5,3,208,228,0.195,0.912
"15284","Oruro","Oruro","Col. Ignacio Leon",135,1,2,1,44,3,21,3,0,210,1,2,213,233,0.21,0.914
"15285","Oruro","Oruro","Col. Ignacio Leon",143,0,3,1,27,2,24,1,3,204,2,6,212,229,0.132,0.926
"15286","Oruro","Oruro","Col. Ignacio Leon",145,0,1,1,27,3,15,0,2,194,0,6,200,226,0.139,0.885
"15287","Oruro","Oruro","Col. Ignacio Leon",133,0,1,0,42,5,19,0,3,203,0,3,206,224,0.207,0.92
"15288","Oruro","Oruro","Col. Ignacio Leon",148,1,0,3,34,3,12,2,1,204,1,4,209,227,0.167,0.921
"15289","Oruro","Oruro","Col. Ignacio Leon",135,1,0,1,39,5,14,0,1,196,3,9,208,227,0.199,0.916
"15290","Oruro","Oruro","Col. Ignacio Leon",134,0,0,2,40,5,11,1,1,194,2,6,202,223,0.206,0.906
"15291","Oruro","Oruro","Col. Ignacio Leon",135,1,1,4,45,2,12,3,0,203,0,0,203,230,0.222,0.883
"15292","Oruro","Oruro","Col. Donato Vasquez",140,0,0,2,43,2,17,0,0,204,1,6,211,229,0.211,0.921
"15293","Oruro","Oruro","Col. Donato Vasquez",125,0,0,1,39,6,9,5,1,186,4,2,192,230,0.21,0.835
"15294","Oruro","Oruro","Col. Donato Vasquez",149,0,0,3,36,1,13,0,1,203,2,2,207,227,0.177,0.912
"15295","Oruro","Oruro","Col. Donato Vasquez",134,1,2,0,44,0,13,0,1,195,2,5,202,227,0.226,0.89
"15296","Oruro","Oruro","Col. Donato Vasquez",145,1,0,0,40,3,12,1,2,204,0,4,208,227,0.196,0.916
"15297","Oruro","Oruro","Col. Donato Vasquez",132,1,1,1,42,3,12,1,0,193,0,5,198,220,0.218,0.9
"15298","Oruro","Oruro","Col. Donato Vasquez",141,0,1,2,32,2,15,1,1,195,1,3,199,217,0.164,0.917
"15299","Oruro","Oruro","Col. Donato Vasquez",122,0,0,0,33,0,9,1,3,168,2,7,177,193,0.196,0.917
"15300","Oruro","Oruro","U. E. Mcal. Antonio Jose De Sucre",111,1,4,1,59,2,12,1,3,194,2,1,197,216,0.304,0.912
"15301","Oruro","Oruro","U. E. Mcal. Antonio Jose De Sucre",125,0,2,0,61,1,17,0,0,206,0,4,210,231,0.296,0.909
"15302","Oruro","Oruro","U. E. Mcal. Antonio Jose De Sucre",91,1,2,0,60,3,11,1,5,174,2,7,183,215,0.345,0.851
"15303","Oruro","Oruro","U. E. Mcal. Antonio Jose De Sucre",120,0,2,0,55,6,14,0,1,198,1,3,202,227,0.278,0.89
"15304","Oruro","Oruro","U. E. Mcal. Antonio Jose De Sucre",113,0,0,1,58,4,20,5,1,202,1,4,207,224,0.287,0.924
"15305","Oruro","Oruro","U. E. Mcal. Antonio Jose De Sucre",109,0,2,2,67,5,10,0,3,198,5,2,205,224,0.338,0.915
"15306","Oruro","Oruro","U. E. Mcal. Antonio Jose De Sucre",117,0,0,0,45,2,20,4,1,189,1,7,197,228,0.238,0.864
"15307","Oruro","Oruro","U. E. Mcal. Antonio Jose De Sucre",125,1,1,1,36,5,20,1,1,191,4,4,199,222,0.188,0.896
"15308","Oruro","Oruro","U. E. Mcal. Antonio Jose De Sucre",118,0,1,0,49,2,15,4,0,189,3,3,195,216,0.259,0.903
"15309","Oruro","Oruro","U. E. Mcal. Antonio Jose De Sucre",119,1,2,0,65,2,14,0,3,206,2,5,213,227,0.316,0.938
"15310","Oruro","Oruro","U. E. Mcal. Antonio Jose De Sucre",115,0,0,1,37,4,19,0,2,178,2,7,187,212,0.208,0.882
"15311","Oruro","Oruro","U. E. Mcal. Antonio Jose De Sucre",126,1,2,2,46,3,18,2,2,202,2,4,208,221,0.228,0.941
"15312","Oruro","Oruro","U. E. Mcal. Antonio Jose De Sucre",108,0,1,2,50,3,15,1,1,181,4,5,190,209,0.276,0.909
"15313","Oruro","Oruro","Col. Jorge Oblitas",128,0,2,3,46,3,12,1,0,195,2,11,208,226,0.236,0.92
"15314","Oruro","Oruro","Col. Jorge Oblitas",118,2,2,3,49,2,15,1,3,195,0,4,199,223,0.251,0.892
"15315","Oruro","Oruro","Col. Jorge Oblitas",106,1,1,1,60,2,21,1,0,193,2,6,201,221,0.311,0.91
"15316","Oruro","Oruro","Col. Jorge Oblitas",121,0,0,2,50,1,13,2,1,190,3,8,201,220,0.263,0.914
"15317","Oruro","Oruro","Col. Jorge Oblitas",116,0,3,1,45,1,23,2,3,194,0,5,199,225,0.232,0.884
"15318","Oruro","Oruro","Col. Jorge Oblitas",119,0,2,1,48,3,17,2,2,194,0,6,200,227,0.247,0.881
"15319","Oruro","Oruro","Col. Jorge Oblitas",134,0,1,2,40,3,10,0,3,193,2,2,197,220,0.207,0.895
"15320","Oruro","Oruro","Col. Particular Anglo Americano",105,2,0,3,68,0,24,2,3,207,1,8,216,230,0.329,0.939
"15321","Oruro","Oruro","Col. Particular Anglo Americano",126,1,1,0,53,3,15,0,2,201,3,8,212,228,0.264,0.93
"15322","Oruro","Oruro","Col. Particular Anglo Americano",119,0,0,1,53,2,28,1,1,205,1,7,213,235,0.259,0.906
"15323","Oruro","Oruro","Col. Particular Anglo Americano",99,0,0,3,67,2,18,0,5,194,3,9,206,223,0.345,0.924
"15324","Oruro","Oruro","Col. Particular Anglo Americano",110,0,0,4,66,2,18,1,8,209,4,0,213,230,0.316,0.926
"15325","Oruro","Oruro","Col. Particular Anglo Americano",114,0,1,1,64,6,10,0,3,199,2,7,208,225,0.322,0.924
"15326","Oruro","Oruro","Col. Particular Anglo Americano",101,0,5,1,58,3,25,1,5,199,1,7,207,223,0.291,0.928
"15327","Oruro","Oruro","Col. Particular Anglo Americano",110,1,0,2,55,1,25,1,1,196,0,8,204,224,0.281,0.911
"15328","Oruro","Oruro","Col. Particular Anglo Americano",107,0,2,0,69,4,17,0,1,200,2,7,209,226,0.345,0.925
"15329","Oruro","Oruro","Col. Particular Anglo Americano",138,0,2,0,45,4,16,1,1,207,0,2,209,227,0.217,0.921
"15330","Oruro","Oruro","Col. Particular Anglo Americano",132,0,1,0,43,1,13,1,5,196,0,7,203,223,0.219,0.91
"15331","Oruro","Oruro","Fac. De Derecho (Esc. 10 De Febrero)",129,0,1,2,47,6,11,0,5,201,2,4,207,229,0.234,0.904
"15332","Oruro","Oruro","Fac. De Derecho (Esc. 10 De Febrero)",122,1,3,2,49,4,17,1,1,200,0,5,205,231,0.245,0.887
"15333","Oruro","Oruro","Fac. De Derecho (Esc. 10 De Febrero)",146,1,1,0,44,3,12,0,2,209,2,1,212,228,0.211,0.93
"15334","Oruro","Oruro","Col. Nal. Juan Misael Saracho",136,0,2,1,53,3,10,0,1,206,0,2,208,227,0.257,0.916
"15335","Oruro","Oruro","Col. Nal. Juan Misael Saracho",140,0,0,1,37,2,9,0,3,192,1,3,196,219,0.193,0.895
"15336","Oruro","Oruro","Col. Nal. Juan Misael Saracho",141,0,0,0,26,2,12,0,0,181,2,3,186,223,0.144,0.834
"15337","Oruro","Oruro","Col. Nal. Juan Misael Saracho",141,1,2,1,26,8,8,2,1,190,0,3,193,218,0.137,0.885
"15338","Oruro","Oruro","Col. Nal. Juan Misael Saracho",132,1,0,3,53,3,9,4,0,205,0,3,208,221,0.259,0.941
"15339","Oruro","Oruro","Col. Nal. Juan Misael Saracho",144,0,0,0,34,5,5,6,2,196,0,2,198,223,0.173,0.888
"15340","Oruro","Oruro","Col. Nal. Juan Misael Saracho",144,0,1,1,29,3,10,3,2,193,1,4,198,222,0.15,0.892
"15341","Oruro","Oruro","Col. Nal. Juan Misael Saracho",156,0,1,2,34,4,3,1,0,201,1,3,205,230,0.169,0.891
"15342","Oruro","Oruro","U. E. Eduardo Avaroa",141,0,1,3,35,1,11,1,1,194,3,5,202,220,0.18,0.918
"15343","Oruro","Oruro","U. E. Eduardo Avaroa",148,0,2,2,34,4,7,0,1,198,1,4,203,219,0.172,0.927
"15344","Oruro","Oruro","U. E. Eduardo Avaroa",130,0,2,1,41,3,11,2,2,192,1,6,199,219,0.214,0.909
"15345","Oruro","Oruro","U. E. Eduardo Avaroa",146,0,0,1,38,2,6,2,2,197,1,6,204,221,0.193,0.923
"15346","Oruro","Oruro","U. E. Eduardo Avaroa",146,0,0,0,31,1,14,1,1,194,3,3,200,223,0.16,0.897
"15347","Oruro","Oruro","U. E. Eduardo Avaroa",152,0,4,0,38,2,8,1,0,205,1,1,207,224,0.185,0.924
"15348","Oruro","Oruro","U. E. Eduardo Avaroa",159,0,0,0,28,2,8,1,0,198,2,4,204,223,0.141,0.915
"15349","Oruro","Oruro","U. E. Eduardo Avaroa",146,0,0,0,37,2,6,2,2,195,2,3,200,224,0.19,0.893
"15350","Oruro","Oruro","U.E. Particular Arrieta",138,0,0,1,58,3,14,0,1,215,1,3,219,238,0.27,0.92
"15351","Oruro","Oruro","U.E. Particular Arrieta",142,1,0,0,51,1,15,0,4,214,0,4,218,238,0.238,0.916
"15352","Oruro","Oruro","U.E. Virgen Del Mar III",116,0,1,1,57,9,20,0,1,205,1,7,213,236,0.278,0.903
"15353","Oruro","Oruro","U. Esc. Luis Llosa - España",136,0,0,2,49,4,10,2,1,204,0,5,209,224,0.24,0.933
"15354","Oruro","Oruro","U. Esc. Luis Llosa - España",131,1,1,0,52,3,13,2,1,204,0,6,210,227,0.255,0.925
"15355","Oruro","Oruro","U. Esc. Luis Llosa - España",126,1,1,1,47,4,13,0,1,194,1,3,198,217,0.242,0.912
"15356","Oruro","Oruro","U. Esc. Luis Llosa - España",126,0,1,0,50,4,15,0,3,199,1,8,208,224,0.251,0.929
"15357","Oruro","Oruro","U. Esc. Luis Llosa - España",122,0,1,1,37,1,9,1,1,173,0,1,174,185,0.214,0.941
"15358","Oruro","Oruro","U. E. Mcal. Andres De Santa Cruz",94,2,2,3,71,1,22,0,2,197,1,5,203,225,0.36,0.902
"15359","Oruro","Oruro","U. E. Mcal. Andres De Santa Cruz",108,0,0,0,63,3,21,1,2,198,2,2,202,220,0.318,0.918
"15360","Oruro","Oruro","U. E. Mcal. Andres De Santa Cruz",80,2,4,2,84,3,14,0,3,192,3,7,202,229,0.438,0.882
"15361","Oruro","Oruro","U. E. Mcal. Andres De Santa Cruz",101,2,4,2,59,2,26,0,4,200,3,10,213,228,0.295,0.934
"15362","Oruro","Oruro","U. E. Mcal. Andres De Santa Cruz",93,1,2,0,75,3,24,1,1,200,2,1,203,220,0.375,0.923
"15363","Oruro","Oruro","U. E. Mcal. Andres De Santa Cruz",97,1,1,0,75,0,27,1,5,207,1,4,212,223,0.362,0.951
"15364","Oruro","Oruro","U. E. Mcal. Andres De Santa Cruz",112,2,0,0,58,4,17,3,5,201,1,4,206,222,0.289,0.928
"15365","Oruro","Oruro","U. E. Mcal. Andres De Santa Cruz",90,0,0,3,73,3,18,1,2,190,2,7,199,222,0.384,0.896
"15366","Oruro","Oruro","U. E. Mcal. Andres De Santa Cruz",112,1,1,0,66,5,8,0,4,197,1,10,208,228,0.335,0.912
"15367","Oruro","Oruro","U. E. Mcal. Andres De Santa Cruz",112,1,0,4,65,3,19,1,2,207,3,7,217,233,0.314,0.931
"15368","Oruro","Oruro","U. E. Mcal. Andres De Santa Cruz",104,1,1,2,58,5,25,0,2,198,3,7,208,230,0.293,0.904
"15369","Oruro","Oruro","U. E. Mcal. Andres De Santa Cruz",119,0,0,3,51,2,23,2,1,201,1,2,204,219,0.254,0.932
"15370","Oruro","Oruro","U. E. Mcal. Andres De Santa Cruz",87,0,3,1,78,2,22,0,0,193,1,1,195,210,0.404,0.929
"15371","Oruro","Oruro","Esc. Jacinto Rodriguez (La Aurora)",89,1,0,1,82,4,25,0,5,207,3,9,219,232,0.396,0.944
"15372","Oruro","Oruro","Esc. Jacinto Rodriguez (La Aurora)",85,1,4,1,83,3,20,1,3,201,2,12,215,229,0.413,0.939
"15373","Oruro","Oruro","Esc. Jacinto Rodriguez (La Aurora)",78,0,4,0,88,4,34,1,3,212,1,5,218,235,0.415,0.928
"15374","Oruro","Oruro","Esc. Jacinto Rodriguez (La Aurora)",81,1,0,0,95,2,36,0,2,217,1,4,222,233,0.438,0.953
"15375","Oruro","Oruro","Esc. Jacinto Rodriguez (La Aurora)",67,0,2,0,101,1,34,0,3,208,2,10,220,232,0.486,0.948
"15376","Oruro","Oruro","Esc. Jacinto Rodriguez (La Aurora)",79,1,3,0,93,4,18,1,2,201,3,7,211,232,0.463,0.909
"15377","Oruro","Oruro","Esc. Jacinto Rodriguez (La Aurora)",86,0,2,2,95,2,20,0,2,209,1,5,215,231,0.455,0.931
"15378","Oruro","Oruro","Esc. Jacinto Rodriguez (La Aurora)",81,2,4,1,85,2,26,2,1,204,3,11,218,237,0.417,0.92
"15379","Oruro","Oruro","Esc. Jacinto Rodriguez (La Aurora)",87,0,2,0,82,4,31,0,3,209,2,8,219,236,0.392,0.928
"15380","Oruro","Oruro","Esc. Jacinto Rodriguez (La Aurora)",76,0,0,0,95,0,26,1,1,199,2,8,209,231,0.477,0.905
"15381","Oruro","Oruro","Esc. Jacinto Rodriguez (La Aurora)",66,0,2,1,109,2,22,0,6,208,3,7,218,237,0.524,0.92
"15382","Oruro","Oruro","Esc. Jacinto Rodriguez (La Aurora)",39,0,6,1,124,2,31,1,1,205,1,11,217,237,0.605,0.916
"15383","Oruro","Oruro","Esc. Jacinto Rodriguez (La Aurora)",95,0,2,1,75,2,30,1,2,208,0,8,216,233,0.361,0.927
"15384","Oruro","Oruro","Esc. Jacinto Rodriguez (La Aurora)",88,1,2,5,69,6,32,1,4,208,3,4,215,233,0.332,0.923
"15385","Oruro","Oruro","Esc. Jacinto Rodriguez (La Aurora)",92,1,4,0,73,7,30,1,1,209,5,6,220,235,0.349,0.936
"15386","Oruro","Oruro","Esc. Jacinto Rodriguez (La Aurora)",72,0,4,0,88,7,31,0,6,208,2,10,220,238,0.423,0.924
"15387","Oruro","Oruro","Esc. Jacinto Rodriguez (La Aurora)",104,0,2,1,66,1,21,0,5,200,0,12,212,235,0.33,0.902
"15388","Oruro","Oruro","Esc. Jacinto Rodriguez (La Aurora)",63,0,3,0,98,4,22,0,3,193,3,7,203,227,0.508,0.894
"15389","Oruro","Oruro","Esc. Jacinto Rodriguez (La Aurora)",87,3,2,0,63,4,38,4,3,204,2,6,212,226,0.309,0.938
"15390","Oruro","Oruro","Esc. Jacinto Rodriguez (La Aurora)",64,0,1,0,63,3,23,1,4,159,1,1,161,169,0.396,0.953
"15391","Oruro","Oruro","Esc. Franz Tamayo (Los Pinos)",54,2,5,0,105,2,32,0,6,206,3,8,217,235,0.51,0.923
"15392","Oruro","Oruro","Esc. Franz Tamayo (Los Pinos)",30,2,3,4,120,5,32,0,0,196,2,9,207,228,0.612,0.908
"15393","Oruro","Oruro","Esc. Franz Tamayo (Los Pinos)",38,2,5,0,101,2,41,1,3,193,3,11,207,229,0.523,0.904
"15394","Oruro","Oruro","Esc. Franz Tamayo (Los Pinos)",23,0,4,1,130,4,28,1,2,193,2,9,204,229,0.674,0.891
"15395","Oruro","Oruro","Esc. Franz Tamayo (Los Pinos)",33,1,5,1,114,3,35,1,6,199,3,8,210,232,0.573,0.905
"15396","Oruro","Oruro","Esc. Franz Tamayo (Los Pinos)",46,1,0,2,110,5,41,1,5,211,5,7,223,236,0.521,0.945
"15397","Oruro","Oruro","Esc. Franz Tamayo (Los Pinos)",33,2,5,0,131,1,34,1,2,209,3,6,218,233,0.627,0.936
"15398","Oruro","Oruro","U.E. Marcelo Quiroga Santa Cruz",61,0,4,1,95,5,32,2,7,207,3,7,217,238,0.459,0.912
"15399","Oruro","Oruro","U.E. Marcelo Quiroga Santa Cruz",52,1,4,0,109,3,39,0,3,211,2,7,220,238,0.517,0.924
"15400","Oruro","Oruro","U.E. Marcelo Quiroga Santa Cruz",62,2,2,1,105,4,42,0,4,222,2,4,228,238,0.473,0.958
"15401","Oruro","Oruro","U.E. Marcelo Quiroga Santa Cruz",54,0,4,1,111,3,34,0,4,211,4,11,226,239,0.526,0.946
"15402","Oruro","Oruro","U.E. Marcelo Quiroga Santa Cruz",57,1,6,0,94,4,39,0,3,204,4,7,215,238,0.461,0.903
"15403","Oruro","Oruro","U.E. Marcelo Quiroga Santa Cruz",67,1,1,2,104,3,38,0,5,221,2,4,227,239,0.471,0.95
"15404","Oruro","Oruro","U.E. Marcelo Quiroga Santa Cruz",49,0,2,0,90,1,30,0,4,176,1,7,184,204,0.511,0.902
"15405","Oruro","Oruro","U. E. Ejercito Nacional",90,0,4,0,78,4,24,1,2,203,5,5,213,231,0.384,0.922
"15406","Oruro","Oruro","U. E. Ejercito Nacional",86,1,1,0,74,2,27,0,5,196,1,5,202,222,0.378,0.91
"15407","Oruro","Oruro","U. E. Ejercito Nacional",93,0,2,1,72,4,20,0,2,194,4,5,203,230,0.371,0.883
"15408","Oruro","Oruro","U. E. Ejercito Nacional",80,2,4,0,78,4,28,2,3,201,2,8,211,230,0.388,0.917
"15409","Oruro","Oruro","U. E. Ejercito Nacional",73,1,3,1,88,4,25,0,2,197,3,5,205,223,0.447,0.919
"15410","Oruro","Oruro","U. E. Ejercito Nacional",75,0,7,1,87,5,23,0,2,200,2,3,205,220,0.435,0.932
"15411","Oruro","Oruro","U. E. Ejercito Nacional",85,1,3,1,74,6,21,0,2,193,3,10,206,223,0.383,0.924
"15412","Oruro","Oruro","U. E. Ejercito Nacional",101,0,0,3,69,7,15,0,7,202,1,8,211,230,0.342,0.917
"15413","Oruro","Oruro","U. E. Ejercito Nacional",83,0,2,1,83,7,24,0,4,204,1,5,210,228,0.407,0.921
"15414","Oruro","Oruro","U. E. Ejercito Nacional",77,0,3,4,82,3,18,0,1,188,2,14,204,226,0.436,0.903
"15415","Oruro","Oruro","U. E. Ejercito Nacional",91,1,2,1,81,2,27,0,1,206,2,6,214,231,0.393,0.926
"15416","Oruro","Oruro","U. E. Ejercito Nacional",98,2,3,1,70,4,21,0,3,202,1,8,211,229,0.347,0.921
"15417","Oruro","Oruro","U. E. Ejercito Nacional",91,1,2,3,75,3,17,1,4,197,1,5,203,226,0.381,0.898
"15418","Oruro","Oruro","U. E. Ejercito Nacional",94,1,2,1,74,1,24,1,6,204,1,4,209,231,0.363,0.905
"15419","Oruro","Oruro","U. E. Ejercito Nacional",86,0,1,1,69,3,24,3,4,191,0,9,200,220,0.361,0.909
"15420","Oruro","Oruro","U. E. Ejercito Nacional",100,0,3,1,72,2,22,0,2,202,2,9,213,225,0.356,0.947
"15421","Oruro","Oruro","U. E. Ejercito Nacional",92,0,1,2,74,7,20,2,2,200,4,5,209,229,0.37,0.913
"15422","Oruro","Oruro","U. E. Ejercito Nacional",77,0,4,2,74,6,35,1,1,200,2,4,206,230,0.37,0.896
"15423","Oruro","Oruro","(Cárcel) Penal San Pedro",20,1,0,0,81,3,47,0,0,152,7,6,165,236,0.533,0.699
"15424","Oruro","Oruro","U. E. John F. Kennedy",94,0,4,3,79,1,16,1,2,200,4,7,211,224,0.395,0.942
"15425","Oruro","Oruro","U. E. John F. Kennedy",79,0,2,0,81,7,20,1,5,195,2,8,205,221,0.415,0.928
"15426","Oruro","Oruro","U. E. John F. Kennedy",100,1,2,0,62,4,27,2,2,200,2,7,209,230,0.31,0.909
"15427","Oruro","Oruro","U. E. John F. Kennedy",73,4,5,0,79,0,29,2,2,194,3,7,204,227,0.407,0.899
"15428","Oruro","Oruro","U. E. John F. Kennedy",74,0,3,2,82,6,28,0,1,196,3,11,210,228,0.418,0.921
"15429","Oruro","Oruro","U. E. John F. Kennedy",93,1,2,1,79,3,21,2,6,208,1,5,214,229,0.38,0.934
"15430","Oruro","Oruro","U. E. John F. Kennedy",87,0,3,0,88,2,33,0,3,216,1,6,223,232,0.407,0.961
"15431","Oruro","Oruro","U. E. John F. Kennedy",102,0,1,0,76,1,20,0,5,205,0,3,208,232,0.371,0.897
"15432","Oruro","Oruro","U. E. John F. Kennedy",73,1,3,1,75,5,30,0,3,191,5,11,207,227,0.393,0.912
"15433","Oruro","Oruro","U. E. John F. Kennedy",88,0,4,1,77,3,33,0,4,210,1,5,216,227,0.367,0.952
"15434","Oruro","Oruro","U. E. John F. Kennedy",76,1,5,0,83,4,38,0,0,207,5,6,218,231,0.401,0.944
"15435","Oruro","Oruro","U. E. John F. Kennedy",78,0,2,1,91,2,21,5,4,204,1,9,214,231,0.446,0.926
"15436","Oruro","Oruro","U. E. John F. Kennedy",95,0,4,0,70,2,25,0,2,198,1,9,208,225,0.354,0.924
"15437","Oruro","Oruro","U. E. John F. Kennedy",88,2,6,0,77,4,17,1,3,198,2,6,206,223,0.389,0.924
"15438","Oruro","Oruro","U. E. John F. Kennedy",88,0,3,1,63,3,25,1,5,189,2,9,200,226,0.333,0.885
"15439","Oruro","Oruro","U. E. John F. Kennedy",89,2,2,1,80,0,22,0,0,196,1,8,205,228,0.408,0.899
"15440","Oruro","Oruro","U. E. John F. Kennedy",83,0,3,3,76,4,31,0,2,202,1,7,210,231,0.376,0.909
"15441","Oruro","Oruro","U. E. John F. Kennedy",88,0,1,2,69,2,27,2,0,191,3,6,200,219,0.361,0.913
"15442","Oruro","Oruro","U. E. Juan Velez de Cordoba (Inca Pozo).",53,0,3,0,100,6,23,0,5,190,4,12,206,222,0.526,0.928
"15443","Oruro","Oruro","U. E. Juan Velez de Cordoba (Inca Pozo).",52,1,3,2,91,8,35,0,5,197,4,10,211,227,0.462,0.93
"15444","Oruro","Oruro","U. E. Juan Velez de Cordoba (Inca Pozo).",47,1,3,1,94,9,31,0,3,189,7,12,208,226,0.497,0.92
"15445","Oruro","Oruro","U. E. Juan Velez de Cordoba (Inca Pozo).",50,0,6,0,106,5,28,1,5,201,3,8,212,231,0.527,0.918
"15446","Oruro","Oruro","U. E. Juan Velez de Cordoba (Inca Pozo).",51,0,7,0,94,5,32,0,3,192,4,13,209,224,0.49,0.933
"15447","Oruro","Oruro","U. E. Juan Velez de Cordoba (Inca Pozo).",54,2,5,4,92,6,33,0,2,198,2,4,204,220,0.465,0.927
"15448","Oruro","Oruro","U. E. Juan Velez de Cordoba (Inca Pozo).",73,1,5,0,92,1,29,0,4,205,0,5,210,225,0.449,0.933
"15449","Oruro","Oruro","U. E. Juan Velez de Cordoba (Inca Pozo).",56,0,2,1,64,2,31,0,1,157,2,5,164,184,0.408,0.891
"15450","Oruro","Oruro","Inst. Normal Superior Angel Mendoza J.",102,0,1,0,71,5,15,0,2,196,5,6,207,227,0.362,0.912
"15451","Oruro","Oruro","Inst. Normal Superior Angel Mendoza J.",107,0,4,1,66,2,10,1,4,195,2,6,203,226,0.338,0.898
"15452","Oruro","Oruro","Inst. Normal Superior Angel Mendoza J.",83,0,2,1,79,2,16,1,2,186,2,6,194,220,0.425,0.882
"15453","Oruro","Oruro","Inst. Normal Superior Angel Mendoza J.",94,0,1,1,66,3,20,3,1,189,2,8,199,222,0.349,0.896
"15454","Oruro","Oruro","Inst. Normal Superior Angel Mendoza J.",100,0,2,0,71,3,19,2,1,198,1,6,205,226,0.359,0.907
"15455","Oruro","Oruro","Inst. Normal Superior Angel Mendoza J.",104,2,1,1,61,3,11,0,1,184,1,5,190,223,0.332,0.852
"15456","Oruro","Oruro","Inst. Normal Superior Angel Mendoza J.",104,0,1,0,67,4,19,2,1,198,0,4,202,226,0.338,0.894
"15457","Oruro","Oruro","Inst. Normal Superior Angel Mendoza J.",95,0,3,1,62,3,26,1,1,192,1,6,199,224,0.323,0.888
"15458","Oruro","Oruro","Inst. Normal Superior Angel Mendoza J.",118,1,0,1,59,4,17,3,0,203,2,6,211,230,0.291,0.917
"15459","Oruro","Oruro","Inst. Normal Superior Angel Mendoza J.",95,0,1,3,64,3,18,0,3,187,1,11,199,227,0.342,0.877
"15460","Oruro","Oruro","Inst. Normal Superior Angel Mendoza J.",112,1,0,3,51,5,13,1,1,187,3,9,199,226,0.273,0.881
"15461","Oruro","Oruro","Inst. Normal Superior Angel Mendoza J.",121,2,1,2,53,4,10,1,2,196,1,5,202,231,0.27,0.874
"15462","Oruro","Oruro","Inst. Normal Superior Angel Mendoza J.",103,1,0,1,52,5,16,2,3,183,1,2,186,213,0.284,0.873
"15463","Oruro","Oruro","Facultad de Medicina",84,2,0,0,91,4,24,1,1,207,2,5,214,220,0.44,0.973
"15464","Oruro","Oruro","Facultad de Medicina",97,0,3,0,77,5,23,1,1,207,1,6,214,228,0.372,0.939
"15465","Oruro","Oruro","Facultad de Medicina",87,0,2,1,76,2,38,1,2,209,4,0,213,233,0.364,0.914
"15466","Oruro","Oruro","Facultad de Medicina",87,0,0,2,82,0,32,0,2,205,3,9,217,236,0.4,0.919
"15467","Oruro","Oruro","Facultad de Medicina",106,3,0,0,68,4,16,3,3,203,1,4,208,223,0.335,0.933
"15468","Oruro","Oruro","Facultad de Medicina",85,0,0,0,84,3,21,3,1,197,1,3,201,225,0.426,0.893
"15469","Oruro","Oruro","Facultad de Medicina",88,1,2,1,79,2,22,3,5,203,1,5,209,226,0.389,0.925
"15470","Oruro","Oruro","Facultad de Medicina",117,1,2,0,69,0,10,0,2,201,1,5,207,223,0.343,0.928
"15471","Oruro","Oruro","Facultad de Medicina",97,0,0,0,67,4,21,1,3,193,3,6,202,229,0.347,0.882
"15472","Oruro","Oruro","Facultad de Medicina",123,0,0,0,55,0,22,0,3,203,2,5,210,222,0.271,0.946
"15473","Oruro","Oruro","Facultad de Medicina",106,3,3,0,68,3,31,0,0,214,0,2,216,232,0.318,0.931
"15474","Oruro","Oruro","Facultad de Medicina",111,0,0,0,57,3,19,2,4,196,0,7,203,216,0.291,0.94
"15475","Oruro","Oruro","U. E. Guido Villagomez",82,1,2,1,88,4,26,0,1,205,2,11,218,227,0.429,0.96
"15476","Oruro","Oruro","U. E. Guido Villagomez",70,1,0,1,103,3,23,0,2,203,2,6,211,227,0.507,0.93
"15477","Oruro","Oruro","U. E. Guido Villagomez",63,0,3,2,97,3,30,0,3,201,2,12,215,233,0.483,0.923
"15478","Oruro","Oruro","U. E. Guido Villagomez",88,1,0,0,86,3,20,0,5,203,2,10,215,227,0.424,0.947
"15479","Oruro","Oruro","U. E. Guido Villagomez",80,1,3,1,89,8,20,0,4,206,5,1,212,228,0.432,0.93
"15480","Oruro","Oruro","U. E. Guido Villagomez",68,1,2,0,84,7,36,1,1,200,2,12,214,232,0.42,0.922
"15481","Oruro","Oruro","U. E. Guido Villagomez",79,0,2,2,95,4,23,0,3,208,3,4,215,232,0.457,0.927
"15482","Oruro","Oruro","U. E. Guido Villagomez",69,1,0,0,94,2,25,2,6,199,3,6,208,230,0.472,0.904
"15483","Oruro","Oruro","U. E. Guido Villagomez",80,1,0,1,89,8,21,0,1,201,2,10,213,228,0.443,0.934
"15484","Oruro","Oruro","U. E. Guido Villagomez",55,0,0,1,73,2,21,1,1,154,3,4,161,167,0.474,0.964
"15485","Oruro","Oruro","U. E. Oscar Unzaga De La Vega",70,0,4,1,83,5,36,0,2,201,1,10,212,228,0.413,0.93
"15486","Oruro","Oruro","U. E. Oscar Unzaga De La Vega",75,0,2,2,84,1,30,0,3,197,2,4,203,232,0.426,0.875
"15487","Oruro","Oruro","U. E. Oscar Unzaga De La Vega",83,0,2,0,75,3,39,1,3,206,1,6,213,227,0.364,0.938
"15488","Oruro","Oruro","U. E. Oscar Unzaga De La Vega",69,0,1,2,92,2,31,2,4,203,2,8,213,230,0.453,0.926
"15489","Oruro","Oruro","U. E. Oscar Unzaga De La Vega",67,1,0,1,88,4,35,0,6,202,3,8,213,229,0.436,0.93
"15490","Oruro","Oruro","U. E. Oscar Unzaga De La Vega",66,0,5,1,76,2,44,1,4,199,1,8,208,232,0.382,0.897
"15491","Oruro","Oruro","U. E. Oscar Unzaga De La Vega",72,1,1,1,94,0,27,0,1,197,3,8,208,228,0.477,0.912
"15492","Oruro","Oruro","U. E. Oscar Unzaga De La Vega",69,0,5,0,85,2,36,0,4,201,3,8,212,232,0.423,0.914
"15493","Oruro","Oruro","U. E. Oscar Unzaga De La Vega",61,1,2,0,97,4,36,1,4,206,3,9,218,230,0.471,0.948
"15494","Oruro","Oruro","U. E. Oscar Unzaga De La Vega",80,2,0,0,87,5,31,1,0,206,2,4,212,228,0.422,0.93
"15495","Oruro","Oruro","U. E. Oscar Unzaga De La Vega",48,0,3,1,105,6,39,1,2,205,4,10,219,232,0.512,0.944
"15496","Oruro","Oruro","U. E. Oscar Unzaga De La Vega",57,0,2,2,102,2,36,2,3,206,0,3,209,229,0.495,0.913
"15497","Oruro","Oruro","U. E. Oscar Unzaga De La Vega",46,1,3,0,102,5,35,3,3,198,4,9,211,231,0.515,0.913
"15498","Oruro","Oruro","U. E. Oscar Unzaga De La Vega",68,1,1,2,91,2,30,0,5,200,2,4,206,228,0.455,0.904
"15499","Oruro","Oruro","U. E. Oscar Unzaga De La Vega",94,2,1,1,73,1,31,0,7,210,1,7,218,233,0.348,0.936
"15500","Oruro","Oruro","U. E. Oscar Unzaga De La Vega",66,0,2,1,83,4,43,0,4,203,4,6,213,223,0.409,0.955
"15501","Oruro","Oruro","U. E. Oscar Unzaga De La Vega",61,0,3,2,88,7,36,1,3,201,3,16,220,230,0.438,0.957
"15502","Oruro","Oruro","U. E. Oscar Unzaga De La Vega",60,0,3,1,91,5,36,0,2,198,3,5,206,227,0.46,0.907
"15503","Oruro","Oruro","U. E. Oscar Unzaga De La Vega",65,2,1,2,86,4,28,2,4,194,2,6,202,222,0.443,0.91
"15504","Oruro","Oruro","U. E. Oscar Unzaga De La Vega",90,0,3,1,72,4,31,0,5,206,3,7,216,229,0.35,0.943
"15505","Oruro","Oruro","U.E. Tomas Barron",59,0,2,1,87,9,33,0,2,193,3,9,205,226,0.451,0.907
"15506","Oruro","Oruro","U.E. Tomas Barron",70,1,2,1,88,3,36,0,7,208,2,9,219,231,0.423,0.948
"15507","Oruro","Oruro","U.E. Tomas Barron",70,2,4,0,88,5,37,0,2,208,1,7,216,233,0.423,0.927
"15508","Oruro","Oruro","U.E. Tomas Barron",63,1,5,1,89,6,43,2,4,214,1,5,220,230,0.416,0.957
"15509","Oruro","Oruro","U.E. Tomas Barron",79,0,3,0,85,3,37,0,3,210,3,5,218,232,0.405,0.94
"15510","Oruro","Oruro","U.E. Tomas Barron",62,1,0,1,92,2,36,1,2,197,3,11,211,229,0.467,0.921
"15511","Oruro","Oruro","U.E. Tomas Barron",55,0,7,1,97,3,30,0,1,194,5,10,209,231,0.5,0.905
"15512","Oruro","Oruro","U.E. Tomas Barron",44,0,4,1,102,2,34,0,6,193,5,11,209,229,0.528,0.913
"15513","Oruro","Oruro","U.E. Tomas Barron",56,1,11,1,82,4,38,0,3,196,3,9,208,227,0.418,0.916
"15514","Oruro","Oruro","U.E. Tomas Barron",49,1,3,0,95,6,41,0,7,202,5,5,212,229,0.47,0.926
"15515","Oruro","Oruro","U.E. Tomas Barron",52,0,4,1,100,2,33,1,6,199,3,10,212,230,0.503,0.922
"15516","Oruro","Oruro","U.E. Tomas Barron",48,0,5,2,118,4,23,0,2,202,3,3,208,232,0.584,0.897
"15517","Oruro","Oruro","U.E. Tomas Barron",81,2,4,2,76,3,28,0,2,198,2,7,207,224,0.384,0.924
"15518","Oruro","Oruro","U.E. Tomas Barron",67,2,2,0,90,3,40,0,2,206,4,11,221,229,0.437,0.965
"15519","Oruro","Oruro","U.E. Tomas Barron",67,0,3,0,98,2,28,1,3,202,1,7,210,227,0.485,0.925
"15520","Oruro","Oruro","U.E. Tomas Barron",61,1,1,0,101,4,29,0,4,201,6,5,212,229,0.502,0.926
"15521","Oruro","Oruro","U.E. Tomas Barron",65,1,3,2,89,4,40,0,0,204,0,10,214,231,0.436,0.926
"15522","Oruro","Oruro","U.E. Tomas Barron",62,1,5,1,100,4,28,0,7,208,0,7,215,226,0.481,0.951
"15523","Oruro","Oruro","U.E. Tomas Barron",75,0,5,0,97,3,20,0,2,202,2,8,212,228,0.48,0.93
"15524","Oruro","Oruro","U.E. Tomas Barron",57,3,2,0,99,5,31,1,4,202,5,7,214,227,0.49,0.943
"15525","Oruro","Oruro","U.E. Tomas Barron",59,0,4,2,91,7,24,0,4,191,2,8,201,231,0.476,0.87
"15526","Oruro","Oruro","U.E. Tomas Barron",53,1,9,0,98,1,30,0,3,195,2,13,210,226,0.503,0.929
"15527","Oruro","Oruro","U.E. Tomas Barron",53,1,2,0,90,2,44,2,2,196,3,8,207,222,0.459,0.932
"15528","Oruro","Oruro","U.E. Tomas Barron",68,1,3,0,94,2,23,1,4,196,8,3,207,229,0.48,0.904
"15529","Oruro","Oruro","U.E. Tomas Barron",71,0,1,2,81,4,35,0,1,195,4,8,207,229,0.415,0.904
"15530","Oruro","Oruro","U.E. Tomas Barron",75,1,3,4,94,2,21,0,3,203,0,7,210,229,0.463,0.917
"15531","Oruro","Oruro","U.E. Tomas Barron",70,0,1,1,92,1,31,0,3,199,2,10,211,230,0.462,0.917
"15532","Oruro","Oruro","U.E. Tomas Barron",58,0,2,0,91,1,47,0,0,199,4,6,209,232,0.457,0.901
"15533","Oruro","Oruro","U.E. Tomas Barron",66,0,2,2,88,5,42,0,0,205,1,7,213,227,0.429,0.938
"15534","Oruro","Oruro","U.E. Tomas Barron",71,2,2,0,80,8,28,0,4,195,2,9,206,229,0.41,0.9
"15535","Oruro","Oruro","U.E. Tomas Barron",75,1,2,0,90,7,31,0,2,208,1,2,211,230,0.433,0.917
"15536","Oruro","Oruro","U.E. Tomas Barron",62,1,5,3,92,1,30,6,3,203,1,7,211,227,0.453,0.93
"15537","Oruro","Oruro","U.E. Tomas Barron",51,1,2,0,99,3,28,1,5,190,2,7,199,222,0.521,0.896
"15538","Oruro","Oruro","U.E. Tomas Barron",73,0,3,0,87,3,41,1,4,212,0,7,219,229,0.41,0.956
"15539","Oruro","Oruro","U.E. Tomas Barron",61,0,3,2,94,3,26,1,4,194,1,15,210,228,0.485,0.921
"15540","Oruro","Oruro","Col. Particular Bolivia Japon",124,1,2,1,44,2,22,1,2,199,3,1,203,224,0.221,0.906
"15541","Oruro","Oruro","Col. Particular Bolivia Japon",120,0,1,1,50,3,20,3,4,202,2,2,206,228,0.248,0.904
"15542","Oruro","Oruro","Col. Particular Bolivia Japon",116,1,1,0,57,9,12,1,1,198,3,1,202,224,0.288,0.902
"15543","Oruro","Oruro","Col. Particular Bolivia Japon",117,0,1,1,46,1,25,2,1,194,4,9,207,227,0.237,0.912
"15544","Oruro","Oruro","Col. Particular Bolivia Japon",140,1,1,0,41,6,17,1,2,209,0,2,211,226,0.196,0.934
"15545","Oruro","Oruro","Col. Particular Bolivia Japon",133,0,0,2,49,5,10,0,2,201,2,2,205,221,0.244,0.928
"15546","Oruro","Oruro","Col. Particular Bolivia Japon",131,0,0,1,47,2,13,0,4,198,1,10,209,227,0.237,0.921
"15547","Oruro","Oruro","Col. Particular Bolivia Japon",103,0,0,0,30,4,15,0,0,152,0,4,156,172,0.197,0.907
"15548","Oruro","Oruro","U. E. Oscar Unzaga De La Vega II",73,0,1,0,85,4,32,0,4,199,3,9,211,234,0.427,0.902
"15549","Oruro","Oruro","U. E. Oscar Unzaga De La Vega II",57,1,2,2,87,3,35,0,2,189,6,10,205,236,0.46,0.869
"15550","Oruro","Oruro","U. E. Oscar Unzaga De La Vega II",64,0,1,1,84,3,41,0,2,196,4,2,202,231,0.429,0.874
"15551","Oruro","Oruro","U. E. Oscar Unzaga De La Vega II",67,0,0,0,90,6,33,0,3,199,3,6,208,233,0.452,0.893
"15552","Oruro","Oruro","U. E. Oscar Unzaga De La Vega II",62,0,6,1,85,1,33,1,5,194,5,7,206,230,0.438,0.896
"15553","Oruro","Oruro","U. E. Oscar Unzaga De La Vega II",70,0,2,0,82,3,34,3,6,200,2,4,206,229,0.41,0.9
"15554","Oruro","Oruro","Inst. De Aprendizaje Industrial - I.A.I.",101,1,1,1,61,1,34,1,0,201,1,4,206,223,0.303,0.924
"15555","Oruro","Oruro","Inst. De Aprendizaje Industrial - I.A.I.",101,2,2,0,58,5,24,1,3,196,1,6,203,221,0.296,0.919
"15556","Oruro","Oruro","Inst. De Aprendizaje Industrial - I.A.I.",90,0,4,1,69,5,26,1,3,199,4,10,213,225,0.347,0.947
"15557","Oruro","Oruro","Inst. De Aprendizaje Industrial - I.A.I.",100,0,3,0,79,7,24,0,2,215,0,5,220,229,0.367,0.961
"15558","Oruro","Oruro","Inst. De Aprendizaje Industrial - I.A.I.",66,1,4,1,83,3,34,1,4,197,4,10,211,229,0.421,0.921
"15559","Oruro","Oruro","Inst. De Aprendizaje Industrial - I.A.I.",74,1,4,1,70,15,36,0,3,204,3,7,214,228,0.343,0.939
"15560","Oruro","Oruro","Inst. De Aprendizaje Industrial - I.A.I.",99,1,1,3,59,3,26,1,3,196,1,6,203,222,0.301,0.914
"15561","Oruro","Oruro","Inst. De Aprendizaje Industrial - I.A.I.",99,0,0,3,64,3,32,1,3,205,2,6,213,230,0.312,0.926
"15562","Oruro","Oruro","Inst. De Aprendizaje Industrial - I.A.I.",86,0,2,0,83,2,24,0,2,199,1,7,207,227,0.417,0.912
"15563","Oruro","Oruro","Inst. De Aprendizaje Industrial - I.A.I.",92,1,1,1,73,3,30,3,4,208,1,4,213,232,0.351,0.918
"15564","Oruro","Oruro","Inst. De Aprendizaje Industrial - I.A.I.",78,0,3,2,67,2,42,1,7,202,1,5,208,227,0.332,0.916
"15565","Oruro","Oruro","Inst. De Aprendizaje Industrial - I.A.I.",84,1,3,0,70,2,22,3,6,191,3,10,204,223,0.366,0.915
"15566","Oruro","Oruro","Inst. De Aprendizaje Industrial - I.A.I.",99,1,0,0,68,5,20,0,4,197,1,6,204,221,0.345,0.923
"15567","Oruro","Oruro","Inst. De Aprendizaje Industrial - I.A.I.",95,2,2,1,60,3,32,2,3,200,2,2,204,223,0.3,0.915
"15568","Oruro","Oruro","Inst. De Aprendizaje Industrial - I.A.I.",87,2,2,0,67,6,27,1,5,197,4,9,210,226,0.34,0.929
"15569","Oruro","Oruro","Inst. De Aprendizaje Industrial - I.A.I.",113,3,3,0,59,6,23,1,1,209,1,7,217,228,0.282,0.952
"15570","Oruro","Oruro","Inst. De Aprendizaje Industrial - I.A.I.",101,2,4,1,65,3,21,1,1,199,1,8,208,226,0.327,0.92
"15571","Oruro","Oruro","Inst. De Aprendizaje Industrial - I.A.I.",109,0,0,0,67,1,34,0,1,212,2,9,223,233,0.316,0.957
"15572","Oruro","Oruro","Inst. De Aprendizaje Industrial - I.A.I.",89,0,1,0,58,4,25,1,2,180,3,5,188,212,0.322,0.887
"15573","Oruro","Oruro","U. Esc. Kantuta",60,3,2,2,81,1,43,1,5,198,2,8,208,233,0.409,0.893
"15574","Oruro","Oruro","U. Esc. Kantuta",65,1,1,1,79,5,39,2,3,196,1,9,206,225,0.403,0.916
"15575","Oruro","Oruro","U. Esc. Kantuta",85,0,0,1,71,4,38,1,4,204,1,3,208,224,0.348,0.929
"15576","Oruro","Oruro","U. Esc. Kantuta",69,3,1,1,86,3,37,0,0,200,2,8,210,226,0.43,0.929
"15577","Oruro","Oruro","U. Esc. Kantuta",46,0,3,1,85,4,54,0,5,198,1,3,202,223,0.429,0.906
"15578","Oruro","Oruro","U. Esc. Kantuta",46,1,4,1,78,7,37,3,10,187,4,12,203,229,0.417,0.886
"15579","Oruro","Oruro","U. Esc. Kantuta",66,1,1,0,86,1,45,2,2,204,2,6,212,230,0.422,0.922
"15580","Oruro","Oruro","U. Esc. Kantuta",58,0,5,1,91,2,31,1,4,193,4,8,205,222,0.472,0.923
"15581","Oruro","Oruro","U. Esc. Kantuta",53,1,3,0,100,2,41,1,1,202,3,5,210,228,0.495,0.921
"15582","Oruro","Oruro","U. Esc. Kantuta",88,3,1,1,80,3,25,1,7,209,2,7,218,230,0.383,0.948
"15583","Oruro","Oruro","U. Esc. Kantuta",69,1,0,1,87,1,27,0,3,189,5,14,208,228,0.46,0.912
"15584","Oruro","Oruro","U. Esc. Kantuta",74,1,6,3,81,3,27,2,3,200,4,11,215,230,0.405,0.935
"15585","Oruro","Oruro","U. Esc. Kantuta",56,2,3,0,94,3,41,1,5,205,4,6,215,236,0.459,0.911
"15586","Oruro","Oruro","U. Esc. Kantuta",49,0,3,0,89,2,43,0,5,191,3,10,204,230,0.466,0.887
"15587","Oruro","Oruro","U. Esc. Kantuta",53,0,2,2,84,4,51,0,3,199,3,7,209,227,0.422,0.921
"15588","Oruro","Oruro","U. Esc. Kantuta",73,2,1,1,76,5,40,1,2,201,3,7,211,227,0.378,0.93
"15589","Oruro","Oruro","U. Esc. Kantuta",73,1,3,1,81,12,23,0,6,200,2,8,210,230,0.405,0.913
"15590","Oruro","Oruro","U. Esc. Kantuta",74,0,4,2,80,1,29,4,3,197,2,10,209,228,0.406,0.917
"15591","Oruro","Oruro","U. Esc. Kantuta",58,2,3,0,84,3,33,1,6,190,2,4,196,223,0.442,0.879
"15592","Oruro","Oruro","U. Esc. Kantuta",79,0,1,0,71,3,36,2,7,199,1,8,208,229,0.357,0.908
"15593","Oruro","Oruro","U. Esc. Kantuta",80,0,4,0,74,5,28,0,2,193,1,8,202,230,0.383,0.878
"15594","Oruro","Oruro","U. Esc. Kantuta",76,0,5,0,65,4,45,0,3,198,2,4,204,222,0.328,0.919
"15595","Oruro","Oruro","U. Esc. Kantuta",66,0,0,0,88,6,24,0,6,190,0,14,204,225,0.463,0.907
"15596","Oruro","Oruro","U.E. Huajara",77,0,3,0,87,4,26,1,6,204,4,4,212,230,0.426,0.922
"15597","Oruro","Oruro","U.E. Huajara",78,0,1,0,81,5,30,1,2,198,5,9,212,230,0.409,0.922
"15598","Oruro","Oruro","U.E. Huajara",73,0,3,2,96,2,35,0,4,215,2,1,218,230,0.447,0.948
"15599","Oruro","Oruro","U.E. Huajara",102,0,3,0,77,1,29,0,3,215,2,5,222,231,0.358,0.961
"15600","Oruro","Oruro","U.E. Huajara",51,0,2,2,101,6,33,0,0,195,2,10,207,223,0.518,0.928
"15601","Oruro","Oruro","U.E. Huajara",70,1,2,2,104,3,29,0,3,214,1,5,220,235,0.486,0.936
"15602","Oruro","Oruro","U.E. Huajara",70,0,1,1,94,1,37,1,1,206,3,8,217,232,0.456,0.935
"15603","Oruro","Oruro","U.E. Huajara",78,0,1,1,84,3,30,0,6,203,2,6,211,226,0.414,0.934
"15604","Oruro","Oruro","U.E. Huajara",81,1,3,2,87,4,24,0,3,205,1,10,216,234,0.424,0.923
"15605","Oruro","Oruro","U.E. Huajara",71,2,3,1,82,5,33,1,3,201,0,7,208,226,0.408,0.92
"15606","Oruro","Oruro","U.E. Huajara",63,0,0,0,94,1,39,0,1,198,3,12,213,227,0.475,0.938
"15607","Oruro","Oruro","U.E. Huajara",78,0,4,1,77,4,36,2,4,206,4,8,218,233,0.374,0.936
"15608","Oruro","Oruro","U.E. Huajara",43,0,7,1,112,4,30,1,4,202,2,8,212,229,0.554,0.926
"15609","Oruro","Oruro","U.E. Huajara",74,1,3,1,73,4,39,1,1,197,1,7,205,225,0.371,0.911
"15610","Oruro","Oruro","U.E. Huajara",96,1,0,1,70,4,19,1,4,196,2,6,204,229,0.357,0.891
"15611","Oruro","Oruro","U.E. Huajara",78,0,1,1,93,3,23,3,2,204,3,5,212,229,0.456,0.926
"15612","Oruro","Oruro","U.E. Huajara",76,2,3,1,76,3,33,0,6,200,2,8,210,228,0.38,0.921
"15613","Oruro","Oruro","U.E. Huajara",79,0,2,1,90,3,31,0,1,207,1,6,214,230,0.435,0.93
"15614","Oruro","Oruro","U.E. Huajara",70,1,2,1,79,1,37,1,2,194,8,5,207,226,0.407,0.916
"15615","Oruro","Oruro","U.E. Huajara",90,0,1,0,77,5,24,1,2,200,3,11,214,231,0.385,0.926
"15616","Oruro","Oruro","U. E. Kantuta II (Josermo Murillo)",47,0,2,1,82,1,60,0,3,196,5,13,214,238,0.418,0.899
"15617","Oruro","Oruro","U. E. Kantuta II (Josermo Murillo)",67,0,4,1,75,2,46,0,5,200,3,9,212,234,0.375,0.906
"15618","Oruro","Oruro","U. E. Kantuta II (Josermo Murillo)",45,0,1,0,90,3,56,0,4,199,1,12,212,230,0.452,0.922
"15619","Oruro","Oruro","U. E. Kantuta II (Josermo Murillo)",41,1,1,0,102,4,48,1,3,201,4,6,211,229,0.507,0.921
"15620","Oruro","Oruro","U. E. Kantuta II (Josermo Murillo)",49,1,7,0,84,6,53,0,7,207,3,10,220,236,0.406,0.932
"15621","Oruro","Oruro","U. E. Kantuta II (Josermo Murillo)",60,1,2,1,90,2,39,1,7,203,1,10,214,230,0.443,0.93
"15622","Oruro","Oruro","U. E. Kantuta II (Josermo Murillo)",52,1,2,0,107,3,33,0,3,201,4,14,219,231,0.532,0.948
"15623","Oruro","Oruro","U. E. Kantuta II (Josermo Murillo)",53,0,2,2,101,4,44,1,4,211,2,5,218,228,0.479,0.956
"15624","Oruro","Oruro","U. E. Kantuta II (Josermo Murillo)",32,0,4,1,110,3,42,0,2,194,7,14,215,237,0.567,0.907
"15625","Oruro","Oruro","U. E. Kantuta II (Josermo Murillo)",75,0,0,1,85,3,39,0,5,208,3,6,217,229,0.409,0.948
"15626","Oruro","Oruro","U. E. Kantuta II (Josermo Murillo)",49,0,0,0,102,6,34,0,3,194,5,22,221,234,0.526,0.944
"15627","Oruro","Oruro","U. E. Kantuta II (Josermo Murillo)",59,1,0,0,89,2,44,1,7,203,1,18,222,233,0.438,0.953
"15628","Oruro","Oruro","U. E. Kantuta II (Josermo Murillo)",54,1,6,2,98,5,39,0,5,210,2,9,221,237,0.467,0.932
"15629","Oruro","Oruro","Facultad Técnica",126,1,0,0,54,6,13,2,1,203,2,2,207,225,0.266,0.92
"15630","Oruro","Oruro","Facultad Técnica",135,1,0,1,36,4,7,1,4,189,4,6,199,224,0.19,0.888
"15631","Oruro","Oruro","Facultad Técnica",124,1,0,1,48,7,13,2,1,197,3,6,206,223,0.244,0.924
"15632","Oruro","Oruro","Facultad Técnica",130,0,0,0,53,2,10,1,0,196,3,7,206,226,0.27,0.912
"15633","Oruro","Oruro","Facultad Técnica",134,0,1,1,48,4,7,2,3,200,2,2,204,224,0.24,0.911
"15634","Oruro","Oruro","Facultad Técnica",131,0,0,1,35,2,14,3,2,188,1,6,195,216,0.186,0.903
"15635","Oruro","Oruro","Facultad Técnica",133,0,0,0,47,2,12,0,3,197,1,6,204,222,0.239,0.919
"15636","Oruro","Oruro","Facultad Técnica",144,1,1,0,38,1,7,4,1,197,2,7,206,222,0.193,0.928
"15637","Oruro","Oruro","Facultad Técnica",138,0,3,0,51,7,13,0,0,212,2,4,218,230,0.241,0.948
"15638","Oruro","Oruro","Facultad Técnica",143,1,1,1,36,3,10,0,0,195,3,7,205,222,0.185,0.923
"15639","Oruro","Oruro","Facultad Técnica",126,1,1,3,37,3,16,4,2,193,3,4,200,220,0.192,0.909
"15640","Oruro","Oruro","Facultad Técnica",106,0,0,1,51,4,12,1,3,178,1,4,183,194,0.287,0.943
"15641","Oruro","Oruro","CEMEI",125,1,2,1,57,3,17,1,2,209,0,3,212,226,0.273,0.938
"15642","Oruro","Oruro","CEMEI",125,2,0,1,50,2,13,1,3,197,0,9,206,228,0.254,0.904
"15643","Oruro","Oruro","CEMEI",89,0,1,0,47,3,12,0,2,154,0,2,156,177,0.305,0.881
"15644","Oruro","Oruro","U. Esc. Francisco Fajardo",109,0,4,0,53,7,16,0,1,190,1,7,198,219,0.279,0.904
"15645","Oruro","Oruro","U. Esc. Francisco Fajardo",86,0,2,1,81,3,17,1,1,192,2,11,205,224,0.422,0.915
"15646","Oruro","Oruro","U. Esc. Francisco Fajardo",90,2,3,2,61,4,31,0,1,194,1,7,202,219,0.314,0.922
"15647","Oruro","Oruro","U. Esc. Francisco Fajardo",105,0,2,2,61,3,12,2,6,193,1,8,202,225,0.316,0.898
"15648","Oruro","Oruro","U. Esc. Francisco Fajardo",106,0,0,0,64,7,15,1,0,193,1,13,207,231,0.332,0.896
"15649","Oruro","Oruro","U. Esc. Francisco Fajardo",91,0,1,1,78,4,26,0,4,205,2,3,210,221,0.38,0.95
"15650","Oruro","Oruro","U. Esc. Francisco Fajardo",111,1,0,2,63,5,16,0,4,202,0,7,209,224,0.312,0.933
"15651","Oruro","Oruro","U. Esc. Francisco Fajardo",121,0,2,0,61,1,13,1,1,200,3,7,210,227,0.305,0.925
"15652","Oruro","Oruro","U. Esc. Francisco Fajardo",114,0,1,0,58,4,22,0,1,200,1,10,211,224,0.29,0.942
"15653","Oruro","Oruro","U. Esc. Francisco Fajardo",111,0,0,1,78,4,10,1,1,206,0,1,207,227,0.379,0.912
"15654","Oruro","Oruro","U. Esc. Melvin Jones",96,0,0,1,71,4,25,1,2,200,2,5,207,224,0.355,0.924
"15655","Oruro","Oruro","U. Esc. Melvin Jones",104,0,2,0,66,2,15,1,4,194,3,7,204,226,0.34,0.903
"15656","Oruro","Oruro","U. Esc. Melvin Jones",96,1,1,1,66,6,27,0,2,200,0,6,206,226,0.33,0.912
"15657","Oruro","Oruro","U. Esc. Melvin Jones",105,0,1,2,57,3,30,0,2,200,0,6,206,227,0.285,0.907
"15658","Oruro","Oruro","U. Esc. Melvin Jones",90,1,1,1,60,4,30,1,3,191,2,12,205,226,0.314,0.907
"15659","Oruro","Oruro","U. Esc. Melvin Jones",92,1,1,0,64,3,30,1,6,198,1,2,201,220,0.323,0.914
"15660","Oruro","Oruro","U. Esc. Melvin Jones",113,0,0,1,57,4,24,0,2,201,1,5,207,230,0.284,0.9
"15661","Oruro","Oruro","U. Esc. Melvin Jones",112,0,2,1,63,6,20,1,4,209,0,5,214,232,0.301,0.922
"15662","Oruro","Oruro","U. Esc. Melvin Jones",103,0,0,0,65,6,23,0,1,198,5,8,211,224,0.328,0.942
"15663","Oruro","Oruro","U. Esc. Melvin Jones",115,0,1,0,67,2,23,1,3,212,4,6,222,245,0.316,0.906
"15664","Oruro","Oruro","U. Esc. Sebastian Pagador(Primario)",130,0,2,1,52,2,14,1,2,204,2,5,211,231,0.255,0.913
"15665","Oruro","Oruro","U. Esc. Sebastian Pagador(Primario)",120,3,1,1,59,3,13,1,1,202,0,7,209,225,0.292,0.929
"15666","Oruro","Oruro","U. Esc. Sebastian Pagador(Primario)",112,1,2,1,63,0,16,1,3,199,2,3,204,228,0.317,0.895
"15667","Oruro","Oruro","U. Esc. Sebastian Pagador(Primario)",119,0,0,0,58,2,12,2,4,197,2,4,203,225,0.294,0.902
"15668","Oruro","Oruro","U. Esc. Sebastian Pagador(Primario)",124,0,2,0,56,2,21,0,1,206,2,3,211,225,0.272,0.938
"15669","Oruro","Oruro","U. Esc. Sebastian Pagador(Primario)",125,0,3,0,53,1,18,2,3,205,2,2,209,229,0.259,0.913
"15670","Oruro","Oruro","U. Esc. Sebastian Pagador(Primario)",136,1,0,0,49,0,13,1,4,204,1,1,206,223,0.24,0.924
"15671","Oruro","Oruro","U. Esc. Sebastian Pagador(Primario)",131,0,0,0,59,1,14,0,3,208,2,2,212,233,0.284,0.91
"15672","Oruro","Oruro","U. E. Virgen Del Mar II",106,0,4,1,71,7,23,1,1,214,7,4,225,236,0.332,0.953
"15673","Oruro","Oruro","U. E. Virgen Del Mar II",105,0,1,0,64,5,30,1,1,207,1,8,216,231,0.309,0.935
"15674","Oruro","Oruro","U. E. Virgen Del Mar II",84,0,3,2,76,4,37,0,2,208,2,10,220,235,0.365,0.936
"15675","Oruro","Oruro","U. E. Virgen Del Mar II",84,2,2,1,68,4,35,0,4,200,1,12,213,235,0.34,0.906
"15676","Oruro","Oruro","U. E. Virgen Del Mar II",93,0,2,0,79,4,22,1,3,204,2,6,212,230,0.387,0.922
"15677","Oruro","Oruro","U. E. Virgen Del Mar II",96,0,2,0,77,6,19,0,4,204,3,4,211,235,0.377,0.898
"15678","Oruro","Oruro","U. E. Virgen Del Mar II",72,0,2,3,81,5,34,0,1,198,2,8,208,232,0.409,0.897
"15679","Oruro","Oruro","U. E. Virgen Del Mar II",89,0,3,2,71,2,29,1,1,198,2,7,207,231,0.359,0.896
"15680","Oruro","Oruro","U. E. Virgen Del Mar II",120,0,1,0,60,1,23,2,1,208,1,8,217,230,0.288,0.943
"15681","Oruro","Oruro","U. E. Virgen Del Mar II",82,4,2,2,84,5,21,1,0,201,4,8,213,233,0.418,0.914
"15682","Oruro","Oruro","U. E. Virgen Del Mar II",125,2,2,0,57,1,20,0,0,207,0,10,217,230,0.275,0.943
"15683","Oruro","Oruro","U. E. Virgen Del Mar II",113,0,2,0,55,5,24,4,1,204,3,7,214,229,0.27,0.934
"15684","Oruro","Oruro","U. E. Virgen Del Mar II",93,0,3,0,83,2,19,1,1,202,3,5,210,225,0.411,0.933
"15685","Oruro","Oruro","Esc. Mixta Ferroviaria",119,0,2,1,51,6,12,1,2,194,1,3,198,218,0.263,0.908
"15686","Oruro","Oruro","Esc. Mixta Ferroviaria",118,0,2,1,51,5,12,1,4,194,1,4,199,220,0.263,0.905
"15687","Oruro","Oruro","Esc. Mixta Ferroviaria",134,0,0,0,41,1,21,0,0,197,2,7,206,225,0.208,0.916
"15688","Oruro","Oruro","Esc. Mixta Ferroviaria",110,0,0,0,70,0,12,1,3,196,1,5,202,215,0.357,0.94
"15689","Oruro","Oruro","Esc. Mixta Ferroviaria",105,0,0,1,69,3,25,1,1,205,2,6,213,225,0.337,0.947
"15690","Oruro","Oruro","Esc. Mixta Ferroviaria",123,0,0,2,56,3,9,1,0,194,1,4,199,219,0.289,0.909
"15691","Oruro","Oruro","Esc. Mixta Ferroviaria",127,1,1,1,56,4,9,1,1,201,1,3,205,231,0.279,0.887
"15692","Oruro","Oruro","Esc. Mixta Ferroviaria",129,0,0,1,53,3,13,0,2,201,0,6,207,231,0.264,0.896
"15693","Oruro","Oruro","Esc. Mixta Ferroviaria",116,1,1,1,54,2,18,0,0,193,1,7,201,220,0.28,0.914
"15694","Oruro","Oruro","Esc. Mixta Ferroviaria",126,1,3,1,44,4,19,0,4,202,0,4,206,228,0.218,0.904
"15695","Oruro","Oruro","Esc. Mixta Ferroviaria",114,0,3,2,51,4,28,0,0,202,1,4,207,224,0.252,0.924
"15696","Oruro","Oruro","Esc. Mixta Ferroviaria",127,0,1,0,52,2,14,3,1,200,0,4,204,222,0.26,0.919
"15697","Oruro","Oruro","Esc. Mixta Ferroviaria",137,1,1,1,47,2,15,2,0,206,0,7,213,224,0.228,0.951
"15698","Oruro","Oruro","Esc. Mixta Ferroviaria",119,2,1,1,47,2,20,1,1,194,4,8,206,231,0.242,0.892
"15699","Oruro","Oruro","Esc. Mixta Ferroviaria",122,1,2,0,47,5,17,1,2,197,1,3,201,221,0.239,0.91
"15700","Oruro","Oruro","Esc. Mixta Ferroviaria",127,2,1,3,52,2,14,2,0,203,0,5,208,223,0.256,0.933
"15701","Oruro","Oruro","Esc. Mixta Ferroviaria",128,0,0,0,41,4,16,1,2,192,1,3,196,221,0.214,0.887
"15702","Oruro","Oruro","Esc. Mixta Ferroviaria",128,0,0,0,52,2,23,0,1,206,1,5,212,221,0.252,0.959
"15703","Oruro","Oruro","U. E. Misael Pacheco Loma",101,0,3,2,56,6,24,2,4,198,3,9,210,230,0.283,0.913
"15704","Oruro","Oruro","U. E. Misael Pacheco Loma",95,0,2,2,64,2,27,1,4,197,0,6,203,225,0.325,0.902
"15705","Oruro","Oruro","U. E. Misael Pacheco Loma",92,1,2,1,65,4,33,2,4,204,1,6,211,233,0.319,0.906
"15706","Oruro","Oruro","U. E. Misael Pacheco Loma",119,2,2,0,64,1,17,0,4,209,2,10,221,234,0.306,0.944
"15707","Oruro","Oruro","U. E. Misael Pacheco Loma",96,3,2,0,70,6,29,1,3,210,2,3,215,232,0.333,0.927
"15708","Oruro","Oruro","U. E. Misael Pacheco Loma",110,0,3,1,47,5,33,1,0,200,0,10,210,227,0.235,0.925
"15709","Oruro","Oruro","U. E. Misael Pacheco Loma",105,1,2,3,54,6,27,0,2,200,2,6,208,227,0.27,0.916
"15710","Oruro","Oruro","U. E. Misael Pacheco Loma",107,1,1,2,65,6,27,1,1,211,2,3,216,230,0.308,0.939
"15711","Oruro","Oruro","Col. Nal. Mixto Carmen Guzman De Mier",75,0,4,0,71,2,33,0,6,191,2,11,204,225,0.372,0.907
"15712","Oruro","Oruro","Col. Nal. Mixto Carmen Guzman De Mier",78,2,4,5,70,5,29,1,0,194,3,4,201,222,0.361,0.905
"15713","Oruro","Oruro","Col. Nal. Mixto Carmen Guzman De Mier",80,2,1,3,68,4,32,0,1,191,2,7,200,224,0.356,0.893
"15714","Oruro","Oruro","Col. Nal. Mixto Carmen Guzman De Mier",99,1,1,0,63,6,23,0,0,193,2,12,207,226,0.326,0.916
"15715","Oruro","Oruro","Col. Nal. Mixto Carmen Guzman De Mier",91,0,1,0,80,3,26,0,1,202,1,5,208,225,0.396,0.924
"15716","Oruro","Oruro","Col. Nal. Mixto Carmen Guzman De Mier",69,0,4,1,77,2,45,0,1,199,3,7,209,229,0.387,0.913
"15717","Oruro","Oruro","Col. Nal. Mixto Carmen Guzman De Mier",79,0,5,2,90,3,22,1,5,207,2,3,212,229,0.435,0.926
"15718","Oruro","Oruro","Col. Nal. Mixto Carmen Guzman De Mier",79,0,1,1,81,3,27,0,1,193,7,11,211,227,0.42,0.93
"15719","Oruro","Oruro","Col. Nal. Mixto Carmen Guzman De Mier",84,0,3,2,71,0,37,0,3,200,3,6,209,232,0.355,0.901
"15720","Oruro","Oruro","Col. Nal. Mixto Carmen Guzman De Mier",92,1,1,2,75,8,20,1,1,201,1,9,211,227,0.373,0.93
"15721","Oruro","Oruro","Col. Nal. Mixto Carmen Guzman De Mier",96,0,1,0,69,0,37,2,2,207,2,7,216,232,0.333,0.931
"15722","Oruro","Oruro","Col. Nal. Mixto Carmen Guzman De Mier",95,0,2,3,74,4,24,0,1,203,3,7,213,229,0.365,0.93
"15723","Oruro","Oruro","Col. Nal. Mixto Carmen Guzman De Mier",104,2,4,2,52,2,28,0,3,197,1,8,206,225,0.264,0.916
"15724","Oruro","Oruro","Col. Nal. Mixto Carmen Guzman De Mier",83,1,1,0,76,5,31,0,4,201,1,8,210,232,0.378,0.905
"15725","Oruro","Oruro","Col. Nal. Mixto Carmen Guzman De Mier",88,0,3,2,74,6,23,0,2,198,0,11,209,222,0.374,0.941
"15726","Oruro","Oruro","Col. Nal. Mixto Carmen Guzman De Mier",75,0,4,1,78,9,27,2,2,198,3,5,206,227,0.394,0.907
"15727","Oruro","Oruro","Col. Nal. Mixto Carmen Guzman De Mier",65,1,4,1,80,1,38,0,1,191,5,12,208,223,0.419,0.933
"15728","Oruro","Oruro","Col. Nal. Mixto Carmen Guzman De Mier",62,2,0,0,88,5,32,1,2,192,0,7,199,218,0.458,0.913
"15729","Oruro","Oruro","Col. Nal. Mixto Carmen Guzman De Mier",97,0,0,1,78,6,15,1,5,203,5,6,214,223,0.384,0.96
"15730","Oruro","Oruro","Col. Nal. Mixto Carmen Guzman De Mier",86,1,3,1,78,3,27,0,6,205,4,3,212,224,0.38,0.946
"15731","Oruro","Oruro","Col. Nal. Mixto Carmen Guzman De Mier",94,2,8,0,67,3,27,1,2,204,1,3,208,222,0.328,0.937
"15732","Oruro","Oruro","Col. Nal. Mixto Carmen Guzman De Mier",88,0,3,0,68,3,31,0,3,196,1,7,204,224,0.347,0.911
"15733","Oruro","Oruro","Col. Nal. Mixto Carmen Guzman De Mier",71,0,4,1,82,2,32,0,4,196,3,6,205,229,0.418,0.895
"15734","Oruro","Oruro","Col. Nal. Mixto Carmen Guzman De Mier",91,2,0,2,65,4,18,2,4,188,3,10,201,218,0.346,0.922
"15735","Oruro","Oruro","Col. Nal. Mixto Carmen Guzman De Mier",98,0,2,0,76,2,23,0,10,211,1,6,218,231,0.36,0.944
"15736","Oruro","Oruro","Col. Nal. Mixto Carmen Guzman De Mier",85,0,2,3,75,5,28,1,2,201,3,7,211,228,0.373,0.925
"15737","Oruro","Oruro","Col. Nal. Mixto Carmen Guzman De Mier",94,2,3,1,69,3,23,1,3,199,1,10,210,232,0.347,0.905
"15738","Oruro","Oruro","Col. Nal. Mixto Carmen Guzman De Mier",93,0,2,2,77,4,18,0,4,200,3,4,207,225,0.385,0.92
"15739","Oruro","Oruro","U. E. Santa Rosa",77,0,1,0,90,2,28,1,0,199,0,5,204,227,0.452,0.899
"15740","Oruro","Oruro","U. E. Santa Rosa",83,1,0,1,72,0,32,1,3,193,1,9,203,229,0.373,0.886
"15741","Oruro","Oruro","U. E. Santa Rosa",58,0,2,0,99,4,32,0,2,197,1,8,206,227,0.503,0.907
"15742","Oruro","Oruro","U. E. Santa Rosa",87,1,1,1,76,0,36,1,2,205,2,5,212,229,0.371,0.926
"15743","Oruro","Oruro","U. E. Santa Rosa",78,0,4,1,80,3,32,1,1,200,0,7,207,223,0.4,0.928
"15744","Oruro","Oruro","U. E. Santa Rosa",71,0,2,1,76,3,38,2,6,199,3,8,210,234,0.382,0.897
"15745","Oruro","Oruro","U. E. Santa Rosa",75,0,3,2,81,1,29,0,4,195,3,5,203,231,0.415,0.879
"15746","Oruro","Oruro","U. E. Santa Rosa",81,3,1,2,73,5,22,1,2,190,2,11,203,227,0.384,0.894
"15747","Oruro","Oruro","U. E. Santa Rosa",97,0,1,2,72,4,29,1,3,209,2,5,216,234,0.344,0.923
"15748","Oruro","Oruro","U. E. Santa Rosa",81,0,3,1,82,6,28,1,8,210,1,8,219,235,0.39,0.932
"15749","Oruro","Oruro","U. E. Santa Rosa",88,0,2,1,80,2,22,1,3,199,3,6,208,230,0.402,0.904
"15750","Oruro","Oruro","Inicial Carmen Guzman De Mier",83,0,2,0,74,3,40,0,2,204,1,5,210,233,0.363,0.901
"15751","Oruro","Oruro","Inicial Carmen Guzman De Mier",76,2,0,0,84,3,39,1,5,210,4,4,218,236,0.4,0.924
"15752","Oruro","Oruro","Inicial Carmen Guzman De Mier",91,1,1,1,68,2,26,0,5,195,1,5,201,220,0.349,0.914
"15753","Oruro","Oruro","U.E. Aby Ayala  (Magdalena Postel II)",69,2,5,1,100,5,32,0,6,220,3,2,225,238,0.455,0.945
"15754","Oruro","Oruro","U.E. Aby Ayala  (Magdalena Postel II)",87,0,3,0,90,3,29,0,7,219,2,6,227,236,0.411,0.962
"15755","Oruro","Oruro","U.E. Aby Ayala  (Magdalena Postel II)",83,0,4,1,90,7,30,1,3,219,1,6,226,238,0.411,0.95
"15756","Oruro","Oruro","U.E. Aby Ayala  (Magdalena Postel II)",76,0,2,2,77,5,33,0,3,198,4,13,215,222,0.389,0.968
"15757","Oruro","Oruro","U.E. Bolivia Vinto",33,0,4,1,106,5,43,0,6,198,2,11,211,231,0.535,0.913
"15758","Oruro","Oruro","U.E. Bolivia Vinto",46,1,3,1,95,12,36,1,1,196,6,12,214,232,0.485,0.922
"15759","Oruro","Oruro","U.E. Bolivia Vinto",36,0,3,0,98,3,36,1,5,182,5,21,208,232,0.538,0.897
"15760","Oruro","Oruro","U.E. Bolivia Vinto",33,1,1,0,108,1,36,1,0,181,1,4,186,228,0.597,0.816
"15761","Oruro","Oruro","U.E. Bolivia Vinto",36,0,0,0,117,6,39,1,1,200,2,13,215,233,0.585,0.923
"15762","Oruro","Oruro","U.E. Bolivia Vinto",42,0,2,0,128,4,24,1,2,203,2,11,216,235,0.631,0.919
"15763","Oruro","Oruro","U.E. Bolivia Vinto",38,4,3,0,112,4,34,0,2,197,4,7,208,232,0.569,0.897
"15764","Oruro","Oruro","U.E. Bolivia Vinto",34,1,1,1,108,0,41,0,3,189,1,7,197,224,0.571,0.879
"15765","Oruro","Oruro","U.E. Bolivia Vinto",42,0,1,4,104,2,47,0,1,201,2,8,211,232,0.517,0.909
"15766","Oruro","Oruro","U.E. Bolivia Vinto",39,0,4,0,114,2,39,1,2,201,2,10,213,232,0.567,0.918
"15767","Oruro","Oruro","U.E. Bolivia Vinto",40,0,1,2,121,8,26,1,2,201,1,8,210,230,0.602,0.913
"15768","Oruro","Oruro","U.E. Bolivia Vinto",46,1,1,0,117,6,24,0,1,196,3,8,207,233,0.597,0.888
"15769","Oruro","Oruro","U.E. Bolivia Vinto",36,0,3,0,102,1,33,0,3,178,4,26,208,236,0.573,0.881
"15770","Oruro","Oruro","U.E. Bolivia Vinto",39,0,2,2,118,1,34,0,6,202,2,4,208,231,0.584,0.9
"15771","Oruro","Oruro","U.E. Bolivia Vinto",50,1,1,1,106,5,39,1,2,206,4,6,216,230,0.515,0.939
"15772","Oruro","Oruro","U.E. Bolivia Vinto",36,2,0,2,124,4,24,2,5,199,5,11,215,230,0.623,0.935
"15773","Oruro","Oruro","U.E. Bolivia Vinto",27,0,6,0,109,5,45,1,4,197,4,8,209,230,0.553,0.909
"15774","Oruro","Oruro","U.E. Bolivia Vinto",35,0,3,0,109,4,43,1,2,197,0,9,206,233,0.553,0.884
"15775","Oruro","Oruro","U.E. Bolivia Vinto",51,0,1,0,124,4,24,1,3,208,5,5,218,233,0.596,0.936
"15776","Oruro","Oruro","U.E. Bolivia Vinto",41,0,4,0,106,5,38,0,2,196,4,10,210,226,0.541,0.929
"15777","Oruro","Oruro","U.E. Bolivia Vinto",32,0,2,0,103,4,36,1,7,185,4,18,207,233,0.557,0.888
"15778","Oruro","Oruro","U.E. Bolivia Vinto",53,0,5,0,101,1,37,0,4,201,4,4,209,230,0.502,0.909
"15779","Oruro","Oruro","U.E. Bolivia Vinto",39,0,2,1,112,5,29,0,2,190,7,5,202,229,0.589,0.882
"15780","Oruro","Oruro","U.E. Bolivia Vinto",34,0,0,0,122,5,39,0,1,201,2,9,212,229,0.607,0.926
"15781","Oruro","Oruro","U.E. Bolivia Vinto",48,0,5,1,95,5,36,0,5,195,4,5,204,231,0.487,0.883
"15782","Oruro","Oruro","U.E. Bolivia Vinto",39,0,0,1,81,4,34,0,0,159,5,8,172,185,0.509,0.93
"15783","Oruro","Oruro","U.E. Los Angeles De Nazaria Ignacia",34,2,3,5,124,3,31,0,2,204,2,10,216,230,0.608,0.939
"15784","Oruro","Oruro","U.E. Los Angeles De Nazaria Ignacia",29,0,5,1,127,1,33,0,3,199,7,13,219,232,0.638,0.944
"15785","Oruro","Oruro","U.E. Los Angeles De Nazaria Ignacia",33,0,4,0,108,2,50,2,3,202,7,8,217,232,0.535,0.935
"15786","Oruro","Oruro","U.E. Los Angeles De Nazaria Ignacia",27,1,2,0,127,4,34,3,5,203,5,11,219,233,0.626,0.94
"15787","Oruro","Oruro","U.E. Los Angeles De Nazaria Ignacia",36,0,1,1,144,0,25,0,1,208,9,8,225,234,0.692,0.962
"15788","Oruro","Oruro","U.E. Los Angeles De Nazaria Ignacia",33,0,1,1,134,0,23,1,4,197,7,12,216,229,0.68,0.943
"15789","Oruro","Oruro","U.E. El Carmen",62,1,1,0,90,4,44,3,4,209,0,9,218,232,0.431,0.94
"15790","Oruro","Oruro","U.E. El Carmen",46,1,0,0,107,4,39,0,3,200,3,9,212,233,0.535,0.91
"15791","Oruro","Oruro","U.E. El Carmen",45,2,1,0,94,0,43,4,4,193,5,11,209,227,0.487,0.921
"15792","Oruro","Oruro","U.E. El Carmen",52,0,0,1,106,3,34,1,2,199,1,14,214,232,0.533,0.922
"15793","Oruro","Oruro","U.E. El Carmen",58,1,4,1,94,8,30,1,3,200,2,11,213,227,0.47,0.938
"15794","Oruro","Oruro","U.E. El Carmen",77,0,1,0,84,5,40,0,1,208,6,7,221,230,0.404,0.961
"15795","Oruro","Oruro","U.E. El Carmen",70,0,4,1,91,5,27,1,3,202,2,14,218,236,0.45,0.924
"15796","Oruro","Oruro","U.E. Socamani",34,0,2,2,113,5,43,0,4,203,10,6,219,229,0.557,0.956
"15797","Oruro","Oruro","U.E. Socamani",18,1,3,0,145,2,22,0,1,192,6,11,209,222,0.755,0.941
"15798","Oruro","Oruro","U.E. Socamani",24,0,4,1,115,4,44,1,2,195,4,10,209,225,0.59,0.929
"15799","Oruro","Oruro","U.E. Socamani",22,0,2,0,121,4,44,2,3,198,7,9,214,225,0.611,0.951
"15800","Oruro","Oruro","U.E. Socamani",15,0,1,1,109,4,23,1,3,157,3,12,172,186,0.694,0.925
"15801","Oruro","Oruro","U. Esc. El Kasso - El Progreso",33,1,3,0,121,5,39,0,3,205,3,10,218,234,0.59,0.932
"15802","Oruro","Oruro","U. Esc. Santa Ana I  Arenales",71,0,4,1,104,4,30,1,2,217,2,8,227,237,0.479,0.958
"15803","Oruro","Oruro","U. Esc. Santa Ana I  Arenales",73,0,1,0,96,8,22,0,2,202,5,11,218,235,0.475,0.928
"15804","Oruro","Oruro","U. Esc. Santa Ana I  Arenales",58,1,4,1,104,6,28,1,0,203,3,8,214,235,0.512,0.911
"15805","Oruro","Oruro","U.E. Nal. Mixto Huajara Secundario",58,1,2,2,93,5,43,0,5,209,1,6,216,236,0.445,0.915
"15806","Oruro","Oruro","U.E. Nal. Mixto Huajara Secundario",51,2,0,3,104,2,46,2,1,211,5,4,220,239,0.493,0.921
"15807","Oruro","Oruro","U.E. Nal. Mixto Huajara Secundario",49,0,1,1,102,6,51,0,1,211,3,7,221,237,0.483,0.932
"15808","Oruro","Oruro","U.E. Nal. Mixto Huajara Secundario",58,0,5,0,105,5,38,0,0,211,4,9,224,238,0.498,0.941
"15809","Oruro","Oruro","U.E. Nal. Mixto Huajara Secundario",56,1,2,0,99,8,40,0,1,207,3,5,215,237,0.478,0.907
"15810","Oruro","Oruro","U.E. Nal. Mixto Huajara Secundario",56,1,5,1,104,3,42,0,2,214,5,7,226,238,0.486,0.95
"15811","Oruro","Oruro","U.E. Nal. Mixto Huajara Secundario",63,0,2,0,94,3,44,3,1,210,5,5,220,236,0.448,0.932
"15812","Oruro","Oruro","U.E. San Luis",22,0,1,0,126,2,54,1,5,211,2,6,219,234,0.597,0.936
"15813","Oruro","Oruro","U.E. San Luis",32,3,3,0,112,4,43,1,0,198,6,21,225,236,0.566,0.953
"15814","Oruro","Oruro","U.E. San Luis",24,2,3,1,116,4,53,0,6,209,5,10,224,233,0.555,0.961
"15815","Oruro","Oruro","U.E. San Luis",20,0,2,1,126,4,54,1,0,208,6,11,225,239,0.606,0.941
"15816","Oruro","Oruro","Centro de Madres Villa Dorina  (U.Esc. Gtanja Capachos)",50,0,2,0,100,5,48,1,4,210,2,9,221,235,0.476,0.94
"15817","Oruro","Oruro","Centro de Madres Villa Dorina  (U.Esc. Gtanja Capachos)",45,3,2,0,109,3,35,1,3,201,2,14,217,232,0.542,0.935
"15818","Oruro","Oruro","Centro de Madres Villa Dorina  (U.Esc. Gtanja Capachos)",41,1,4,1,109,4,42,3,2,207,3,15,225,236,0.527,0.953
"15819","Oruro","Oruro","Centro de Madres Villa Dorina  (U.Esc. Gtanja Capachos)",57,1,2,0,91,7,38,2,5,203,0,8,211,224,0.448,0.942
"15820","Oruro","Oruro","CEA Boliviano Alemán",59,2,4,1,87,5,50,0,5,213,2,5,220,236,0.408,0.932
"15821","Oruro","Oruro","U.E. Avelino Siñani Magisterio",61,0,7,0,104,2,36,0,1,211,2,13,226,240,0.493,0.942
"15822","Oruro","Oruro","U.E. Avelino Siñani Magisterio",60,1,4,0,90,5,45,1,3,209,4,4,217,238,0.431,0.912
"15823","Oruro","Oruro","U.E. Cristo el Salvador",31,0,8,1,136,6,31,0,5,218,6,8,232,239,0.624,0.971
"15824","Oruro","Oruro","U.E. Gerardina Lafuente Callejas",30,2,4,1,135,7,36,0,4,219,4,15,238,240,0.616,0.992
"15825","Oruro","Oruro","U.E. Gerardina Lafuente Callejas",23,1,4,1,119,5,44,1,3,201,5,13,219,225,0.592,0.973
"15826","Oruro","Oruro","Col. Nal. Mixto Bolivia",88,1,1,0,68,5,30,0,3,196,0,7,203,225,0.347,0.902
"15827","Oruro","Oruro","Col. Nal. Mixto Bolivia",100,0,0,1,59,3,25,0,2,190,2,6,198,225,0.311,0.88
"15828","Oruro","Oruro","Col. Nal. Mixto Bolivia",100,0,3,4,68,2,22,0,4,203,1,6,210,232,0.335,0.905
"15829","Oruro","Oruro","Col. Nal. Mixto Bolivia",91,0,0,2,72,4,16,2,2,189,2,5,196,221,0.381,0.887
"15830","Oruro","Oruro","Col. Nal. Mixto Bolivia",102,0,2,2,60,4,34,1,2,207,2,2,211,231,0.29,0.913
"15831","Oruro","Oruro","Col. Nal. Mixto Bolivia",85,0,1,1,68,6,26,1,2,190,1,4,195,224,0.358,0.871
"15832","Oruro","Oruro","Col. Nal. Mixto Bolivia",101,1,3,2,53,3,19,1,4,187,2,1,190,224,0.283,0.848
"15833","Oruro","Oruro","Col. Nal. Mixto Bolivia",67,2,1,2,76,3,24,0,0,175,3,4,182,215,0.434,0.847
"15834","Oruro","Oruro","Col. Nal. Mixto Bolivia",92,1,3,0,71,6,20,3,1,197,1,9,207,229,0.36,0.904
"15835","Oruro","Oruro","Col. Nal. Mixto Bolivia",73,1,2,2,89,3,20,1,2,193,2,5,200,223,0.461,0.897
"15836","Oruro","Oruro","Col. Nal. Mixto Bolivia",92,0,0,0,64,0,22,2,2,182,4,7,193,225,0.352,0.858
"15837","Oruro","Oruro","Col. Nal. Mixto Bolivia",99,1,3,2,61,3,23,2,3,197,3,4,204,227,0.31,0.899
"15838","Oruro","Oruro","Col. Nal. Mixto Bolivia",80,0,1,1,74,4,23,1,1,185,3,9,197,226,0.4,0.872
"15839","Oruro","Oruro","Col. Nal. Mixto Bolivia",106,2,0,0,59,2,25,0,2,196,2,6,204,227,0.301,0.899
"15840","Oruro","Oruro","Col. Nal. Mixto Bolivia",98,0,1,0,61,6,17,3,3,189,2,3,194,223,0.323,0.87
"15841","Oruro","Oruro","Col. Nal. Mixto Bolivia",95,0,4,2,55,3,22,1,2,184,1,5,190,208,0.299,0.913
"15842","Oruro","Oruro","Col. Particular Naciones Unidas",111,0,1,1,50,5,27,0,6,201,3,3,207,231,0.249,0.896
"15843","Oruro","Oruro","Col. Particular Naciones Unidas",81,1,2,0,79,2,30,0,3,198,0,7,205,227,0.399,0.903
"15844","Oruro","Oruro","Col. Particular Naciones Unidas",96,0,2,1,65,8,28,0,4,204,1,2,207,229,0.319,0.904
"15845","Oruro","Oruro","Col. Marcos Beltran Avila",100,0,0,1,58,2,25,0,0,186,1,5,192,223,0.312,0.861
"15846","Oruro","Oruro","Col. Marcos Beltran Avila",79,0,3,1,59,4,26,1,4,177,4,4,185,221,0.333,0.837
"15847","Oruro","Oruro","Col. Marcos Beltran Avila",63,0,6,2,71,11,28,1,3,185,0,7,192,217,0.384,0.885
"15848","Oruro","Oruro","Col. Marcos Beltran Avila",89,2,4,0,74,4,20,1,2,196,4,1,201,223,0.378,0.901
"15849","Oruro","Oruro","Col. Marcos Beltran Avila",69,0,3,3,70,7,37,2,6,197,2,3,202,226,0.355,0.894
"15850","Oruro","Oruro","Col. Marcos Beltran Avila",76,1,0,2,81,1,25,2,3,191,0,7,198,221,0.424,0.896
"15851","Oruro","Oruro","Col. Marcos Beltran Avila",94,0,1,0,62,5,13,0,1,176,1,8,185,215,0.352,0.86
"15852","Oruro","Oruro","Col. Marcos Beltran Avila",82,1,0,0,76,5,23,0,4,191,2,6,199,228,0.398,0.873
"15853","Oruro","Oruro","Col. Marcos Beltran Avila",83,0,1,1,66,3,22,0,3,179,1,5,185,217,0.369,0.853
"15854","Oruro","Oruro","U. Esc. Benemeritos De La Patria",48,0,1,2,107,3,36,1,2,200,1,3,204,228,0.535,0.895
"15855","Oruro","Oruro","U. Esc. Benemeritos De La Patria",52,1,4,1,100,2,36,0,3,199,2,5,206,228,0.503,0.904
"15856","Oruro","Oruro","U. Esc. Benemeritos De La Patria",66,2,1,0,82,4,38,0,3,196,1,7,204,230,0.418,0.887
"15857","Oruro","Oruro","U. Esc. Benemeritos De La Patria",72,1,2,0,90,2,34,3,3,207,1,7,215,232,0.435,0.927
"15858","Oruro","Oruro","U. Esc. Benemeritos De La Patria",50,3,4,2,99,0,39,1,4,202,4,5,211,229,0.49,0.921
"15859","Oruro","Oruro","U. Esc. Benemeritos De La Patria",49,1,6,2,92,1,40,0,4,195,0,7,202,228,0.472,0.886
"15860","Oruro","Oruro","U. Esc. Benemeritos De La Patria",68,0,1,0,82,3,30,2,3,189,4,7,200,231,0.434,0.866
"15861","Oruro","Oruro","U. Esc. Benemeritos De La Patria",68,0,1,1,93,2,33,0,1,199,1,7,207,228,0.467,0.908
"15862","Oruro","Oruro","U. E. Luis Mario Careaga",45,0,2,2,93,5,33,2,4,186,2,11,199,222,0.5,0.896
"15863","Oruro","Oruro","U. E. Luis Mario Careaga",66,1,1,1,82,4,31,1,1,188,1,15,204,230,0.436,0.887
"15864","Oruro","Oruro","U. E. Luis Mario Careaga",61,0,5,0,99,4,36,0,1,206,3,5,214,235,0.481,0.911
"15865","Oruro","Oruro","U. E. Luis Mario Careaga",66,0,3,0,99,5,32,1,2,208,17,8,233,233,0.476,1
"15866","Oruro","Oruro","U. E. Luis Mario Careaga",54,0,5,1,95,1,30,0,7,193,2,11,206,231,0.492,0.892
"15867","Oruro","Oruro","U. E. Luis Mario Careaga",75,0,3,0,75,3,45,0,4,205,0,9,214,231,0.366,0.926
"15868","Oruro","Oruro","U. E. Luis Mario Careaga",42,0,5,2,94,8,39,0,3,193,2,7,202,230,0.487,0.878
"15869","Oruro","Oruro","U. E. Luis Mario Careaga",56,0,3,0,85,4,38,0,2,188,1,11,200,225,0.452,0.889
"15870","Oruro","Oruro","U. E. Luis Mario Careaga",32,0,2,0,116,2,38,0,4,194,6,9,209,232,0.598,0.901
"15871","Oruro","Oruro","U. E. Luis Mario Careaga",74,2,2,0,89,5,23,1,4,200,3,3,206,231,0.445,0.892
"15872","Oruro","Oruro","U. E. Luis Mario Careaga",59,0,4,1,95,1,39,1,2,202,1,5,208,237,0.47,0.878
"15873","Oruro","Oruro","U. E. Luis Mario Careaga",47,0,1,0,119,5,23,0,4,199,1,7,207,218,0.598,0.95
"15874","Oruro","Oruro","U. E. Luis Mario Careaga",54,2,4,1,105,4,30,1,6,207,2,4,213,232,0.507,0.918
"15875","Oruro","Oruro","U. E. Luis Mario Careaga",59,0,4,0,91,2,36,1,7,200,4,9,213,233,0.455,0.914
"15876","Oruro","Oruro","U. E. Luis Mario Careaga",51,1,4,1,100,3,33,1,5,199,3,8,210,227,0.503,0.925
"15877","Oruro","Oruro","U. E. Luis Mario Careaga",40,0,0,0,89,2,42,2,6,181,5,16,202,230,0.492,0.878
"15878","Oruro","Oruro","U. E. Luis Mario Careaga",53,0,4,0,95,2,34,4,5,197,3,7,207,228,0.482,0.908
"15879","Oruro","Oruro","U. E. Luis Mario Careaga",39,1,4,0,108,3,33,0,9,197,5,5,207,232,0.548,0.892
"15880","Oruro","Oruro","U. E. Luis Mario Careaga",62,1,3,0,79,6,40,5,0,196,3,7,206,227,0.403,0.907
"15881","Oruro","Oruro","U. E. Luis Mario Careaga",46,1,3,1,90,3,38,1,4,187,4,6,197,228,0.481,0.864
"15882","Oruro","Oruro","U. E. Luis Mario Careaga",84,0,7,1,75,3,37,0,3,210,1,6,217,233,0.357,0.931
"15883","Oruro","Oruro","U. E. Luis Mario Careaga",81,0,0,1,71,3,33,5,2,196,6,6,208,231,0.362,0.9
"15884","Oruro","Oruro","U. E. Luis Mario Careaga",64,0,3,1,100,5,24,0,1,198,5,8,211,232,0.505,0.909
"15885","Oruro","Oruro","U. E. Luis Mario Careaga",55,0,4,2,102,2,36,1,2,204,2,3,209,234,0.5,0.893
"15886","Oruro","Oruro","U. E. Luis Mario Careaga",49,0,4,0,100,1,38,0,2,194,0,9,203,233,0.515,0.871
"15887","Oruro","Oruro","Kinder Edith Zamora De Paz",63,0,2,2,96,3,36,0,1,203,2,6,211,233,0.473,0.906
"15888","Oruro","Oruro","Kinder Edith Zamora De Paz",70,1,4,0,94,4,37,0,0,210,1,3,214,230,0.448,0.93
"15889","Oruro","Oruro","Kinder Edith Zamora De Paz",69,0,3,0,89,6,33,1,0,201,4,7,212,230,0.443,0.922
"15890","Oruro","Oruro","Kinder Edith Zamora De Paz",66,0,3,0,81,4,30,1,4,189,2,10,201,224,0.429,0.897
"15891","Oruro","Oruro","U. Esc. San Ignacio De Loyola",100,0,2,2,62,6,25,1,6,204,0,5,209,230,0.304,0.909
"15892","Oruro","Oruro","U. Esc. San Ignacio De Loyola",88,1,2,1,82,3,16,2,1,196,5,2,203,223,0.418,0.91
"15893","Oruro","Oruro","U. Esc. San Ignacio De Loyola",98,0,2,0,71,8,22,0,3,204,2,2,208,225,0.348,0.924
"15894","Oruro","Oruro","U. Esc. San Ignacio De Loyola",107,3,1,3,65,6,18,0,8,211,0,7,218,230,0.308,0.948
"15895","Oruro","Oruro","U. Esc. San Ignacio De Loyola",89,1,0,1,81,0,23,2,6,203,1,5,209,229,0.399,0.913
"15896","Oruro","Oruro","U. Esc. San Ignacio De Loyola",86,2,1,0,73,3,26,2,5,198,1,5,204,222,0.369,0.919
"15897","Oruro","Oruro","U. Esc. San Ignacio De Loyola",88,3,4,2,78,1,21,0,3,200,2,4,206,228,0.39,0.904
"15898","Oruro","Oruro","U. Esc. San Ignacio De Loyola",101,0,0,1,65,3,17,0,3,190,1,8,199,222,0.342,0.896
"15899","Oruro","Oruro","U. Esc. San Ignacio De Loyola",95,0,0,2,68,2,27,2,1,197,2,8,207,226,0.345,0.916
"15900","Oruro","Oruro","U. Esc. San Ignacio De Loyola",89,1,3,0,76,2,25,0,4,200,0,6,206,226,0.38,0.912
"15901","Oruro","Oruro","U. Esc. San Ignacio De Loyola",84,0,1,1,72,3,25,3,3,192,1,9,202,220,0.375,0.918
"15902","Oruro","Oruro","U. Esc. San Ignacio De Loyola",82,2,5,3,80,3,28,0,5,208,6,4,218,229,0.385,0.952
"15903","Oruro","Oruro","U. Esc. San Ignacio De Loyola",85,3,1,0,85,2,22,2,3,203,2,2,207,226,0.419,0.916
"15904","Oruro","Oruro","U. Esc. San Ignacio De Loyola",93,2,1,1,87,3,17,1,2,207,3,3,213,231,0.42,0.922
"15905","Oruro","Oruro","U. Esc. San Ignacio De Loyola",75,5,3,7,63,7,12,3,4,179,19,5,203,228,0.352,0.89
"15906","Oruro","Oruro","U. Esc. San Ignacio De Loyola",103,1,0,1,72,2,21,0,6,206,1,5,212,228,0.35,0.93
"15907","Oruro","Oruro","U. Esc. San Ignacio De Loyola",106,1,1,1,64,3,23,3,1,203,3,2,208,226,0.315,0.92
"15908","Oruro","Oruro","U. Esc. San Ignacio De Loyola",85,0,1,2,73,3,23,2,2,191,1,11,203,218,0.382,0.931
"15909","Oruro","Oruro","U. Esc. San Ignacio De Loyola",100,1,4,3,72,4,24,0,3,211,2,0,213,228,0.341,0.934
"15910","Oruro","Oruro","U. Esc. San Ignacio De Loyola",99,0,2,3,64,3,21,2,2,196,1,10,207,224,0.327,0.924
"15911","Oruro","Oruro","U. Esc. San Ignacio De Loyola",113,1,1,1,64,4,16,1,1,202,3,3,208,229,0.317,0.908
"15912","Oruro","Oruro","U. Esc. San Ignacio De Loyola",102,1,2,0,65,2,21,1,5,199,3,3,205,224,0.327,0.915
"15913","Oruro","Oruro","U. Esc. San Ignacio De Loyola",95,0,2,0,76,5,15,2,6,201,4,8,213,230,0.378,0.926
"15914","Oruro","Oruro","U. Esc. San Ignacio De Loyola",88,1,4,2,68,6,22,2,0,193,3,5,201,226,0.352,0.889
"15915","Oruro","Oruro","U. Esc. San Ignacio De Loyola",98,3,0,2,59,1,24,2,2,191,2,4,197,211,0.309,0.934
"15916","Oruro","Oruro","U. E. Jesus de Nazareth",51,0,2,2,91,6,39,0,6,197,2,7,206,229,0.462,0.9
"15917","Oruro","Oruro","U. E. Jesus de Nazareth",74,0,0,2,86,6,39,0,1,208,0,5,213,226,0.413,0.942
"15918","Oruro","Oruro","U. E. Jesus de Nazareth",51,1,2,1,108,1,29,0,2,195,1,10,206,234,0.554,0.88
"15919","Oruro","Oruro","U. E. Jesus de Nazareth",69,0,0,1,80,3,42,0,3,198,3,11,212,226,0.404,0.938
"15920","Oruro","Oruro","U. E. Jesus de Nazareth",44,0,5,0,102,8,37,0,5,201,2,8,211,233,0.507,0.906
"15921","Oruro","Oruro","U. E. Jesus de Nazareth",67,0,1,1,77,1,44,2,2,195,1,12,208,227,0.395,0.916
"15922","Oruro","Oruro","U. E. Jesus de Nazareth",62,1,0,1,93,1,50,1,1,210,2,6,218,231,0.443,0.944
"15923","Oruro","Oruro","U. E. Jesus de Nazareth",66,1,3,0,71,6,39,0,3,189,6,8,203,230,0.376,0.883
"15924","Oruro","Oruro","U. E. Jesus de Nazareth",63,1,4,2,93,1,35,1,4,204,2,3,209,230,0.456,0.909
"15925","Oruro","Oruro","U. E. Jesus de Nazareth",69,2,2,2,86,3,31,1,2,198,2,10,210,230,0.434,0.913
"15926","Oruro","Oruro","U. E. Jesus de Nazareth",67,0,3,1,86,4,39,1,2,203,3,7,213,229,0.424,0.93
"15927","Oruro","Oruro","U. E. Jesus de Nazareth",65,0,0,3,86,9,34,0,4,201,0,8,209,228,0.428,0.917
"15928","Oruro","Oruro","U. E. Jesus de Nazareth",58,1,5,0,103,2,33,0,1,203,2,2,207,231,0.507,0.896
"15929","Oruro","Oruro","U. E. Jesus de Nazareth",66,1,3,0,86,5,32,0,4,197,3,12,212,230,0.437,0.922
"15930","Oruro","Oruro","U. E. Jesus de Nazareth",52,0,3,1,92,7,40,1,7,203,2,12,217,234,0.453,0.927
"15931","Oruro","Oruro","U. E. Jesus de Nazareth",81,0,1,0,85,1,30,2,0,200,0,13,213,233,0.425,0.914
"15932","Oruro","Oruro","U. E. Jesus de Nazareth",72,2,2,0,88,0,30,1,2,197,4,14,215,230,0.447,0.935
"15933","Oruro","Oruro","U. E. Jesus de Nazareth",79,0,3,1,73,2,38,0,5,201,1,6,208,226,0.363,0.92
"15934","Oruro","Oruro","U. Esc. Oruro Otawa (Primaria)",104,0,1,1,69,4,25,1,0,205,0,9,214,227,0.337,0.943
"15935","Oruro","Oruro","U. Esc. Oruro Otawa (Primaria)",109,1,1,1,64,4,21,0,2,203,1,4,208,223,0.315,0.933
"15936","Oruro","Oruro","U. Esc. Oruro Otawa (Primaria)",97,0,0,0,68,4,19,1,6,195,0,9,204,224,0.349,0.911
"15937","Oruro","Oruro","U. Esc. Oruro Otawa (Primaria)",78,2,6,7,51,8,8,4,3,167,24,20,211,226,0.305,0.934
"15938","Oruro","Oruro","U. Esc. Oruro Otawa (Primaria)",113,0,3,3,56,6,20,0,3,204,1,6,211,222,0.275,0.95
"15939","Oruro","Oruro","U. Esc. Oruro Otawa (Primaria)",120,0,1,0,54,3,10,2,2,192,0,5,197,216,0.281,0.912
"15940","Oruro","Oruro","U. Esc. Oruro Otawa (Primaria)",98,1,1,1,55,2,26,1,3,188,1,7,196,222,0.293,0.883
"15941","Oruro","Oruro","U. Esc. Oruro Otawa (Primaria)",98,0,1,1,78,1,17,0,0,196,2,4,202,220,0.398,0.918
"15942","Oruro","Oruro","U. Esc. Oruro Otawa (Primaria)",113,0,1,3,65,6,12,0,2,202,3,7,212,227,0.322,0.934
"15943","Oruro","Oruro","U. Esc. Oruro Otawa (Primaria)",111,0,1,3,65,3,15,0,2,200,2,3,205,229,0.325,0.895
"15944","Oruro","Oruro","U. Esc. Oruro Otawa (Primaria)",110,0,1,0,70,2,19,0,1,203,1,7,211,228,0.345,0.925
"15945","Oruro","Oruro","U. Esc. Oruro Otawa (Primaria)",114,0,0,1,69,1,11,0,2,198,0,4,202,228,0.348,0.886
"15946","Oruro","Oruro","U. Esc. Oruro Otawa (Primaria)",110,0,2,1,60,6,18,1,2,200,2,1,203,224,0.3,0.906
"15947","Oruro","Oruro","Centro Educativo Luis Espinal",88,0,1,4,77,4,18,2,6,200,0,6,206,222,0.385,0.928
"15948","Oruro","Oruro","Centro Educativo Luis Espinal",99,1,0,1,62,5,24,0,1,193,1,8,202,221,0.321,0.914
"15949","Oruro","Oruro","Centro Educativo Luis Espinal",106,0,4,4,61,3,15,0,4,197,1,3,201,222,0.31,0.905
"15950","Oruro","Oruro","Centro Educativo Luis Espinal",97,1,1,0,75,0,19,0,3,196,1,5,202,215,0.383,0.94
"15951","Oruro","Oruro","Centro Educativo Luis Espinal",101,1,1,1,58,4,16,0,2,184,3,4,191,207,0.315,0.923
"15952","Oruro","Oruro","U. E. Oruro Otawa (Secundaria)",94,0,1,0,81,3,24,0,2,205,4,7,216,235,0.395,0.919
"15953","Oruro","Oruro","U. E. Oruro Otawa (Secundaria)",67,1,2,2,87,3,39,0,1,202,2,8,212,232,0.431,0.914
"15954","Oruro","Oruro","U. E. Oruro Otawa (Secundaria)",88,0,2,1,71,0,29,2,4,197,3,11,211,226,0.36,0.934
"15955","Oruro","Oruro","U. E. Oruro Otawa (Secundaria)",75,1,3,1,87,2,26,1,2,198,3,7,208,226,0.439,0.92
"15956","Oruro","Oruro","U. E. Oruro Otawa (Secundaria)",70,0,4,0,86,4,32,1,3,200,0,9,209,227,0.43,0.921
"15957","Oruro","Oruro","U. E. Oruro Otawa (Secundaria)",73,0,3,2,84,2,28,1,3,196,2,12,210,228,0.429,0.921
"15958","Oruro","Oruro","U. E. Oruro Otawa (Secundaria)",72,3,1,1,85,3,33,0,0,198,2,5,205,227,0.429,0.903
"15959","Oruro","Oruro","U. E. Oruro Otawa (Secundaria)",91,2,0,1,75,3,26,0,1,199,4,8,211,227,0.377,0.93
"15960","Oruro","Oruro","U. E. Oruro Otawa (Secundaria)",81,0,1,0,63,2,26,2,2,177,2,7,186,204,0.356,0.912
"15961","Oruro","Oruro","U.E. Maria  De Nazareth",41,2,2,0,93,5,42,1,2,188,5,24,217,231,0.495,0.939
"15962","Oruro","Oruro","U.E. Maria  De Nazareth",36,1,1,0,109,0,52,0,1,200,2,14,216,231,0.545,0.935
"15963","Oruro","Oruro","U.E. Maria  De Nazareth",25,3,2,1,132,1,44,0,1,209,2,15,226,238,0.632,0.95
"15964","Oruro","Oruro","U.E. Maria  De Nazareth",37,1,2,3,104,3,47,1,0,198,0,14,212,233,0.525,0.91
"15965","Oruro","Oruro","U.E. Maria  De Nazareth",32,1,2,0,103,0,43,1,4,186,2,19,207,228,0.554,0.908
"15966","Oruro","Oruro","U.E. Maria  De Nazareth",19,1,3,0,129,3,44,0,1,200,6,14,220,236,0.645,0.932
"15967","Oruro","Oruro","U.E. Maria  De Nazareth",36,1,3,1,106,3,48,0,4,202,6,17,225,234,0.525,0.962
"15968","Oruro","Oruro","U.E. Maria  De Nazareth",29,0,2,0,123,3,33,0,1,191,3,16,210,226,0.644,0.929
"15969","Oruro","Oruro","U.E. Maria  De Nazareth",30,0,2,0,107,0,51,1,1,192,3,11,206,229,0.557,0.9
"15970","Oruro","Oruro","U. E. Movimiento Sin Techo",30,1,1,2,132,2,32,0,0,200,3,15,218,233,0.66,0.936
"15971","Oruro","Oruro","U. E. Movimiento Sin Techo",28,0,1,0,127,4,36,0,5,201,4,7,212,232,0.632,0.914
"15972","Oruro","Oruro","U. E. Movimiento Sin Techo",16,2,1,1,139,1,37,1,3,201,3,9,213,225,0.692,0.947
"15973","Oruro","Oruro","U. E. Movimiento Sin Techo",24,0,2,1,129,6,43,1,1,207,0,11,218,232,0.623,0.94
"15974","Oruro","Oruro","U. E. Movimiento Sin Techo",22,0,1,0,136,1,30,0,2,192,4,15,211,232,0.708,0.909
"15975","Oruro","Oruro","U. E. Movimiento Sin Techo",25,0,1,1,133,3,46,0,0,209,2,12,223,237,0.636,0.941
"15976","Oruro","Oruro","U. E. Movimiento Sin Techo",16,0,2,1,136,4,30,0,0,189,9,10,208,226,0.72,0.92
"15977","Oruro","Oruro","U. E. Movimiento Sin Techo",28,1,2,1,133,2,32,1,3,203,2,11,216,236,0.655,0.915
"15978","Oruro","Oruro","U. E. Movimiento Sin Techo",17,1,0,0,138,0,34,0,4,194,3,20,217,233,0.711,0.931
"15979","Oruro","Oruro","U. E. Movimiento Sin Techo",27,1,3,0,129,6,35,1,2,204,2,10,216,235,0.632,0.919
"15980","Oruro","Oruro","U. E. Movimiento Sin Techo",23,2,1,0,135,4,36,0,1,202,4,6,212,231,0.668,0.918
"15981","Oruro","Oruro","U. E. Movimiento Sin Techo",17,1,4,0,135,1,44,0,3,205,2,10,217,233,0.659,0.931
"15982","Oruro","Oruro","U. E. Movimiento Sin Techo",23,0,1,0,133,7,28,1,2,195,3,19,217,236,0.682,0.919
"15983","Oruro","Oruro","U. E. Movimiento Sin Techo",29,0,4,1,134,3,20,2,0,193,3,22,218,230,0.694,0.948
"15984","Oruro","Oruro","U. E. Movimiento Sin Techo",16,1,2,1,134,2,34,0,3,193,5,10,208,231,0.694,0.9
"15985","Oruro","Oruro","U. E. Movimiento Sin Techo",18,1,1,0,138,3,31,1,1,194,3,15,212,227,0.711,0.934
"15986","Oruro","Oruro","U. E. Movimiento Sin Techo",21,2,2,3,126,4,43,2,3,206,4,12,222,238,0.612,0.933
"15987","Oruro","Oruro","U. E. Movimiento Sin Techo",21,1,0,0,131,2,46,1,0,202,6,7,215,233,0.649,0.923
"15988","Oruro","Oruro","U. E. Movimiento Sin Techo",27,0,0,0,123,6,44,0,0,200,5,13,218,232,0.615,0.94
"15989","Oruro","Oruro","U. E. Movimiento Sin Techo",13,1,3,0,140,6,34,0,3,200,4,8,212,231,0.7,0.918
"15990","Oruro","Oruro","U. E. Movimiento Sin Techo",23,1,2,1,131,4,30,0,3,195,3,17,215,234,0.672,0.919
"15991","Oruro","Oruro","U. E. Movimiento Sin Techo",17,0,1,1,113,5,43,0,1,181,8,21,210,233,0.624,0.901
"15992","Oruro","Oruro","U. E. Movimiento Sin Techo",34,1,7,0,109,2,34,4,1,192,4,14,210,236,0.568,0.89
"15993","Oruro","Oruro","U. E. Movimiento Sin Techo",11,0,2,3,150,2,34,0,0,202,7,13,222,234,0.743,0.949
"15994","Oruro","Oruro","U. Esc. San Isidro",26,0,1,1,131,6,36,1,0,202,7,9,218,228,0.649,0.956
"15995","Oruro","Oruro","U. Esc. San Isidro",34,1,2,1,113,1,41,0,1,194,9,10,213,235,0.582,0.906
"15996","Oruro","Oruro","U. Esc. San Isidro",30,0,5,1,110,8,46,0,1,201,1,17,219,233,0.547,0.94
"15997","Oruro","Oruro","U. Esc. San Isidro",25,2,1,0,130,4,30,0,1,193,6,12,211,230,0.674,0.917
"15998","Oruro","Oruro","U. Esc. San Isidro",29,1,4,0,121,4,41,0,3,203,8,10,221,234,0.596,0.944
"15999","Oruro","Oruro","U. Esc. San Isidro",28,2,2,0,114,7,36,1,1,191,2,13,206,232,0.597,0.888
"16000","Oruro","Oruro","U. Esc. San Isidro",27,0,4,3,122,7,39,1,1,204,7,8,219,237,0.598,0.924
"16001","Oruro","Oruro","U. Esc. San Isidro",29,0,3,0,117,5,34,0,2,190,3,14,207,232,0.616,0.892
"16002","Oruro","Oruro","U. Esc. San Isidro",18,0,2,0,132,3,40,1,2,198,6,7,211,229,0.667,0.921
"16003","Oruro","Oruro","U. Esc. San Isidro",41,0,5,0,128,1,22,0,3,200,1,9,210,231,0.64,0.909
"16004","Oruro","Oruro","U. Esc. San Isidro",35,1,5,3,112,6,34,0,1,197,2,12,211,231,0.569,0.913
"16005","Oruro","Oruro","U.E. Niño Quirquincho Feliz",34,1,5,4,110,5,39,1,0,199,2,17,218,233,0.553,0.936
"16006","Oruro","Oruro","U.E. Niño Quirquincho Feliz",26,2,4,1,132,2,41,1,1,210,0,11,221,235,0.629,0.94
"16007","Oruro","Oruro","U.E. Niño Quirquincho Feliz",35,0,4,0,114,1,36,1,5,196,5,13,214,230,0.582,0.93
"16008","Oruro","Oruro","U.E. Niño Quirquincho Feliz",54,0,4,4,115,1,42,0,1,221,3,8,232,240,0.52,0.967
"16009","Oruro","Oruro","U.E. Niño Quirquincho Feliz",45,1,5,3,108,4,38,2,2,208,3,8,219,235,0.519,0.932
"16010","Oruro","Oruro","U.E. Niño Quirquincho Feliz",34,0,3,0,115,2,34,0,6,194,1,17,212,232,0.593,0.914
"16011","Oruro","Oruro","U.E. Niño Quirquincho Feliz",36,0,3,0,111,4,41,1,4,200,2,13,215,233,0.555,0.923
"16012","Oruro","Oruro","U.E. Niño Quirquincho Feliz",48,0,0,1,107,5,30,1,3,195,2,16,213,231,0.549,0.922
"16013","Oruro","Oruro","U.E. Niño Quirquincho Feliz",44,1,1,1,110,4,40,0,6,207,6,10,223,236,0.531,0.945
"16014","Oruro","Oruro","U. Esc. San Juan De Dios",23,0,4,1,128,4,40,0,4,204,6,15,225,235,0.627,0.957
"16015","Oruro","Oruro","U. Esc. San Juan De Dios",29,3,0,2,136,2,37,0,1,210,3,10,223,236,0.648,0.945
"16016","Oruro","Oruro","U. Esc. San Juan De Dios",22,2,1,0,135,0,35,2,7,204,3,12,219,238,0.662,0.92
"16017","Oruro","Oruro","U. Esc. San Juan De Dios",25,1,4,1,126,5,36,0,4,202,5,15,222,235,0.624,0.945
"16018","Oruro","Oruro","U. Esc. San Juan De Dios",27,4,1,0,116,1,46,1,4,200,5,12,217,232,0.58,0.935
"16019","Oruro","Oruro","U. Esc. Dios Es Amor",37,1,4,0,114,2,43,1,3,205,3,12,220,237,0.556,0.928
"16020","Oruro","Oruro","U. Esc. Dios Es Amor",25,1,6,0,144,5,33,0,0,214,2,7,223,236,0.673,0.945
"16021","Oruro","Oruro","U. Esc. Dios Es Amor",29,1,7,1,127,2,33,0,4,204,4,12,220,237,0.623,0.928
"16022","Oruro","Oruro","U. Esc. Dios Es Amor",30,0,3,0,127,5,42,0,2,209,2,13,224,232,0.608,0.966
"16023","Oruro","Oruro","U. Esc. Dios Es Amor",45,2,4,3,103,3,42,1,4,207,5,8,220,237,0.498,0.928
"16024","Oruro","Oruro","U. Esc. Dios Es Amor",37,3,4,0,118,1,46,0,1,210,1,7,218,236,0.562,0.924
"16025","Oruro","Oruro","U. Esc. Dios Es Amor",38,1,4,1,121,4,29,0,4,202,3,14,219,231,0.599,0.948
"16026","Oruro","Oruro","U.E. Valle Hermoso - Vinto II",15,0,1,0,161,1,27,0,3,208,3,14,225,234,0.774,0.962
"16027","Oruro","Oruro","U.E. Valle Hermoso - Vinto II",13,0,1,0,176,3,25,0,4,222,3,7,232,234,0.793,0.991
"16028","Oruro","Oruro","Esc. Juan Pablo",84,3,6,1,69,4,26,0,3,196,3,7,206,230,0.352,0.896
"16029","Oruro","Oruro","Esc. Juan Pablo",69,0,2,0,89,6,35,0,1,202,2,8,212,230,0.441,0.922
"16030","Oruro","Oruro","Esc. Juan Pablo",77,0,4,1,77,1,38,1,1,200,1,8,209,229,0.385,0.913
"16031","Oruro","Oruro","Esc. Juan Pablo",62,0,3,1,83,2,20,0,3,174,5,14,193,226,0.477,0.854
"16032","Oruro","Oruro","Esc. Juan Pablo",82,2,4,2,78,2,27,2,3,202,4,6,212,231,0.386,0.918
"16033","Oruro","Oruro","Esc. Juan Pablo",66,0,5,0,72,4,41,4,4,196,1,3,200,223,0.367,0.897
"16034","Oruro","Oruro","Esc. Juan Pablo",75,1,2,1,69,4,23,4,4,183,1,6,190,219,0.377,0.868
"16035","Oruro","Oruro","Esc. Juan Pablo",63,0,3,1,87,3,27,0,4,188,3,7,198,228,0.463,0.868
"16036","Oruro","Oruro","Esc. Juan Pablo",98,1,5,0,77,4,23,0,0,208,1,5,214,230,0.37,0.93
"16037","Oruro","Oruro","Esc. Juan Pablo",64,1,2,2,90,2,38,1,5,205,1,7,213,227,0.439,0.938
"16038","Oruro","Oruro","Esc. Juan Pablo",73,1,3,3,74,7,33,2,4,200,0,11,211,232,0.37,0.909
"16039","Oruro","Oruro","Esc. Juan Pablo",66,0,6,0,81,2,31,1,2,189,2,8,199,225,0.429,0.884
"16040","Oruro","Oruro","Esc. Juan Pablo",61,2,0,1,76,2,50,1,2,195,0,8,203,228,0.39,0.89
"16041","Oruro","Oruro","Esc. Juan Pablo",73,0,1,1,75,6,32,1,4,193,2,10,205,225,0.389,0.911
"16042","Oruro","Oruro","Esc. Juan Pablo",78,1,3,0,72,1,32,0,2,189,3,9,201,229,0.381,0.878
"16043","Oruro","Oruro","Esc. Juan Pablo",49,1,4,1,98,7,33,0,3,196,3,6,205,229,0.5,0.895
"16044","Oruro","Oruro","U. Esc. Uru Uru",89,0,4,3,78,2,34,0,2,212,0,3,215,232,0.368,0.927
"16045","Oruro","Oruro","U. Esc. Uru Uru",74,0,5,0,74,1,46,0,1,201,2,5,208,230,0.368,0.904
"16046","Oruro","Oruro","U. Esc. Uru Uru",70,1,0,1,74,4,34,2,2,188,5,4,197,233,0.394,0.845
"16047","Oruro","Oruro","U. Esc. Uru Uru",90,0,1,0,68,2,25,0,8,194,2,9,205,233,0.351,0.88
"16048","Oruro","Oruro","U. Esc. Uru Uru",90,0,4,0,75,4,22,0,2,197,3,9,209,231,0.381,0.905
"16049","Oruro","Oruro","U. Esc. Uru Uru",83,2,2,0,78,2,27,0,2,196,1,8,205,229,0.398,0.895
"16050","Oruro","Oruro","U. Esc. Uru Uru",77,0,1,1,95,5,26,1,1,207,3,5,215,233,0.459,0.923
"16051","Oruro","Oruro","U. Esc. Uru Uru",94,0,0,0,69,5,28,1,4,201,3,5,209,230,0.343,0.909
"16052","Oruro","Oruro","U. Esc. Uru Uru",103,0,1,1,65,1,34,0,4,209,2,6,217,231,0.311,0.939
"16053","Oruro","Oruro","U. Esc. Uru Uru",72,2,1,1,78,2,28,0,2,186,3,8,197,227,0.419,0.868
"16054","Oruro","Oruro","U. Esc. Uru Uru",100,1,2,2,65,3,29,0,1,203,2,6,211,230,0.32,0.917
"16055","Oruro","Oruro","Fundacion Infocal",77,0,7,0,74,7,40,3,2,210,3,3,216,232,0.352,0.931
"16056","Oruro","Oruro","Fundacion Infocal",82,2,9,3,70,4,23,1,3,197,1,6,204,228,0.355,0.895
"16057","Oruro","Oruro","Fundacion Infocal",98,0,2,1,63,3,29,1,3,200,1,5,206,229,0.315,0.9
"16058","Oruro","Oruro","Fundacion Infocal",82,1,3,1,79,2,28,0,0,196,2,4,202,222,0.403,0.91
"16059","Oruro","Oruro","Fundacion Infocal",92,1,0,0,76,5,26,1,2,203,0,5,208,231,0.374,0.9
"16060","Oruro","Oruro","Fundacion Infocal",85,0,5,2,79,6,27,0,2,206,4,3,213,225,0.383,0.947
"16061","Oruro","Oruro","Kinder Juancito Pinto",90,0,4,0,65,1,30,0,4,194,4,7,205,228,0.335,0.899
"16062","Oruro","Oruro","Kinder Juancito Pinto",90,1,4,0,73,4,23,0,3,198,2,7,207,218,0.369,0.95
"16063","Oruro","Oruro","Kinder Juancito Pinto",84,0,3,0,70,6,30,1,1,195,1,3,199,220,0.359,0.905
"16064","Oruro","Oruro","Kinder Juancito Pinto",93,1,3,1,71,1,28,0,1,199,2,2,203,231,0.357,0.879
"16065","Oruro","Oruro","Kinder Juancito Pinto",82,0,5,1,57,3,35,0,0,183,7,4,194,225,0.311,0.862
"16066","Oruro","Oruro","Kinder Juancito Pinto",101,1,1,1,62,1,29,0,0,196,1,6,203,224,0.316,0.906
"16067","Oruro","Oruro","Kinder Juancito Pinto",88,1,0,1,81,3,25,1,2,202,0,3,205,230,0.401,0.891
"16068","Oruro","Oruro","Kinder Juancito Pinto",79,1,0,0,67,1,32,3,6,189,2,10,201,228,0.354,0.882
"16069","Oruro","Oruro","Centro Educativo Alcira Cardona",83,1,3,3,74,1,29,0,2,196,0,7,203,223,0.378,0.91
"16070","Oruro","Oruro","Centro Educativo Alcira Cardona",79,0,1,1,72,5,31,2,2,193,1,2,196,225,0.373,0.871
"16071","Oruro","Oruro","Centro Educativo Alcira Cardona",87,2,0,1,57,5,31,0,2,185,0,12,197,229,0.308,0.86
"16072","Oruro","Oruro","Centro Educativo Alcira Cardona",78,1,1,1,62,5,37,1,3,189,3,7,199,225,0.328,0.884
"16073","Oruro","Oruro","Centro Educativo Alcira Cardona",108,0,1,0,65,2,24,0,2,202,2,1,205,229,0.322,0.895
"16074","Oruro","Oruro","Centro Educativo Alcira Cardona",88,1,2,2,65,3,23,1,3,188,3,5,196,226,0.346,0.867
"16075","Oruro","Oruro","Centro Educativo Alcira Cardona",77,0,1,1,66,4,40,1,3,193,3,3,199,226,0.342,0.881
"16076","Oruro","Oruro","Centro Educativo Alcira Cardona",93,0,1,1,62,1,27,1,1,187,2,5,194,223,0.332,0.87
"16077","Oruro","Oruro","Centro Educativo Alcira Cardona",97,0,3,2,56,4,25,0,2,189,0,5,194,215,0.296,0.902
"16078","Oruro","Oruro","Centro Educativo Alcira Cardona",103,1,3,2,52,4,25,2,2,194,2,7,203,227,0.268,0.894
"16079","Oruro","Oruro","Centro Educativo Alcira Cardona",106,0,2,2,54,2,28,1,3,198,3,7,208,229,0.273,0.908
"16080","Oruro","Oruro","U. Esc. Hijos Del Sol (Plan 500)",61,0,7,3,85,2,29,0,4,191,3,10,204,225,0.445,0.907
"16081","Oruro","Oruro","U. Esc. Hijos Del Sol (Plan 500)",68,1,3,0,60,6,47,1,3,189,1,6,196,225,0.317,0.871
"16082","Oruro","Oruro","U. Esc. Hijos Del Sol (Plan 500)",35,0,4,1,104,4,42,2,3,195,1,2,198,227,0.533,0.872
"16083","Oruro","Oruro","U. Esc. Hijos Del Sol (Plan 500)",67,1,4,0,79,4,28,0,0,183,4,10,197,224,0.432,0.879
"16084","Oruro","Oruro","U. Esc. Hijos Del Sol (Plan 500)",52,0,3,1,84,5,38,0,2,185,2,9,196,229,0.454,0.856
"16085","Oruro","Oruro","U. Esc. Hijos Del Sol (Plan 500)",43,3,5,0,91,2,37,2,1,184,3,13,200,228,0.495,0.877
"16086","Oruro","Oruro","U. Esc. Hijos Del Sol (Plan 500)",44,0,4,2,107,3,24,1,4,189,4,12,205,233,0.566,0.88
"16087","Oruro","Oruro","U. Esc. Hijos Del Sol (Plan 500)",61,0,0,2,88,3,33,2,3,192,3,7,202,227,0.458,0.89
"16088","Oruro","Oruro","U. Esc. Hijos Del Sol (Plan 500)",63,3,0,2,83,4,25,1,3,184,2,13,199,226,0.451,0.881
"16089","Oruro","Oruro","Kinder Chiripujio",81,1,7,0,71,1,34,1,2,198,1,6,205,227,0.359,0.903
"16090","Oruro","Oruro","Kinder Chiripujio",74,0,1,0,54,1,32,1,2,165,2,3,170,189,0.327,0.899
"16091","Oruro","Oruro","U. E. Hijos Del Sol II",63,0,4,1,83,5,26,0,3,185,2,5,192,233,0.449,0.824
"16092","Oruro","Oruro","Col. Nal.Mixto Mejillones (V. Challacollo)",48,1,3,2,83,5,34,1,4,181,3,9,193,220,0.459,0.877
"16093","Oruro","Oruro","Col. Nal.Mixto Mejillones (V. Challacollo)",42,0,2,0,87,1,47,1,4,184,2,6,192,230,0.473,0.835
"16094","Oruro","Oruro","Col. Nal.Mixto Mejillones (V. Challacollo)",51,0,1,1,92,0,42,1,2,190,6,8,204,228,0.484,0.895
"16095","Oruro","Oruro","Col. Nal.Mixto Mejillones (V. Challacollo)",42,0,1,0,96,1,34,1,3,178,3,11,192,224,0.539,0.857
"16096","Oruro","Oruro","Col. Nal.Mixto Mejillones (V. Challacollo)",42,1,4,0,107,0,31,0,2,187,2,6,195,223,0.572,0.874
"16097","Oruro","Oruro","Col. Nal.Mixto Mejillones (V. Challacollo)",47,3,6,3,95,3,27,2,6,192,2,6,200,234,0.495,0.855
"16098","Oruro","Oruro","Col. Nal.Mixto Mejillones (V. Challacollo)",34,2,4,0,90,3,44,0,5,182,2,3,187,222,0.495,0.842
"16099","Oruro","Oruro","Col. Particular La Salle",111,0,5,1,60,4,24,1,2,208,1,5,214,234,0.288,0.915
"16100","Oruro","Oruro","Col. Particular La Salle",120,2,1,1,49,5,16,2,3,199,0,4,203,232,0.246,0.875
"16101","Oruro","Oruro","Col. Particular La Salle",100,0,3,0,70,3,24,1,1,202,2,5,209,231,0.347,0.905
"16102","Oruro","Oruro","Col. Particular La Salle",85,0,0,1,68,4,33,0,2,193,0,8,201,228,0.352,0.882
"16103","Oruro","Oruro","Col. Particular La Salle",105,0,4,1,53,9,28,2,1,203,3,3,209,227,0.261,0.921
"16104","Oruro","Oruro","Col. Particular La Salle",107,1,1,1,55,6,24,1,3,199,3,3,205,224,0.276,0.915
"16105","Oruro","Oruro","Col. Particular La Salle",107,0,0,0,58,4,32,1,4,206,1,4,211,229,0.282,0.921
"16106","Oruro","Oruro","Col. Particular La Salle",96,0,1,1,64,2,30,2,4,200,1,7,208,225,0.32,0.924
"16107","Oruro","Oruro","Col. Particular La Salle",118,0,0,2,50,4,17,1,2,194,0,4,198,230,0.258,0.861
"16108","Oruro","Oruro","Col. Particular La Salle",134,1,0,1,47,4,16,2,1,206,2,5,213,229,0.228,0.93
"16109","Oruro","Oruro","Col. Particular La Salle",102,0,2,2,72,5,18,1,3,205,2,7,214,235,0.351,0.911
"16110","Oruro","Oruro","Col. Particular La Salle",113,0,1,2,57,4,17,2,1,197,2,6,205,230,0.289,0.891
"16111","Oruro","Oruro","Col. Particular La Salle",128,0,0,0,52,3,16,1,1,201,2,6,209,228,0.259,0.917
"16112","Oruro","Oruro","Col. Particular La Salle",112,1,2,0,57,2,36,2,0,212,0,12,224,246,0.269,0.911
"16113","Oruro","Oruro","Facultad de Agronomia",68,0,1,0,82,5,35,0,5,196,0,4,200,232,0.418,0.862
"16114","Oruro","Oruro","Facultad de Agronomia",55,2,3,0,85,2,49,1,1,198,1,10,209,231,0.429,0.905
"16115","Oruro","Oruro","Facultad de Agronomia",68,1,2,0,73,4,43,1,1,193,3,9,205,231,0.378,0.887
"16116","Oruro","Oruro","Facultad de Agronomia",60,1,4,1,75,1,56,0,0,198,2,8,208,232,0.379,0.897
"16117","Oruro","Oruro","Facultad de Agronomia",65,0,2,1,93,6,32,0,3,202,0,9,211,237,0.46,0.89
"16118","Oruro","Oruro","U. E. Carmela Cerruto",73,0,0,1,73,3,35,0,3,188,4,6,198,229,0.388,0.865
"16119","Oruro","Oruro","U. E. Carmela Cerruto",63,4,4,3,77,7,31,0,2,191,1,10,202,227,0.403,0.89
"16120","Oruro","Oruro","U.E. Mejillones II (Secundario)",55,0,3,1,83,3,56,0,2,203,1,11,215,237,0.409,0.907
"16121","Oruro","Oruro","U.E. Mejillones II (Secundario)",41,1,5,0,94,9,35,0,7,192,4,16,212,238,0.49,0.891
"16122","Oruro","Oruro","U.E. Mejillones II (Secundario)",39,1,4,2,100,1,44,0,5,196,3,5,204,233,0.51,0.876
"16123","Oruro","Caracollo","Esc. Mariscal Sucre",26,0,12,1,126,4,23,1,1,194,2,6,202,218,0.649,0.927
"16124","Oruro","Caracollo","Esc. Mariscal Sucre",27,0,5,1,125,2,22,2,5,189,5,6,200,217,0.661,0.922
"16125","Oruro","Caracollo","Esc. Mariscal Sucre",33,1,4,0,121,3,34,0,1,197,2,6,205,215,0.614,0.953
"16126","Oruro","Caracollo","Esc. Mariscal Sucre",36,0,3,2,112,10,34,1,1,199,4,3,206,224,0.563,0.92
"16127","Oruro","Caracollo","Esc. Mariscal Sucre",32,1,6,2,137,4,13,0,1,196,2,4,202,221,0.699,0.914
"16128","Oruro","Caracollo","Esc. Mariscal Sucre",19,0,6,1,131,3,19,1,2,182,6,9,197,213,0.72,0.925
"16129","Oruro","Caracollo","Esc. Mariscal Sucre",15,3,4,0,150,3,24,0,0,199,3,6,208,222,0.754,0.937
"16130","Oruro","Caracollo","Esc. Mariscal Sucre",31,1,4,1,122,3,22,2,4,190,3,6,199,219,0.642,0.909
"16131","Oruro","Caracollo","Esc. Mariscal Sucre",32,2,9,1,121,2,24,0,5,196,4,10,210,227,0.617,0.925
"16132","Oruro","Caracollo","Esc. Mariscal Sucre",36,0,5,0,121,6,25,0,3,196,1,5,202,220,0.617,0.918
"16133","Oruro","Caracollo","Esc. Mariscal Sucre",20,2,3,1,125,4,26,0,1,182,5,15,202,218,0.687,0.927
"16134","Oruro","Caracollo","Esc. Mariscal Sucre",29,3,6,1,126,2,18,0,3,188,3,5,196,219,0.67,0.895
"16135","Oruro","Caracollo","Esc. Mariscal Sucre",24,0,7,2,139,1,12,1,0,186,2,10,198,217,0.747,0.912
"16136","Oruro","Caracollo","Esc. Mariscal Sucre",24,1,9,1,108,1,33,0,1,178,1,8,187,214,0.607,0.874
"16137","Oruro","Caracollo","Esc. Mariscal Sucre",22,1,7,0,146,2,18,0,3,199,2,7,208,224,0.734,0.929
"16138","Oruro","Caracollo","Esc. Mariscal Sucre",30,1,8,1,128,2,18,1,2,191,8,4,203,218,0.67,0.931
"16139","Oruro","Caracollo","Esc. Mariscal Sucre",33,2,6,0,123,1,24,0,3,192,1,2,195,210,0.641,0.929
"16140","Oruro","Caracollo","Esc. Mariscal Sucre",37,2,7,1,122,5,20,1,1,196,4,4,204,223,0.622,0.915
"16141","Oruro","Caracollo","Esc. Mariscal Sucre",16,2,6,2,142,2,17,1,1,189,5,9,203,218,0.751,0.931
"16142","Oruro","Caracollo","Esc. Mariscal Sucre",21,1,2,0,147,0,17,1,4,193,7,7,207,225,0.762,0.92
"16143","Oruro","Caracollo","Esc. Mariscal Sucre",22,2,3,1,135,3,21,0,3,190,6,7,203,219,0.711,0.927
"16144","Oruro","Caracollo","Esc. Mariscal Sucre",13,0,6,1,153,3,17,0,1,194,3,6,203,220,0.789,0.923
"16145","Oruro","Caracollo","Esc. Mariscal Sucre",35,2,6,1,137,3,17,0,0,201,5,4,210,234,0.682,0.897
"16146","Oruro","Caracollo","U.E. Simon Bolivar Primario",24,1,10,0,125,3,41,0,1,205,2,8,215,236,0.61,0.911
"16147","Oruro","Caracollo","U.E. Simon Bolivar Primario",25,0,9,0,139,1,35,0,1,210,5,11,226,237,0.662,0.954
"16148","Oruro","Caracollo","U.E. Simon Bolivar Primario",20,1,5,0,131,2,38,0,1,198,2,6,206,224,0.662,0.92
"16149","Oruro","Caracollo","U.E. Litoral",31,0,7,1,120,2,31,1,4,197,3,12,212,235,0.609,0.902
"16150","Oruro","Caracollo","U.E. Litoral",24,0,8,4,129,3,43,0,4,215,1,3,219,238,0.6,0.92
"16151","Oruro","Caracollo","U.E. Litoral",29,0,3,0,122,1,43,0,4,202,3,7,212,239,0.604,0.887
"16152","Oruro","Caracollo","U.E. Litoral",19,0,7,0,126,1,45,0,5,203,3,10,216,235,0.621,0.919
"16153","Oruro","Caracollo","U.E. Litoral",31,0,4,0,131,3,36,0,1,206,1,5,212,238,0.636,0.891
"16154","Oruro","Caracollo","Esc. Arca de Noe",10,0,2,0,161,1,12,0,2,188,1,7,196,216,0.856,0.907
"16155","Oruro","Caracollo","U.E. Max Fernandez",2,0,7,2,173,2,9,0,0,195,4,16,215,222,0.887,0.968
"16156","Oruro","Caracollo","U.E. Max Fernandez",3,0,6,0,175,0,12,4,0,200,2,3,205,221,0.875,0.928
"16157","Oruro","Caracollo","Esc. Elizardo Perez",19,0,2,3,141,2,23,0,0,190,7,8,205,219,0.742,0.936
"16158","Oruro","Caracollo","Casa Productiva",26,1,4,1,123,1,30,0,3,189,1,4,194,216,0.651,0.898
"16159","Oruro","Caracollo","Casa Productiva",34,2,3,2,129,3,18,1,3,195,2,3,200,224,0.662,0.893
"16160","Oruro","Caracollo","Casa Productiva",41,1,3,1,100,1,35,1,2,185,4,5,194,218,0.541,0.89
"16161","Oruro","Caracollo","Casa Productiva",31,0,2,1,117,2,30,0,2,185,1,6,192,214,0.632,0.897
"16162","Oruro","Caracollo","Esc. Gualberto Villarroel",28,0,4,1,102,3,23,0,3,164,2,4,170,179,0.622,0.95
"16163","Oruro","Caracollo","U.E. Ayacucho",34,4,5,2,100,3,21,3,2,174,3,6,183,206,0.575,0.888
"16164","Oruro","Caracollo","U.E. Otto Saucedo Rivera",27,1,0,0,104,1,24,0,0,157,0,8,165,182,0.662,0.907
"16165","Oruro","Caracollo","U.E. Florencio Alvarado",24,0,5,2,135,2,20,0,1,189,2,9,200,206,0.714,0.971
"16166","Oruro","Caracollo","U.E. Alemania",9,0,3,1,126,2,15,0,1,157,4,20,181,201,0.803,0.9
"16167","Oruro","Caracollo","U.E. Alemania",17,0,6,4,139,2,18,0,0,186,9,16,211,228,0.747,0.925
"16168","Oruro","Caracollo","Col.Nal. Simón Bolivar",17,2,10,0,147,6,11,1,2,196,2,2,200,207,0.75,0.966
"16169","Oruro","Caracollo","U.E. Sebastian Pagador",9,3,4,2,146,1,20,1,1,187,3,11,201,219,0.781,0.918
"16170","Oruro","Caracollo","U.E. Franz Tamayo",24,0,1,1,141,5,26,1,2,201,7,12,220,230,0.701,0.957
"16171","Oruro","Caracollo","Esc. Central Horenco",10,4,4,0,156,1,10,0,0,185,4,15,204,222,0.843,0.919
"16172","Oruro","Caracollo","Esc. Central Horenco",6,0,4,0,165,0,13,0,2,190,3,8,201,213,0.868,0.944
"16173","Oruro","Caracollo","Casa Comunal",4,1,4,0,168,1,20,0,0,198,7,11,216,225,0.848,0.96
"16174","Oruro","Caracollo","Esc. Rene Bernal Escalante",8,2,5,0,165,3,9,0,0,192,7,10,209,224,0.859,0.933
"16175","Oruro","Caracollo","U.Esc. Marcelo Quiroga Santa Cruz",24,5,4,3,122,4,25,0,1,188,5,16,209,221,0.649,0.946
"16176","Oruro","El Choro","Esc. Sebastian  Pagador",19,0,0,1,137,3,11,1,0,172,5,9,186,209,0.797,0.89
"16177","Oruro","El Choro","Esc. Sebastian  Pagador",12,0,1,2,124,1,13,0,1,154,4,10,168,209,0.805,0.804
"16178","Oruro","El Choro","Esc. Sebastian  Pagador",12,0,2,2,152,1,14,0,1,184,3,8,195,214,0.826,0.911
"16179","Oruro","El Choro","U.E. Crucero Belén",20,3,2,0,116,2,29,0,0,172,5,7,184,201,0.674,0.915
"16180","Oruro","El Choro","Esc. Jose Ballivian",8,4,1,1,131,1,24,0,1,171,4,4,179,211,0.766,0.848
"16181","Oruro","El Choro","Esc. Jose Ballivian",12,3,0,0,143,3,15,2,1,179,4,7,190,211,0.799,0.9
"16182","Oruro","El Choro","Esc. Gualberto Villarroel",16,2,1,1,123,3,37,1,2,186,8,11,205,220,0.661,0.932
"16183","Oruro","Paria (Soracachi)","U.E. Teniente Jose Rosendo Bullain Renjel",25,0,2,0,124,8,35,1,2,197,6,12,215,219,0.629,0.982
"16184","Oruro","Paria (Soracachi)","U.E. Teniente Jose Rosendo Bullain Renjel",19,1,3,4,147,2,36,0,1,213,4,11,228,232,0.69,0.983
"16185","Oruro","Paria (Soracachi)","U.E. Teniente Jose Rosendo Bullain Renjel",19,0,3,0,126,2,41,0,1,192,5,16,213,223,0.656,0.955
"16186","Oruro","Paria (Soracachi)","U.E. Teniente Jose Rosendo Bullain Renjel",29,1,3,0,131,4,26,0,2,196,6,11,213,220,0.668,0.968
"16187","Oruro","Paria (Soracachi)","Esc. Central Paria",19,0,4,1,138,3,23,0,3,191,5,11,207,223,0.723,0.928
"16188","Oruro","Paria (Soracachi)","Esc. Central Paria",12,0,3,0,136,4,21,2,2,180,10,14,204,214,0.756,0.953
"16189","Oruro","Paria (Soracachi)","Esc. Central Paria",21,1,3,1,128,6,28,1,1,190,3,9,202,216,0.674,0.935
"16190","Oruro","Paria (Soracachi)","Col. Eduardo Avaroa",24,0,1,0,136,1,35,0,3,200,5,10,215,224,0.68,0.96
"16191","Oruro","Paria (Soracachi)","Col. Eduardo Avaroa",5,1,1,0,153,2,37,0,2,201,4,13,218,232,0.761,0.94
"16192","Oruro","Paria (Soracachi)","U.E. Mariscal Sucre Tolapalca",19,2,2,1,133,5,15,1,0,178,11,10,199,220,0.747,0.905
"16193","Oruro","Paria (Soracachi)","U.E. Eduardo Avaroa",19,0,0,0,153,1,27,2,2,204,5,6,215,225,0.75,0.956
"16194","Oruro","Paria (Soracachi)","U.E. Eduardo Avaroa",17,2,3,0,140,2,34,2,0,200,5,9,214,220,0.7,0.973
"16195","Oruro","Paria (Soracachi)","Esc. Simon Bolivar - Recinto 159 -  Lequepalca",9,0,0,0,142,1,19,0,0,171,6,6,183,209,0.83,0.876
"16196","Oruro","Paria (Soracachi)","Col. Nal. Mixto Soracachi",18,0,3,0,129,6,34,1,2,193,8,18,219,224,0.668,0.978
"16197","Oruro","Paria (Soracachi)","Col. Nal. Mixto Soracachi",29,0,5,1,116,6,37,0,2,196,5,8,209,219,0.592,0.954
"16198","Oruro","Paria (Soracachi)","Col. Nal. Mixto Soracachi",5,1,1,0,138,3,38,2,2,190,11,12,213,222,0.726,0.959
"16199","Oruro","Paria (Soracachi)","Col. Nal. Mixto Soracachi",17,0,2,0,112,2,52,1,0,186,4,13,203,215,0.602,0.944
"16200","Oruro","Paria (Soracachi)","Col. Nal. Iruma",14,3,4,0,141,1,16,2,5,186,1,11,198,219,0.758,0.904
"16201","Oruro","Paria (Soracachi)","Esc. Cachi Cachi",14,1,4,0,135,3,38,0,6,201,5,8,214,225,0.672,0.951
"16202","Oruro","Paria (Soracachi)","Esc. Seccional San Juan Pampa",26,2,5,2,108,6,36,0,3,188,4,17,209,220,0.574,0.95
"16203","Oruro","Paria (Soracachi)","Esc. Seccional San Juan Pampa",12,3,9,0,145,4,29,0,3,205,2,12,219,231,0.707,0.948
"16204","Oruro","Paria (Soracachi)","Esc. Carlos Beltran Morales",8,0,1,1,164,2,15,0,0,191,5,10,206,215,0.859,0.958
"16205","Oruro","Paria (Soracachi)","Esc. Elizardo Perez",13,1,2,0,141,2,41,1,0,201,4,17,222,228,0.701,0.974
"16206","Oruro","Paria (Soracachi)","U. E. Jatita",21,3,2,1,123,1,31,0,2,184,5,12,201,220,0.668,0.914
"16207","Oruro","Paria (Soracachi)","Esc. Litoral",4,0,0,1,165,2,21,1,1,195,2,16,213,219,0.846,0.973
"16208","Oruro","Paria (Soracachi)","U. E. K'Asa Huasa",31,1,1,1,111,1,42,1,5,194,3,17,214,225,0.572,0.951
"16209","Oruro","Paria (Soracachi)","Esc. Seccional Condorchinoca",16,3,2,0,146,1,33,0,2,203,7,9,219,231,0.719,0.948
"16210","Oruro","Paria (Soracachi)","Esc. Multigrado Cullcupampa",8,1,0,0,125,2,46,0,2,184,6,20,210,228,0.679,0.921
"16211","Oruro","Paria (Soracachi)","U. E. Calapata",10,1,0,2,131,5,43,1,4,197,4,19,220,228,0.665,0.965
"16212","Oruro","Paria (Soracachi)","U. Esc. Simon Bolivar",3,0,2,0,148,6,32,0,1,192,6,19,217,230,0.771,0.943
"16213","Oruro","Challapata","U. E. Republica Argentina",48,0,1,2,78,5,35,1,4,174,6,13,193,218,0.448,0.885
"16214","Oruro","Challapata","U. E. Republica Argentina",40,2,4,1,89,6,31,1,5,179,9,14,202,225,0.497,0.898
"16215","Oruro","Challapata","U. E. Republica Argentina",48,0,0,1,83,8,33,2,2,177,5,10,192,225,0.469,0.853
"16216","Oruro","Challapata","U. E. Republica Argentina",29,2,2,0,97,4,43,1,5,183,3,11,197,222,0.53,0.887
"16217","Oruro","Challapata","U. E. Republica Argentina",37,2,1,1,83,3,48,1,3,179,4,7,190,218,0.464,0.872
"16218","Oruro","Challapata","U. E. Republica Argentina",43,2,4,2,80,2,39,1,3,176,8,14,198,220,0.455,0.9
"16219","Oruro","Challapata","U. E. Republica Argentina",47,3,3,3,76,5,38,0,1,176,6,15,197,225,0.432,0.876
"16220","Oruro","Challapata","U. E. Republica Argentina",47,3,2,1,90,0,36,1,2,182,5,6,193,220,0.495,0.877
"16221","Oruro","Challapata","U. E. Republica Argentina",45,4,2,0,84,4,33,0,0,172,5,16,193,217,0.488,0.889
"16222","Oruro","Challapata","U. E. Republica Argentina",40,1,2,0,89,3,39,1,2,177,8,8,193,220,0.503,0.877
"16223","Oruro","Challapata","U. E. Republica Argentina",27,1,1,1,87,8,48,0,2,175,6,8,189,218,0.497,0.867
"16224","Oruro","Challapata","U. E. Republica Argentina",39,2,4,1,90,6,38,0,9,189,3,3,195,222,0.476,0.878
"16225","Oruro","Challapata","U. E. Republica Argentina",38,2,6,2,87,2,37,2,1,177,3,9,189,216,0.492,0.875
"16226","Oruro","Challapata","U. E. Republica Argentina",44,0,6,0,78,4,43,1,1,177,5,16,198,217,0.441,0.912
"16227","Oruro","Challapata","U. E. Republica Argentina",40,1,4,1,82,3,43,1,4,179,3,7,189,219,0.458,0.863
"16228","Oruro","Challapata","U. E. Eduardo Avaroa",41,2,2,0,86,2,37,1,2,173,4,16,193,223,0.497,0.865
"16229","Oruro","Challapata","U. E. Eduardo Avaroa",47,0,2,1,86,3,32,1,1,173,5,19,197,223,0.497,0.883
"16230","Oruro","Challapata","U. E. Eduardo Avaroa",40,0,6,1,84,6,34,2,5,178,7,10,195,219,0.472,0.89
"16231","Oruro","Challapata","U. E. Eduardo Avaroa",40,2,4,3,93,4,30,1,1,178,3,16,197,224,0.522,0.879
"16232","Oruro","Challapata","U. E. Eduardo Avaroa",33,2,5,0,88,5,46,0,3,182,2,11,195,217,0.484,0.899
"16233","Oruro","Challapata","U. E. Eduardo Avaroa",39,0,5,1,83,4,41,0,5,178,5,14,197,223,0.466,0.883
"16234","Oruro","Challapata","U. E. Eduardo Avaroa",36,1,1,0,95,4,39,0,0,176,3,9,188,217,0.54,0.866
"16235","Oruro","Challapata","U. E. Eduardo Avaroa",45,1,4,2,81,2,37,0,2,174,3,10,187,212,0.466,0.882
"16236","Oruro","Challapata","U. E. Eduardo Avaroa",35,1,4,2,89,0,32,3,3,169,5,12,186,217,0.527,0.857
"16237","Oruro","Challapata","U. E. Eduardo Avaroa",37,1,5,1,85,3,43,1,2,178,6,7,191,221,0.478,0.864
"16238","Oruro","Challapata","U. E. Eduardo Avaroa",28,2,1,0,95,6,39,0,4,175,5,10,190,222,0.543,0.856
"16239","Oruro","Challapata","U. E. Eduardo Avaroa",29,1,1,1,86,3,48,1,0,170,6,6,182,219,0.506,0.831
"16240","Oruro","Challapata","U. E. Eduardo Avaroa",47,1,4,2,71,2,40,2,1,170,5,7,182,216,0.418,0.843
"16241","Oruro","Challapata","U. E. Eduardo Avaroa",34,3,3,4,91,1,39,1,6,182,7,10,199,221,0.5,0.9
"16242","Oruro","Challapata","U. E. San Juan de Dios",57,1,3,0,79,0,27,0,3,170,5,14,189,224,0.465,0.844
"16243","Oruro","Challapata","U. E. San Juan de Dios",40,2,3,0,99,4,26,1,2,177,5,12,194,217,0.559,0.894
"16244","Oruro","Challapata","U. E. San Juan de Dios",42,1,4,2,83,5,43,0,3,183,3,13,199,221,0.454,0.9
"16245","Oruro","Challapata","U. E. San Juan de Dios",35,1,3,1,85,3,42,0,2,172,7,20,199,223,0.494,0.892
"16246","Oruro","Challapata","U. E. San Juan de Dios",48,2,2,2,74,5,39,1,4,177,6,13,196,219,0.418,0.895
"16247","Oruro","Challapata","U. E. San Juan de Dios",42,0,4,2,81,2,46,0,6,183,3,11,197,216,0.443,0.912
"16248","Oruro","Challapata","U. E. San Juan de Dios",44,0,2,0,86,0,38,0,3,173,5,11,189,220,0.497,0.859
"16249","Oruro","Challapata","U. E. San Juan de Dios",25,3,3,1,86,4,42,0,2,166,2,11,179,220,0.518,0.814
"16250","Oruro","Challapata","U. E. San Juan de Dios",28,0,2,1,84,8,52,5,2,182,6,14,202,221,0.462,0.914
"16251","Oruro","Challapata","U. E. San Juan de Dios",32,0,4,1,87,4,47,1,4,180,6,11,197,214,0.483,0.921
"16252","Oruro","Challapata","U. E. San Juan de Dios",34,3,4,1,81,3,48,2,4,180,2,15,197,226,0.45,0.872
"16253","Oruro","Challapata","U. E. San Juan de Dios",41,1,4,1,96,3,47,1,3,197,6,9,212,233,0.487,0.91
"16254","Oruro","Challapata","U.E. Mons. Ricardo Beni Moro",35,3,2,3,81,8,51,0,4,187,5,18,210,238,0.433,0.882
"16255","Oruro","Challapata","U.E. Mons. Ricardo Beni Moro",19,1,6,0,108,8,49,0,2,193,4,16,213,235,0.56,0.906
"16256","Oruro","Challapata","U.E. Mons. Ricardo Beni Moro",37,0,3,1,100,4,46,0,4,195,6,10,211,233,0.513,0.906
"16257","Oruro","Challapata","U.E. Mons. Ricardo Beni Moro",28,2,4,1,104,7,41,1,2,190,7,14,211,237,0.547,0.89
"16258","Oruro","Challapata","U.E. Mons. Ricardo Beni Moro",35,2,1,2,78,2,62,0,4,186,6,19,211,234,0.419,0.902
"16259","Oruro","Challapata","U.E. Mons. Ricardo Beni Moro",24,2,5,0,87,5,55,1,1,180,5,17,202,235,0.483,0.86
"16260","Oruro","Challapata","U.E. Mons. Ricardo Beni Moro",33,1,2,0,95,5,54,0,3,193,6,8,207,233,0.492,0.888
"16261","Oruro","Challapata","U.E. Mons. Ricardo Beni Moro",24,0,5,2,109,4,45,0,3,192,1,10,203,237,0.568,0.857
"16262","Oruro","Challapata","U.E. Antofagasta",36,0,4,0,92,2,49,0,4,187,3,14,204,234,0.492,0.872
"16263","Oruro","Challapata","U.E. Antofagasta",43,1,4,1,85,8,41,1,5,189,3,9,201,235,0.45,0.855
"16264","Oruro","Challapata","U.E. Antofagasta",27,1,2,7,116,4,36,0,3,196,6,12,214,234,0.592,0.915
"16265","Oruro","Challapata","U.E. Antofagasta",18,3,6,2,108,4,51,0,6,198,4,10,212,236,0.545,0.898
"16266","Oruro","Challapata","U.E. Antofagasta",30,1,1,1,91,2,54,0,6,186,11,15,212,236,0.489,0.898
"16267","Oruro","Challapata","U.E. Antofagasta",29,1,3,0,105,3,48,1,0,190,11,10,211,237,0.553,0.89
"16268","Oruro","Challapata","U.E. Antofagasta",22,1,6,1,113,8,47,0,2,200,3,9,212,235,0.565,0.902
"16269","Oruro","Challapata","Col. Nemecio Barrientos",4,1,3,0,186,0,6,1,0,201,3,8,212,216,0.925,0.981
"16270","Oruro","Challapata","Col. Nemecio Barrientos",2,1,1,0,187,0,16,3,0,210,3,4,217,217,0.89,1
"16271","Oruro","Challapata","Col. Nemecio Barrientos",0,0,1,1,198,0,4,0,0,204,1,5,210,216,0.971,0.972
"16272","Oruro","Challapata","Col. Nemecio Barrientos",2,3,1,1,183,1,12,1,0,204,3,7,214,220,0.897,0.973
"16273","Oruro","Challapata","Col. Nemecio Barrientos",2,3,1,0,192,3,20,0,0,221,3,6,230,230,0.869,1
"16274","Oruro","Challapata","Col. Nemecio Barrientos",2,1,2,0,182,0,11,2,1,201,3,10,214,218,0.905,0.982
"16275","Oruro","Challapata","Col. Nemecio Barrientos",5,0,0,0,173,1,16,0,1,196,7,7,210,214,0.883,0.981
"16276","Oruro","Challapata","Col. Nemecio Barrientos",4,2,0,1,170,2,11,5,0,195,12,5,212,224,0.872,0.946
"16277","Oruro","Challapata","Col. Nemecio Barrientos",2,2,2,0,167,0,17,0,0,190,1,6,197,200,0.879,0.985
"16278","Oruro","Challapata","Esc. Gualberto Villarroel",13,2,5,3,135,1,7,2,0,168,4,6,178,208,0.804,0.856
"16279","Oruro","Challapata","Col. Simon Bolivar",3,1,6,3,132,0,19,2,6,172,11,9,192,215,0.767,0.893
"16280","Oruro","Challapata","Col. Simon Bolivar",6,2,3,0,151,1,24,0,1,188,10,7,205,216,0.803,0.949
"16281","Oruro","Challapata","Col. Simon Bolivar",4,1,4,0,155,2,19,0,0,185,3,8,196,220,0.838,0.891
"16282","Oruro","Challapata","Col. Simon Bolivar",7,1,1,2,142,5,34,3,1,196,7,12,215,225,0.724,0.956
"16283","Oruro","Challapata","U.E. German Busch",15,1,11,3,118,4,15,1,3,171,3,11,185,196,0.69,0.944
"16284","Oruro","Challapata","Esc. Elizardo Perez",4,4,2,2,106,0,40,1,2,161,9,17,187,214,0.658,0.874
"16285","Oruro","Challapata","U.E. Huancane",21,0,3,3,114,6,29,1,5,182,4,11,197,211,0.626,0.934
"16286","Oruro","Challapata","U.E. Tolapalca",4,3,7,3,116,3,39,2,1,178,11,21,210,224,0.652,0.938
"16287","Oruro","Challapata","Iglesia",4,1,2,1,130,3,24,1,2,168,10,9,187,218,0.774,0.858
"16288","Oruro","Challapata","Iglesia",7,4,4,2,128,7,24,2,1,179,4,7,190,215,0.715,0.884
"16289","Oruro","Challapata","U. E. Churacani",18,5,10,1,94,5,34,0,1,168,8,9,185,206,0.56,0.898
"16290","Oruro","Challapata","U. E. Cruce Aguas Calientes",7,3,6,1,159,3,11,1,1,192,6,15,213,234,0.828,0.91
"16291","Oruro","Challapata","U. E. Cochuyo",11,0,1,2,121,5,29,1,0,170,10,11,191,215,0.712,0.888
"16292","Oruro","Santuario de Quillacas","U.E. Santuario de Quillacas",19,1,7,0,141,3,16,0,2,189,2,4,195,220,0.746,0.886
"16293","Oruro","Santuario de Quillacas","U.E. Santuario de Quillacas",37,1,2,2,127,1,16,2,1,189,5,7,201,216,0.672,0.931
"16294","Oruro","Santuario de Quillacas","U.E. Santuario de Quillacas",30,2,5,3,113,2,19,0,0,174,2,6,182,206,0.649,0.883
"16295","Oruro","Santuario de Quillacas","Col. Nal. Mixto Sevaruyo",18,0,2,0,143,0,23,1,0,187,8,7,202,223,0.765,0.906
"16296","Oruro","Santuario de Quillacas","Col. Nal. Mixto Sevaruyo",14,0,1,1,151,0,26,0,2,195,0,6,201,217,0.774,0.926
"16297","Oruro","Santuario de Quillacas","Col. Nal. Mixto Sevaruyo",12,0,4,2,135,1,30,3,3,190,6,6,202,219,0.711,0.922
"16298","Oruro","Santuario de Quillacas","Esc. Soraga",6,0,3,2,160,1,15,0,1,188,7,3,198,218,0.851,0.908
"16299","Oruro","Corque","Col.  Jose Trifiro",13,0,0,3,117,3,16,4,4,160,3,4,167,211,0.731,0.791
"16300","Oruro","Corque","Col.  Jose Trifiro",20,1,5,1,125,0,15,0,1,168,2,6,176,224,0.744,0.786
"16301","Oruro","Corque","Col.  Jose Trifiro",16,2,6,1,118,0,13,0,3,159,3,5,167,219,0.742,0.763
"16302","Oruro","Corque","Col.  Jose Trifiro",22,0,3,2,127,6,16,0,1,177,6,6,189,227,0.718,0.833
"16303","Oruro","Corque","Esc. Rafael Pabon",65,0,5,2,114,2,26,0,0,214,4,4,222,226,0.533,0.982
"16304","Oruro","Corque","Esc. Rafael Pabon",93,1,1,1,69,0,16,0,1,182,2,2,186,187,0.379,0.995
"16305","Oruro","Corque","Proyecto Cristian Childrens",23,3,7,1,105,2,40,0,2,183,2,7,192,222,0.574,0.865
"16306","Oruro","Corque","Proyecto Cristian Childrens",14,0,8,1,140,0,21,1,0,185,6,4,195,219,0.757,0.89
"16307","Oruro","Corque","Esc. Elizardo Perez",32,0,4,1,155,1,22,1,3,219,3,4,226,230,0.708,0.983
"16308","Oruro","Corque","U.E. Ismael Montes",24,1,1,2,96,1,33,0,0,158,1,0,159,172,0.608,0.924
"16309","Oruro","Corque","U.E. Franz Tamayo",6,0,3,1,148,5,11,0,0,174,4,4,182,195,0.851,0.933
"16310","Oruro","Corque","U. E. Franz Tamayo - Villa Esperanza",10,3,1,3,133,0,25,3,3,181,5,7,193,219,0.735,0.881
"16311","Oruro","Corque","U.E. Huaylloco",8,1,2,1,118,3,21,1,3,158,4,5,167,192,0.747,0.87
"16312","Oruro","Corque","U.E. Villa Copacabana",33,1,2,1,112,5,19,0,2,175,7,7,189,219,0.64,0.863
"16313","Oruro","Choquecota","Esc. Jose Ballivian",9,0,2,1,156,4,7,1,0,180,5,2,187,220,0.867,0.85
"16314","Oruro","Choquecota","Esc. Jose Ballivian",13,0,3,0,158,2,14,0,1,191,2,5,198,219,0.827,0.904
"16315","Oruro","Choquecota","Esc. Jose Ballivian",5,1,4,1,140,2,18,0,0,171,2,7,180,214,0.819,0.841
"16316","Oruro","Curahuara de Carangas","Esc. Eduardo Sagarnaga",17,1,9,1,108,2,15,0,1,154,7,11,172,220,0.701,0.782
"16317","Oruro","Curahuara de Carangas","Esc. Eduardo Sagarnaga",10,0,3,2,135,5,17,0,1,173,8,5,186,220,0.78,0.845
"16318","Oruro","Curahuara de Carangas","Esc. Eduardo Sagarnaga",10,1,7,1,117,2,14,0,1,153,3,2,158,221,0.765,0.715
"16319","Oruro","Curahuara de Carangas","Esc. Eduardo Sagarnaga",7,4,5,0,128,0,16,1,2,163,7,12,182,223,0.785,0.816
"16320","Oruro","Curahuara de Carangas","Esc. Eduardo Sagarnaga",8,2,7,1,129,2,15,0,0,164,6,6,176,223,0.787,0.789
"16321","Oruro","Curahuara de Carangas","Esc. Eduardo Sagarnaga",15,1,5,0,98,2,29,1,1,152,4,5,161,220,0.645,0.732
"16322","Oruro","Curahuara de Carangas","Esc. Eduardo Sagarnaga",14,2,2,1,133,2,20,1,1,176,0,7,183,237,0.756,0.772
"16323","Oruro","Curahuara de Carangas","Esc. Eduardo Sagarnaga",8,2,2,0,131,1,18,1,2,165,8,8,181,217,0.794,0.834
"16324","Oruro","Curahuara de Carangas","Esc. Eduardo Sagarnaga",11,0,7,1,115,0,16,0,2,152,7,5,164,223,0.757,0.735
"16325","Oruro","Curahuara de Carangas","Esc. Eduardo Sagarnaga",12,0,8,1,113,2,21,0,0,157,3,7,167,220,0.72,0.759
"16326","Oruro","Curahuara de Carangas","Col. Bolivia",19,0,0,0,104,1,34,0,5,163,0,9,172,217,0.638,0.793
"16327","Oruro","Turco","U.E. Porvenir",42,0,6,0,94,4,39,1,2,188,7,2,197,220,0.5,0.895
"16328","Oruro","Turco","U.E. Pedro Domingo Murillo A",31,0,5,0,122,0,34,1,3,196,1,3,200,224,0.622,0.893
"16329","Oruro","Turco","U.E. Pedro Domingo Murillo A",29,0,7,0,105,0,27,1,4,173,3,2,178,205,0.607,0.868
"16330","Oruro","Turco","Esc. Central Turco",22,1,4,1,138,5,17,0,1,189,3,1,193,222,0.73,0.869
"16331","Oruro","Turco","Esc. Central Turco",15,0,7,2,143,4,23,1,0,195,1,4,200,218,0.733,0.917
"16332","Oruro","Turco","Esc. Central Turco",8,0,6,1,139,2,23,0,1,180,5,8,193,221,0.772,0.873
"16333","Oruro","Turco","Esc. Central Turco",2,0,5,1,153,2,14,0,1,178,1,3,182,212,0.86,0.858
"16334","Oruro","Turco","Esc. Central Turco",5,3,4,0,147,2,16,2,1,180,9,5,194,215,0.817,0.902
"16335","Oruro","Escara","U.E. Franz Tamayo",75,0,5,1,57,9,22,1,1,171,10,5,186,219,0.333,0.849
"16336","Oruro","Escara","U.E. Franz Tamayo",58,0,0,0,69,11,15,2,1,156,5,7,168,196,0.442,0.857
"16337","Oruro","Cruz de Machacamarca","Esc. Cruz De Machacamarca",71,4,4,0,50,0,29,1,2,161,4,2,167,196,0.311,0.852
"16338","Oruro","Esmeralda","Esc. Sebastian Pagador",89,1,0,1,53,4,15,1,0,164,1,9,174,200,0.323,0.87
"16339","Oruro","Poopó","Esc. Ismael Montes",40,0,2,3,122,1,14,2,1,185,10,7,202,221,0.659,0.914
"16340","Oruro","Poopó","Esc. Ismael Montes",43,0,3,1,135,3,17,0,3,205,1,2,208,221,0.659,0.941
"16341","Oruro","Poopó","Esc. Ismael Montes",36,2,2,1,129,1,21,2,2,196,3,7,206,221,0.658,0.932
"16342","Oruro","Poopó","Esc. Ismael Montes",37,1,3,0,127,3,16,0,4,191,3,4,198,217,0.665,0.912
"16343","Oruro","Poopó","Esc. Ismael Montes",40,0,2,3,106,2,20,0,5,178,5,8,191,218,0.596,0.876
"16344","Oruro","Poopó","Esc. Ismael Montes",30,0,1,1,130,6,17,0,1,186,9,8,203,217,0.699,0.935
"16345","Oruro","Poopó","Esc. Ismael Montes",40,1,7,1,117,3,24,1,2,196,5,6,207,221,0.597,0.937
"16346","Oruro","Poopó","Esc. Ismael Montes",40,0,5,0,108,4,17,0,3,177,2,9,188,216,0.61,0.87
"16347","Oruro","Poopó","Esc. Ismael Montes",29,1,2,2,131,3,23,1,1,193,3,6,202,215,0.679,0.94
"16348","Oruro","Poopó","Esc. Ismael Montes",26,2,5,0,138,1,21,1,3,197,6,7,210,220,0.701,0.955
"16349","Oruro","Poopó","Esc. Ismael Montes",40,1,2,2,116,2,36,0,0,199,2,5,206,221,0.583,0.932
"16350","Oruro","Poopó","Esc. Ismael Montes",39,1,1,1,120,5,25,2,1,195,5,8,208,219,0.615,0.95
"16351","Oruro","Poopó","U.E. Hernando Siles",20,2,6,4,120,2,13,0,3,170,7,6,183,202,0.706,0.906
"16352","Oruro","Poopó","U.E. Hernando Siles",19,0,3,4,122,1,19,3,3,174,11,11,196,206,0.701,0.951
"16353","Oruro","Pazña","Col. Oscar Unzaga De La Vega",38,2,2,1,109,1,18,0,3,174,7,7,188,220,0.626,0.855
"16354","Oruro","Pazña","Col. Oscar Unzaga De La Vega",31,4,0,5,129,6,15,1,2,193,2,4,199,217,0.668,0.917
"16355","Oruro","Pazña","Col. Oscar Unzaga De La Vega",37,2,6,0,117,5,16,1,3,187,7,7,201,216,0.626,0.931
"16356","Oruro","Pazña","Col. Oscar Unzaga De La Vega",49,0,4,0,118,2,15,0,3,191,1,7,199,215,0.618,0.926
"16357","Oruro","Pazña","Esc. Mariscal Sucre",19,2,4,3,119,1,22,1,1,172,8,8,188,212,0.692,0.887
"16358","Oruro","Pazña","Esc. Mariscal Sucre",19,1,3,1,119,2,12,0,1,158,4,36,198,218,0.753,0.908
"16359","Oruro","Pazña","Esc. Mariscal Sucre",12,0,3,1,129,0,24,1,1,171,5,12,188,217,0.754,0.866
"16360","Oruro","Pazña","Esc. Mariscal Sucre",22,1,1,1,120,0,17,0,0,162,5,10,177,195,0.741,0.908
"16361","Oruro","Pazña","Col. Juan Lechin Oquendo",33,2,1,2,115,7,28,1,5,194,9,5,208,222,0.593,0.937
"16362","Oruro","Pazña","Col. Juan Lechin Oquendo",27,1,1,1,137,5,22,1,1,196,5,8,209,223,0.699,0.937
"16363","Oruro","Pazña","U.E. Guillermo Gutierrez",27,0,1,1,140,5,15,2,1,192,7,6,205,222,0.729,0.923
"16364","Oruro","Antequera","Esc. Sebastian Pagador",73,0,3,0,94,6,19,1,0,196,4,12,212,233,0.48,0.91
"16365","Oruro","Antequera","Esc. Sebastian Pagador",73,1,6,2,97,1,14,0,5,199,6,8,213,223,0.487,0.955
"16366","Oruro","Antequera","Esc. Sebastian Pagador",76,0,1,0,86,9,25,0,3,200,3,7,210,226,0.43,0.929
"16367","Oruro","Antequera","Esc. Sebastian Pagador",60,1,1,1,100,4,23,0,5,195,4,7,206,225,0.513,0.916
"16368","Oruro","Antequera","Esc. Sebastian Pagador",67,1,2,0,105,5,11,0,0,191,2,16,209,225,0.55,0.929
"16369","Oruro","Huanuni","Esc. Eduardo Avaroa",43,0,1,0,117,2,24,1,4,192,1,6,199,224,0.609,0.888
"16370","Oruro","Huanuni","Esc. Eduardo Avaroa",43,1,0,2,116,2,23,1,2,190,4,7,201,215,0.611,0.935
"16371","Oruro","Huanuni","Esc. Eduardo Avaroa",29,0,1,0,141,3,20,0,0,194,5,8,207,224,0.727,0.924
"16372","Oruro","Huanuni","Esc. Eduardo Avaroa",51,1,3,0,117,0,23,0,2,197,2,10,209,226,0.594,0.925
"16373","Oruro","Huanuni","Esc. Eduardo Avaroa",39,0,1,2,121,2,15,1,2,183,2,10,195,219,0.661,0.89
"16374","Oruro","Huanuni","Esc. Eduardo Avaroa",52,0,2,1,105,6,30,0,3,199,2,5,206,217,0.528,0.949
"16375","Oruro","Huanuni","Esc. Eduardo Avaroa",28,1,1,1,125,5,23,0,3,187,1,7,195,217,0.668,0.899
"16376","Oruro","Huanuni","Esc. Eduardo Avaroa",49,1,2,0,118,3,13,1,1,188,3,5,196,215,0.628,0.912
"16377","Oruro","Huanuni","Esc. Eduardo Avaroa",41,0,1,0,118,2,21,0,4,187,6,11,204,224,0.631,0.911
"16378","Oruro","Huanuni","Esc. Eduardo Avaroa",45,1,2,2,118,0,23,1,3,195,3,12,210,224,0.605,0.938
"16379","Oruro","Huanuni","Esc. Eduardo Avaroa",46,1,1,3,116,1,20,0,1,189,5,10,204,223,0.614,0.915
"16380","Oruro","Huanuni","Esc. Eduardo Avaroa",43,0,1,1,117,2,25,1,1,191,4,6,201,225,0.613,0.893
"16381","Oruro","Huanuni","Esc. Eduardo Avaroa",39,0,1,1,127,2,14,1,2,187,3,8,198,220,0.679,0.9
"16382","Oruro","Huanuni","Esc. Eduardo Avaroa",52,0,2,1,108,5,26,1,0,195,2,12,209,223,0.554,0.937
"16383","Oruro","Huanuni","Esc. Eduardo Avaroa",38,0,3,0,120,2,21,0,1,185,1,17,203,224,0.649,0.906
"16384","Oruro","Huanuni","Esc. Eduardo Avaroa",46,0,1,1,104,3,25,0,1,181,3,15,199,215,0.575,0.926
"16385","Oruro","Huanuni","Esc. Eduardo Avaroa",60,1,2,0,114,3,19,0,5,204,1,8,213,227,0.559,0.938
"16386","Oruro","Huanuni","Esc. Eduardo Avaroa",30,0,1,0,113,6,34,1,6,191,1,10,202,222,0.592,0.91
"16387","Oruro","Huanuni","Esc. Eduardo Avaroa",38,1,0,2,118,1,20,0,2,182,4,15,201,220,0.648,0.914
"16388","Oruro","Huanuni","Col. Ayacucho",37,0,2,1,126,2,15,0,2,185,2,8,195,215,0.681,0.907
"16389","Oruro","Huanuni","Col. Ayacucho",36,2,1,1,117,1,33,0,1,192,1,10,203,222,0.609,0.914
"16390","Oruro","Huanuni","Col. Ayacucho",47,0,0,0,124,3,19,0,2,195,0,9,204,223,0.636,0.915
"16391","Oruro","Huanuni","Col. Ayacucho",43,0,1,2,116,3,18,2,6,191,5,13,209,225,0.607,0.929
"16392","Oruro","Huanuni","Col. Ayacucho",34,0,0,2,125,0,21,1,4,187,6,22,215,231,0.668,0.931
"16393","Oruro","Huanuni","Col. Ayacucho",38,0,2,1,126,5,23,0,3,198,2,8,208,224,0.636,0.929
"16394","Oruro","Huanuni","Col. Ayacucho",38,0,1,3,118,1,35,1,6,203,2,5,210,222,0.581,0.946
"16395","Oruro","Huanuni","Col. Ayacucho",24,1,0,1,135,4,19,0,1,185,6,15,206,224,0.73,0.92
"16396","Oruro","Huanuni","Col. Ayacucho",47,1,1,0,107,3,18,1,0,178,2,12,192,221,0.601,0.869
"16397","Oruro","Huanuni","Col. Ayacucho",46,0,0,1,107,3,27,0,2,186,4,10,200,226,0.575,0.885
"16398","Oruro","Huanuni","Col. Ayacucho",38,1,3,1,120,2,26,1,3,195,1,7,203,221,0.615,0.919
"16399","Oruro","Huanuni","Col. Ayacucho",32,1,1,0,129,2,29,1,4,199,0,7,206,219,0.648,0.941
"16400","Oruro","Huanuni","Col. Ayacucho",44,1,0,2,116,5,21,0,6,195,1,15,211,221,0.595,0.955
"16401","Oruro","Huanuni","Col. Ayacucho",38,0,1,1,123,5,24,1,2,195,3,5,203,225,0.631,0.902
"16402","Oruro","Huanuni","Col. Ayacucho",27,0,0,1,119,5,37,0,5,194,5,7,206,229,0.613,0.9
"16403","Oruro","Huanuni","Col. Ayacucho",47,0,1,0,113,2,31,0,1,195,3,6,204,227,0.579,0.899
"16404","Oruro","Huanuni","Col. Ayacucho",43,1,0,0,104,2,29,1,3,183,4,17,204,224,0.568,0.911
"16405","Oruro","Huanuni","Col. Ayacucho",51,0,0,1,111,3,25,1,1,193,2,11,206,226,0.575,0.912
"16406","Oruro","Huanuni","Esc. Franz Tamayo",32,0,1,0,121,4,25,1,3,187,3,10,200,225,0.647,0.889
"16407","Oruro","Huanuni","Esc. Franz Tamayo",57,1,1,1,108,4,15,0,0,187,4,14,205,222,0.578,0.923
"16408","Oruro","Huanuni","Esc. Franz Tamayo",44,0,3,1,118,1,23,1,0,191,5,14,210,222,0.618,0.946
"16409","Oruro","Huanuni","Esc. Franz Tamayo",38,0,2,1,130,3,29,0,1,204,1,7,212,225,0.637,0.942
"16410","Oruro","Huanuni","Esc. Franz Tamayo",42,0,0,1,116,1,33,1,2,196,1,11,208,221,0.592,0.941
"16411","Oruro","Huanuni","Esc. Franz Tamayo",43,2,1,1,110,2,25,1,3,188,3,13,204,218,0.585,0.936
"16412","Oruro","Huanuni","Esc. Franz Tamayo",42,1,3,1,121,2,17,0,2,189,4,10,203,220,0.64,0.923
"16413","Oruro","Huanuni","Esc. Franz Tamayo",45,0,2,0,130,2,16,0,1,196,4,7,207,222,0.663,0.932
"16414","Oruro","Huanuni","Esc. Franz Tamayo",30,0,1,0,136,5,25,0,0,197,0,9,206,221,0.69,0.932
"16415","Oruro","Huanuni","Esc. Franz Tamayo",50,0,2,1,115,4,15,0,1,188,2,16,206,226,0.612,0.912
"16416","Oruro","Huanuni","Esc. Franz Tamayo",49,2,1,2,106,2,33,0,2,197,4,3,204,224,0.538,0.911
"16417","Oruro","Huanuni","Esc. Franz Tamayo",47,0,4,0,117,3,16,1,3,191,2,12,205,221,0.613,0.928
"16418","Oruro","Huanuni","Esc. Franz Tamayo",41,0,2,1,103,1,28,0,5,181,5,10,196,212,0.569,0.925
"16419","Oruro","Huanuni","U.E. Venezuela",23,1,1,2,97,0,57,0,5,186,4,14,204,236,0.522,0.864
"16420","Oruro","Huanuni","U.E. 12 de Abril",24,0,0,0,117,3,30,0,4,178,7,13,198,232,0.657,0.853
"16421","Oruro","Huanuni","U.E. 12 de Abril",26,0,1,3,119,3,35,0,2,189,3,16,208,234,0.63,0.889
"16422","Oruro","Huanuni","U.E. 12 de Abril",27,0,0,1,94,1,33,0,5,161,4,13,178,196,0.584,0.908
"16423","Oruro","Huanuni","U.E. Victor Manuel Ayllon",33,1,2,0,96,5,46,1,5,189,9,12,210,224,0.508,0.938
"16424","Oruro","Huanuni","Esc. Oscar Alfaro",51,2,2,0,111,0,43,1,5,215,1,13,229,242,0.516,0.946
"16425","Oruro","Huanuni","Esc. Huallatiri",4,3,2,3,136,0,25,3,1,177,4,19,200,208,0.768,0.962
"16426","Oruro","Huanuni","U.E. Bombo",9,1,8,1,137,4,15,1,4,180,8,7,195,217,0.761,0.899
"16427","Oruro","Huanuni","U.E. Tayaquira",5,0,2,0,172,0,17,3,1,200,4,14,218,232,0.86,0.94
"16428","Oruro","Huanuni","U.E. Gualberto Villarroel",13,0,1,0,163,1,30,1,2,211,4,9,224,231,0.773,0.97
"16429","Oruro","Huanuni","U.E. Gualberto Villarroel",12,1,4,0,127,2,16,0,0,162,2,6,170,172,0.784,0.988
"16430","Oruro","Machacamarca","Col. P. D. Murillo",48,0,0,0,117,8,18,1,1,193,4,3,200,218,0.606,0.917
"16431","Oruro","Machacamarca","Col. P. D. Murillo",53,1,1,0,108,4,23,0,2,192,1,7,200,215,0.562,0.93
"16432","Oruro","Machacamarca","Col. P. D. Murillo",49,1,1,0,111,3,21,1,0,187,7,10,204,218,0.594,0.936
"16433","Oruro","Machacamarca","Col. P. D. Murillo",29,2,2,0,114,0,28,0,1,176,4,11,191,218,0.648,0.876
"16434","Oruro","Machacamarca","Col. P. D. Murillo",50,0,0,0,106,3,24,1,1,185,3,6,194,215,0.573,0.902
"16435","Oruro","Machacamarca","Col. P. D. Murillo",42,0,1,3,118,2,22,3,2,193,0,8,201,213,0.611,0.944
"16436","Oruro","Machacamarca","Col. P. D. Murillo",69,1,3,0,105,6,19,0,0,203,1,3,207,220,0.517,0.941
"16437","Oruro","Machacamarca","Col. P. D. Murillo",61,1,3,0,97,15,13,0,0,190,3,6,199,213,0.511,0.934
"16438","Oruro","Machacamarca","Col. P. D. Murillo",42,0,2,0,103,2,15,0,0,164,0,4,168,190,0.628,0.884
"16439","Oruro","Machacamarca","Esc. German Busch",12,0,2,0,131,5,22,3,3,178,5,4,187,210,0.736,0.89
"16440","Oruro","Machacamarca","Esc. German Busch",20,0,6,0,117,1,28,1,4,177,10,10,197,219,0.661,0.9
"16441","Oruro","Machacamarca","Esc. Adolfo Mier",24,1,3,1,109,2,58,1,1,200,4,10,214,225,0.545,0.951
"16442","Oruro","Salinas de Garcí Mendoza","Col. Franz Tamayo",19,0,2,1,129,2,18,2,4,177,6,8,191,225,0.729,0.849
"16443","Oruro","Salinas de Garcí Mendoza","Col. Franz Tamayo",23,0,1,0,139,4,22,1,2,192,1,9,202,224,0.724,0.902
"16444","Oruro","Salinas de Garcí Mendoza","Col. Franz Tamayo",18,0,1,0,153,5,17,0,1,195,1,2,198,227,0.785,0.872
"16445","Oruro","Salinas de Garcí Mendoza","Col. Franz Tamayo",17,0,3,1,149,1,9,0,8,188,2,7,197,223,0.793,0.883
"16446","Oruro","Salinas de Garcí Mendoza","Col. Franz Tamayo",22,2,3,1,132,3,20,0,5,188,5,6,199,216,0.702,0.921
"16447","Oruro","Salinas de Garcí Mendoza","Col. Franz Tamayo",18,0,6,0,144,3,14,0,0,185,2,5,192,220,0.778,0.873
"16448","Oruro","Salinas de Garcí Mendoza","Col. Franz Tamayo",20,1,3,0,122,1,15,0,2,164,5,6,175,191,0.744,0.916
"16449","Oruro","Salinas de Garcí Mendoza","Esc. Central Puqui",4,1,0,1,169,4,10,1,3,193,5,4,202,223,0.876,0.906
"16450","Oruro","Salinas de Garcí Mendoza","Esc. Central Puqui",4,1,2,0,158,0,17,1,3,186,3,7,196,223,0.849,0.879
"16451","Oruro","Salinas de Garcí Mendoza","U.E. Challacota",41,1,3,0,80,3,56,0,1,185,4,6,195,197,0.432,0.99
"16452","Oruro","Salinas de Garcí Mendoza","Col. Antofagasta",12,0,4,1,145,2,27,0,1,192,3,8,203,223,0.755,0.91
"16453","Oruro","Salinas de Garcí Mendoza","Col. Antofagasta",9,0,3,1,168,1,27,0,1,210,5,7,222,233,0.8,0.953
"16454","Oruro","Salinas de Garcí Mendoza","Col. Antofagasta",6,0,2,1,149,2,15,0,1,176,5,7,188,200,0.847,0.94
"16455","Oruro","Salinas de Garcí Mendoza","U.E. Otto Saucedo Rivera",4,1,2,1,158,5,16,1,1,189,10,7,206,230,0.836,0.896
"16456","Oruro","Salinas de Garcí Mendoza","U.E. Otto Saucedo Rivera",5,3,1,1,162,3,13,2,1,191,7,5,203,222,0.848,0.914
"16457","Oruro","Salinas de Garcí Mendoza","U.E. Otto Saucedo Rivera",2,0,2,2,172,1,17,0,0,196,6,10,212,229,0.878,0.926
"16458","Oruro","Salinas de Garcí Mendoza","U.E. Otto Saucedo Rivera",5,1,5,0,167,2,14,1,0,195,12,4,211,222,0.856,0.95
"16459","Oruro","Salinas de Garcí Mendoza","U.E. Otto Saucedo Rivera",13,2,1,0,162,3,16,0,0,197,4,13,214,225,0.822,0.951
"16460","Oruro","Salinas de Garcí Mendoza","Esc. America San Martin",8,0,2,0,142,1,32,0,8,193,10,8,211,225,0.736,0.938
"16461","Oruro","Salinas de Garcí Mendoza","Esc. Villa Esperanza",18,3,3,1,147,4,21,0,5,202,5,4,211,230,0.728,0.917
"16462","Oruro","Pampa Aullagas","Esc. Maria Sanchez Fernandez",7,0,2,3,161,1,21,1,0,196,10,10,216,225,0.821,0.96
"16463","Oruro","Pampa Aullagas","Esc. Maria Sanchez Fernandez",6,3,2,1,150,3,29,2,2,198,5,2,205,218,0.758,0.94
"16464","Oruro","Pampa Aullagas","Esc. Maria Sanchez Fernandez",13,4,2,2,159,2,18,0,1,201,2,7,210,224,0.791,0.938
"16465","Oruro","Pampa Aullagas","Esc. Maria Sanchez Fernandez",13,4,5,2,143,1,12,0,0,180,10,11,201,218,0.794,0.922
"16466","Oruro","Pampa Aullagas","Esc. Maria Sanchez Fernandez",7,0,0,2,148,1,24,0,1,183,3,14,200,216,0.809,0.926
"16467","Oruro","Pampa Aullagas","U.E. Gualberto Villarroel",3,1,2,1,141,1,32,0,6,187,7,9,203,220,0.754,0.923
"16468","Oruro","Sabaya","Esc. Jose Maria Egues Cuellar",69,1,3,0,34,4,48,1,4,164,3,8,175,218,0.207,0.803
"16469","Oruro","Sabaya","Esc. Jose Maria Egues Cuellar",51,0,4,4,48,4,37,1,3,152,6,5,163,219,0.316,0.744
"16470","Oruro","Sabaya","U.E. Libertador Simon Bolivar",76,2,5,3,42,2,47,0,4,181,6,11,198,227,0.232,0.872
"16471","Oruro","Sabaya","Esc. Ildefonso Murguia",56,2,0,0,63,3,49,0,2,175,1,7,183,208,0.36,0.88
"16472","Oruro","Sabaya","Esc. German Busch",76,2,1,1,63,3,58,1,3,208,1,4,213,233,0.303,0.914
"16473","Oruro","Sabaya","Esc. Franz Tamayo - Villa Vitalina - 2",130,0,0,0,26,6,29,2,2,195,8,3,206,206,0.133,1
"16474","Oruro","Coipasa","U.E. Coipasa",75,0,1,1,72,9,36,0,0,194,6,7,207,229,0.371,0.904
"16475","Oruro","Coipasa","U.E. Coipasa",68,4,1,5,64,5,25,1,2,175,2,2,179,196,0.366,0.913
"16476","Oruro","Chipaya","U.E. Santa Ana",5,2,0,0,95,4,30,0,15,151,3,4,158,221,0.629,0.715
"16477","Oruro","Toledo","Col. Nacional Toledo",27,4,1,0,101,2,26,1,3,165,5,12,182,212,0.612,0.858
"16478","Oruro","Toledo","Col. Nacional Toledo",22,1,9,0,102,5,35,2,1,177,5,6,188,219,0.576,0.858
"16479","Oruro","Toledo","Col. Nacional Toledo",29,2,2,2,103,1,30,0,0,169,2,5,176,201,0.609,0.876
"16480","Oruro","Toledo","Col. Nacional Toledo",23,0,7,0,98,2,25,0,3,158,4,12,174,210,0.62,0.829
"16481","Oruro","Toledo","Col. Nacional Toledo",14,0,1,1,127,1,21,2,1,168,6,7,181,207,0.756,0.874
"16482","Oruro","Toledo","Esc. M. M. Vaca Guzman",30,0,1,0,111,2,25,1,4,174,1,5,180,215,0.638,0.837
"16483","Oruro","Eucaliptus","U.E. Benedeto Vincenti",41,0,6,1,125,0,17,0,2,192,2,6,200,218,0.651,0.917
"16484","Oruro","Eucaliptus","U.E. Benedeto Vincenti",28,0,7,0,137,1,12,0,1,186,2,12,200,223,0.737,0.897
"16485","Oruro","Eucaliptus","U.E. Benedeto Vincenti",39,1,3,0,124,4,17,0,2,190,1,2,193,214,0.653,0.902
"16486","Oruro","Eucaliptus","U.E. Benedeto Vincenti",33,0,9,0,123,2,21,0,1,189,5,7,201,222,0.651,0.905
"16487","Oruro","Eucaliptus","U.E. Benedeto Vincenti",36,1,3,1,116,1,23,0,2,183,3,3,189,213,0.634,0.887
"16488","Oruro","Eucaliptus","U.E. Benedeto Vincenti",39,1,9,1,112,2,24,0,0,188,3,4,195,222,0.596,0.878
"16489","Oruro","Eucaliptus","U.E. Benedeto Vincenti",47,0,7,2,98,8,13,1,0,176,7,6,189,212,0.557,0.892
"16490","Oruro","Eucaliptus","Esc. Mariscal Antonio Jose De Sucre",4,0,1,1,166,3,9,0,0,184,3,14,201,224,0.902,0.897
"16491","Oruro","Eucaliptus","Esc. Tupac Katari - Recinto 2 -  Alcamarca",13,1,8,0,151,2,16,0,1,192,6,5,203,215,0.786,0.944
"16492","Oruro","Eucaliptus","U.E. Quelcata",7,1,3,0,143,1,15,0,0,170,7,4,181,203,0.841,0.892
"16493","Oruro","Andamarca","Esc. Sebastian Pagador",19,1,18,3,107,4,15,1,2,170,7,2,179,211,0.629,0.848
"16494","Oruro","Andamarca","Esc. Sebastian Pagador",11,1,6,0,149,3,6,0,3,179,5,4,188,215,0.832,0.874
"16495","Oruro","Andamarca","Esc. Sebastian Pagador",17,1,5,1,123,5,22,1,5,180,5,2,187,211,0.683,0.886
"16496","Oruro","Andamarca","Esc. Sebastian Pagador",16,1,13,0,123,6,15,0,0,174,4,5,183,215,0.707,0.851
"16497","Oruro","Andamarca","U.E. Orinoca",1,0,1,1,181,0,5,0,0,189,2,3,194,213,0.958,0.911
"16498","Oruro","Andamarca","U.E. Orinoca",2,0,1,0,176,1,7,0,1,188,0,4,192,212,0.936,0.906
"16499","Oruro","Andamarca","U.E. Orinoca",1,0,0,0,194,0,9,0,1,205,1,1,207,220,0.946,0.941
"16500","Oruro","Andamarca","U.E. Orinoca",3,0,0,1,180,0,7,0,0,191,2,3,196,215,0.942,0.912
"16501","Oruro","Andamarca","U.E. Mejillones",7,0,1,2,139,4,17,0,2,172,12,3,187,211,0.808,0.886
"16502","Oruro","Andamarca","U.E. Mejillones",9,2,6,4,135,2,20,1,3,182,7,3,192,215,0.742,0.893
"16503","Oruro","Andamarca","U.E. Mejillones",14,1,1,1,151,1,10,1,1,181,10,6,197,224,0.834,0.879
"16504","Oruro","Belén de Andamarca","Col. Tec. Humanistico Simon Bolivar",12,1,5,5,133,3,13,2,1,175,3,3,181,204,0.76,0.887
"16505","Oruro","Belén de Andamarca","U.E. Bolivia",17,1,9,1,138,0,16,1,1,184,3,7,194,210,0.75,0.924
"16506","Oruro","Belén de Andamarca","Esc. Aniceto Arce",8,1,0,0,122,1,15,0,5,152,4,8,164,177,0.803,0.927
"16507","Oruro","Totora","U.E. Totora",6,0,1,0,173,0,8,0,0,188,3,11,202,224,0.92,0.902
"16508","Oruro","Totora","U.E. Totora",4,0,4,1,163,2,9,1,0,184,3,12,199,230,0.886,0.865
"16509","Oruro","Totora","U.E. Totora",7,0,1,0,153,2,7,2,0,172,8,6,186,222,0.89,0.838
"16510","Oruro","Totora","U.E. Totora",10,1,2,0,145,4,9,1,0,172,7,6,185,214,0.843,0.864
"16511","Oruro","Totora","Esc. Franz Tamayo",0,0,4,0,157,0,11,2,0,174,1,2,177,196,0.902,0.903
"16512","Oruro","Totora","Col. Nal. Calazaya",6,0,13,1,161,0,6,0,0,187,5,4,196,219,0.861,0.895
"16513","Oruro","Totora","Esc. Litoral De Culta",7,0,0,1,162,3,13,0,0,186,3,2,191,216,0.871,0.884
"16514","Oruro","Totora","Esc. Central Sora Sora",5,1,2,0,174,1,11,1,0,195,2,6,203,223,0.892,0.91
"16515","Oruro","Santiago de Huari","Col. Mixto Gualberto Villarroel",55,2,5,1,95,5,22,0,0,185,4,12,201,217,0.514,0.926
"16516","Oruro","Santiago de Huari","Col. Mixto Gualberto Villarroel",40,2,4,0,88,2,23,1,2,162,4,18,184,210,0.543,0.876
"16517","Oruro","Santiago de Huari","Col. Mixto Gualberto Villarroel",37,0,2,0,104,2,21,1,1,168,4,23,195,216,0.619,0.903
"16518","Oruro","Santiago de Huari","Col. Mixto Gualberto Villarroel",44,0,5,2,86,1,27,1,3,169,4,12,185,205,0.509,0.902
"16519","Oruro","Santiago de Huari","Col. Mixto Gualberto Villarroel",44,1,6,3,109,2,24,0,4,193,1,12,206,221,0.565,0.932
"16520","Oruro","Santiago de Huari","Col. Mixto Gualberto Villarroel",38,0,2,4,108,3,21,1,3,180,3,11,194,215,0.6,0.902
"16521","Oruro","Santiago de Huari","Col. Mixto Gualberto Villarroel",47,0,5,0,109,6,19,0,2,188,2,9,199,222,0.58,0.896
"16522","Oruro","Santiago de Huari","Col. Mixto Gualberto Villarroel",33,1,0,2,106,4,42,1,1,190,5,20,215,228,0.558,0.943
"16523","Oruro","Santiago de Huari","U.E. San Pedro de Condo",28,0,3,3,122,2,17,1,2,178,3,6,187,212,0.685,0.882
"16524","Oruro","Santiago de Huari","U.E. San Pedro de Condo",16,2,4,0,116,3,27,1,1,170,8,7,185,206,0.682,0.898
"16525","Oruro","Santiago de Huari","U.E. San Pedro de Condo",27,2,0,2,117,3,27,1,0,179,3,10,192,214,0.654,0.897
"16526","Oruro","Santiago de Huari","U. E. Urmiri De Quillacas",9,1,4,0,159,4,10,0,4,191,5,2,198,212,0.832,0.934
"16527","Oruro","Santiago de Huari","Esc. Vichaj Lupe",8,1,3,0,145,1,20,0,1,179,2,14,195,214,0.81,0.911
"16528","Oruro","Santiago de Huari","Nucleo Marca Lagunillas",4,1,2,2,135,2,28,0,1,175,7,9,191,213,0.771,0.897
"16529","Oruro","Santiago de Huari","Nucleo Marca Lagunillas",5,3,3,0,141,0,30,0,0,182,2,11,195,224,0.775,0.871
"16530","Oruro","Santiago de Huari","Nucleo Escolar Bolivia",23,2,1,0,148,5,14,0,0,193,1,6,200,214,0.767,0.935
"16531","Oruro","Santiago de Huari","Esc. Castilla Huma",28,2,4,2,127,3,13,1,2,182,7,10,199,216,0.698,0.921
"16532","Oruro","La Rivera","U.E. La Rivera",65,0,1,1,89,2,51,0,1,210,2,3,215,225,0.424,0.956
"16533","Oruro","Todos Santos","U.E. Eduardo Avaroa",100,0,4,2,39,5,35,1,0,186,4,2,192,225,0.21,0.853
"16534","Oruro","Carangas","Esc. Eliodoro Villazon",67,1,1,1,49,1,43,1,1,165,1,4,170,190,0.297,0.895
"16535","Oruro","Huayllamarca","Col. José Mérida Montaño",7,0,7,0,149,1,17,2,0,183,7,7,197,223,0.814,0.883
"16536","Oruro","Huayllamarca","Col. José Mérida Montaño",8,1,6,0,152,1,17,2,1,188,10,7,205,218,0.809,0.94
"16537","Oruro","Huayllamarca","Col. José Mérida Montaño",15,0,9,2,130,1,10,0,3,170,6,7,183,214,0.765,0.855
"16538","Oruro","Huayllamarca","U.E. Pedro Domingo Murillo",14,2,2,1,151,1,17,1,0,189,2,0,191,216,0.799,0.884
"16539","Oruro","Huayllamarca","U. E. San Miguel",35,1,3,1,142,3,14,1,0,200,6,3,209,217,0.71,0.963
"16540","Oruro","Huayllamarca","U. E. San Miguel",26,1,1,4,146,1,10,0,1,190,3,3,196,199,0.768,0.985
"16541","Oruro","Huayllamarca","Col. Llanquera",22,1,3,3,136,5,15,1,1,187,7,7,201,219,0.727,0.918
"16542","Oruro","Huayllamarca","Col. Llanquera",18,1,2,0,131,5,20,0,2,179,9,7,195,221,0.732,0.882
"16543","Potosí","Potosí","Kinder Ismael Montes",122,0,0,1,39,12,16,0,1,191,2,9,202,224,0.204,0.902
"16544","Potosí","Potosí","Kinder Ismael Montes",124,1,0,1,25,18,18,1,1,189,2,5,196,223,0.132,0.879
"16545","Potosí","Potosí","Kinder Ismael Montes",137,0,0,0,24,15,19,1,3,199,0,9,208,225,0.121,0.924
"16546","Potosí","Potosí","Kinder Ismael Montes",115,0,1,3,34,11,21,0,3,188,3,14,205,224,0.181,0.915
"16547","Potosí","Potosí","Kinder Ismael Montes",138,1,2,0,34,9,15,1,0,200,4,7,211,229,0.17,0.921
"16548","Potosí","Potosí","Kinder Ismael Montes",126,1,0,2,31,10,13,2,2,187,4,11,202,223,0.166,0.906
"16549","Potosí","Potosí","Kinder Ismael Montes",133,1,0,0,43,8,14,1,3,203,0,9,212,230,0.212,0.922
"16550","Potosí","Potosí","Kinder Ismael Montes",127,1,0,2,34,6,17,3,4,194,5,8,207,227,0.175,0.912
"16551","Potosí","Potosí","Kinder Ismael Montes",115,2,2,0,33,14,23,2,2,193,3,7,203,225,0.171,0.902
"16552","Potosí","Potosí","Kinder Ismael Montes",98,0,2,0,38,14,27,1,2,182,3,15,200,223,0.209,0.897
"16553","Potosí","Potosí","Kinder Ismael Montes",128,0,1,1,26,13,20,0,1,190,4,6,200,227,0.137,0.881
"16554","Potosí","Potosí","Kinder Ismael Montes",124,0,3,2,37,11,21,3,2,203,1,9,213,231,0.182,0.922
"16555","Potosí","Potosí","Kinder Ismael Montes",125,0,0,0,27,8,16,1,0,177,3,13,193,217,0.153,0.889
"16556","Potosí","Potosí","Kinder Ismael Montes",130,1,1,1,27,11,13,0,1,185,3,7,195,226,0.146,0.863
"16557","Potosí","Potosí","Kinder Ismael Montes",143,0,0,1,23,13,13,2,0,195,3,10,208,228,0.118,0.912
"16558","Potosí","Potosí","Kinder Ismael Montes",136,1,0,0,36,9,14,0,1,197,6,9,212,231,0.183,0.918
"16559","Potosí","Potosí","Kinder Ismael Montes",141,0,1,2,26,13,7,3,1,194,7,7,208,223,0.134,0.933
"16560","Potosí","Potosí","Kinder Ismael Montes",135,0,0,1,34,11,15,1,0,197,0,6,203,229,0.173,0.886
"16561","Potosí","Potosí","Kinder Ismael Montes",142,1,1,3,27,13,11,0,1,199,2,4,205,226,0.136,0.907
"16562","Potosí","Potosí","Kinder Ismael Montes",146,1,2,0,30,10,15,1,0,205,3,17,225,241,0.146,0.934
"16563","Potosí","Potosí","Unidad Educativa Mejillones",87,2,2,4,39,15,37,0,0,186,5,11,202,225,0.21,0.898
"16564","Potosí","Potosí","Unidad Educativa Mejillones",98,0,4,2,32,12,27,1,4,180,5,15,200,220,0.178,0.909
"16565","Potosí","Potosí","Unidad Educativa Mejillones",107,0,5,1,32,15,30,0,4,194,6,12,212,229,0.165,0.926
"16566","Potosí","Potosí","Unidad Educativa Mejillones",108,1,3,1,37,13,27,1,2,193,2,15,210,230,0.192,0.913
"16567","Potosí","Potosí","Unidad Educativa Mejillones",101,0,1,1,38,22,32,0,4,199,4,15,218,232,0.191,0.94
"16568","Potosí","Potosí","Unidad Educativa Mejillones",119,0,2,2,31,10,27,0,2,193,1,14,208,229,0.161,0.908
"16569","Potosí","Potosí","Unidad Educativa Mejillones",106,0,0,0,36,14,33,0,3,192,7,13,212,230,0.188,0.922
"16570","Potosí","Potosí","Unidad Educativa Mejillones",116,1,1,0,30,23,26,0,1,198,3,10,211,225,0.152,0.938
"16571","Potosí","Potosí","Unidad Educativa Mejillones",95,1,2,4,42,17,30,2,2,195,2,12,209,230,0.215,0.909
"16572","Potosí","Potosí","Unidad Educativa Mejillones",86,0,1,0,45,17,31,0,3,183,1,12,196,226,0.246,0.867
"16573","Potosí","Potosí","Unidad Educativa Mejillones",99,1,0,2,43,19,19,1,4,188,6,15,209,230,0.229,0.909
"16574","Potosí","Potosí","Unidad Educativa Mejillones",101,1,2,2,42,8,37,0,3,196,6,7,209,232,0.214,0.901
"16575","Potosí","Potosí","Unidad Educativa Mejillones",103,0,1,2,36,18,23,1,1,185,3,20,208,229,0.195,0.908
"16576","Potosí","Potosí","Unidad Educativa Mejillones",102,0,2,4,27,13,35,0,2,185,12,13,210,225,0.146,0.933
"16577","Potosí","Potosí","Unidad Educativa Mejillones",104,1,2,1,45,8,30,0,1,192,6,16,214,233,0.234,0.918
"16578","Potosí","Potosí","Unidad Educativa Mejillones",91,1,3,3,45,15,28,1,2,189,4,9,202,223,0.238,0.906
"16579","Potosí","Potosí","Unidad Educativa Mejillones",108,0,0,1,35,13,28,1,1,187,5,17,209,227,0.187,0.921
"16580","Potosí","Potosí","Unidad Educativa Mejillones",95,1,3,2,28,19,35,1,2,186,5,20,211,229,0.151,0.921
"16581","Potosí","Potosí","Unidad Educativa Mejillones",102,4,2,0,36,18,24,2,3,191,2,12,205,227,0.188,0.903
"16582","Potosí","Potosí","Unidad Educativa Mejillones",95,2,1,2,54,13,27,5,5,204,1,6,211,232,0.265,0.909
"16583","Potosí","Potosí","Unidad Educativa Mejillones",115,0,3,4,34,11,23,0,3,193,2,11,206,228,0.176,0.904
"16584","Potosí","Potosí","Unidad Educativa Mejillones",108,0,0,1,26,17,33,2,3,190,5,12,207,229,0.137,0.904
"16585","Potosí","Potosí","U.E. Dr. Gonzalo Calderon Rios",69,1,1,1,56,22,36,1,0,187,3,23,213,238,0.299,0.895
"16586","Potosí","Potosí","U.E. Dr. Gonzalo Calderon Rios",60,0,3,0,50,25,49,2,1,190,3,17,210,235,0.263,0.894
"16587","Potosí","Potosí","U.E. Dr. Gonzalo Calderon Rios",62,2,3,2,51,23,49,2,2,196,8,11,215,239,0.26,0.9
"16588","Potosí","Potosí","U.E. Dr. Gonzalo Calderon Rios",72,2,2,4,59,21,35,2,3,200,4,18,222,237,0.295,0.937
"16589","Potosí","Potosí","Unidad Educativa Villa Colon",96,0,3,1,43,12,30,2,3,190,6,11,207,225,0.226,0.92
"16590","Potosí","Potosí","Unidad Educativa Villa Colon",94,0,1,1,37,21,30,0,3,187,6,12,205,222,0.198,0.923
"16591","Potosí","Potosí","Unidad Educativa Villa Colon",71,1,2,1,46,13,44,1,4,183,9,13,205,225,0.251,0.911
"16592","Potosí","Potosí","Unidad Educativa Villa Colon",89,2,4,4,50,19,28,1,4,201,5,11,217,224,0.249,0.969
"16593","Potosí","Potosí","Unidad Educativa Villa Colon",92,1,2,1,34,25,29,2,4,190,5,24,219,235,0.179,0.932
"16594","Potosí","Potosí","Unidad Educativa Villa Colon",90,2,3,2,33,24,36,0,4,194,6,19,219,232,0.17,0.944
"16595","Potosí","Potosí","Unidad Educativa Villa Colon",86,3,1,1,55,14,33,0,1,194,7,15,216,231,0.284,0.935
"16596","Potosí","Potosí","Unidad Educativa Villa Colon",85,1,4,1,55,15,33,1,4,199,4,7,210,229,0.276,0.917
"16597","Potosí","Potosí","Unidad Educativa Villa Colon",85,2,2,2,53,13,30,0,2,189,6,11,206,226,0.28,0.912
"16598","Potosí","Potosí","Unidad Educativa Villa Colon",97,1,2,2,42,13,28,3,6,194,5,13,212,232,0.216,0.914
"16599","Potosí","Potosí","Unidad Educativa Villa Colon",79,2,3,1,48,7,36,1,2,179,5,23,207,226,0.268,0.916
"16600","Potosí","Potosí","Unidad Educativa Villa Colon",72,1,4,0,52,17,48,0,2,196,5,13,214,227,0.265,0.943
"16601","Potosí","Potosí","Unidad Educativa Villa Colon",96,1,2,1,34,18,35,0,4,191,5,19,215,226,0.178,0.951
"16602","Potosí","Potosí","Unidad Educativa Villa Colon",85,1,4,1,42,17,33,2,5,190,1,12,203,223,0.221,0.91
"16603","Potosí","Potosí","Unidad Educativa Villa Colon",91,1,2,1,41,17,34,3,2,192,4,20,216,230,0.214,0.939
"16604","Potosí","Potosí","Unidad Educativa Villa Colon",92,1,0,0,47,7,37,1,3,188,2,19,209,228,0.25,0.917
"16605","Potosí","Potosí","Unidad Educativa Villa Colon",87,1,1,1,44,18,44,0,1,197,3,17,217,229,0.223,0.948
"16606","Potosí","Potosí","Unidad Educativa Villa Colon",89,2,2,0,53,7,35,0,3,191,8,13,212,228,0.277,0.93
"16607","Potosí","Potosí","Unidad Educativa Villa Colon",91,0,4,1,42,17,30,2,4,191,3,16,210,226,0.22,0.929
"16608","Potosí","Potosí","Unidad Educativa Villa Colon",88,3,2,0,59,11,29,1,4,197,5,9,211,236,0.299,0.894
"16609","Potosí","Potosí","Unidad Educativa Villa Colon",95,1,3,0,30,9,44,2,2,186,5,14,205,223,0.161,0.919
"16610","Potosí","Potosí","Unidad Educativa Villa Colon",77,3,3,1,50,10,30,2,3,179,4,24,207,227,0.279,0.912
"16611","Potosí","Potosí","Unidad Educativa Villa Colon",85,2,6,0,29,13,44,1,3,183,13,14,210,232,0.158,0.905
"16612","Potosí","Potosí","Esc. Jose Maria Linares",143,0,1,1,27,12,18,1,4,207,3,7,217,237,0.13,0.916
"16613","Potosí","Potosí","Esc. Jose Maria Linares",121,0,1,0,28,17,31,0,2,200,0,12,212,236,0.14,0.898
"16614","Potosí","Potosí","Esc. Jose Maria Linares",136,0,2,0,30,8,19,2,8,205,0,9,214,233,0.146,0.918
"16615","Potosí","Potosí","Esc. Jose Maria Linares",136,0,2,0,22,8,17,1,4,190,4,9,203,215,0.116,0.944
"16616","Potosí","Potosí","Esc. Jose Maria Linares",157,0,1,0,25,7,7,1,3,201,4,4,209,223,0.124,0.937
"16617","Potosí","Potosí","Esc. Jose Maria Linares",146,0,0,0,23,12,10,0,7,198,2,3,203,222,0.116,0.914
"16618","Potosí","Potosí","Esc. Jose Maria Linares",138,1,1,0,22,8,12,1,3,186,2,12,200,219,0.118,0.913
"16619","Potosí","Potosí","Esc. Jose Maria Linares",143,0,0,0,31,7,0,0,1,182,2,11,195,221,0.17,0.882
"16620","Potosí","Potosí","Esc. Jose Maria Linares",146,2,1,0,32,3,10,1,0,195,3,10,208,222,0.164,0.937
"16621","Potosí","Potosí","Esc. Jose Maria Linares",150,0,2,1,21,9,10,0,1,194,4,10,208,226,0.108,0.92
"16622","Potosí","Potosí","Unid. Educ. Oscar Alfaro",167,0,0,1,25,3,11,1,0,208,0,5,213,235,0.12,0.906
"16623","Potosí","Potosí","Unid. Educ. Oscar Alfaro",164,0,1,0,20,6,13,0,3,207,1,3,211,226,0.097,0.934
"16624","Potosí","Potosí","Unid. Educ. Oscar Alfaro",154,1,0,0,27,3,11,0,0,196,1,6,203,222,0.138,0.914
"16625","Potosí","Potosí","Unid. Educ. Oscar Alfaro",161,0,0,0,16,9,7,1,3,197,2,7,206,221,0.081,0.932
"16626","Potosí","Potosí","Unid. Educ. Oscar Alfaro",148,0,0,0,39,3,7,1,3,201,1,4,206,225,0.194,0.916
"16627","Potosí","Potosí","Esc. Benicio Montero Mallo",139,2,1,0,24,5,11,1,2,185,2,11,198,221,0.13,0.896
"16628","Potosí","Potosí","Esc. Benicio Montero Mallo",145,1,1,0,32,5,5,0,3,192,0,9,201,218,0.167,0.922
"16629","Potosí","Potosí","Esc. Benicio Montero Mallo",140,0,1,2,26,10,13,2,3,197,2,4,203,220,0.132,0.923
"16630","Potosí","Potosí","Esc. Benicio Montero Mallo",137,0,2,0,31,6,10,1,1,188,1,10,199,216,0.165,0.921
"16631","Potosí","Potosí","Esc. Benicio Montero Mallo",141,0,0,0,30,12,12,0,3,198,3,7,208,218,0.152,0.954
"16632","Potosí","Potosí","Esc. Benicio Montero Mallo",148,1,1,2,24,6,9,1,1,193,2,7,202,221,0.124,0.914
"16633","Potosí","Potosí","Esc. Benicio Montero Mallo",137,3,0,0,20,14,10,3,1,188,1,8,197,217,0.106,0.908
"16634","Potosí","Potosí","Esc. Benicio Montero Mallo",140,0,4,1,33,9,10,3,3,203,1,6,210,219,0.163,0.959
"16635","Potosí","Potosí","Esc. Benicio Montero Mallo",148,0,2,0,29,7,12,0,1,199,3,2,204,233,0.146,0.876
"16636","Potosí","Potosí","Esc. Jaime Mendoza",88,0,4,1,49,22,20,1,1,186,5,6,197,221,0.263,0.891
"16637","Potosí","Potosí","Esc. Jaime Mendoza",81,1,4,1,60,10,35,0,2,194,3,12,209,225,0.309,0.929
"16638","Potosí","Potosí","Esc. Jaime Mendoza",108,1,2,1,34,19,24,3,1,193,8,8,209,230,0.176,0.909
"16639","Potosí","Potosí","Esc. Jaime Mendoza",107,1,1,0,29,23,24,3,2,190,7,9,206,229,0.153,0.9
"16640","Potosí","Potosí","Esc. Jaime Mendoza",96,0,1,2,39,6,30,5,4,183,8,15,206,223,0.213,0.924
"16641","Potosí","Potosí","Esc. Jaime Mendoza",114,1,2,0,27,14,25,5,2,190,3,13,206,228,0.142,0.904
"16642","Potosí","Potosí","Esc. Jaime Mendoza",103,0,3,0,30,17,32,0,6,191,6,5,202,229,0.157,0.882
"16643","Potosí","Potosí","Coleg. Luis Espinal",129,1,2,0,36,9,19,0,2,198,4,9,211,227,0.182,0.93
"16644","Potosí","Potosí","Coleg. Luis Espinal",120,0,2,0,30,14,21,1,0,188,1,12,201,218,0.16,0.922
"16645","Potosí","Potosí","Coleg. Luis Espinal",139,0,0,0,29,5,20,0,2,195,2,11,208,225,0.149,0.924
"16646","Potosí","Potosí","Coleg. Luis Espinal",119,1,0,0,39,17,24,0,0,200,2,8,210,222,0.195,0.946
"16647","Potosí","Potosí","Coleg. Luis Espinal",126,1,1,0,30,9,22,1,2,192,2,6,200,227,0.156,0.881
"16648","Potosí","Potosí","Coleg. Luis Espinal",123,0,1,0,42,8,20,1,1,196,3,10,209,225,0.214,0.929
"16649","Potosí","Potosí","Coleg. Luis Espinal",137,3,0,1,34,15,15,1,0,206,3,6,215,225,0.165,0.956
"16650","Potosí","Potosí","Coleg. Luis Espinal",122,0,0,0,35,13,10,1,0,181,1,8,190,225,0.193,0.844
"16651","Potosí","Potosí","Coleg. Luis Espinal",109,0,2,1,43,14,18,0,4,191,7,12,210,225,0.225,0.933
"16652","Potosí","Potosí","Coleg. Luis Espinal",102,1,2,0,42,9,22,3,1,182,2,12,196,223,0.231,0.879
"16653","Potosí","Potosí","Coleg. Luis Espinal",115,0,1,2,29,14,19,0,2,182,5,17,204,223,0.159,0.915
"16654","Potosí","Potosí","Coleg. Luis Espinal",107,0,2,0,29,17,0,2,3,160,2,19,181,228,0.181,0.794
"16655","Potosí","Potosí","Coleg. Luis Espinal",127,0,0,1,37,10,20,0,2,197,1,7,205,223,0.188,0.919
"16656","Potosí","Potosí","Coleg. Luis Espinal",123,3,2,0,37,8,17,0,3,193,4,8,205,225,0.192,0.911
"16657","Potosí","Potosí","Coleg. Luis Espinal",119,0,3,0,33,11,17,0,1,184,3,11,198,225,0.179,0.88
"16658","Potosí","Potosí","Coleg. Luis Espinal",144,0,0,0,24,20,16,0,5,209,4,3,216,233,0.115,0.927
"16659","Potosí","Potosí","Coleg. Luis Espinal",130,1,2,0,27,15,14,0,3,192,5,15,212,229,0.141,0.926
"16660","Potosí","Potosí","Coleg. Luis Espinal",109,1,1,0,42,18,23,0,0,194,3,5,202,228,0.216,0.886
"16661","Potosí","Potosí","Coleg. Luis Espinal",106,0,1,0,20,9,15,0,4,155,0,10,165,188,0.129,0.878
"16662","Potosí","Potosí","Esc. L. Subieta Sagarnaga",102,2,3,1,37,16,23,1,1,186,5,8,199,220,0.199,0.905
"16663","Potosí","Potosí","Esc. L. Subieta Sagarnaga",112,1,5,2,46,14,20,0,0,200,4,13,217,233,0.23,0.931
"16664","Potosí","Potosí","Esc. L. Subieta Sagarnaga",106,0,2,1,40,8,32,4,0,193,3,6,202,223,0.207,0.906
"16665","Potosí","Potosí","Esc. L. Subieta Sagarnaga",121,0,3,0,42,7,15,4,2,194,3,13,210,231,0.216,0.909
"16666","Potosí","Potosí","Esc. L. Subieta Sagarnaga",99,1,1,1,41,16,21,0,4,184,6,10,200,225,0.223,0.889
"16667","Potosí","Potosí","Esc. L. Subieta Sagarnaga",94,0,3,1,41,18,30,3,1,191,4,14,209,229,0.215,0.913
"16668","Potosí","Potosí","Esc. L. Subieta Sagarnaga",86,0,3,1,44,18,28,0,2,182,4,16,202,222,0.242,0.91
"16669","Potosí","Potosí","Esc. L. Subieta Sagarnaga",104,2,1,1,38,15,15,1,10,187,4,11,202,226,0.203,0.894
"16670","Potosí","Potosí","Esc. L. Subieta Sagarnaga",105,1,6,0,35,13,17,1,2,180,2,18,200,227,0.194,0.881
"16671","Potosí","Potosí","Esc. L. Subieta Sagarnaga",113,0,0,0,24,20,18,0,2,177,5,18,200,221,0.136,0.905
"16672","Potosí","Potosí","Kinder Concepcion",130,1,2,1,32,5,10,1,2,184,4,8,196,222,0.174,0.883
"16673","Potosí","Potosí","Kinder Concepcion",120,1,4,2,36,13,17,2,1,196,1,4,201,223,0.184,0.901
"16674","Potosí","Potosí","Kinder Concepcion",114,3,1,1,42,7,19,0,2,189,5,8,202,216,0.222,0.935
"16675","Potosí","Potosí","Kinder Concepcion",132,1,2,1,21,8,17,3,2,187,2,10,199,222,0.112,0.896
"16676","Potosí","Potosí","Kinder Concepcion",104,0,0,1,34,14,12,2,3,170,4,9,183,216,0.2,0.847
"16677","Potosí","Potosí","Kinder Concepcion",110,2,0,3,38,13,32,0,4,202,3,12,217,231,0.188,0.939
"16678","Potosí","Potosí","Kinder Concepcion",128,0,1,1,32,10,22,1,3,198,2,12,212,235,0.162,0.902
"16679","Potosí","Potosí","Centro Ed. Fray Vicente Bernedo",93,3,3,3,37,6,0,30,2,177,6,10,193,221,0.209,0.873
"16680","Potosí","Potosí","Centro Ed. Fray Vicente Bernedo",126,1,1,4,33,9,9,0,4,187,4,7,198,227,0.176,0.872
"16681","Potosí","Potosí","Centro Ed. Fray Vicente Bernedo",116,0,0,0,42,9,16,1,3,187,1,17,205,224,0.225,0.915
"16682","Potosí","Potosí","Centro Ed. Fray Vicente Bernedo",108,0,2,2,32,18,23,2,1,188,7,10,205,225,0.17,0.911
"16683","Potosí","Potosí","Centro Ed. Fray Vicente Bernedo",89,1,2,2,35,16,33,1,2,181,6,10,197,221,0.193,0.891
"16684","Potosí","Potosí","Centro Ed. Fray Vicente Bernedo",111,0,1,2,34,10,25,5,1,189,2,16,207,223,0.18,0.928
"16685","Potosí","Potosí","Centro Ed. Fray Vicente Bernedo",109,1,3,1,39,11,16,2,3,185,4,11,200,228,0.211,0.877
"16686","Potosí","Potosí","Centro Ed. Fray Vicente Bernedo",139,0,1,2,23,9,23,0,2,199,4,10,213,228,0.116,0.934
"16687","Potosí","Potosí","Centro Ed. Fray Vicente Bernedo",113,1,1,1,36,7,29,1,0,189,2,8,199,222,0.19,0.896
"16688","Potosí","Potosí","Centro Ed. Fray Vicente Bernedo",120,2,0,0,28,11,18,1,1,181,5,12,198,227,0.155,0.872
"16689","Potosí","Potosí","Centro Ed. Fray Vicente Bernedo",113,2,1,2,24,14,35,0,2,193,7,15,215,229,0.124,0.939
"16690","Potosí","Potosí","Centro Ed. Fray Vicente Bernedo",111,1,1,1,41,12,22,1,3,193,1,10,204,225,0.212,0.907
"16691","Potosí","Potosí","Centro Ed. Fray Vicente Bernedo",112,3,1,0,35,13,27,0,0,191,9,4,204,224,0.183,0.911
"16692","Potosí","Potosí","Centro Ed. Fray Vicente Bernedo",116,1,2,0,42,10,18,0,1,190,5,9,204,219,0.221,0.932
"16693","Potosí","Potosí","Centro Ed. Fray Vicente Bernedo",107,0,0,0,41,10,24,0,2,184,5,8,197,220,0.223,0.895
"16694","Potosí","Potosí","Centro Ed. Fray Vicente Bernedo",105,1,3,3,33,15,33,1,2,196,0,9,205,224,0.168,0.915
"16695","Potosí","Potosí","Centro Ed. Fray Vicente Bernedo",117,0,5,4,25,11,22,2,4,190,3,9,202,221,0.132,0.914
"16696","Potosí","Potosí","Centro Ed. Fray Vicente Bernedo",106,1,1,1,33,20,28,0,0,190,5,12,207,223,0.174,0.928
"16697","Potosí","Potosí","Centro Ed. Fray Vicente Bernedo",142,0,5,1,25,10,21,1,0,205,4,8,217,230,0.122,0.943
"16698","Potosí","Potosí","Centro Ed. Fray Vicente Bernedo",116,1,0,1,32,13,15,2,4,184,1,11,196,216,0.174,0.907
"16699","Potosí","Potosí","Centro Ed. Fray Vicente Bernedo",126,2,4,2,27,5,21,1,1,189,2,3,194,221,0.143,0.878
"16700","Potosí","Potosí","Centro Ed. Fray Vicente Bernedo",127,0,1,0,27,8,19,0,5,187,5,15,207,227,0.144,0.912
"16701","Potosí","Potosí","Esc. Litoral",159,0,1,0,14,2,11,0,4,191,1,6,198,225,0.073,0.88
"16702","Potosí","Potosí","Esc. Litoral",160,0,1,1,31,2,11,1,0,207,1,3,211,228,0.15,0.925
"16703","Potosí","Potosí","Esc. Litoral",142,1,1,1,34,4,17,1,1,202,1,6,209,235,0.168,0.889
"16704","Potosí","Potosí","Esc. Litoral",145,0,0,0,31,1,14,1,1,193,1,3,197,229,0.161,0.86
"16705","Potosí","Potosí","Esc. Litoral",149,0,1,1,32,5,9,0,3,200,2,3,205,229,0.16,0.895
"16706","Potosí","Potosí","Esc. Litoral",140,0,1,1,32,7,11,0,2,194,2,11,207,236,0.165,0.877
"16707","Potosí","Potosí","Esc. Litoral",125,0,1,0,32,7,23,1,2,191,2,10,203,225,0.168,0.902
"16708","Potosí","Potosí","Esc. Litoral",149,1,4,0,20,5,12,3,1,195,1,6,202,228,0.103,0.886
"16709","Potosí","Potosí","Esc. Litoral",141,0,2,1,30,8,14,1,0,197,1,6,204,232,0.152,0.879
"16710","Potosí","Potosí","Esc. Litoral",154,0,1,0,29,3,14,1,0,202,1,2,205,229,0.144,0.895
"16711","Potosí","Potosí","Esc. Litoral",135,1,0,1,32,1,16,0,1,187,1,5,193,233,0.171,0.828
"16712","Potosí","Potosí","Esc. Litoral",128,0,1,1,24,0,5,1,0,160,0,4,164,186,0.15,0.882
"16713","Potosí","Potosí","Esc. Jose A.Zampa",109,1,3,1,25,11,16,1,2,169,0,8,177,224,0.148,0.79
"16714","Potosí","Potosí","Esc. Jose A.Zampa",128,0,0,2,25,3,24,0,3,185,0,5,190,226,0.135,0.841
"16715","Potosí","Potosí","Esc. Jose A.Zampa",106,0,0,0,37,7,21,1,0,172,1,7,180,222,0.215,0.811
"16716","Potosí","Potosí","Esc. Jose A.Zampa",129,0,1,3,32,4,18,0,1,188,0,1,189,222,0.17,0.851
"16717","Potosí","Potosí","Coleg. Cristo Maestro",156,0,0,1,24,6,12,1,0,200,1,6,207,227,0.12,0.912
"16718","Potosí","Potosí","Coleg. Cristo Maestro",172,0,0,0,21,2,7,1,0,203,0,6,209,225,0.103,0.929
"16719","Potosí","Potosí","Coleg. Cristo Maestro",175,0,1,0,24,1,6,0,0,207,1,5,213,232,0.116,0.918
"16720","Potosí","Potosí","Esc. Daniel Campos",126,0,2,0,35,7,22,1,1,194,3,8,205,231,0.18,0.887
"16721","Potosí","Potosí","Esc. Daniel Campos",120,0,1,2,34,9,18,0,2,186,4,4,194,220,0.183,0.882
"16722","Potosí","Potosí","Esc. Daniel Campos",133,0,1,0,32,3,18,2,3,192,0,12,204,231,0.167,0.883
"16723","Potosí","Potosí","Esc. Daniel Campos",144,0,0,0,24,6,19,0,2,195,0,6,201,225,0.123,0.893
"16724","Potosí","Potosí","Esc. Daniel Campos",135,1,0,0,32,2,19,0,0,189,0,14,203,229,0.169,0.886
"16725","Potosí","Potosí","Esc. Daniel Campos",107,1,5,1,40,10,27,1,2,194,4,7,205,230,0.206,0.891
"16726","Potosí","Potosí","Esc. Daniel Campos",133,2,3,1,27,7,20,1,0,194,3,7,204,226,0.139,0.903
"16727","Potosí","Potosí","Esc. Daniel Campos",128,0,0,0,32,9,20,1,1,191,4,7,202,229,0.168,0.882
"16728","Potosí","Potosí","Esc. Daniel Campos",132,0,0,1,35,8,17,0,0,193,1,10,204,231,0.181,0.883
"16729","Potosí","Potosí","Esc. Daniel Campos",140,0,1,3,22,8,21,0,1,196,1,3,200,228,0.112,0.877
"16730","Potosí","Potosí","Esc. Daniel Campos",134,0,3,1,29,5,15,2,2,191,1,9,201,226,0.152,0.889
"16731","Potosí","Potosí","Esc. Daniel Campos",133,1,1,1,32,5,19,0,0,192,1,10,203,229,0.167,0.886
"16732","Potosí","Potosí","Esc. Daniel Campos",125,1,0,1,31,6,19,0,0,183,2,11,196,222,0.169,0.883
"16733","Potosí","Potosí","Esc. Daniel Campos",122,0,1,1,30,3,28,0,1,186,3,10,199,225,0.161,0.884
"16734","Potosí","Potosí","Esc. Daniel Campos",114,0,2,1,35,10,16,0,1,179,6,19,204,229,0.196,0.891
"16735","Potosí","Potosí","Esc. Daniel Campos",132,1,0,0,32,5,15,1,0,186,4,10,200,228,0.172,0.877
"16736","Potosí","Potosí","Esc. Daniel Campos",127,0,0,2,32,5,19,1,2,188,2,12,202,226,0.17,0.894
"16737","Potosí","Potosí","Esc. Daniel Campos",133,1,2,0,32,6,14,0,1,189,0,5,194,224,0.169,0.866
"16738","Potosí","Potosí","Esc. Daniel Campos",128,0,1,0,29,10,19,2,0,189,4,10,203,227,0.153,0.894
"16739","Potosí","Potosí","Esc. Daniel Campos",130,2,1,1,34,8,21,1,0,198,2,7,207,224,0.172,0.924
"16740","Potosí","Potosí","Esc. Daniel Campos",122,2,1,0,41,6,20,1,2,195,5,10,210,231,0.21,0.909
"16741","Potosí","Potosí","Esc. Daniel Campos",123,0,1,0,28,7,18,2,1,180,1,11,192,219,0.156,0.877
"16742","Potosí","Potosí","Esc. Daniel Campos",129,0,3,0,41,8,15,0,0,196,0,8,204,227,0.209,0.899
"16743","Potosí","Potosí","Esc. Daniel Campos",133,1,0,1,32,5,19,1,1,193,5,2,200,228,0.166,0.877
"16744","Potosí","Potosí","Esc. Daniel Campos",125,0,1,0,44,5,21,2,2,200,2,5,207,227,0.22,0.912
"16745","Potosí","Potosí","Esc. Daniel Campos",126,1,1,0,25,9,16,0,1,179,3,9,191,216,0.14,0.884
"16746","Potosí","Potosí","Esc. Daniel Campos",121,2,2,1,39,5,18,1,0,189,3,9,201,219,0.206,0.918
"16747","Potosí","Potosí","Coleg. Bancario",155,0,0,2,23,7,5,0,0,192,0,8,200,219,0.12,0.913
"16748","Potosí","Potosí","Coleg. Bancario",160,0,2,0,26,4,4,0,1,197,0,7,204,225,0.132,0.907
"16749","Potosí","Potosí","Coleg. Bancario",163,1,1,1,22,4,4,1,0,197,4,4,205,221,0.112,0.928
"16750","Potosí","Potosí","Coleg. Bancario",155,0,0,0,28,6,3,1,0,193,0,8,201,219,0.145,0.918
"16751","Potosí","Potosí","Coleg. Bancario",142,0,0,1,17,1,6,0,2,169,2,3,174,192,0.101,0.906
"16752","Potosí","Potosí","Coleg. Don Bosco",168,0,0,0,16,8,3,1,0,196,3,6,205,226,0.082,0.907
"16753","Potosí","Potosí","Coleg. Don Bosco",164,0,1,1,32,3,7,0,1,209,0,0,209,229,0.153,0.913
"16754","Potosí","Potosí","Coleg. Don Bosco",150,3,1,1,25,6,6,1,0,193,1,2,196,223,0.13,0.879
"16755","Potosí","Potosí","Coleg. Don Bosco",162,0,0,1,20,8,5,0,0,196,2,5,203,226,0.102,0.898
"16756","Potosí","Potosí","Coleg. Don Bosco",168,0,0,0,16,3,4,0,0,191,0,3,194,211,0.084,0.919
"16757","Potosí","Potosí","Esc. Gregorio Barriga",142,0,0,0,19,13,8,0,0,182,0,4,186,205,0.104,0.907
"16758","Potosí","Potosí","Esc. Salvador Revilla",167,1,0,1,23,5,4,0,1,202,0,4,206,219,0.114,0.941
"16759","Potosí","Potosí","Esc. Salvador Revilla",161,0,2,0,30,6,3,2,0,204,1,7,212,223,0.147,0.951
"16760","Potosí","Potosí","Esc. Salvador Revilla",153,1,0,1,28,5,8,0,1,197,2,11,210,225,0.142,0.933
"16761","Potosí","Potosí","Esc. Salvador Revilla",167,0,1,1,19,5,5,0,0,198,1,2,201,216,0.096,0.931
"16762","Potosí","Potosí","Esc. Salvador Revilla",160,0,1,0,31,8,10,2,1,213,1,2,216,231,0.146,0.935
"16763","Potosí","Potosí","Escuela José Alonso De Ibáñez",154,0,0,0,28,7,5,0,1,195,1,3,199,230,0.144,0.865
"16764","Potosí","Potosí","Escuela José Alonso De Ibáñez",162,1,0,1,22,5,7,2,3,203,0,4,207,226,0.108,0.916
"16765","Potosí","Potosí","Escuela José Alonso De Ibáñez",155,0,1,1,29,2,9,3,1,201,3,3,207,222,0.144,0.932
"16766","Potosí","Potosí","Escuela José Alonso De Ibáñez",156,0,0,1,29,8,9,1,0,204,0,3,207,227,0.142,0.912
"16767","Potosí","Potosí","Escuela José Alonso De Ibáñez",154,0,0,0,28,5,5,0,0,192,1,7,200,225,0.146,0.889
"16768","Potosí","Potosí","Escuela José Alonso De Ibáñez",163,0,0,0,23,5,5,1,0,197,0,6,203,219,0.117,0.927
"16769","Potosí","Potosí","Esc. Modesto Omiste",136,1,1,0,23,7,11,3,2,184,1,3,188,207,0.125,0.908
"16770","Potosí","Potosí","Esc. Modesto Omiste",153,0,1,0,20,4,8,1,3,190,1,5,196,224,0.105,0.875
"16771","Potosí","Potosí","Esc. 1ro de Abril",147,0,2,1,19,8,15,2,1,195,1,6,202,224,0.097,0.902
"16772","Potosí","Potosí","Esc. 1ro de Abril",172,0,0,1,19,6,7,0,0,205,1,8,214,227,0.093,0.943
"16773","Potosí","Potosí","Esc. Antonio Quijarro",166,0,1,2,26,3,5,0,0,203,0,3,206,222,0.128,0.928
"16774","Potosí","Potosí","Esc. Antonio Quijarro",168,0,0,0,26,2,2,1,0,199,1,2,202,222,0.131,0.91
"16775","Potosí","Potosí","Colegio Franciscano",180,0,0,1,16,6,4,1,0,208,1,1,210,228,0.077,0.921
"16776","Potosí","Potosí","Colegio Franciscano",162,0,0,1,22,6,10,1,2,204,2,3,209,230,0.108,0.909
"16777","Potosí","Potosí","Colegio Franciscano",161,0,0,1,21,6,7,1,0,197,0,5,202,225,0.107,0.898
"16778","Potosí","Potosí","Colegio Franciscano",165,0,0,2,21,4,5,1,0,198,2,1,201,222,0.106,0.905
"16779","Potosí","Potosí","Colegio Franciscano",168,0,0,1,25,5,6,2,0,207,0,1,208,228,0.121,0.912
"16780","Potosí","Potosí","Lic. Sucre",168,1,0,1,16,8,7,0,0,201,2,1,204,229,0.08,0.891
"16781","Potosí","Potosí","Lic. Sucre",157,0,0,0,30,3,9,1,1,201,1,4,206,220,0.149,0.936
"16782","Potosí","Potosí","Lic. Sucre",158,0,1,0,34,3,6,1,0,203,3,5,211,229,0.167,0.921
"16783","Potosí","Potosí","Lic. Sucre",159,0,2,0,20,7,9,0,4,201,0,0,201,218,0.1,0.922
"16784","Potosí","Potosí","Lic. Sucre",154,0,1,2,25,9,4,2,1,198,1,5,204,225,0.126,0.907
"16785","Potosí","Potosí","Lic. Sucre",143,0,0,0,22,7,15,1,1,189,0,10,199,225,0.116,0.884
"16786","Potosí","Potosí","Lic. Sucre",157,0,0,0,23,6,9,1,0,196,1,7,204,229,0.117,0.891
"16787","Potosí","Potosí","Lic. Sucre",164,2,1,0,20,8,4,2,1,202,1,2,205,226,0.099,0.907
"16788","Potosí","Potosí","Lic. Sucre",167,0,0,0,16,6,5,1,2,197,1,2,200,219,0.081,0.913
"16789","Potosí","Potosí","Unidad Educativa Santa Rosa",149,0,0,0,21,4,20,2,3,199,0,7,206,221,0.106,0.932
"16790","Potosí","Potosí","Unidad Educativa Santa Rosa",163,0,0,3,22,7,12,1,1,209,1,2,212,232,0.105,0.914
"16791","Potosí","Potosí","Unidad Educativa Santa Rosa",152,0,1,0,28,6,9,1,1,198,0,6,204,222,0.141,0.919
"16792","Potosí","Potosí","Unidad Educativa Santa Rosa",153,0,1,0,18,7,13,0,5,197,0,4,201,219,0.091,0.918
"16793","Potosí","Potosí","Unidad Educativa Santa Rosa",159,0,1,0,19,4,19,1,1,204,0,4,208,229,0.093,0.908
"16794","Potosí","Potosí","Unidad Educativa Santa Rosa",150,0,0,0,22,7,15,0,3,197,2,5,204,230,0.112,0.887
"16795","Potosí","Potosí","Unidad Educativa Santa Rosa",157,1,0,0,29,3,12,2,2,206,1,5,212,232,0.141,0.914
"16796","Potosí","Potosí","Esc. Simon Rodriguez",164,0,0,1,27,6,7,0,1,206,2,3,211,224,0.131,0.942
"16797","Potosí","Potosí","Esc. Simon Rodriguez",158,1,3,0,24,5,8,0,0,199,1,7,207,221,0.121,0.937
"16798","Potosí","Potosí","Esc. Simon Rodriguez",144,0,2,0,35,3,13,0,2,199,2,3,204,224,0.176,0.911
"16799","Potosí","Potosí","Esc. Simon Rodriguez",158,0,1,0,23,3,9,0,1,195,1,9,205,229,0.118,0.895
"16800","Potosí","Potosí","Esc. Simon Rodriguez",145,0,2,2,29,7,8,1,1,195,0,5,200,218,0.149,0.917
"16801","Potosí","Potosí","Esc. Simon Rodriguez",151,0,0,1,24,3,12,0,1,192,0,5,197,220,0.125,0.895
"16802","Potosí","Potosí","Esc. Simon Rodriguez",132,0,0,0,21,4,6,0,1,164,3,2,169,194,0.128,0.871
"16803","Potosí","Potosí","Col. Carlos Medinaceli",152,0,1,0,28,5,16,3,3,208,1,0,209,230,0.135,0.909
"16804","Potosí","Potosí","Col. Carlos Medinaceli",158,0,0,0,22,2,16,0,0,198,2,9,209,230,0.111,0.909
"16805","Potosí","Potosí","Col. Carlos Medinaceli",145,0,1,4,26,8,10,0,4,198,2,2,202,232,0.131,0.871
"16806","Potosí","Potosí","Col. Carlos Medinaceli",140,0,1,1,11,5,8,0,0,166,0,3,169,186,0.066,0.909
"16807","Potosí","Potosí","Esc. San Jose",159,0,4,1,21,3,11,0,0,199,0,6,205,224,0.106,0.915
"16808","Potosí","Potosí","Esc. San Jose",157,1,4,1,27,6,9,0,3,208,1,4,213,229,0.13,0.93
"16809","Potosí","Potosí","Esc. San Jose",151,0,3,2,23,4,10,2,5,200,0,7,207,226,0.115,0.916
"16810","Potosí","Potosí","Esc. San Jose",143,0,4,0,26,7,13,4,4,201,1,13,215,235,0.129,0.915
"16811","Potosí","Potosí","Esc. San Jose",161,0,2,0,18,8,12,0,4,205,0,3,208,228,0.088,0.912
"16812","Potosí","Potosí","Esc. San Jose",160,2,1,0,25,3,9,1,2,203,2,6,211,227,0.123,0.93
"16813","Potosí","Potosí","Esc. San Jose",151,0,1,0,32,10,9,1,1,205,1,2,208,227,0.156,0.916
"16814","Potosí","Potosí","Esc. San Jose",150,0,2,0,18,6,11,1,1,189,0,3,192,219,0.095,0.877
"16815","Potosí","Potosí","Col. 31 de Octubre",128,0,1,0,44,5,19,0,2,199,0,3,202,225,0.221,0.898
"16816","Potosí","Potosí","Col. 31 de Octubre",148,0,4,1,30,3,12,0,2,200,2,8,210,234,0.15,0.897
"16817","Potosí","Potosí","Col. 31 de Octubre",149,1,1,0,25,6,13,0,1,196,2,8,206,227,0.128,0.907
"16818","Potosí","Potosí","Col. 31 de Octubre",147,1,1,0,22,8,12,0,4,195,1,9,205,233,0.113,0.88
"16819","Potosí","Potosí","Col. 31 de Octubre",137,0,3,0,36,6,13,0,1,196,0,8,204,231,0.184,0.883
"16820","Potosí","Potosí","Col. 31 de Octubre",138,1,0,2,24,6,20,1,1,193,2,8,203,230,0.124,0.883
"16821","Potosí","Potosí","Col. 31 de Octubre",151,0,4,2,28,3,14,1,1,204,2,3,209,233,0.137,0.897
"16822","Potosí","Potosí","U.E. 31 de Octubre",137,0,0,1,32,6,17,0,3,196,0,7,203,223,0.163,0.91
"16823","Potosí","Potosí","U.E. 31 de Octubre",143,0,1,1,39,6,7,1,2,200,3,7,210,225,0.195,0.933
"16824","Potosí","Potosí","U.E. 31 de Octubre",153,0,3,0,25,5,8,0,0,194,1,7,202,223,0.129,0.906
"16825","Potosí","Potosí","U.E. 31 de Octubre",163,0,0,0,21,5,11,2,4,206,1,3,210,227,0.102,0.925
"16826","Potosí","Potosí","U.E. 31 de Octubre",126,1,0,0,37,8,13,2,3,190,1,9,200,228,0.195,0.877
"16827","Potosí","Potosí","U.E. 31 de Octubre",144,1,5,0,20,10,18,1,0,199,3,3,205,226,0.101,0.907
"16828","Potosí","Potosí","U.E. 31 de Octubre",137,0,0,0,33,8,15,1,0,194,2,6,202,223,0.17,0.906
"16829","Potosí","Potosí","U.E. 31 de Octubre",139,0,0,1,33,10,13,0,3,199,4,5,208,228,0.166,0.912
"16830","Potosí","Potosí","U.E. 31 de Octubre",138,2,1,0,36,5,14,0,2,198,1,5,204,227,0.182,0.899
"16831","Potosí","Potosí","U.E. 31 de Octubre",132,0,0,0,25,8,12,1,1,179,0,5,184,218,0.14,0.844
"16832","Potosí","Potosí","U.E. 31 de Octubre",132,0,2,0,34,8,12,1,5,194,1,6,201,223,0.175,0.901
"16833","Potosí","Potosí","U.E. 31 de Octubre",141,1,1,0,26,10,5,2,0,186,3,8,197,220,0.14,0.895
"16834","Potosí","Potosí","U.E. 31 de Octubre",130,1,1,1,29,5,18,0,1,186,4,10,200,214,0.156,0.935
"16835","Potosí","Potosí","U.E. 31 de Octubre",141,2,0,3,32,6,11,0,2,197,3,2,202,227,0.162,0.89
"16836","Potosí","Potosí","U.E. 31 de Octubre",143,0,4,1,36,10,11,0,1,206,1,1,208,221,0.175,0.941
"16837","Potosí","Potosí","U.E. 31 de Octubre",142,0,0,1,31,4,15,1,2,196,3,4,203,223,0.158,0.91
"16838","Potosí","Potosí","U.E. 31 de Octubre",132,0,2,0,38,8,12,1,4,197,3,11,211,231,0.193,0.913
"16839","Potosí","Potosí","Col. Aniceto Arce",149,1,3,2,24,4,15,0,0,198,0,3,201,228,0.121,0.882
"16840","Potosí","Potosí","Col. Aniceto Arce",167,0,2,1,24,7,7,1,0,209,0,6,215,233,0.115,0.923
"16841","Potosí","Potosí","Col. Aniceto Arce",143,0,1,1,34,8,13,1,1,202,0,3,205,228,0.168,0.899
"16842","Potosí","Potosí","Col. Aniceto Arce",128,0,1,2,43,4,10,0,3,191,1,5,197,226,0.225,0.872
"16843","Potosí","Potosí","Esc. Gualberto Villarroel",107,0,3,0,30,18,26,0,0,184,4,13,201,225,0.163,0.893
"16844","Potosí","Potosí","Esc. Gualberto Villarroel",124,0,0,1,46,6,16,1,2,196,3,8,207,226,0.235,0.916
"16845","Potosí","Potosí","Esc. Gualberto Villarroel",107,0,2,2,38,12,30,1,1,193,4,11,208,223,0.197,0.933
"16846","Potosí","Potosí","Esc. Gualberto Villarroel",111,0,2,0,33,16,21,1,4,188,3,6,197,226,0.176,0.872
"16847","Potosí","Potosí","Esc. Gualberto Villarroel",130,0,1,1,26,10,15,1,0,184,7,13,204,221,0.141,0.923
"16848","Potosí","Potosí","Esc. Gualberto Villarroel",103,0,5,3,30,19,16,1,3,180,5,4,189,214,0.167,0.883
"16849","Potosí","Potosí","Esc. Gualberto Villarroel",121,1,1,2,37,12,21,1,1,197,4,6,207,224,0.188,0.924
"16850","Potosí","Potosí","Esc. Gualberto Villarroel",101,0,2,1,49,22,14,1,2,192,0,13,205,226,0.255,0.907
"16851","Potosí","Potosí","Esc. Gualberto Villarroel",126,1,0,1,42,9,11,2,3,195,3,7,205,221,0.215,0.928
"16852","Potosí","Potosí","Esc. Gualberto Villarroel",108,1,1,2,36,11,28,2,1,190,0,4,194,222,0.189,0.874
"16853","Potosí","Potosí","Esc. Gualberto Villarroel",123,0,0,3,30,14,20,3,4,197,5,9,211,228,0.152,0.925
"16854","Potosí","Potosí","Esc. Gualberto Villarroel",105,0,1,0,28,8,16,0,1,159,2,13,174,193,0.176,0.902
"16855","Potosí","Potosí","Coleg. Antofagasta",129,0,0,0,28,8,15,1,4,185,2,5,192,221,0.151,0.869
"16856","Potosí","Potosí","Coleg. Antofagasta",116,1,1,3,56,10,14,1,1,203,5,6,214,233,0.276,0.918
"16857","Potosí","Potosí","Coleg. Antofagasta",152,1,2,0,25,9,13,1,2,205,0,6,211,226,0.122,0.934
"16858","Potosí","Potosí","Coleg. Antofagasta",135,0,0,0,26,9,20,2,3,195,4,13,212,229,0.133,0.926
"16859","Potosí","Potosí","Coleg. Antofagasta",136,0,2,0,23,8,19,1,4,193,6,11,210,223,0.119,0.942
"16860","Potosí","Potosí","Coleg. Antofagasta",138,1,2,0,35,6,8,4,3,197,3,9,209,221,0.178,0.946
"16861","Potosí","Potosí","Coleg. Antofagasta",129,1,1,2,33,13,16,2,4,201,0,6,207,227,0.164,0.912
"16862","Potosí","Potosí","Coleg. Antofagasta",143,0,2,0,30,9,11,3,1,199,6,8,213,234,0.151,0.91
"16863","Potosí","Potosí","Coleg. Antofagasta",130,1,2,0,29,6,8,1,3,180,1,24,205,228,0.161,0.899
"16864","Potosí","Potosí","Coleg. Antofagasta",136,0,1,0,34,7,12,1,3,194,3,8,205,225,0.175,0.911
"16865","Potosí","Potosí","Coleg. Antofagasta",129,0,0,1,34,13,8,2,2,189,2,5,196,216,0.18,0.907
"16866","Potosí","Potosí","Coleg. Antofagasta",130,0,0,0,34,8,10,0,2,184,2,10,196,224,0.185,0.875
"16867","Potosí","Potosí","Coleg. Antofagasta",123,0,0,2,33,7,17,1,3,186,6,15,207,229,0.177,0.904
"16868","Potosí","Potosí","Coleg. Antofagasta",147,1,0,0,24,10,8,0,2,192,8,7,207,226,0.125,0.916
"16869","Potosí","Potosí","Coleg. Antofagasta",117,1,3,0,28,10,16,3,7,185,9,9,203,227,0.151,0.894
"16870","Potosí","Potosí","Coleg. Antofagasta",102,0,0,0,20,9,18,1,2,152,2,4,158,176,0.132,0.898
"16871","Potosí","Potosí","Esc. 12 de Abril",110,0,0,1,45,9,27,0,0,192,6,7,205,229,0.234,0.895
"16872","Potosí","Potosí","Esc. 12 de Abril",122,0,4,1,26,11,16,0,3,183,3,10,196,214,0.142,0.916
"16873","Potosí","Potosí","Esc. 12 de Abril",120,1,3,0,33,13,23,0,1,194,3,12,209,228,0.17,0.917
"16874","Potosí","Potosí","Esc. 12 de Abril",120,2,2,1,27,9,21,0,4,186,1,12,199,221,0.145,0.9
"16875","Potosí","Potosí","Esc. Copacabana",143,0,1,1,26,10,13,0,0,194,0,6,200,227,0.134,0.881
"16876","Potosí","Potosí","Esc. Copacabana",155,2,3,0,23,7,11,0,2,203,2,5,210,230,0.113,0.913
"16877","Potosí","Potosí","Esc. Copacabana",143,1,2,1,22,11,11,1,3,195,2,6,203,225,0.113,0.902
"16878","Potosí","Potosí","Esc. Copacabana",140,2,0,1,31,11,11,0,3,199,3,3,205,225,0.156,0.911
"16879","Potosí","Potosí","Esc. Copacabana",146,1,1,1,31,7,13,0,2,202,0,3,205,228,0.153,0.899
"16880","Potosí","Potosí","Esc. Copacabana",134,1,3,1,23,9,16,1,2,190,3,11,204,224,0.121,0.911
"16881","Potosí","Potosí","Esc. Copacabana",145,0,1,1,23,13,9,1,1,194,1,8,203,230,0.119,0.883
"16882","Potosí","Potosí","Esc. Copacabana",155,1,1,0,19,9,16,1,1,203,1,7,211,222,0.094,0.95
"16883","Potosí","Potosí","Esc. Copacabana",158,0,3,0,17,8,9,0,2,197,4,5,206,226,0.086,0.912
"16884","Potosí","Potosí","Esc. Copacabana",145,0,1,0,22,9,12,4,2,195,4,6,205,229,0.113,0.895
"16885","Potosí","Potosí","Esc. Copacabana",144,0,3,0,25,8,17,4,3,204,4,4,212,229,0.123,0.926
"16886","Potosí","Potosí","Esc. Cleto Loayza",114,0,1,1,51,11,22,2,2,204,4,9,217,230,0.25,0.943
"16887","Potosí","Potosí","Esc. Cleto Loayza",135,1,1,0,29,4,14,1,3,188,0,13,201,226,0.154,0.889
"16888","Potosí","Potosí","Esc. Cleto Loayza",145,1,0,0,28,7,13,0,2,196,4,6,206,222,0.143,0.928
"16889","Potosí","Potosí","Esc. Cleto Loayza",131,0,3,0,19,9,31,1,1,195,3,13,211,228,0.097,0.925
"16890","Potosí","Potosí","Esc. Cleto Loayza",130,0,2,1,28,7,17,0,0,185,1,7,193,220,0.151,0.877
"16891","Potosí","Potosí","Esc. Cleto Loayza",160,0,1,1,21,6,16,0,2,207,1,7,215,230,0.101,0.935
"16892","Potosí","Potosí","Esc. Cleto Loayza",146,1,2,1,19,12,8,0,1,190,2,12,204,224,0.1,0.911
"16893","Potosí","Potosí","Esc. Cleto Loayza",117,2,1,0,31,15,25,1,1,193,2,9,204,228,0.161,0.895
"16894","Potosí","Potosí","Esc. Cleto Loayza",135,0,2,0,27,14,18,0,3,199,6,9,214,236,0.136,0.907
"16895","Potosí","Potosí","Esc. Cleto Loayza",114,0,1,3,37,11,20,0,7,193,4,12,209,226,0.192,0.925
"16896","Potosí","Potosí","Esc. Cleto Loayza",135,0,2,0,26,10,18,0,1,192,2,12,206,225,0.135,0.916
"16897","Potosí","Potosí","Esc. Cleto Loayza",134,0,0,0,31,7,22,0,6,200,1,5,206,229,0.155,0.9
"16898","Potosí","Potosí","Esc. Cleto Loayza",128,1,0,0,38,6,15,0,1,189,7,12,208,228,0.201,0.912
"16899","Potosí","Potosí","Esc. Cleto Loayza",118,2,1,2,38,12,13,0,5,191,0,11,202,224,0.199,0.902
"16900","Potosí","Potosí","Instituto San Juan",132,0,1,0,29,10,9,1,2,184,2,7,193,215,0.158,0.898
"16901","Potosí","Potosí","Instituto San Juan",144,0,1,0,21,11,14,1,0,192,1,8,201,218,0.109,0.922
"16902","Potosí","Potosí","Instituto San Juan",136,1,0,4,22,8,15,1,1,188,3,7,198,216,0.117,0.917
"16903","Potosí","Potosí","Instituto San Juan",151,1,0,1,28,9,8,1,1,200,0,9,209,221,0.14,0.946
"16904","Potosí","Potosí","Instituto San Juan",158,1,2,2,16,7,14,1,6,207,2,13,222,239,0.077,0.929
"16905","Potosí","Potosí","Esc. German Busch",105,2,2,2,43,10,20,1,3,188,8,9,205,222,0.229,0.923
"16906","Potosí","Potosí","Esc. German Busch",102,3,3,1,36,7,23,1,2,178,2,18,198,228,0.202,0.868
"16907","Potosí","Potosí","Esc. German Busch",96,1,3,1,43,15,25,3,4,191,4,19,214,232,0.225,0.922
"16908","Potosí","Potosí","Esc. German Busch",107,1,3,1,47,10,24,2,1,196,7,10,213,231,0.24,0.922
"16909","Potosí","Potosí","Esc. German Busch",117,2,0,0,34,15,19,1,1,189,6,10,205,230,0.18,0.891
"16910","Potosí","Potosí","Esc. German Busch",120,1,0,1,33,9,18,1,4,187,6,13,206,230,0.176,0.896
"16911","Potosí","Potosí","Esc. German Busch",106,1,4,3,35,13,20,1,2,185,3,18,206,227,0.189,0.907
"16912","Potosí","Potosí","Esc. German Busch",98,2,4,1,36,15,32,2,3,193,9,12,214,233,0.187,0.918
"16913","Potosí","Potosí","Esc. German Busch",127,1,0,1,31,14,14,1,3,192,4,15,211,229,0.161,0.921
"16914","Potosí","Potosí","Esc. German Busch",96,2,1,0,55,8,21,2,1,186,2,15,203,225,0.296,0.902
"16915","Potosí","Potosí","Esc. German Busch",105,1,2,1,51,5,20,1,2,188,4,11,203,233,0.271,0.871
"16916","Potosí","Potosí","Esc. German Busch",115,0,2,1,35,10,18,2,2,185,4,15,204,228,0.189,0.895
"16917","Potosí","Potosí","U.E. Don Bosco B",134,0,0,2,38,10,22,0,4,210,2,5,217,236,0.181,0.919
"16918","Potosí","Potosí","U.E. Don Bosco B",121,1,3,0,32,12,27,0,1,197,2,6,205,237,0.162,0.865
"16919","Potosí","Potosí","U.E. Don Bosco B",124,0,0,2,44,8,31,1,0,210,3,5,218,235,0.21,0.928
"16920","Potosí","Potosí","U.E. Don Bosco B",120,0,1,0,46,7,22,0,1,197,1,7,205,227,0.234,0.903
"16921","Potosí","Potosí","U.E. Humberto Iporre Salinas",66,5,2,1,56,7,46,1,2,186,7,17,210,229,0.301,0.917
"16922","Potosí","Potosí","U.E. Humberto Iporre Salinas",62,3,1,4,67,11,38,1,1,188,3,13,204,230,0.356,0.887
"16923","Potosí","Potosí","U.E. Humberto Iporre Salinas",51,1,4,4,69,7,54,0,3,193,3,15,211,231,0.358,0.913
"16924","Potosí","Potosí","U.E. Humberto Iporre Salinas",62,1,5,1,54,19,39,0,2,183,8,20,211,231,0.295,0.913
"16925","Potosí","Potosí","U.E. Humberto Iporre Salinas",69,0,3,0,71,6,39,2,2,192,4,21,217,230,0.37,0.943
"16926","Potosí","Potosí","U.E. Humberto Iporre Salinas",70,0,0,1,63,9,42,2,0,187,2,12,201,226,0.337,0.889
"16927","Potosí","Potosí","U.E. Humberto Iporre Salinas",59,2,2,0,62,9,45,1,2,182,3,24,209,227,0.341,0.921
"16928","Potosí","Potosí","U.E. Humberto Iporre Salinas",49,3,3,1,55,16,60,0,3,190,3,16,209,225,0.289,0.929
"16929","Potosí","Potosí","U.E. Humberto Iporre Salinas",55,4,2,2,49,14,44,1,1,172,10,25,207,230,0.285,0.9
"16930","Potosí","Potosí","U.E. Humberto Iporre Salinas",68,0,3,0,54,7,42,1,3,178,7,17,202,228,0.303,0.886
"16931","Potosí","Potosí","U.E. Humberto Iporre Salinas",75,2,5,1,49,12,41,1,0,186,4,23,213,233,0.263,0.914
"16932","Potosí","Potosí","U.E. Humberto Iporre Salinas",78,0,5,4,47,20,33,1,6,194,4,10,208,223,0.242,0.933
"16933","Potosí","Potosí","U.E. Humberto Iporre Salinas",59,1,2,1,59,8,41,0,3,174,3,23,200,226,0.339,0.885
"16934","Potosí","Potosí","U.E. Humberto Iporre Salinas",73,1,2,1,54,14,38,3,2,188,3,15,206,228,0.287,0.904
"16935","Potosí","Potosí","U.E. Antonio Jose De Sucre",88,1,1,4,42,15,28,3,1,183,6,18,207,228,0.23,0.908
"16936","Potosí","Potosí","U.E. Antonio Jose De Sucre",104,3,5,0,37,6,18,0,3,176,4,10,190,224,0.21,0.848
"16937","Potosí","Potosí","U.E. Antonio Jose De Sucre",108,1,1,2,40,10,26,1,1,190,1,11,202,229,0.211,0.882
"16938","Potosí","Potosí","U.E. Antonio Jose De Sucre",94,0,3,2,38,11,30,0,2,180,4,17,201,224,0.211,0.897
"16939","Potosí","Potosí","U.E. Antonio Jose De Sucre",104,2,3,0,38,15,27,2,4,195,6,13,214,232,0.195,0.922
"16940","Potosí","Potosí","U.E. Antonio Jose De Sucre",97,2,4,0,33,12,32,0,1,181,6,16,203,227,0.182,0.894
"16941","Potosí","Potosí","U.E. Antonio Jose De Sucre",106,1,1,3,33,10,26,4,0,184,5,12,201,223,0.179,0.901
"16942","Potosí","Potosí","U.E. Antonio Jose De Sucre",100,1,1,0,36,14,19,1,6,178,0,18,196,222,0.202,0.883
"16943","Potosí","Potosí","U.E. Antonio Jose De Sucre",100,0,4,5,32,11,28,0,3,183,3,15,201,223,0.175,0.901
"16944","Potosí","Potosí","U.E. Antonio Jose De Sucre",91,1,1,3,46,10,27,3,3,185,5,18,208,227,0.249,0.916
"16945","Potosí","Potosí","U.E. Antonio Jose De Sucre",91,2,1,4,43,12,26,1,1,181,2,14,197,219,0.238,0.9
"16946","Potosí","Potosí","U.E. Antonio Jose De Sucre",81,2,3,1,46,14,34,0,3,184,6,13,203,228,0.25,0.89
"16947","Potosí","Potosí","U.E. Antonio Jose De Sucre",107,3,0,0,39,10,29,3,0,191,5,13,209,228,0.204,0.917
"16948","Potosí","Potosí","U.E. Antonio Jose De Sucre",99,3,1,2,44,5,29,0,1,184,3,14,201,217,0.239,0.926
"16949","Potosí","Potosí","U.E. Antonio Jose De Sucre",91,0,2,1,33,15,31,2,2,177,3,11,191,213,0.186,0.897
"16950","Potosí","Potosí","U.E. Antonio Jose De Sucre",114,2,2,7,32,11,15,0,1,184,4,4,192,220,0.174,0.873
"16951","Potosí","Potosí","U.E. Antonio Jose De Sucre",93,2,4,3,51,9,19,1,1,183,5,14,202,226,0.279,0.894
"16952","Potosí","Potosí","U.E. Antonio Jose De Sucre",108,1,2,0,36,13,27,0,1,188,4,8,200,219,0.191,0.913
"16953","Potosí","Potosí","Esc. Enrique Viana",138,0,3,1,29,8,15,0,1,195,0,8,203,235,0.149,0.864
"16954","Potosí","Potosí","Esc. Enrique Viana",127,0,0,4,32,4,23,2,4,196,3,11,210,225,0.163,0.933
"16955","Potosí","Potosí","Esc. Enrique Viana",149,1,1,1,27,5,19,1,3,207,0,10,217,233,0.13,0.931
"16956","Potosí","Potosí","Esc. Enrique Viana",156,1,0,0,21,5,16,1,2,202,4,7,213,229,0.104,0.93
"16957","Potosí","Potosí","Esc. Enrique Viana",128,0,1,1,38,4,20,1,1,194,2,10,206,229,0.196,0.9
"16958","Potosí","Potosí","Esc. Enrique Viana",130,0,2,0,34,15,14,0,1,196,1,6,203,225,0.173,0.902
"16959","Potosí","Potosí","Esc. Enrique Viana",147,0,0,1,30,5,21,5,1,210,0,3,213,226,0.143,0.942
"16960","Potosí","Potosí","Esc. Enrique Viana",144,0,0,0,23,10,10,3,2,192,4,13,209,229,0.12,0.913
"16961","Potosí","Potosí","Esc. Enrique Viana",146,1,0,1,37,6,10,2,4,207,1,2,210,228,0.179,0.921
"16962","Potosí","Potosí","Esc. Enrique Viana",149,0,2,1,27,8,11,0,2,200,1,8,209,229,0.135,0.913
"16963","Potosí","Potosí","Esc. Enrique Viana",135,1,2,1,32,5,11,1,3,191,2,10,203,231,0.168,0.879
"16964","Potosí","Potosí","Esc. Enrique Viana",125,1,1,1,27,13,25,2,2,197,1,10,208,231,0.137,0.9
"16965","Potosí","Potosí","Esc. Enrique Viana",146,2,1,0,30,7,11,0,0,197,0,6,203,224,0.152,0.906
"16966","Potosí","Potosí","Esc. Enrique Viana",122,3,1,2,41,9,19,1,0,198,5,9,212,231,0.207,0.918
"16967","Potosí","Potosí","Esc. Enrique Viana",148,1,0,0,24,5,11,1,1,191,3,6,200,226,0.126,0.885
"16968","Potosí","Potosí","Esc. Enrique Viana",144,0,0,2,33,6,13,1,0,199,3,5,207,228,0.166,0.908
"16969","Potosí","Potosí","Esc. Enrique Viana",156,0,0,0,23,11,17,0,1,208,2,3,213,230,0.111,0.926
"16970","Potosí","Potosí","Esc. Enrique Viana",129,2,2,2,40,8,18,0,0,201,1,4,206,225,0.199,0.916
"16971","Potosí","Potosí","Esc. Enrique Viana",153,0,1,0,26,10,16,0,2,208,2,7,217,230,0.125,0.943
"16972","Potosí","Potosí","Esc. Enrique Viana",137,0,1,2,26,2,24,0,1,193,2,11,206,228,0.135,0.904
"16973","Potosí","Potosí","Esc. Kenny Prieto Melgarejo",100,1,0,1,37,8,43,0,2,192,3,13,208,231,0.193,0.9
"16974","Potosí","Potosí","Esc. Kenny Prieto Melgarejo",113,1,1,0,37,9,34,0,1,196,4,10,210,227,0.189,0.925
"16975","Potosí","Potosí","Esc. Kenny Prieto Melgarejo",106,0,3,2,47,8,36,2,2,206,3,10,219,237,0.228,0.924
"16976","Potosí","Potosí","Esc. Kenny Prieto Melgarejo",105,0,5,1,48,16,20,3,1,199,2,8,209,229,0.241,0.913
"16977","Potosí","Potosí","Esc. Kenny Prieto Melgarejo",91,1,2,2,50,8,34,0,3,191,4,10,205,228,0.262,0.899
"16978","Potosí","Potosí","Esc. Kenny Prieto Melgarejo",105,0,5,1,50,6,33,0,1,201,5,6,212,231,0.249,0.918
"16979","Potosí","Potosí","Esc. Kenny Prieto Melgarejo",101,0,1,1,44,11,29,0,4,191,3,15,209,230,0.23,0.909
"16980","Potosí","Potosí","Esc. Kenny Prieto Melgarejo",125,0,4,1,34,4,25,0,4,197,1,14,212,225,0.173,0.942
"16981","Potosí","Potosí","Esc. Kenny Prieto Melgarejo",129,1,0,2,26,4,35,0,1,198,0,14,212,229,0.131,0.926
"16982","Potosí","Potosí","Esc. Kenny Prieto Melgarejo",132,0,1,3,29,6,33,1,1,206,5,4,215,232,0.141,0.927
"16983","Potosí","Potosí","Esc. Kenny Prieto Melgarejo",106,0,2,1,42,6,31,2,2,192,4,12,208,227,0.219,0.916
"16984","Potosí","Potosí","Esc. Kenny Prieto Melgarejo",112,0,3,1,44,8,26,2,1,197,2,15,214,227,0.223,0.943
"16985","Potosí","Potosí","Esc. Kenny Prieto Melgarejo",106,0,5,1,51,3,35,0,0,201,4,8,213,230,0.254,0.926
"16986","Potosí","Potosí","Esc. Kenny Prieto Melgarejo",113,1,0,2,33,9,37,0,1,196,3,10,209,232,0.168,0.901
"16987","Potosí","Potosí","Esc. Kenny Prieto Melgarejo",105,0,4,1,57,8,32,1,1,209,1,5,215,232,0.273,0.927
"16988","Potosí","Potosí","Esc. Kenny Prieto Melgarejo",117,0,2,1,56,5,22,1,2,206,3,11,220,235,0.272,0.936
"16989","Potosí","Potosí","Esc. Kenny Prieto Melgarejo",122,0,2,1,36,2,32,2,1,198,1,8,207,224,0.182,0.924
"16990","Potosí","Potosí","Esc. Kenny Prieto Melgarejo",114,0,2,4,46,4,29,1,0,200,5,10,215,235,0.23,0.915
"16991","Potosí","Potosí","Esc. Kenny Prieto Melgarejo",114,0,2,2,33,10,26,2,0,189,4,22,215,235,0.175,0.915
"16992","Potosí","Potosí","Esc. Kenny Prieto Melgarejo",128,1,1,1,34,6,24,1,3,199,3,7,209,227,0.171,0.921
"16993","Potosí","Potosí","Esc. Kenny Prieto Melgarejo",94,0,4,1,41,20,39,0,2,201,2,8,211,226,0.204,0.934
"16994","Potosí","Potosí","Esc. Cobija",140,0,3,0,25,11,15,0,2,196,2,9,207,229,0.128,0.904
"16995","Potosí","Potosí","Esc. Cobija",141,0,0,0,31,4,19,1,0,196,3,8,207,225,0.158,0.92
"16996","Potosí","Potosí","Esc. Cobija",145,0,1,1,28,7,18,2,4,206,0,7,213,226,0.136,0.942
"16997","Potosí","Potosí","Esc. Cobija",138,0,3,0,30,5,17,0,2,195,0,13,208,231,0.154,0.9
"16998","Potosí","Potosí","Esc. Cobija",140,1,2,0,40,5,12,0,2,202,2,3,207,228,0.198,0.908
"16999","Potosí","Potosí","Esc. Cobija",142,1,1,0,13,10,16,1,2,186,1,4,191,221,0.07,0.864
"17000","Potosí","Potosí","Esc. Cobija",136,1,1,3,28,10,8,4,4,195,2,5,202,219,0.144,0.922
"17001","Potosí","Potosí","Esc. Cobija",141,3,3,0,27,8,18,2,1,203,1,7,211,227,0.133,0.93
"17002","Potosí","Potosí","Esc. Cobija",147,0,1,0,20,9,16,0,2,195,3,7,205,222,0.103,0.923
"17003","Potosí","Potosí","Esc. Cobija",108,0,1,0,46,9,14,0,2,180,3,10,193,220,0.256,0.877
"17004","Potosí","Potosí","Esc. Cobija",144,0,1,1,31,9,9,1,3,199,2,4,205,229,0.156,0.895
"17005","Potosí","Potosí","Esc. Cobija",151,0,1,1,17,10,20,3,1,204,1,7,212,227,0.083,0.934
"17006","Potosí","Potosí","Esc. Cobija",133,1,1,0,32,8,16,0,3,194,0,3,197,228,0.165,0.864
"17007","Potosí","Potosí","Esc. Cobija",162,0,2,2,18,5,11,1,0,201,2,11,214,228,0.09,0.939
"17008","Potosí","Potosí","Esc. Cobija",139,1,1,0,29,5,18,0,4,197,4,6,207,228,0.147,0.908
"17009","Potosí","Potosí","Esc. Cobija",148,1,1,1,23,7,17,1,1,200,1,8,209,223,0.115,0.937
"17010","Potosí","Potosí","Mariscal Santa Cruz",97,1,0,2,51,5,32,2,2,192,4,11,207,232,0.266,0.892
"17011","Potosí","Potosí","Mariscal Santa Cruz",146,1,1,0,26,8,14,0,1,197,4,11,212,234,0.132,0.906
"17012","Potosí","Potosí","Mariscal Santa Cruz",112,0,3,0,39,10,28,1,2,195,0,13,208,225,0.2,0.924
"17013","Potosí","Potosí","Mariscal Santa Cruz",131,0,2,2,29,6,24,0,3,197,3,13,213,231,0.147,0.922
"17014","Potosí","Potosí","Mariscal Santa Cruz",119,0,3,2,33,6,28,0,4,195,4,9,208,233,0.169,0.893
"17015","Potosí","Potosí","Mariscal Santa Cruz",118,1,3,2,38,8,26,2,2,200,2,6,208,226,0.19,0.92
"17016","Potosí","Potosí","Mariscal Santa Cruz",124,1,0,0,41,9,30,0,2,207,0,8,215,234,0.198,0.919
"17017","Potosí","Potosí","Mariscal Santa Cruz",118,1,1,3,42,12,29,1,1,208,4,9,221,233,0.202,0.948
"17018","Potosí","Potosí","Mariscal Santa Cruz",127,0,3,0,32,4,32,1,3,202,3,8,213,229,0.158,0.93
"17019","Potosí","Potosí","Mariscal Santa Cruz",134,0,1,1,30,7,21,0,0,194,3,13,210,228,0.155,0.921
"17020","Potosí","Potosí","Mariscal Santa Cruz",110,1,0,1,40,19,35,1,1,208,3,4,215,232,0.192,0.927
"17021","Potosí","Potosí","Mariscal Santa Cruz",116,0,2,1,38,8,35,1,3,204,3,9,216,235,0.186,0.919
"17022","Potosí","Potosí","Mariscal Santa Cruz",115,0,3,1,42,9,25,0,1,196,2,10,208,229,0.214,0.908
"17023","Potosí","Potosí","Mariscal Santa Cruz",109,1,2,0,31,8,40,1,6,198,8,8,214,234,0.157,0.915
"17024","Potosí","Potosí","Mariscal Santa Cruz",110,1,1,0,44,10,33,3,1,203,1,11,215,232,0.217,0.927
"17025","Potosí","Potosí","Mariscal Santa Cruz",112,2,3,1,43,6,31,0,1,199,2,9,210,231,0.216,0.909
"17026","Potosí","Potosí","Mariscal Santa Cruz",119,3,1,0,42,4,24,1,1,195,0,9,204,227,0.215,0.899
"17027","Potosí","Potosí","Mariscal Santa Cruz",115,0,1,1,32,4,33,1,3,190,6,7,203,224,0.168,0.906
"17028","Potosí","Potosí","Mariscal Santa Cruz",122,0,0,3,32,10,23,1,5,196,4,10,210,232,0.163,0.905
"17029","Potosí","Potosí","Mariscal Santa Cruz",128,0,3,2,32,11,26,1,1,204,2,14,220,233,0.157,0.944
"17030","Potosí","Potosí","Mariscal Santa Cruz",102,1,3,0,47,14,24,1,2,194,3,6,203,230,0.242,0.883
"17031","Potosí","Potosí","Mariscal Santa Cruz",122,0,1,1,32,9,24,1,0,190,6,8,204,229,0.168,0.891
"17032","Potosí","Potosí","Mariscal Santa Cruz",122,1,2,1,28,12,30,1,0,197,4,9,210,235,0.142,0.894
"17033","Potosí","Potosí","U.E. Cecilio Guzman Rojas",115,1,2,0,43,5,43,0,1,210,2,6,218,239,0.205,0.912
"17034","Potosí","Potosí","U.E. Cecilio Guzman Rojas",135,1,3,0,27,8,29,0,2,205,2,6,213,238,0.132,0.895
"17035","Potosí","Potosí","U.E. Cecilio Guzman Rojas",111,0,2,1,43,5,45,0,2,209,1,7,217,235,0.206,0.923
"17036","Potosí","Potosí","Coleg. David Berrios",124,3,1,0,39,5,29,0,5,206,3,5,214,238,0.189,0.899
"17037","Potosí","Potosí","Coleg. David Berrios",123,0,3,0,24,7,32,1,1,191,4,11,206,234,0.126,0.88
"17038","Potosí","Potosí","Coleg. David Berrios",132,0,1,0,32,4,29,1,0,199,2,9,210,234,0.161,0.897
"17039","Potosí","Potosí","Coleg. David Berrios",134,1,1,0,31,4,33,0,3,207,0,5,212,233,0.15,0.91
"17040","Potosí","Potosí","Coleg. David Berrios",132,0,0,0,34,5,18,3,1,193,1,8,202,227,0.176,0.89
"17041","Potosí","Potosí","Coleg. David Berrios",135,0,0,1,35,8,14,1,1,195,1,5,201,227,0.179,0.885
"17042","Potosí","Potosí","Coleg. David Berrios",159,0,0,0,23,7,15,0,2,206,0,4,210,228,0.112,0.921
"17043","Potosí","Potosí","Coleg. David Berrios",147,0,0,0,27,9,8,1,3,195,0,6,201,226,0.138,0.889
"17044","Potosí","Potosí","Coleg. David Berrios",150,0,1,0,26,8,11,1,1,198,1,5,204,226,0.131,0.903
"17045","Potosí","Potosí","Fe y Alegría y San Clemente",165,0,2,0,24,4,12,1,0,208,2,3,213,225,0.115,0.947
"17046","Potosí","Potosí","Fe y Alegría y San Clemente",152,0,1,0,30,4,14,1,0,202,2,3,207,233,0.149,0.888
"17047","Potosí","Potosí","Fe y Alegría y San Clemente",169,1,0,1,19,6,13,0,0,209,1,8,218,232,0.091,0.94
"17048","Potosí","Potosí","Fe y Alegría y San Clemente",152,0,5,0,32,2,14,2,1,208,1,5,214,231,0.154,0.926
"17049","Potosí","Potosí","Fe y Alegría y San Clemente",148,0,2,2,25,6,18,0,0,201,1,8,210,228,0.124,0.921
"17050","Potosí","Potosí","Fe y Alegría y San Clemente",150,0,1,0,32,2,10,0,1,196,2,8,206,229,0.163,0.9
"17051","Potosí","Potosí","Fe y Alegría y San Clemente",152,0,3,0,27,5,24,0,1,212,2,6,220,229,0.127,0.961
"17052","Potosí","Potosí","Fe y Alegría y San Clemente",162,1,2,0,26,3,10,0,0,204,0,2,206,230,0.127,0.896
"17053","Potosí","Potosí","Fe y Alegría y San Clemente",147,1,0,0,33,8,18,2,0,209,0,6,215,226,0.158,0.951
"17054","Potosí","Potosí","Fe y Alegría y San Clemente",156,0,1,1,34,6,12,0,1,211,0,2,213,234,0.161,0.91
"17055","Potosí","Potosí","Fe y Alegría y San Clemente",143,0,0,0,35,8,14,1,2,203,1,4,208,228,0.172,0.912
"17056","Potosí","Potosí","Fe y Alegría y San Clemente",157,1,1,0,23,3,24,1,0,210,1,4,215,233,0.11,0.923
"17057","Potosí","Potosí","Fe y Alegría y San Clemente",155,2,3,1,17,2,16,0,1,197,2,3,202,222,0.086,0.91
"17058","Potosí","Potosí","Fe y Alegría y San Clemente",146,0,3,0,27,6,16,1,2,201,2,7,210,227,0.134,0.925
"17059","Potosí","Potosí","Fe y Alegría y San Clemente",154,1,2,0,19,2,23,1,1,203,1,7,211,235,0.094,0.898
"17060","Potosí","Potosí","Fe y Alegría y San Clemente",181,0,1,0,15,6,5,0,0,208,1,2,211,226,0.072,0.934
"17061","Potosí","Potosí","Fe y Alegría y San Clemente",142,2,0,1,39,4,12,1,0,201,1,4,206,227,0.194,0.907
"17062","Potosí","Potosí","Fe y Alegría y San Clemente",148,0,1,0,18,8,16,1,1,193,1,8,202,227,0.093,0.89
"17063","Potosí","Potosí","Fe y Alegría y San Clemente",172,0,0,0,21,3,13,0,2,211,1,5,217,232,0.1,0.935
"17064","Potosí","Potosí","Fe y Alegría y San Clemente",147,0,1,1,23,4,21,2,1,200,2,8,210,235,0.115,0.894
"17065","Potosí","Potosí","Fe y Alegría y San Clemente",154,0,0,1,26,3,18,0,2,204,4,7,215,236,0.127,0.911
"17066","Potosí","Potosí","Fe y Alegría y San Clemente",165,0,2,1,21,8,13,0,1,211,0,6,217,238,0.1,0.912
"17067","Potosí","Potosí","Instituto I.S.E.C.",154,1,2,2,25,3,19,0,1,207,2,4,213,227,0.121,0.938
"17068","Potosí","Potosí","Instituto I.S.E.C.",175,0,2,1,20,3,7,1,0,209,0,7,216,227,0.096,0.952
"17069","Potosí","Potosí","Instituto I.S.E.C.",148,1,1,1,21,7,10,2,1,192,1,8,201,221,0.109,0.91
"17070","Potosí","Potosí","Instituto I.S.E.C.",177,0,2,2,18,1,0,0,1,201,1,3,205,226,0.09,0.907
"17071","Potosí","Potosí","Instituto I.S.E.C.",162,1,0,2,23,8,6,1,1,204,0,7,211,224,0.113,0.942
"17072","Potosí","Potosí","U.E. Elizardo Perez",147,0,1,1,48,4,13,0,0,214,3,5,222,239,0.224,0.929
"17073","Potosí","Potosí","Esc. Topater",152,1,1,1,28,5,12,1,1,202,0,4,206,225,0.139,0.916
"17074","Potosí","Potosí","Esc. Topater",146,0,0,2,25,0,17,3,0,193,0,10,203,225,0.13,0.902
"17075","Potosí","Potosí","Esc. Topater",143,0,1,0,25,9,16,1,3,198,0,6,204,225,0.126,0.907
"17076","Potosí","Potosí","Esc. Topater",156,0,1,0,27,6,16,0,1,207,0,6,213,231,0.13,0.922
"17077","Potosí","Potosí","Esc. Topater",137,0,1,0,37,12,8,1,1,197,1,7,205,230,0.188,0.891
"17078","Potosí","Potosí","Esc. Topater",139,0,0,2,29,5,19,1,2,197,1,5,203,224,0.147,0.906
"17079","Potosí","Potosí","Esc. Topater",121,0,1,1,42,13,25,0,1,204,0,5,209,225,0.206,0.929
"17080","Potosí","Potosí","Esc. Topater",156,1,1,0,22,11,8,1,1,201,2,8,211,232,0.109,0.909
"17081","Potosí","Potosí","Esc. Topater",147,0,2,1,34,5,15,0,5,209,0,3,212,229,0.163,0.926
"17082","Potosí","Potosí","Esc. Topater",152,0,1,1,29,6,9,0,1,199,1,9,209,225,0.146,0.929
"17083","Potosí","Potosí","Esc. Topater",123,0,4,1,26,6,21,4,4,189,1,10,200,225,0.138,0.889
"17084","Potosí","Potosí","Esc. Topater",140,0,1,1,30,6,14,0,1,193,0,12,205,224,0.155,0.915
"17085","Potosí","Potosí","Esc. Topater",134,3,4,2,38,5,11,0,0,197,1,4,202,226,0.193,0.894
"17086","Potosí","Potosí","Esc. Topater",129,0,2,1,32,5,20,2,2,193,0,13,206,229,0.166,0.9
"17087","Potosí","Potosí","Esc. Topater",151,0,1,0,24,9,13,0,1,199,0,5,204,228,0.121,0.895
"17088","Potosí","Potosí","Esc. Topater",146,0,1,1,32,6,12,1,1,200,3,6,209,227,0.16,0.921
"17089","Potosí","Potosí","Esc. Topater",143,1,1,0,33,6,8,1,2,195,1,4,200,225,0.169,0.889
"17090","Potosí","Potosí","Esc. Topater",153,0,0,2,29,5,17,1,2,209,0,11,220,237,0.139,0.928
"17091","Potosí","Potosí","Esc. Topater",147,0,0,1,28,4,20,2,3,205,0,5,210,236,0.137,0.89
"17092","Potosí","Potosí","Esc. Topater",149,0,1,0,23,3,20,0,1,197,1,15,213,233,0.117,0.914
"17093","Potosí","Potosí","Col. Divino Maestro",137,0,0,0,32,7,30,1,1,208,0,6,214,235,0.154,0.911
"17094","Potosí","Potosí","Col. Divino Maestro",142,0,0,1,37,7,12,1,1,201,0,10,211,229,0.184,0.921
"17095","Potosí","Potosí","Col. Divino Maestro",139,0,3,1,41,7,13,0,2,206,0,8,214,234,0.199,0.915
"17096","Potosí","Potosí","Col. Divino Maestro",143,0,2,1,23,14,16,0,3,202,4,8,214,230,0.114,0.93
"17097","Potosí","Potosí","Col. Divino Maestro",140,0,1,0,38,2,24,0,0,205,0,5,210,231,0.185,0.909
"17098","Potosí","Potosí","Col. Divino Maestro",127,0,3,1,41,6,21,1,0,200,2,3,205,231,0.205,0.887
"17099","Potosí","Potosí","Col. Divino Maestro",117,1,0,0,44,6,20,3,2,193,0,11,204,229,0.228,0.891
"17100","Potosí","Potosí","Col. Divino Maestro",135,0,2,0,43,2,18,0,0,200,2,8,210,230,0.215,0.913
"17101","Potosí","Potosí","Col. Divino Maestro",134,1,0,1,38,6,20,1,4,205,2,10,217,231,0.185,0.939
"17102","Potosí","Potosí","Col. Divino Maestro",150,0,0,4,25,8,15,1,1,204,1,2,207,229,0.123,0.904
"17103","Potosí","Potosí","Col. Divino Maestro",144,0,2,1,32,5,14,0,2,200,2,7,209,227,0.16,0.921
"17104","Potosí","Potosí","Col. Divino Maestro",137,0,0,2,48,3,16,4,1,211,3,4,218,232,0.227,0.94
"17105","Potosí","Potosí","Col. Divino Maestro",126,0,3,0,37,11,20,0,2,199,2,7,208,235,0.186,0.885
"17106","Potosí","Potosí","Col. Divino Maestro",144,0,2,0,30,5,19,2,1,203,2,8,213,227,0.148,0.938
"17107","Potosí","Potosí","Esc. 6 de Junio",92,1,1,4,54,13,20,1,3,189,8,19,216,231,0.286,0.935
"17108","Potosí","Potosí","Esc. 6 de Junio",59,1,2,2,94,7,30,0,1,196,3,20,219,230,0.48,0.952
"17109","Potosí","Potosí","Esc. 6 de Junio",78,2,4,0,67,8,22,1,0,182,5,22,209,229,0.368,0.913
"17110","Potosí","Potosí","Esc. 6 de Junio",90,1,4,2,64,9,22,1,1,194,3,20,217,229,0.33,0.948
"17111","Potosí","Potosí","Esc. 6 de Junio",62,3,3,2,69,9,27,1,3,179,8,17,204,227,0.385,0.899
"17112","Potosí","Potosí","Esc. 6 de Junio",69,1,1,1,70,8,29,1,2,182,7,27,216,230,0.385,0.939
"17113","Potosí","Potosí","Esc. 6 de Junio",61,3,3,1,73,19,26,3,0,189,9,17,215,232,0.386,0.927
"17114","Potosí","Potosí","Esc. 6 de Junio",56,1,1,1,72,16,19,0,4,170,7,32,209,229,0.424,0.913
"17115","Potosí","Potosí","Esc. 6 de Junio",80,1,0,2,53,15,25,0,4,180,5,11,196,220,0.294,0.891
"17116","Potosí","Potosí","Esc. 6 de Junio",62,0,2,1,79,18,19,2,0,183,4,15,202,230,0.432,0.878
"17117","Potosí","Potosí","Esc. Boliviano Alemán",116,0,2,0,40,11,18,1,1,189,2,19,210,228,0.212,0.921
"17118","Potosí","Potosí","Esc. Boliviano Alemán",104,2,6,3,34,9,29,2,1,190,1,12,203,227,0.179,0.894
"17119","Potosí","Potosí","Esc. Boliviano Alemán",114,0,5,1,30,11,32,1,1,195,2,7,204,225,0.154,0.907
"17120","Potosí","Potosí","Esc. Boliviano Alemán",95,1,0,2,39,9,45,1,1,193,1,9,203,233,0.202,0.871
"17121","Potosí","Potosí","Esc. Boliviano Alemán",100,0,5,0,39,17,30,0,0,191,6,12,209,233,0.204,0.897
"17122","Potosí","Potosí","Esc. Boliviano Alemán",112,2,1,0,42,7,32,0,2,198,6,12,216,233,0.212,0.927
"17123","Potosí","Potosí","Unidad Educativa Juan Pablo II",116,0,1,1,30,12,20,4,3,187,12,6,205,226,0.16,0.907
"17124","Potosí","Potosí","Unidad Educativa Juan Pablo II",119,0,3,0,31,5,22,0,4,184,5,16,205,231,0.168,0.887
"17125","Potosí","Potosí","Unidad Educativa Juan Pablo II",136,1,3,2,30,7,21,0,1,201,3,12,216,233,0.149,0.927
"17126","Potosí","Potosí","Unidad Educativa Juan Pablo II",124,1,2,1,35,9,28,0,1,201,4,12,217,236,0.174,0.919
"17127","Potosí","Potosí","Unidad Educativa Juan Pablo II",122,0,1,1,48,11,15,0,0,198,2,12,212,230,0.242,0.922
"17128","Potosí","Potosí","Unidad Educativa Juan Pablo II",112,0,1,1,58,2,28,2,0,204,0,8,212,231,0.284,0.918
"17129","Potosí","Potosí","Unidad Educativa Juan Pablo II",120,0,1,1,47,10,28,0,2,209,1,7,217,225,0.225,0.964
"17130","Potosí","Potosí","Unidad Educativa Juan Pablo II",123,1,3,1,29,9,19,1,2,188,3,16,207,230,0.154,0.9
"17131","Potosí","Potosí","Unidad Educativa Juan Pablo II",129,2,4,0,25,9,27,1,3,200,2,11,213,231,0.125,0.922
"17132","Potosí","Potosí","Unidad Educativa Juan Pablo II",110,0,1,0,42,9,34,2,1,199,4,12,215,230,0.211,0.935
"17133","Potosí","Potosí","Unidad Educativa Juan Pablo II",110,1,3,1,42,6,30,2,1,196,2,9,207,232,0.214,0.892
"17134","Potosí","Potosí","Unidad Educativa Juan Pablo II",103,1,2,2,36,12,38,1,5,200,4,8,212,227,0.18,0.934
"17135","Potosí","Potosí","Unidad Educativa Juan Pablo II",101,0,4,1,46,10,32,0,1,195,4,8,207,227,0.236,0.912
"17136","Potosí","Potosí","Unidad Educativa Juan Pablo II",114,0,0,1,31,15,27,1,3,192,2,10,204,228,0.161,0.895
"17137","Potosí","Potosí","Unidad Educativa Juan Pablo II",113,0,2,2,41,11,30,1,1,201,4,11,216,232,0.204,0.931
"17138","Potosí","Potosí","Unidad Educativa Juan Pablo II",119,0,1,1,33,15,25,0,2,196,1,9,206,227,0.168,0.907
"17139","Potosí","Potosí","Unidad Educativa Juan Pablo II",107,2,5,2,45,11,32,1,2,207,3,8,218,238,0.217,0.916
"17140","Potosí","Potosí","Unidad Educativa Juan Pablo II",102,1,2,2,48,14,25,0,3,197,4,11,212,237,0.244,0.895
"17141","Potosí","Potosí","Unidad Educativa Juan Pablo II",106,0,5,0,52,13,25,0,1,202,5,10,217,237,0.257,0.916
"17142","Potosí","Potosí","Unidad Educativa Juan Pablo II",120,2,0,2,47,8,26,0,0,205,2,7,214,235,0.229,0.911
"17143","Potosí","Potosí","Unidad Educativa Juan Pablo II",128,0,1,0,31,4,36,1,3,204,3,11,218,236,0.152,0.924
"17144","Potosí","Potosí","Unidad Educativa Juan Pablo II",101,0,2,3,53,11,29,0,3,202,5,7,214,236,0.262,0.907
"17145","Potosí","Potosí","Unidad Educativa Juan Pablo II",125,0,2,2,23,10,38,1,2,203,2,6,211,236,0.113,0.894
"17146","Potosí","Potosí","Esc. Jesus de Nazaret",99,0,2,1,59,14,32,0,1,208,2,12,222,235,0.284,0.945
"17147","Potosí","Potosí","Esc. Jesus de Nazaret",79,1,2,0,72,13,28,0,5,200,3,15,218,237,0.36,0.92
"17148","Potosí","Potosí","Esc. Jesus de Nazaret",83,0,4,1,62,11,32,3,2,198,4,16,218,236,0.313,0.924
"17149","Potosí","Potosí","Esc. Jesus de Nazaret",90,0,1,0,53,10,40,1,3,198,2,14,214,233,0.268,0.918
"17150","Potosí","Potosí","Esc. Jesus de Nazaret",104,1,3,1,41,9,24,2,3,188,3,11,202,224,0.218,0.902
"17151","Potosí","Potosí","Esc. Jesus de Nazaret",104,0,0,0,39,11,31,3,3,191,6,10,207,228,0.204,0.908
"17152","Potosí","Potosí","Esc. Jesus de Nazaret",98,0,0,0,54,8,32,0,2,194,4,12,210,232,0.278,0.905
"17153","Potosí","Potosí","Esc. Jesus de Nazaret",97,1,1,0,50,8,30,1,2,190,7,17,214,230,0.263,0.93
"17154","Potosí","Potosí","Esc. Jesus de Nazaret",100,0,2,0,55,5,29,2,1,194,5,9,208,224,0.284,0.929
"17155","Potosí","Potosí","Esc. Jesus de Nazaret",118,1,1,0,43,14,23,1,0,201,3,11,215,226,0.214,0.951
"17156","Potosí","Potosí","Esc. Jesus de Nazaret",111,2,2,2,35,5,25,3,3,188,2,12,202,222,0.186,0.91
"17157","Potosí","Potosí","Esc. Jesus de Nazaret",103,0,0,1,55,2,31,2,5,199,4,15,218,231,0.276,0.944
"17158","Potosí","Potosí","Esc. Jesus de Nazaret",88,0,2,2,50,10,38,2,3,195,6,4,205,224,0.256,0.915
"17159","Potosí","Potosí","Esc. Jesus de Nazaret",107,2,3,2,36,10,33,1,2,196,3,9,208,225,0.184,0.924
"17160","Potosí","Potosí","Esc. Karachipampa",47,3,5,5,54,10,37,3,0,164,11,19,194,220,0.329,0.882
"17161","Potosí","Potosí","Esc. Karachipampa",54,3,5,2,45,14,32,2,3,160,7,18,185,220,0.281,0.841
"17162","Potosí","Potosí","Esc. Karachipampa",47,1,4,5,46,15,38,3,2,161,8,20,189,214,0.286,0.883
"17163","Potosí","Potosí","U.E. Liceo de Señoritas Maria Gutierrez",110,1,1,1,49,7,44,0,2,215,0,11,226,240,0.228,0.942
"17164","Potosí","Potosí","U.E. Liceo de Señoritas Maria Gutierrez",91,2,2,1,56,11,53,0,0,216,1,7,224,239,0.259,0.937
"17165","Potosí","Potosí","U.E. Liceo de Señoritas Maria Gutierrez",85,1,2,1,35,3,24,0,3,154,1,4,159,168,0.227,0.946
"17166","Potosí","Potosí","Esc. Tarapaya",75,2,3,3,50,10,30,2,2,177,5,12,194,211,0.282,0.919
"17167","Potosí","Potosí","Coleg. San Rafael",83,1,8,1,47,10,26,4,8,188,7,10,205,222,0.25,0.923
"17168","Potosí","Potosí","Coleg. San Rafael",54,4,6,1,61,7,39,0,2,174,6,15,195,214,0.351,0.911
"17169","Potosí","Potosí","Coleg. San Rafael",52,3,4,1,85,8,28,2,4,187,11,10,208,222,0.455,0.937
"17170","Potosí","Potosí","Coleg. San Rafael",53,3,0,1,73,15,33,6,2,186,4,12,202,221,0.392,0.914
"17171","Potosí","Potosí","Esc. Martin Cruz",46,7,4,3,66,20,25,1,0,172,10,7,189,208,0.384,0.909
"17172","Potosí","Potosí","Esc. Martin Cruz",46,5,4,9,55,16,32,4,2,173,10,12,195,211,0.318,0.924
"17173","Potosí","Tinguipaya","U. E. Mariscal Sucre A",26,2,2,2,103,7,11,2,1,156,17,10,183,223,0.66,0.821
"17174","Potosí","Tinguipaya","U. E. Turiri",0,1,1,1,157,1,7,0,0,168,0,7,175,217,0.935,0.806
"17175","Potosí","Tinguipaya","U. E. Turiri",0,0,0,0,177,0,0,0,1,178,1,1,180,224,0.994,0.804
"17176","Potosí","Tinguipaya","U. E. Anthura",10,7,4,1,141,6,13,1,1,184,12,9,205,227,0.766,0.903
"17177","Potosí","Tinguipaya","U. E. Anthura",4,4,5,4,120,4,18,6,2,167,10,29,206,228,0.719,0.904
"17178","Potosí","Tinguipaya","U. E. Anthura",4,3,0,6,146,2,7,2,0,170,9,17,196,213,0.859,0.92
"17179","Potosí","Tinguipaya","U. E. Anthura",4,2,3,2,134,4,14,1,0,164,8,19,191,212,0.817,0.901
"17180","Potosí","Tinguipaya","U. E. Foroctiri Junin",0,0,2,2,139,2,8,2,0,155,13,5,173,211,0.897,0.82
"17181","Potosí","Tinguipaya","U. E. Foroctiri Junin",6,1,2,1,134,5,8,1,7,165,2,8,175,230,0.812,0.761
"17182","Potosí","Tinguipaya","U. E. Calazaya",0,1,0,1,180,2,0,0,0,184,1,2,187,216,0.978,0.866
"17183","Potosí","Tinguipaya","U.E. Ithinocka",6,2,1,0,145,1,4,0,0,159,7,5,171,216,0.912,0.792
"17184","Potosí","Tinguipaya","U.E. Machac Marca",41,3,5,4,51,11,44,3,0,162,17,37,216,237,0.315,0.911
"17185","Potosí","Tinguipaya","U.E. Cienegoma",11,4,12,5,142,4,8,1,0,187,21,24,232,235,0.759,0.987
"17186","Potosí","Yocalla","Esc. Alonso De Ibanez",106,0,3,2,58,13,3,0,1,186,3,9,198,216,0.312,0.917
"17187","Potosí","Yocalla","Esc. Jose Antonio Zampa",43,0,1,5,86,5,28,0,0,168,5,13,186,205,0.512,0.907
"17188","Potosí","Yocalla","Esc. Jose Antonio Zampa",34,4,5,1,62,21,43,1,1,172,9,9,190,210,0.36,0.905
"17189","Potosí","Yocalla","Esc. Eduardo Avaroa",29,3,2,2,86,4,25,3,3,157,11,5,173,208,0.548,0.832
"17190","Potosí","Yocalla","Esc. Eduardo Avaroa",28,1,3,1,86,7,26,1,4,157,9,11,177,215,0.548,0.823
"17191","Potosí","Yocalla","Esc. Eduardo Avaroa",42,1,3,1,77,6,26,1,2,159,11,18,188,213,0.484,0.883
"17192","Potosí","Yocalla","Esc. Juan XXIII",3,3,6,0,140,3,25,1,1,182,1,4,187,212,0.769,0.882
"17193","Potosí","Yocalla","Esc. Juan XXIII",3,1,8,1,136,8,11,0,0,168,0,1,169,193,0.81,0.876
"17194","Potosí","Yocalla","Esc. Santa Lucia",106,2,1,2,24,5,9,1,1,151,2,9,162,196,0.159,0.827
"17195","Potosí","Yocalla","Esc. Cayara",37,8,5,2,71,9,29,2,2,165,16,8,189,219,0.43,0.863
"17196","Potosí","Yocalla","Esc. Cayara",55,0,6,3,68,4,30,0,2,168,10,10,188,212,0.405,0.887
"17197","Potosí","Yocalla","Esc. Chiracoro",27,0,6,0,106,5,35,1,1,181,3,10,194,220,0.586,0.882
"17198","Potosí","Yocalla","Coleg. Elizardo Perez",24,2,4,0,115,9,20,0,3,177,6,3,186,216,0.65,0.861
"17199","Potosí","Yocalla","Esc. San Antonio",109,1,6,1,32,8,19,1,5,182,5,8,195,228,0.176,0.855
"17200","Potosí","Yocalla","Esc. San Antonio",92,0,3,4,46,12,18,0,4,179,5,12,196,222,0.257,0.883
"17201","Potosí","Yocalla","U.E. San Agustin de La Palca",71,3,5,2,59,23,26,1,2,192,2,12,206,207,0.307,0.995
"17202","Potosí","Urmiri","Esc. Juan Jose Perez",3,0,4,0,124,2,39,1,1,174,7,6,187,218,0.713,0.858
"17203","Potosí","Urmiri","Esc. Secc. Vacuyo",11,1,14,3,65,3,52,4,1,154,7,7,168,184,0.422,0.913
"17204","Potosí","Uncía","Coleg. Rafael Bustillo",31,0,1,2,93,5,31,0,0,163,10,10,183,209,0.571,0.876
"17205","Potosí","Uncía","Coleg. Rafael Bustillo",77,0,3,0,78,6,12,0,3,179,9,4,192,223,0.436,0.861
"17206","Potosí","Uncía","Coleg. Rafael Bustillo",40,0,0,3,103,4,17,1,0,168,7,20,195,225,0.613,0.867
"17207","Potosí","Uncía","Coleg. Rafael Bustillo",39,1,3,0,115,5,17,0,0,180,2,10,192,216,0.639,0.889
"17208","Potosí","Uncía","Coleg. Rafael Bustillo",39,1,2,2,120,6,15,0,0,185,4,11,200,223,0.649,0.897
"17209","Potosí","Uncía","Coleg. Rafael Bustillo",32,2,2,0,119,5,19,0,1,180,9,9,198,219,0.661,0.904
"17210","Potosí","Uncía","Coleg. Rafael Bustillo",61,1,0,0,81,5,26,1,1,176,6,13,195,216,0.46,0.903
"17211","Potosí","Uncía","Coleg. Rafael Bustillo",34,1,0,1,95,9,29,0,1,170,7,15,192,214,0.559,0.897
"17212","Potosí","Uncía","Coleg. Rafael Bustillo",46,0,2,0,90,6,29,2,0,175,8,8,191,222,0.514,0.86
"17213","Potosí","Uncía","Coleg. Rafael Bustillo",46,0,5,1,110,6,21,0,5,194,2,12,208,225,0.567,0.924
"17214","Potosí","Uncía","Coleg. Rafael Bustillo",46,2,1,1,99,7,19,1,1,177,4,12,193,235,0.559,0.821
"17215","Potosí","Uncía","Coleg. Rafael Bustillo",45,0,2,2,93,5,28,1,2,178,6,8,192,235,0.522,0.817
"17216","Potosí","Uncía","Coleg. Rafael Bustillo",40,1,1,2,77,8,27,0,0,156,1,7,164,191,0.494,0.859
"17217","Potosí","Uncía","Col. Intermedio Independencia",64,0,4,1,66,6,28,2,0,171,3,28,202,217,0.386,0.931
"17218","Potosí","Uncía","Col. Intermedio Independencia",58,1,0,0,93,2,33,0,0,187,5,16,208,225,0.497,0.924
"17219","Potosí","Uncía","Col. Intermedio Independencia",43,1,2,2,78,7,40,0,0,173,8,20,201,226,0.451,0.889
"17220","Potosí","Uncía","Col. Intermedio Independencia",59,1,2,0,78,5,23,0,2,170,10,15,195,218,0.459,0.894
"17221","Potosí","Uncía","Col. Intermedio Independencia",46,3,2,1,96,11,22,0,1,182,8,17,207,225,0.527,0.92
"17222","Potosí","Uncía","Col. Intermedio Independencia",74,0,0,1,78,6,25,1,2,187,4,11,202,226,0.417,0.894
"17223","Potosí","Uncía","Col. Intermedio Independencia",70,3,1,1,78,4,29,0,3,189,8,12,209,225,0.413,0.929
"17224","Potosí","Uncía","Col. Intermedio Independencia",40,0,3,0,98,7,28,1,0,177,7,16,200,226,0.554,0.885
"17225","Potosí","Uncía","Col. Intermedio Independencia",59,1,11,1,71,7,26,0,0,176,11,16,203,228,0.403,0.89
"17226","Potosí","Uncía","Col. Intermedio Independencia",85,1,2,1,58,4,26,2,0,179,6,9,194,215,0.324,0.902
"17227","Potosí","Uncía","Esc. Modesto Omiste",95,0,4,1,73,4,11,0,1,189,3,6,198,218,0.386,0.908
"17228","Potosí","Uncía","Esc. Modesto Omiste",64,2,3,3,79,4,18,0,3,176,9,8,193,221,0.449,0.873
"17229","Potosí","Uncía","Esc. Modesto Omiste",91,1,2,2,64,3,18,1,2,184,1,9,194,222,0.348,0.874
"17230","Potosí","Uncía","Esc. Modesto Omiste",82,4,3,0,68,7,16,0,2,182,5,7,194,221,0.374,0.878
"17231","Potosí","Uncía","Esc. Modesto Omiste",76,2,1,0,70,5,19,1,1,175,6,17,198,225,0.4,0.88
"17232","Potosí","Uncía","Esc. Juana Azurduy De Padilla",18,0,0,1,125,1,34,0,0,179,11,11,201,234,0.698,0.859
"17233","Potosí","Uncía","Esc. Juana Azurduy De Padilla",21,0,1,0,121,7,32,0,0,182,10,11,203,236,0.665,0.86
"17234","Potosí","Uncía","Esc. Juana Azurduy De Padilla",15,1,2,0,128,2,31,1,4,184,7,11,202,237,0.696,0.852
"17235","Potosí","Uncía","Esc. Juana Azurduy De Padilla",30,4,5,1,114,7,29,0,2,192,4,9,205,230,0.594,0.891
"17236","Potosí","Uncía","Esc. Juana Azurduy De Padilla",46,0,2,0,86,5,31,0,1,171,10,4,185,213,0.503,0.869
"17237","Potosí","Uncía","Esc. Juana Azurduy De Padilla",44,1,3,0,89,4,22,1,0,164,2,13,179,214,0.543,0.836
"17238","Potosí","Uncía","Esc. Juana Azurduy De Padilla",42,3,5,1,99,3,22,1,3,179,9,12,200,221,0.553,0.905
"17239","Potosí","Uncía","Esc. Juana Azurduy De Padilla",40,0,8,0,114,2,18,2,2,186,5,6,197,219,0.613,0.9
"17240","Potosí","Uncía","Esc. Juana Azurduy De Padilla",39,2,3,2,103,6,23,0,1,179,4,9,192,223,0.575,0.861
"17241","Potosí","Uncía","Esc. Juana Azurduy De Padilla",27,1,1,0,112,2,36,1,1,181,7,7,195,222,0.619,0.878
"17242","Potosí","Uncía","Esc. Juana Azurduy De Padilla",68,0,3,1,83,3,22,0,0,180,4,9,193,218,0.461,0.885
"17243","Potosí","Uncía","Nucleo Escolar Cala Cala",3,0,0,1,163,5,11,0,0,183,2,8,193,209,0.891,0.923
"17244","Potosí","Uncía","Nucleo Escolar Cala Cala",4,1,0,3,137,3,8,4,0,160,9,17,186,212,0.856,0.877
"17245","Potosí","Uncía","Nucleo Escolar Cala Cala",7,2,3,1,143,2,19,0,0,177,3,10,190,217,0.808,0.876
"17246","Potosí","Uncía","Nucleo Escolar Cala Cala",13,1,2,0,125,2,10,1,1,155,6,18,179,216,0.806,0.829
"17247","Potosí","Uncía","Nucleo Escolar Cala Cala",2,1,2,0,156,1,16,1,1,180,3,9,192,217,0.867,0.885
"17248","Potosí","Uncía","Esc. Morocomarca",6,1,2,1,135,2,3,1,0,151,19,14,184,212,0.894,0.868
"17249","Potosí","Uncía","Chilca Palca",4,1,0,2,148,2,7,0,0,164,14,14,192,219,0.902,0.877
"17250","Potosí","Uncía","Chilca Palca",5,0,0,2,147,1,4,0,0,159,16,14,189,221,0.925,0.855
"17251","Potosí","Uncía","Esc. Subcentral Lagunillas",8,2,1,3,171,3,5,0,0,193,12,9,214,222,0.886,0.964
"17252","Potosí","Uncía","Esc. Subcentral Lagunillas",7,2,4,3,140,1,4,0,0,161,11,3,175,190,0.87,0.921
"17253","Potosí","Chayanta","U. E. Quila Quila",16,0,5,3,124,4,10,0,0,162,12,9,183,205,0.765,0.893
"17254","Potosí","Chayanta","U. E. Mariscal Andres De Santa Cruz B",42,0,4,1,122,4,12,0,1,186,7,4,197,219,0.656,0.9
"17255","Potosí","Chayanta","U. E. Mariscal Andres De Santa Cruz B",23,4,1,2,138,7,13,1,1,190,7,13,210,222,0.726,0.946
"17256","Potosí","Chayanta","U. E. Mariscal Andres De Santa Cruz B",22,2,1,1,128,1,19,1,0,175,9,14,198,213,0.731,0.93
"17257","Potosí","Chayanta","U. E. Mariscal Andres De Santa Cruz B",31,0,3,2,108,12,18,1,3,178,9,3,190,213,0.607,0.892
"17258","Potosí","Chayanta","U. E. Mariscal Andres De Santa Cruz B",31,0,2,3,116,5,17,0,4,178,10,15,203,221,0.652,0.919
"17259","Potosí","Chayanta","U. E. Mariscal Andres De Santa Cruz B",29,1,3,0,115,9,24,0,0,181,9,14,204,219,0.635,0.932
"17260","Potosí","Chayanta","U. E. Mariscal Andres De Santa Cruz B",40,0,2,1,109,5,22,1,1,181,8,19,208,227,0.602,0.916
"17261","Potosí","Chayanta","U. E. Mariscal Andres De Santa Cruz B",30,3,2,0,116,4,20,2,3,180,10,8,198,221,0.644,0.896
"17262","Potosí","Chayanta","U. E. Mariscal Andres De Santa Cruz B",31,3,7,0,104,4,32,0,1,182,13,15,210,222,0.571,0.946
"17263","Potosí","Chayanta","U. E. San Cristobal",12,1,9,2,134,3,3,1,0,165,12,15,192,218,0.812,0.881
"17264","Potosí","Chayanta","U. E. Rafael Pabón",18,1,3,3,126,3,14,1,0,169,14,15,198,214,0.746,0.925
"17265","Potosí","Chayanta","U. E. Rafael Pabón",25,2,1,2,114,6,21,0,2,173,8,17,198,218,0.659,0.908
"17266","Potosí","Chayanta","U. E. Rafael Pabón",27,1,1,3,97,5,19,0,1,154,8,12,174,185,0.63,0.941
"17267","Potosí","Chayanta","U. E. Octavio Murillo",20,1,2,1,152,2,22,0,1,201,7,10,218,227,0.756,0.96
"17268","Potosí","Chayanta","U. E. Octavio Murillo",20,0,0,3,152,2,28,0,0,205,7,6,218,226,0.741,0.965
"17269","Potosí","Chayanta","U. E. Octavio Murillo",21,0,0,0,153,4,15,0,0,193,7,10,210,219,0.793,0.959
"17270","Potosí","Chayanta","U. E. Octavio Murillo",20,1,2,1,143,1,24,0,3,195,8,19,222,230,0.733,0.965
"17271","Potosí","Chayanta","U. E. Julian Apaza",7,1,1,1,144,3,20,0,0,177,11,12,200,219,0.814,0.913
"17272","Potosí","Chayanta","U. E. Cnl. Ramon Acero",6,2,1,1,152,4,5,0,0,171,5,9,185,220,0.889,0.841
"17273","Potosí","Chayanta","U. E. Rafael Bustillos",3,3,3,1,140,1,9,1,0,161,15,17,193,219,0.87,0.881
"17274","Potosí","Chayanta","U. E. Rafael Bustillos",3,2,2,1,150,1,6,3,0,168,17,11,196,221,0.893,0.887
"17275","Potosí","Chayanta","U. E. Rafael Bustillos",3,0,0,1,176,0,4,0,1,185,7,9,201,220,0.951,0.914
"17276","Potosí","Chayanta","U. E. Rafael Bustillos",5,1,3,10,131,4,5,3,0,162,11,14,187,213,0.809,0.878
"17277","Potosí","Chayanta","U. E. Gualberto Villarroel",1,2,3,5,139,0,18,1,0,169,5,19,193,217,0.822,0.889
"17278","Potosí","Chayanta","U. E. Max Fernandez Rojas",0,0,4,0,172,0,12,1,0,189,0,13,202,222,0.91,0.91
"17279","Potosí","Chayanta","U. E. Max Fernandez Rojas",6,0,1,1,146,1,10,1,0,166,4,1,171,187,0.88,0.914
"17280","Potosí","Chayanta","U. E. Copana",3,2,3,3,168,0,6,1,0,186,9,8,203,212,0.903,0.958
"17281","Potosí","Chayanta","U. E. Copana",2,4,0,1,142,1,2,1,0,153,11,11,175,180,0.928,0.972
"17282","Potosí","Chayanta","U. E. Tomas Katari",7,2,5,2,120,5,18,1,1,161,10,26,197,211,0.745,0.934
"17283","Potosí","Llallagua","Esc. Jaime Mendoza",87,2,2,1,70,4,14,0,1,181,5,12,198,220,0.387,0.9
"17284","Potosí","Llallagua","Esc. Jaime Mendoza",86,1,1,0,74,3,16,0,5,186,5,10,201,223,0.398,0.901
"17285","Potosí","Llallagua","Esc. Jaime Mendoza",84,0,2,1,69,4,17,0,4,181,5,11,197,217,0.381,0.908
"17286","Potosí","Llallagua","Esc. Jaime Mendoza",64,0,6,0,83,5,18,1,2,179,4,22,205,221,0.464,0.928
"17287","Potosí","Llallagua","Esc. Jaime Mendoza",69,1,6,2,76,8,26,0,0,188,4,16,208,224,0.404,0.929
"17288","Potosí","Llallagua","Esc. Jaime Mendoza",84,0,3,0,78,5,21,1,0,192,2,3,197,211,0.406,0.934
"17289","Potosí","Llallagua","Esc. Jaime Mendoza",97,0,2,0,75,7,14,0,1,196,6,3,205,222,0.383,0.923
"17290","Potosí","Llallagua","Esc. Jaime Mendoza",72,1,5,1,96,3,15,0,0,193,6,12,211,226,0.497,0.934
"17291","Potosí","Llallagua","Esc. Jaime Mendoza",72,0,3,0,81,1,22,0,0,179,4,6,189,216,0.453,0.875
"17292","Potosí","Llallagua","Esc. Jaime Mendoza",68,1,0,0,99,4,17,0,3,192,4,6,202,218,0.516,0.927
"17293","Potosí","Llallagua","Esc. Jaime Mendoza",68,1,2,1,76,2,33,1,2,186,4,8,198,220,0.409,0.9
"17294","Potosí","Llallagua","Esc. Jaime Mendoza",74,0,6,0,91,3,16,0,3,193,5,7,205,224,0.472,0.915
"17295","Potosí","Llallagua","Esc. Jaime Mendoza",101,0,2,3,71,4,18,1,0,200,4,6,210,225,0.355,0.933
"17296","Potosí","Llallagua","Esc. Jaime Mendoza",92,2,1,4,68,7,14,0,1,189,4,5,198,222,0.36,0.892
"17297","Potosí","Llallagua","Esc. Jaime Mendoza",69,0,2,0,79,3,25,1,1,180,7,16,203,217,0.439,0.935
"17298","Potosí","Llallagua","Esc. Jaime Mendoza",73,0,1,1,68,3,25,0,0,171,3,10,184,205,0.398,0.898
"17299","Potosí","Llallagua","Martin Cardenas",14,3,5,0,122,5,27,0,1,177,8,16,201,222,0.689,0.905
"17300","Potosí","Llallagua","Martin Cardenas",20,0,2,0,117,3,32,1,1,176,4,21,201,216,0.665,0.931
"17301","Potosí","Llallagua","Martin Cardenas",35,2,2,2,124,2,30,0,1,198,7,10,215,228,0.626,0.943
"17302","Potosí","Llallagua","Martin Cardenas",25,2,1,1,109,3,34,2,1,178,9,18,205,229,0.612,0.895
"17303","Potosí","Llallagua","Martin Cardenas",28,1,5,0,99,8,45,0,0,186,11,15,212,228,0.532,0.93
"17304","Potosí","Llallagua","Martin Cardenas",19,0,2,2,132,2,34,1,2,194,4,14,212,228,0.68,0.93
"17305","Potosí","Llallagua","Martin Cardenas",32,1,3,0,107,3,37,0,1,184,5,15,204,226,0.582,0.903
"17306","Potosí","Llallagua","Martin Cardenas",39,1,2,0,96,6,42,2,2,190,4,20,214,227,0.505,0.943
"17307","Potosí","Llallagua","Martin Cardenas",21,1,0,0,118,5,38,0,1,184,9,19,212,225,0.641,0.942
"17308","Potosí","Llallagua","Martin Cardenas",27,5,8,0,107,4,32,0,2,185,7,12,204,222,0.578,0.919
"17309","Potosí","Llallagua","Martin Cardenas",15,0,2,0,126,4,47,1,3,198,8,10,216,231,0.636,0.935
"17310","Potosí","Llallagua","Martin Cardenas",31,1,0,2,103,5,43,3,2,190,5,7,202,217,0.542,0.931
"17311","Potosí","Llallagua","Martin Cardenas",32,0,3,0,109,1,25,2,1,173,13,15,201,225,0.63,0.893
"17312","Potosí","Llallagua","Martin Cardenas",26,1,4,0,108,1,36,2,0,178,14,9,201,225,0.607,0.893
"17313","Potosí","Llallagua","Martin Cardenas",44,1,1,1,105,7,22,1,2,184,15,13,212,231,0.571,0.918
"17314","Potosí","Llallagua","Martin Cardenas",23,2,8,0,128,3,29,1,0,194,3,12,209,227,0.66,0.921
"17315","Potosí","Llallagua","Martin Cardenas",31,1,0,2,119,3,30,1,0,187,2,8,197,218,0.636,0.904
"17316","Potosí","Llallagua","Col. 1ro. De Mayo",55,1,2,0,108,1,19,0,0,186,3,10,199,224,0.581,0.888
"17317","Potosí","Llallagua","Col. 1ro. De Mayo",75,1,0,2,90,4,22,0,2,196,2,4,202,223,0.459,0.906
"17318","Potosí","Llallagua","Col. 1ro. De Mayo",58,0,2,1,107,5,24,1,1,199,2,10,211,229,0.538,0.921
"17319","Potosí","Llallagua","Col. 1ro. De Mayo",49,1,3,0,84,6,40,1,2,186,5,17,208,228,0.452,0.912
"17320","Potosí","Llallagua","Col. 1ro. De Mayo",45,0,2,2,90,5,33,1,1,179,7,19,205,227,0.503,0.903
"17321","Potosí","Llallagua","Col. 1ro. De Mayo",31,2,0,0,113,2,42,1,2,193,7,9,209,228,0.585,0.917
"17322","Potosí","Llallagua","Col. 1ro. De Mayo",63,1,3,0,91,1,26,1,0,186,6,11,203,220,0.489,0.923
"17323","Potosí","Llallagua","Col. 1ro. De Mayo",102,0,1,0,72,7,24,0,1,207,2,5,214,227,0.348,0.943
"17324","Potosí","Llallagua","Col. 1ro. De Mayo",72,1,1,0,87,1,18,1,2,183,1,11,195,221,0.475,0.882
"17325","Potosí","Llallagua","Col. 1ro. De Mayo",48,0,5,0,122,1,18,1,0,195,3,17,215,229,0.626,0.939
"17326","Potosí","Llallagua","Col. 1ro. De Mayo",65,1,2,1,67,2,24,1,2,165,5,36,206,225,0.406,0.916
"17327","Potosí","Llallagua","Col. 1ro. De Mayo",54,2,5,0,95,2,34,1,1,194,2,10,206,220,0.49,0.936
"17328","Potosí","Llallagua","Col. 1ro. De Mayo",60,0,3,1,103,0,23,0,1,191,6,16,213,227,0.539,0.938
"17329","Potosí","Llallagua","Col. 1ro. De Mayo",67,0,3,0,82,5,34,2,6,199,4,6,209,227,0.412,0.921
"17330","Potosí","Llallagua","Col. 1ro. De Mayo",78,0,3,3,89,3,20,0,0,196,3,8,207,218,0.454,0.95
"17331","Potosí","Llallagua","Col. 1ro. De Mayo",62,0,1,0,89,4,27,1,3,187,2,16,205,228,0.476,0.899
"17332","Potosí","Llallagua","Col. 1ro. De Mayo",78,0,4,0,68,4,25,1,3,183,6,17,206,221,0.372,0.932
"17333","Potosí","Llallagua","Col. 1ro. De Mayo",58,0,3,0,103,2,27,1,1,195,1,15,211,228,0.528,0.925
"17334","Potosí","Llallagua","Col. 1ro. De Mayo",67,1,1,1,91,2,28,0,0,191,3,14,208,229,0.476,0.908
"17335","Potosí","Llallagua","Col. 1ro. De Mayo",64,1,0,1,66,1,27,0,2,162,4,10,176,191,0.407,0.921
"17336","Potosí","Llallagua","Coleg. Junin",59,0,1,0,110,7,21,0,2,200,3,8,211,231,0.55,0.913
"17337","Potosí","Llallagua","Coleg. Junin",46,0,2,1,116,1,21,0,0,187,3,15,205,220,0.62,0.932
"17338","Potosí","Llallagua","Coleg. Junin",30,3,2,0,102,5,37,0,1,180,10,17,207,225,0.567,0.92
"17339","Potosí","Llallagua","Coleg. Junin",28,1,3,0,119,9,27,1,0,188,8,11,207,228,0.633,0.908
"17340","Potosí","Llallagua","Coleg. Junin",67,0,0,2,95,8,17,1,1,191,1,12,204,226,0.497,0.903
"17341","Potosí","Llallagua","Coleg. Junin",58,0,2,0,107,4,20,0,2,193,3,9,205,222,0.554,0.923
"17342","Potosí","Llallagua","Coleg. Junin",38,1,4,1,112,8,20,0,0,184,11,12,207,223,0.609,0.928
"17343","Potosí","Llallagua","Coleg. Junin",48,1,0,0,109,5,26,1,2,192,4,9,205,220,0.568,0.932
"17344","Potosí","Llallagua","Coleg. Junin",58,0,3,2,102,5,28,0,1,199,3,12,214,230,0.513,0.93
"17345","Potosí","Llallagua","Coleg. Junin",49,1,2,1,108,2,25,0,5,193,3,11,207,226,0.56,0.916
"17346","Potosí","Llallagua","Coleg. Junin",61,1,1,0,105,4,23,0,0,195,4,13,212,224,0.538,0.946
"17347","Potosí","Llallagua","Coleg. Junin",53,0,1,0,117,5,26,0,1,203,5,6,214,225,0.576,0.951
"17348","Potosí","Llallagua","Coleg. Siglo XX-America",68,0,0,0,86,5,19,0,3,181,5,13,199,223,0.475,0.892
"17349","Potosí","Llallagua","Coleg. Siglo XX-America",60,1,4,0,94,5,28,0,1,193,2,10,205,223,0.487,0.919
"17350","Potosí","Llallagua","Coleg. Siglo XX-America",60,1,4,1,83,4,30,0,0,183,13,14,210,232,0.454,0.905
"17351","Potosí","Llallagua","Coleg. Siglo XX-America",44,3,6,1,96,3,34,0,3,190,5,13,208,225,0.505,0.924
"17352","Potosí","Llallagua","Coleg. Siglo XX-America",56,0,3,2,99,4,26,1,2,193,3,11,207,225,0.513,0.92
"17353","Potosí","Llallagua","Coleg. Siglo XX-America",57,0,2,1,102,5,32,0,3,202,3,9,214,223,0.505,0.96
"17354","Potosí","Llallagua","Coleg. Siglo XX-America",75,0,1,0,81,5,20,2,2,186,6,12,204,224,0.435,0.911
"17355","Potosí","Llallagua","Coleg. Siglo XX-America",81,0,1,0,91,3,17,0,1,194,1,11,206,226,0.469,0.912
"17356","Potosí","Llallagua","Coleg. Siglo XX-America",43,0,2,1,104,7,28,0,0,185,0,21,206,233,0.562,0.884
"17357","Potosí","Llallagua","Coleg. Siglo XX-America",61,2,7,0,87,13,21,1,0,192,4,5,201,221,0.453,0.91
"17358","Potosí","Llallagua","Coleg. Siglo XX-America",58,2,6,1,74,8,28,3,1,181,3,16,200,223,0.409,0.897
"17359","Potosí","Llallagua","Coleg. Siglo XX-America",61,3,1,2,87,3,24,1,1,183,5,12,200,226,0.475,0.885
"17360","Potosí","Llallagua","Coleg. Siglo XX-America",47,1,2,1,113,8,25,0,2,199,1,9,209,227,0.568,0.921
"17361","Potosí","Llallagua","Coleg. Siglo XX-America",82,0,1,1,80,3,25,0,0,192,1,12,205,225,0.417,0.911
"17362","Potosí","Llallagua","Coleg. Siglo XX-America",74,1,2,2,84,10,19,0,0,192,1,10,203,228,0.438,0.89
"17363","Potosí","Llallagua","Coleg. Siglo XX-America",70,0,3,0,85,5,21,1,2,187,0,18,205,225,0.455,0.911
"17364","Potosí","Llallagua","Coleg. Siglo XX-America",76,1,2,1,86,4,23,0,0,193,5,4,202,227,0.446,0.89
"17365","Potosí","Llallagua","Coleg. Siglo XX-America",72,1,3,0,83,3,21,0,0,183,6,9,198,224,0.454,0.884
"17366","Potosí","Llallagua","Esc. Carlos Medinaceli",61,0,2,1,91,2,26,0,1,184,6,12,202,218,0.495,0.927
"17367","Potosí","Llallagua","Esc. Carlos Medinaceli",58,0,5,0,106,2,21,0,5,197,4,8,209,227,0.538,0.921
"17368","Potosí","Llallagua","Esc. Carlos Medinaceli",50,2,2,3,90,4,35,0,1,187,3,9,199,218,0.481,0.913
"17369","Potosí","Llallagua","Esc. Carlos Medinaceli",68,0,7,1,82,3,31,1,1,194,4,10,208,222,0.423,0.937
"17370","Potosí","Llallagua","Esc. Carlos Medinaceli",66,2,3,0,72,8,30,0,2,183,5,10,198,218,0.393,0.908
"17371","Potosí","Llallagua","Esc. Carlos Medinaceli",61,0,6,0,92,1,24,0,2,186,6,15,207,223,0.495,0.928
"17372","Potosí","Llallagua","Esc. Carlos Medinaceli",54,1,2,1,86,6,31,2,2,185,9,9,203,215,0.465,0.944
"17373","Potosí","Llallagua","Esc. Carlos Medinaceli",60,1,3,0,88,21,24,1,2,200,5,14,219,223,0.44,0.982
"17374","Potosí","Llallagua","Esc. Carlos Medinaceli",62,0,6,1,80,4,27,0,0,180,3,17,200,219,0.444,0.913
"17375","Potosí","Llallagua","Esc. Carlos Medinaceli",65,2,3,0,95,5,20,0,1,191,5,10,206,218,0.497,0.945
"17376","Potosí","Llallagua","Esc. Carlos Medinaceli",55,1,4,2,82,4,18,1,0,167,3,14,184,200,0.491,0.92
"17377","Potosí","Llallagua","Esc. 6 de Junio",61,1,3,0,83,2,32,0,1,183,3,9,195,221,0.454,0.882
"17378","Potosí","Llallagua","Esc. 6 de Junio",52,1,5,1,92,8,29,0,3,191,10,7,208,221,0.482,0.941
"17379","Potosí","Llallagua","Esc. 6 de Junio",38,2,3,0,92,6,32,1,3,177,6,18,201,213,0.52,0.944
"17380","Potosí","Llallagua","Esc. 6 de Junio",54,1,3,2,98,4,20,0,0,182,4,16,202,224,0.538,0.902
"17381","Potosí","Llallagua","Esc. 6 de Junio",54,1,2,2,85,3,25,1,3,176,8,9,193,220,0.483,0.877
"17382","Potosí","Llallagua","Esc. 6 de Junio",54,0,6,0,89,5,22,2,0,178,8,7,193,218,0.5,0.885
"17383","Potosí","Llallagua","Esc. 6 de Junio",64,1,2,3,81,4,23,1,2,181,5,9,195,221,0.448,0.882
"17384","Potosí","Llallagua","Humanistico Llallagua",63,0,1,1,97,5,20,0,0,187,8,8,203,225,0.519,0.902
"17385","Potosí","Llallagua","Humanistico Llallagua",56,0,2,1,87,6,34,0,5,191,7,8,206,223,0.455,0.924
"17386","Potosí","Llallagua","Humanistico Llallagua",56,0,5,0,82,5,28,0,3,179,8,12,199,221,0.458,0.9
"17387","Potosí","Llallagua","Humanistico Llallagua",59,0,2,0,100,4,28,0,1,194,3,9,206,226,0.515,0.912
"17388","Potosí","Llallagua","Humanistico Llallagua",65,4,3,1,75,6,30,1,1,186,4,10,200,223,0.403,0.897
"17389","Potosí","Llallagua","Humanistico Llallagua",75,1,2,0,75,3,28,0,0,184,4,7,195,223,0.408,0.874
"17390","Potosí","Llallagua","Humanistico Llallagua",53,1,7,1,85,4,29,1,0,181,2,16,199,221,0.47,0.9
"17391","Potosí","Llallagua","Humanistico Llallagua",54,1,2,2,80,2,22,2,4,169,5,22,196,219,0.473,0.895
"17392","Potosí","Llallagua","Humanistico Llallagua",64,3,3,0,81,5,26,0,3,185,3,5,193,218,0.438,0.885
"17393","Potosí","Llallagua","Humanistico Llallagua",61,2,7,0,88,2,30,1,1,192,6,11,209,234,0.458,0.893
"17394","Potosí","Llallagua","Humanistico Llallagua",54,1,1,0,93,4,21,0,4,178,5,10,193,222,0.522,0.869
"17395","Potosí","Llallagua","Humanistico Llallagua",62,1,6,0,98,3,22,1,0,193,2,11,206,226,0.508,0.912
"17396","Potosí","Llallagua","Humanistico Llallagua",67,0,3,0,84,2,16,3,1,176,2,16,194,216,0.477,0.898
"17397","Potosí","Llallagua","Humanistico Llallagua",50,2,0,3,85,7,20,1,2,170,1,13,184,209,0.5,0.88
"17398","Potosí","Llallagua","Esc. Bartolina Sisa",3,3,2,0,135,4,22,0,0,169,7,22,198,214,0.799,0.925
"17399","Potosí","Llallagua","Esc. Bartolina Sisa",6,1,0,0,172,0,10,0,1,190,8,9,207,213,0.905,0.972
"17400","Potosí","Llallagua","Esc. Capunita",9,3,5,1,149,5,5,2,1,180,2,9,191,206,0.828,0.927
"17401","Potosí","Llallagua","Esc. Uyuni",1,0,1,1,162,4,13,1,0,183,0,21,204,226,0.885,0.903
"17402","Potosí","Llallagua","Esc. Chiru Chiru",0,2,5,2,183,1,4,0,0,197,15,10,222,232,0.929,0.957
"17403","Potosí","Llallagua","Nucleo Jisk'anqui",14,1,4,1,136,3,13,2,1,175,23,13,211,223,0.777,0.946
"17404","Potosí","Chuquihuta Ayllu Jucumani","Col. Pablo Zarate Villca",4,5,1,1,139,5,22,1,1,179,18,11,208,230,0.777,0.904
"17405","Potosí","Chuquihuta Ayllu Jucumani","Col. Pablo Zarate Villca",10,2,1,2,140,1,17,1,1,175,9,9,193,223,0.8,0.865
"17406","Potosí","Chuquihuta Ayllu Jucumani","Col. Pablo Zarate Villca",10,0,0,1,141,0,15,0,1,168,14,14,196,220,0.839,0.891
"17407","Potosí","Chuquihuta Ayllu Jucumani","Col. Pablo Zarate Villca",7,6,3,3,131,8,12,3,2,175,11,11,197,224,0.749,0.879
"17408","Potosí","Chuquihuta Ayllu Jucumani","Col. Pablo Zarate Villca",10,2,2,2,137,10,28,1,0,192,9,14,215,230,0.714,0.935
"17409","Potosí","Chuquihuta Ayllu Jucumani","Col. Pablo Zarate Villca",29,0,4,0,126,5,13,0,0,177,11,9,197,222,0.712,0.887
"17410","Potosí","Chuquihuta Ayllu Jucumani","Col. Pablo Zarate Villca",12,2,3,3,132,5,12,1,1,171,14,11,196,219,0.772,0.895
"17411","Potosí","Chuquihuta Ayllu Jucumani","Col. Pablo Zarate Villca",11,2,1,1,132,3,21,0,1,172,10,18,200,220,0.767,0.909
"17412","Potosí","Chuquihuta Ayllu Jucumani","Col. Pablo Zarate Villca",12,0,2,1,125,6,14,0,0,160,11,10,181,202,0.781,0.896
"17413","Potosí","Chuquihuta Ayllu Jucumani","Esc. Tacopalca",2,4,4,1,125,2,18,1,0,157,15,14,186,224,0.796,0.83
"17414","Potosí","Chuquihuta Ayllu Jucumani","Esc. Tacopalca",4,4,4,0,147,4,14,0,0,177,2,16,195,226,0.831,0.863
"17415","Potosí","Chuquihuta Ayllu Jucumani","Esc. Tacopalca",2,1,0,2,139,0,11,1,0,156,30,12,198,226,0.891,0.876
"17416","Potosí","Chuquihuta Ayllu Jucumani","Esc. Tacopalca",1,2,2,0,137,3,16,0,0,161,17,18,196,219,0.851,0.895
"17417","Potosí","Chuquihuta Ayllu Jucumani","Esc. Tacopalca",9,2,5,4,127,4,15,3,0,169,17,18,204,223,0.751,0.915
"17418","Potosí","Betanzos","Coleg. R. Bohorquez",57,1,3,1,100,5,19,0,0,186,3,6,195,223,0.538,0.874
"17419","Potosí","Betanzos","Coleg. R. Bohorquez",46,0,3,1,111,3,16,0,1,181,2,8,191,224,0.613,0.853
"17420","Potosí","Betanzos","Coleg. R. Bohorquez",35,3,2,0,112,4,17,0,1,174,4,11,189,225,0.644,0.84
"17421","Potosí","Betanzos","Coleg. R. Bohorquez",55,1,2,0,99,5,15,1,0,178,3,13,194,224,0.556,0.866
"17422","Potosí","Betanzos","Coleg. R. Bohorquez",50,2,2,2,81,1,31,0,0,169,7,9,185,228,0.479,0.811
"17423","Potosí","Betanzos","Coleg. R. Bohorquez",51,2,1,0,108,2,17,0,0,181,6,10,197,224,0.597,0.879
"17424","Potosí","Betanzos","Coleg. R. Bohorquez",60,0,1,0,95,0,17,0,1,174,3,11,188,224,0.546,0.839
"17425","Potosí","Betanzos","Coleg. R. Bohorquez",48,2,2,0,109,2,16,0,2,181,3,7,191,213,0.602,0.897
"17426","Potosí","Betanzos","Coleg. R. Bohorquez",5,2,2,0,152,0,8,0,1,170,10,9,189,221,0.894,0.855
"17427","Potosí","Betanzos","Coleg. R. Bohorquez",43,1,1,2,101,5,18,0,0,171,3,9,183,225,0.591,0.813
"17428","Potosí","Betanzos","Kinder Villa Imperial",44,2,1,1,89,3,21,2,1,164,13,18,195,220,0.543,0.886
"17429","Potosí","Betanzos","Kinder Villa Imperial",21,0,5,2,118,0,20,1,3,170,11,8,189,228,0.694,0.829
"17430","Potosí","Betanzos","Kinder Villa Imperial",20,1,3,1,116,3,23,1,1,169,7,7,183,215,0.686,0.851
"17431","Potosí","Betanzos","Kinder Villa Imperial",37,2,0,4,106,2,20,0,1,172,5,9,186,211,0.616,0.882
"17432","Potosí","Betanzos","Kinder Villa Imperial",33,0,3,3,108,4,23,1,0,175,6,10,191,218,0.617,0.876
"17433","Potosí","Betanzos","Esc. Modesto Omiste",42,0,3,1,99,1,15,0,0,161,3,17,181,218,0.615,0.83
"17434","Potosí","Betanzos","Esc. Modesto Omiste",38,2,3,1,108,2,15,0,1,170,7,12,189,224,0.635,0.844
"17435","Potosí","Betanzos","Esc. Modesto Omiste",28,3,1,1,115,0,16,0,3,167,7,13,187,221,0.689,0.846
"17436","Potosí","Betanzos","Esc. Modesto Omiste",27,0,5,1,116,4,27,2,0,182,7,8,197,223,0.637,0.883
"17437","Potosí","Betanzos","Esc. Modesto Omiste",44,2,3,4,82,3,21,2,3,164,6,13,183,215,0.5,0.851
"17438","Potosí","Betanzos","Esc. Modesto Omiste",37,4,3,1,102,1,10,1,1,160,6,20,186,216,0.637,0.861
"17439","Potosí","Betanzos","Esc. Modesto Omiste",20,0,3,1,103,3,23,0,1,154,12,15,181,230,0.669,0.787
"17440","Potosí","Betanzos","Esc. Modesto Omiste",44,0,1,2,87,0,23,4,1,162,3,3,168,207,0.537,0.812
"17441","Potosí","Betanzos","Esc. Unzaga De La Vega",11,2,1,0,155,3,13,2,0,187,8,7,202,224,0.829,0.902
"17442","Potosí","Betanzos","Esc. Unzaga De La Vega",20,1,3,1,144,3,17,0,0,189,6,8,203,226,0.762,0.898
"17443","Potosí","Betanzos","Esc. Central Otuyo",8,5,0,2,141,1,2,1,0,160,1,7,168,205,0.881,0.82
"17444","Potosí","Betanzos","Esc. Tarija Cuchu",8,4,2,1,132,1,10,2,0,160,10,14,184,211,0.825,0.872
"17445","Potosí","Betanzos","Esc. Buey Tambo",13,0,1,0,145,2,18,3,0,182,5,14,201,220,0.797,0.914
"17446","Potosí","Betanzos","Esc. Alonzo De Ibañez",11,1,1,0,166,3,8,1,2,193,3,5,201,221,0.86,0.91
"17447","Potosí","Betanzos","Esc. Alonzo De Ibañez",11,5,4,2,151,0,13,1,0,187,2,8,197,225,0.807,0.876
"17448","Potosí","Betanzos","Esc. de Mamahota",3,5,2,0,160,5,3,3,1,182,11,7,200,221,0.879,0.905
"17449","Potosí","Betanzos","Esc. de Mariaca",2,4,0,5,153,1,4,2,0,171,7,11,189,223,0.895,0.848
"17450","Potosí","Betanzos","Esc. Central Tecoya",2,4,0,0,145,2,8,2,0,163,10,8,181,217,0.89,0.834
"17451","Potosí","Betanzos","Esc. Central Tecoya",5,2,2,0,152,0,8,0,1,170,10,9,189,224,0.894,0.844
"17452","Potosí","Betanzos","Esc. Central Tecoya",5,1,0,0,143,2,7,2,1,161,10,9,180,213,0.888,0.845
"17453","Potosí","Betanzos","Esc. Central Tecoya",6,0,1,0,142,0,7,3,0,159,10,8,177,217,0.893,0.816
"17454","Potosí","Betanzos","Esc. Central Tecoya",6,2,2,0,128,1,9,2,1,151,11,14,176,217,0.848,0.811
"17455","Potosí","Betanzos","Esc. Central Tecoya",3,2,0,1,154,1,4,1,0,166,5,6,177,215,0.928,0.823
"17456","Potosí","Betanzos","Esc. Central Tecoya",3,0,3,0,134,1,7,1,2,151,10,12,173,211,0.887,0.82
"17457","Potosí","Betanzos","Esc. Poco Poco",17,4,2,0,130,3,17,2,1,176,8,12,196,222,0.739,0.883
"17458","Potosí","Betanzos","Esc. Tauri Cancha",22,2,2,2,116,5,18,1,2,170,8,9,187,215,0.682,0.87
"17459","Potosí","Betanzos","Esc. Tauri Cancha",15,1,1,3,119,3,23,0,1,166,11,5,182,213,0.717,0.854
"17460","Potosí","Betanzos","Esc. Tauri Cancha",13,0,3,0,122,2,36,0,0,176,2,9,187,218,0.693,0.858
"17461","Potosí","Betanzos","Esc. Tauri Cancha",19,3,1,3,121,4,18,1,4,174,7,11,192,218,0.695,0.881
"17462","Potosí","Betanzos","Esc. Tauri Cancha",12,8,3,2,119,4,13,2,4,167,13,20,200,221,0.713,0.905
"17463","Potosí","Betanzos","Esc. Tirispaya",7,11,2,1,122,2,7,3,1,156,12,14,182,213,0.782,0.854
"17464","Potosí","Betanzos","Esc. Camali",1,1,1,2,140,0,12,2,0,159,10,16,185,222,0.881,0.833
"17465","Potosí","Betanzos","Esc. Camali",2,4,3,1,137,0,11,3,1,162,9,12,183,227,0.846,0.806
"17466","Potosí","Betanzos","Esc. Urifaya",10,3,0,1,178,5,4,0,1,202,0,3,205,214,0.881,0.958
"17467","Potosí","Betanzos","Central Elizardo Perez",10,9,2,0,122,3,13,6,0,165,19,9,193,219,0.739,0.881
"17468","Potosí","Betanzos","Central Elizardo Perez",6,2,2,4,118,6,11,2,0,151,21,18,190,217,0.781,0.876
"17469","Potosí","Betanzos","U. E. Chillcani",14,4,4,3,101,6,26,0,1,159,5,34,198,220,0.635,0.9
"17470","Potosí","Betanzos","Esc. Troja Pampa",4,2,2,2,146,2,3,1,0,162,2,12,176,213,0.901,0.826
"17471","Potosí","Chaquí","Esc. Andres De Santa Cruz",38,4,3,2,77,9,18,3,0,154,11,16,181,212,0.5,0.854
"17472","Potosí","Chaquí","Esc. Andres De Santa Cruz",34,1,4,1,92,10,13,1,0,156,17,11,184,215,0.59,0.856
"17473","Potosí","Chaquí","Esc. Don Diego",51,1,3,1,59,10,30,3,6,164,11,17,192,216,0.36,0.889
"17474","Potosí","Chaquí","Esc. Don Diego",35,1,3,3,59,10,40,1,5,157,5,21,183,216,0.376,0.847
"17475","Potosí","Chaquí","Esc. Central El Palomar",10,1,2,2,133,8,11,1,1,169,6,6,181,210,0.787,0.862
"17476","Potosí","Chaquí","Esc. Rodero",16,1,6,3,90,11,31,0,1,159,10,13,182,208,0.566,0.875
"17477","Potosí","Chaquí","Col. Villa Imperial",32,3,7,5,81,11,18,1,2,160,5,20,185,208,0.506,0.889
"17478","Potosí","Tacobamba","Esc. Challviri",34,12,5,4,70,8,19,5,0,157,7,8,172,208,0.446,0.827
"17479","Potosí","Tacobamba","Col. Gualberto Villarroel",28,4,3,3,88,7,14,4,2,153,10,18,181,214,0.575,0.846
"17480","Potosí","Tacobamba","Esc. Rodeo",2,2,1,1,147,1,3,2,0,159,1,9,169,226,0.925,0.748
"17481","Potosí","Tacobamba","Esc. Ancoma",6,0,0,0,164,2,0,0,0,172,4,1,177,216,0.953,0.819
"17482","Potosí","Tacobamba","Esc. Juruna",5,1,0,0,158,0,9,1,1,175,12,14,201,229,0.903,0.878
"17483","Potosí","Tacobamba","Unid. Educ. Franz Tamayo",5,9,5,0,114,10,23,0,2,168,7,19,194,221,0.679,0.878
"17484","Potosí","Colquechaca","U. E. Junin",21,1,6,0,87,3,35,1,2,156,10,24,190,212,0.558,0.896
"17485","Potosí","Colquechaca","U. E. Junin",32,1,0,5,85,2,27,1,2,155,13,19,187,212,0.548,0.882
"17486","Potosí","Colquechaca","U. E. Junin",28,1,3,1,85,4,28,2,1,153,13,18,184,207,0.556,0.889
"17487","Potosí","Colquechaca","U. E. Junin",46,4,7,2,95,1,30,0,0,185,13,13,211,236,0.514,0.894
"17488","Potosí","Colquechaca","U. E. Roberto Alvarado Daza",28,0,3,0,104,3,43,0,1,182,5,26,213,236,0.571,0.903
"17489","Potosí","Colquechaca","U. E. Roberto Alvarado Daza",19,0,5,0,98,4,31,0,2,159,11,20,190,207,0.616,0.918
"17490","Potosí","Colquechaca","U. E. Roberto Alvarado Daza",33,2,3,3,88,1,25,1,0,156,6,19,181,206,0.564,0.879
"17491","Potosí","Colquechaca","U. E. Roberto Alvarado Daza",41,2,4,2,70,7,27,0,1,154,19,18,191,209,0.455,0.914
"17492","Potosí","Colquechaca","U. E. Roberto Alvarado Daza",34,1,4,0,72,5,34,1,0,151,10,20,181,212,0.477,0.854
"17493","Potosí","Colquechaca","U. E. Tomas Katari De Macha",8,0,0,3,136,2,6,0,0,155,15,22,192,223,0.877,0.861
"17494","Potosí","Colquechaca","U. E. Tomas Katari De Macha",2,0,2,2,142,2,8,0,0,158,22,12,192,221,0.899,0.869
"17495","Potosí","Colquechaca","U. E. Tomas Katari De Macha",3,1,0,1,145,4,8,1,0,163,12,14,189,218,0.89,0.867
"17496","Potosí","Colquechaca","U. E. Elizardo Perez",8,2,3,1,144,1,14,3,1,177,13,10,200,215,0.814,0.93
"17497","Potosí","Colquechaca","U. E. Elizardo Perez",3,1,1,2,156,2,16,2,0,183,11,14,208,217,0.852,0.959
"17498","Potosí","Colquechaca","U. E. Elizardo Perez",4,0,1,1,149,3,9,2,1,170,9,10,189,214,0.876,0.883
"17499","Potosí","Colquechaca","U. E. Elizardo Perez",3,1,1,2,145,3,19,0,0,174,14,9,197,220,0.833,0.895
"17500","Potosí","Colquechaca","U. E. Elizardo Perez",2,3,0,1,157,0,14,1,1,179,6,13,198,219,0.877,0.904
"17501","Potosí","Colquechaca","U. E. 1ro. de Mayo De Salinas Alta",0,1,1,1,166,3,11,0,0,183,4,11,198,221,0.907,0.896
"17502","Potosí","Colquechaca","U. E. 1ro. de Mayo De Salinas Alta",4,2,20,5,120,3,18,2,1,175,10,8,193,222,0.686,0.869
"17503","Potosí","Colquechaca","U. E. 1ro. de Mayo De Salinas Alta",4,0,2,1,149,7,14,3,2,182,12,9,203,226,0.819,0.898
"17504","Potosí","Colquechaca","U. E. Jaime Mendoza",6,3,0,1,149,1,14,1,0,175,12,3,190,210,0.851,0.905
"17505","Potosí","Colquechaca","U. E. Jaime Mendoza",4,0,0,1,135,5,18,0,0,163,20,15,198,211,0.828,0.938
"17506","Potosí","Colquechaca","U. E. Jaime Mendoza",6,2,1,2,153,1,2,0,1,168,7,13,188,211,0.911,0.891
"17507","Potosí","Colquechaca","U. E. Junin De Rosario",8,1,1,0,156,1,7,2,0,176,5,19,200,213,0.886,0.939
"17508","Potosí","Colquechaca","U. E. Junin De Rosario",7,2,2,3,140,6,9,1,0,170,16,8,194,214,0.824,0.907
"17509","Potosí","Colquechaca","U. E. Guadalupe San Antonio",0,1,1,1,158,0,1,0,0,162,2,8,172,223,0.975,0.771
"17510","Potosí","Colquechaca","U. E. Guadalupe San Antonio",0,0,0,0,152,0,0,0,0,152,8,1,161,220,1,0.732
"17511","Potosí","Colquechaca","U. E. Simon Bolivar de Choquecayara Baja",2,2,3,2,130,5,17,0,5,166,12,21,199,221,0.783,0.9
"17512","Potosí","Colquechaca","U. E. Juancito Pinto De Phutina",2,2,3,2,144,5,23,1,0,182,1,2,185,215,0.791,0.86
"17513","Potosí","Colquechaca","U. E. Juancito Pinto De Phutina",1,3,1,3,156,0,12,1,0,177,0,1,178,217,0.881,0.82
"17514","Potosí","Colquechaca","U. E. Juancito Pinto De Phutina",8,4,5,6,111,6,20,2,0,162,26,12,200,224,0.685,0.893
"17515","Potosí","Colquechaca","U. E. Juancito Pinto De Phutina",3,4,1,2,150,2,10,3,0,175,0,11,186,214,0.857,0.869
"17516","Potosí","Colquechaca","U. E. Marcelo Quirves",0,3,1,0,154,5,11,0,1,175,1,11,187,223,0.88,0.839
"17517","Potosí","Colquechaca","U. E. Marcelo Quirves",3,7,1,6,111,10,9,3,1,151,25,30,206,233,0.735,0.884
"17518","Potosí","Colquechaca","U. E. Qayarani Mejillones 10 de Octubre",1,0,0,0,169,0,1,0,0,171,0,32,203,218,0.988,0.931
"17519","Potosí","Colquechaca","U. E. Qayarani Mejillones 10 de Octubre",0,1,1,0,179,1,1,1,0,184,0,25,209,221,0.973,0.946
"17520","Potosí","Colquechaca","U.E. Ayacucho de Sicuta",0,0,2,0,209,0,3,0,0,214,4,3,221,235,0.977,0.94
"17521","Potosí","Colquechaca","U.E. Ayacucho de Sicuta",0,1,3,0,166,1,0,1,0,172,2,3,177,187,0.965,0.947
"17522","Potosí","Colquechaca","U. E. Jaime Mendoza De Jamachiri",5,4,1,4,164,2,0,0,1,181,21,12,214,226,0.906,0.947
"17523","Potosí","Colquechaca","U.E. Juana Azurduy De Padilla De San Lazaro",8,3,0,0,145,6,13,3,0,178,2,12,192,199,0.815,0.965
"17524","Potosí","Ravelo","Esc. M. Ascencio Padilla",25,0,3,5,110,6,8,2,0,159,8,23,190,222,0.692,0.856
"17525","Potosí","Ravelo","Esc. Antora",4,7,1,5,107,7,10,4,9,154,13,13,180,212,0.695,0.849
"17526","Potosí","Ravelo","Esc. Huaycoma",1,5,2,4,136,2,4,2,1,157,14,13,184,237,0.866,0.776
"17527","Potosí","Ravelo","Esc. S. Yurubamba",8,4,4,0,114,2,29,3,1,165,11,8,184,219,0.691,0.84
"17528","Potosí","Ravelo","Esc. Central Rodeo Huayllas",4,1,2,1,133,1,3,2,4,151,9,14,174,207,0.881,0.841
"17529","Potosí","Ravelo","Esc. Seccional Molle Molle",8,0,1,2,130,0,5,2,4,152,12,12,176,204,0.855,0.863
"17530","Potosí","Ravelo","Esc. Seccional Molle Molle",1,5,0,3,134,0,4,2,3,152,21,13,186,210,0.882,0.886
"17531","Potosí","Ravelo","Esc. Sasanta",6,1,5,2,123,3,20,1,3,164,10,15,189,227,0.75,0.833
"17532","Potosí","Ravelo","Esc. Central 1º de Mayo",4,3,4,1,119,15,6,0,3,155,12,14,181,217,0.768,0.834
"17533","Potosí","Ravelo","Esc. Central Saucy Mayu",3,0,2,0,130,5,18,3,0,161,12,13,186,217,0.807,0.857
"17534","Potosí","Ravelo","Col. Jose Alonso De Ibañez",2,2,3,0,157,2,5,0,1,172,20,10,202,225,0.913,0.898
"17535","Potosí","Ravelo","U.E. Janina",15,6,7,1,110,5,9,7,3,163,33,25,221,235,0.675,0.94
"17536","Potosí","Pocoata","U. E. Pedro Gutierrez",20,2,7,2,105,5,13,1,2,157,15,15,187,209,0.669,0.895
"17537","Potosí","Pocoata","U. E. Pedro Gutierrez",15,2,3,2,105,7,24,0,3,161,11,14,186,217,0.652,0.857
"17538","Potosí","Pocoata","U. E. Pedro Gutierrez",12,2,5,0,128,6,22,0,0,175,10,15,200,219,0.731,0.913
"17539","Potosí","Pocoata","U. E. Pedro Gutierrez",23,2,3,2,115,2,14,0,1,162,13,12,187,214,0.71,0.874
"17540","Potosí","Pocoata","U. E. Pedro Gutierrez",29,2,2,2,94,6,17,4,1,157,15,16,188,216,0.599,0.87
"17541","Potosí","Pocoata","U. E. Pedro Gutierrez",26,1,2,0,99,4,29,1,1,163,11,15,189,215,0.607,0.879
"17542","Potosí","Pocoata","U. E. Pedro Gutierrez",19,0,3,0,104,4,21,0,1,152,14,22,188,221,0.684,0.851
"17543","Potosí","Pocoata","U. E. Pedro Gutierrez",22,2,5,1,103,5,13,4,0,155,12,28,195,218,0.665,0.894
"17544","Potosí","Pocoata","U. E. Pedro Gutierrez",39,2,2,3,97,6,22,0,1,172,9,21,202,217,0.564,0.931
"17545","Potosí","Pocoata","U. E. Pedro Gutierrez",26,1,2,0,101,3,16,2,0,151,14,22,187,214,0.669,0.874
"17546","Potosí","Pocoata","U. E. Jarana",5,1,0,1,146,1,12,1,0,167,8,9,184,212,0.874,0.868
"17547","Potosí","Pocoata","U. E. Jarana",10,1,2,0,141,0,15,0,1,170,11,8,189,220,0.829,0.859
"17548","Potosí","Pocoata","U. E. Saye",0,0,2,0,157,3,6,0,0,168,7,2,177,190,0.935,0.932
"17549","Potosí","Pocoata","U. E. Huancarani",11,0,0,2,135,0,14,1,1,164,9,7,180,219,0.823,0.822
"17550","Potosí","Pocoata","U. E. Huancarani",26,0,2,1,114,6,17,0,0,166,7,7,180,209,0.687,0.861
"17551","Potosí","Pocoata","U. E. Huancarani",13,1,0,3,134,4,10,1,0,166,1,14,181,211,0.807,0.858
"17552","Potosí","Pocoata","U. E. Collana Tuica",0,1,2,0,198,0,6,0,0,207,1,0,208,217,0.957,0.959
"17553","Potosí","Pocoata","U. E. Collana Tuica",0,0,0,0,208,1,4,0,0,213,0,1,214,222,0.977,0.964
"17554","Potosí","Pocoata","U. E. Sarijchi",1,0,0,0,153,1,3,1,0,159,1,2,162,211,0.962,0.768
"17555","Potosí","Pocoata","U. E. Tomas Katari",7,0,1,0,175,0,15,0,0,198,5,8,211,221,0.884,0.955
"17556","Potosí","Pocoata","U. E. Tomas Katari",1,0,0,2,194,1,8,0,0,206,2,1,209,218,0.942,0.959
"17557","Potosí","Pocoata","U. E. Tomas Katari",4,0,1,1,187,0,7,0,0,200,6,4,210,222,0.935,0.946
"17558","Potosí","Pocoata","U. E. Tomas Katari",0,1,1,1,163,0,14,1,0,181,4,5,190,210,0.901,0.905
"17559","Potosí","Pocoata","U. E. Tomas Katari",1,0,0,1,172,0,12,0,0,186,6,11,203,214,0.925,0.949
"17560","Potosí","Pocoata","Nucleo Escolar Kesimpucu",0,2,4,2,112,3,44,2,0,169,6,13,188,231,0.663,0.814
"17561","Potosí","Pocoata","U. E. Kari",11,1,1,1,130,2,39,0,0,185,10,8,203,206,0.703,0.985
"17562","Potosí","Pocoata","U. E. Kari",5,2,2,1,162,1,42,0,0,215,7,13,235,237,0.753,0.992
"17563","Potosí","Pocoata","U. E. Villa Alcarapi",1,0,1,0,171,1,15,0,0,189,6,15,210,228,0.905,0.921
"17564","Potosí","Pocoata","U. E. Tomoyo",5,0,1,4,148,4,7,0,1,170,6,12,188,211,0.871,0.891
"17565","Potosí","Pocoata","U. E. Turberia",2,0,1,0,134,1,14,2,0,154,18,15,187,219,0.87,0.854
"17566","Potosí","Pocoata","U. E. Turberia",1,1,0,0,173,0,5,0,0,180,8,6,194,227,0.961,0.855
"17567","Potosí","Pocoata","U. E. Turberia",1,2,2,2,141,2,10,2,0,162,15,9,186,216,0.87,0.861
"17568","Potosí","Pocoata","U. E. Achacana",0,0,2,0,157,1,3,0,0,163,0,5,168,212,0.963,0.792
"17569","Potosí","Pocoata","U. E. Achacana",0,0,0,0,176,1,1,0,0,178,1,2,181,223,0.989,0.812
"17570","Potosí","Pocoata","U. E. Cachuyo",4,1,4,0,147,0,8,0,0,164,24,16,204,223,0.896,0.915
"17571","Potosí","Ocurí","Col. Nac. Marcelo Quiroga Santa Cruz",15,1,1,2,120,12,19,0,1,171,6,12,189,227,0.702,0.833
"17572","Potosí","San Pedro","Coleg. Nal. Charcas",33,1,1,1,110,1,10,0,0,157,12,8,177,219,0.701,0.808
"17573","Potosí","San Pedro","Coleg. Nal. Charcas",10,0,2,1,134,5,9,0,0,161,14,5,180,220,0.832,0.818
"17574","Potosí","San Pedro","Coleg. Nal. Charcas",17,1,2,1,142,1,11,0,0,175,8,15,198,219,0.811,0.904
"17575","Potosí","San Pedro","Coleg. Nal. Charcas",13,2,2,1,122,2,11,1,0,154,13,20,187,219,0.792,0.854
"17576","Potosí","San Pedro","Coleg. Nal. Charcas",21,1,1,0,2,125,3,9,1,163,17,11,191,220,0.012,0.868
"17577","Potosí","San Pedro","Coleg. Nal. Charcas",16,2,3,2,126,1,8,2,0,160,15,7,182,219,0.787,0.831
"17578","Potosí","San Pedro","Coleg. Nal. Charcas",32,3,1,0,124,1,5,0,1,167,8,13,188,223,0.743,0.843
"17579","Potosí","San Pedro","Coleg. Nal. Charcas",34,0,1,4,124,2,2,0,0,167,12,9,188,218,0.743,0.862
"17580","Potosí","San Pedro","Coleg. Nal. Charcas",32,0,0,1,106,5,7,5,0,156,19,5,180,211,0.679,0.853
"17581","Potosí","San Pedro","Coleg. Nal. Charcas",19,0,4,0,130,2,10,0,0,165,15,3,183,207,0.788,0.884
"17582","Potosí","San Pedro","Coleg. Nal. Charcas",28,1,1,1,113,4,9,1,0,158,8,10,176,213,0.715,0.826
"17583","Potosí","San Pedro","Esc. Quinamara",3,0,1,1,156,1,2,0,0,164,14,5,183,219,0.951,0.836
"17584","Potosí","San Pedro","Esc. Quinamara",3,1,1,4,149,0,1,0,0,159,10,7,176,210,0.937,0.838
"17585","Potosí","San Pedro","Esc. San Marcos",1,1,0,0,154,0,0,0,1,157,2,0,159,222,0.981,0.716
"17586","Potosí","San Pedro","Esc. San Marcos",0,0,0,0,167,0,1,0,0,168,1,0,169,222,0.994,0.761
"17587","Potosí","San Pedro","Esc. San Marcos",2,1,1,1,143,0,7,1,0,156,3,3,162,234,0.917,0.692
"17588","Potosí","San Pedro","Esc. Moscari",1,0,0,2,156,0,3,0,0,162,0,2,164,217,0.963,0.756
"17589","Potosí","San Pedro","Esc. Moscari",2,0,0,0,151,0,1,1,0,155,3,13,171,219,0.974,0.781
"17590","Potosí","San Pedro","Nucleo Escolar Micani",0,0,2,1,197,0,0,1,0,201,1,0,202,228,0.98,0.886
"17591","Potosí","San Pedro","Nucleo Escolar Micani",0,0,0,0,180,1,4,0,0,185,0,0,185,220,0.973,0.841
"17592","Potosí","San Pedro","Nucleo Escolar Micani",1,1,1,0,171,1,1,0,0,176,3,0,179,225,0.972,0.796
"17593","Potosí","San Pedro","Nucleo Escolar Micani",1,1,0,0,184,0,2,0,0,188,5,6,199,225,0.979,0.884
"17594","Potosí","San Pedro","Esc. Toracari",1,2,20,0,134,2,7,3,0,169,12,10,191,222,0.793,0.86
"17595","Potosí","San Pedro","Esc. Toracari",5,4,16,1,120,1,5,0,0,152,12,19,183,217,0.789,0.843
"17596","Potosí","San Pedro","Esc. Toracari",6,0,9,3,138,2,4,1,2,165,11,13,189,222,0.836,0.851
"17597","Potosí","San Pedro","Esc. Ñequeta",6,0,2,0,159,0,14,2,0,183,5,6,194,214,0.869,0.907
"17598","Potosí","San Pedro","Esc. Ñequeta",18,2,1,4,146,0,3,1,0,175,5,5,185,211,0.834,0.877
"17599","Potosí","San Pedro","Esc. Ñequeta",10,1,5,1,140,1,7,1,0,166,8,15,189,216,0.843,0.875
"17600","Potosí","San Pedro","Esc. Chiro Ckasa",13,1,13,3,115,2,9,2,0,158,18,10,186,222,0.728,0.838
"17601","Potosí","San Pedro","Esc. Chiro Ckasa",5,1,7,1,145,3,9,5,0,176,13,13,202,214,0.824,0.944
"17602","Potosí","San Pedro","Esc. Chiro Ckasa",10,1,14,1,136,4,11,3,0,180,17,6,203,217,0.756,0.935
"17603","Potosí","San Pedro","Esc. Chiro Ckasa",5,2,9,0,145,2,9,2,0,174,8,9,191,217,0.833,0.88
"17604","Potosí","San Pedro","Esc. Chiro Ckasa",4,3,5,0,147,2,6,0,1,168,11,9,188,210,0.875,0.895
"17605","Potosí","San Pedro","Esc. Chiro Ckasa",8,1,5,0,139,2,12,3,0,170,11,13,194,212,0.818,0.915
"17606","Potosí","San Pedro","Esc. Sapacari",12,3,4,5,117,2,10,4,0,157,19,9,185,213,0.745,0.869
"17607","Potosí","San Pedro","Escuela Seccional Cota Cota",3,3,8,2,158,0,6,0,0,180,10,11,201,223,0.878,0.901
"17608","Potosí","San Pedro","Esc. Ipote",0,0,1,0,213,0,0,0,1,215,0,0,215,222,0.991,0.968
"17609","Potosí","San Pedro","Esc. Arakani",0,3,2,1,158,5,2,1,1,173,26,16,215,236,0.913,0.911
"17610","Potosí","San Pedro","Esc. Martin Cala",0,0,0,0,190,0,1,0,0,191,1,0,192,235,0.995,0.817
"17611","Potosí","San Pedro","Nucleo Educativo Banduriri",3,1,4,1,178,1,10,0,0,198,8,8,214,234,0.899,0.915
"17612","Potosí","San Pedro","Nucleo Educativo Banduriri",4,2,1,0,195,0,2,0,1,205,1,4,210,232,0.951,0.905
"17613","Potosí","San Pedro","U.E. Suycoma",7,3,1,2,175,0,7,2,0,197,16,9,222,236,0.888,0.941
"17614","Potosí","San Pedro","U.E. Sacana",1,1,1,1,204,1,4,3,1,217,10,6,233,238,0.94,0.979
"17615","Potosí","Toro Toro","U. E. Mariscal Sucre",30,0,0,1,118,6,21,0,0,176,6,5,187,216,0.67,0.866
"17616","Potosí","Toro Toro","U. E. Mariscal Sucre",18,3,0,0,129,1,9,0,0,160,4,8,172,214,0.806,0.804
"17617","Potosí","Toro Toro","U. E. Mariscal Sucre",18,1,0,3,129,3,17,0,0,171,7,7,185,212,0.754,0.873
"17618","Potosí","Toro Toro","U. E. Mariscal Sucre",19,1,2,1,149,0,11,0,0,183,3,10,196,221,0.814,0.887
"17619","Potosí","Toro Toro","U. E. Mariscal Sucre",23,0,3,0,130,1,23,0,0,180,3,10,193,217,0.722,0.889
"17620","Potosí","Toro Toro","U. E. Mariscal Sucre",23,0,1,0,124,3,8,2,1,162,5,11,178,221,0.765,0.805
"17621","Potosí","Toro Toro","U. E. Mariscal Sucre",26,0,2,1,117,3,20,0,0,169,7,8,184,215,0.692,0.856
"17622","Potosí","Toro Toro","U.E. Julio Grande",12,2,2,1,134,0,40,0,0,191,3,8,202,234,0.702,0.863
"17623","Potosí","Toro Toro","U.E. Julio Grande",12,2,0,1,148,3,20,0,0,186,8,2,196,229,0.796,0.856
"17624","Potosí","Toro Toro","U.E. Julio Grande",18,1,1,0,148,5,11,0,0,184,4,5,193,217,0.804,0.889
"17625","Potosí","Toro Toro","U. E. Añahuani",4,0,0,0,168,0,5,0,0,177,4,1,182,213,0.949,0.854
"17626","Potosí","Toro Toro","U. E. Carasi",5,3,0,2,153,2,1,3,0,169,7,6,182,220,0.905,0.827
"17627","Potosí","Toro Toro","U. E. Carasi",11,1,0,1,141,0,0,2,0,156,7,6,169,221,0.904,0.765
"17628","Potosí","Toro Toro","U. E. Yambata",2,1,0,1,148,0,0,0,1,153,4,7,164,217,0.967,0.756
"17629","Potosí","Toro Toro","U. E. Tambo K'Asa",0,0,0,1,205,0,2,1,0,209,0,1,210,214,0.981,0.981
"17630","Potosí","Toro Toro","U. E. Tambo K'Asa",0,0,0,0,160,0,0,0,0,160,0,0,160,167,1,0.958
"17631","Potosí","Toro Toro","U. E. Palla Palla",2,0,0,0,168,0,8,1,0,179,4,15,198,224,0.939,0.884
"17632","Potosí","Toro Toro","U. E. Palla Palla",2,0,0,1,196,0,1,0,0,200,0,3,203,226,0.98,0.898
"17633","Potosí","Toro Toro","U. E. Poco Suco",3,0,0,0,201,0,2,0,0,206,0,0,206,219,0.976,0.941
"17634","Potosí","Cotagaita","U.E. Manuel Jose Cortez",36,0,2,1,118,4,17,1,2,181,7,13,201,225,0.652,0.893
"17635","Potosí","Cotagaita","U.E. Manuel Jose Cortez",32,0,7,0,101,6,33,3,2,184,7,5,196,224,0.549,0.875
"17636","Potosí","Cotagaita","U.E. Manuel Jose Cortez",42,2,9,0,114,1,25,0,1,194,4,7,205,231,0.588,0.887
"17637","Potosí","Cotagaita","U.E. Manuel Jose Cortez",44,2,5,0,123,1,17,0,0,192,2,5,199,223,0.641,0.892
"17638","Potosí","Cotagaita","U.E. Manuel Jose Cortez",34,0,5,1,120,1,22,0,2,185,6,6,197,223,0.649,0.883
"17639","Potosí","Cotagaita","U.E. Manuel Jose Cortez",33,5,3,2,117,3,21,1,0,185,4,7,196,226,0.632,0.867
"17640","Potosí","Cotagaita","Coleg. Carlos Medinaceli",40,1,2,2,118,2,20,0,2,187,2,9,198,221,0.631,0.896
"17641","Potosí","Cotagaita","Coleg. Carlos Medinaceli",48,0,7,1,101,3,26,0,1,187,4,4,195,218,0.54,0.894
"17642","Potosí","Cotagaita","Coleg. Carlos Medinaceli",52,3,6,1,97,4,16,0,0,179,6,13,198,223,0.542,0.888
"17643","Potosí","Cotagaita","Coleg. Carlos Medinaceli",39,2,3,1,112,2,18,0,0,177,9,10,196,223,0.633,0.879
"17644","Potosí","Cotagaita","Coleg. Carlos Medinaceli",35,0,7,0,108,1,21,0,2,174,5,13,192,222,0.621,0.865
"17645","Potosí","Cotagaita","Coleg. Carlos Medinaceli",41,0,0,0,102,3,13,2,0,161,5,16,182,212,0.634,0.858
"17646","Potosí","Cotagaita","U.E. Villa Imperial de Vichacla",7,0,2,0,149,2,4,0,0,164,10,4,178,200,0.909,0.89
"17647","Potosí","Cotagaita","U.E. Santiago Wright",8,1,2,3,130,4,14,0,0,162,10,5,177,209,0.802,0.847
"17648","Potosí","Cotagaita","U.E. Santiago Wright",15,0,1,1,131,5,23,0,1,177,6,10,193,216,0.74,0.894
"17649","Potosí","Cotagaita","U.E. Carlos Medinaceli De Tasna Rosario",29,0,3,1,122,5,20,1,2,183,9,10,202,223,0.667,0.906
"17650","Potosí","Cotagaita","U.E. Carlos Medinaceli De Tasna Rosario",26,1,5,3,130,4,16,2,1,188,6,11,205,225,0.691,0.911
"17651","Potosí","Cotagaita","U.E. Carlos Medinaceli De Tasna Rosario",28,1,3,3,107,12,23,2,3,182,4,8,194,219,0.588,0.886
"17652","Potosí","Cotagaita","U.E. Carlos Medinaceli De Tasna Rosario",38,1,4,2,122,6,19,2,2,196,5,17,218,237,0.622,0.92
"17653","Potosí","Cotagaita","U.E. Jose Alonzo De Ibañez",26,0,0,0,122,18,22,0,4,192,4,5,201,226,0.635,0.889
"17654","Potosí","Cotagaita","U.E. Cornaca",7,2,7,3,148,1,11,3,3,185,4,6,195,217,0.8,0.899
"17655","Potosí","Cotagaita","U.E. Pedro Domingo Murillo De Sagrario",22,0,1,0,161,5,14,0,0,203,4,7,214,228,0.793,0.939
"17656","Potosí","Cotagaita","U.E. Ascanty",5,1,1,0,141,3,13,1,0,165,8,4,177,217,0.855,0.816
"17657","Potosí","Cotagaita","U.E. Cotagaitilla",7,0,0,0,153,5,6,1,0,172,2,9,183,213,0.89,0.859
"17658","Potosí","Cotagaita","U.E. Simon Bolivar A de Toropalca",11,0,3,4,109,4,20,3,1,155,2,8,165,212,0.703,0.778
"17659","Potosí","Cotagaita","U.E. Simon Bolivar A de Toropalca",15,1,0,0,116,3,21,1,0,157,0,7,164,213,0.739,0.77
"17660","Potosí","Cotagaita","U.E. El Porvenir A De Totora I",2,2,1,1,129,1,25,2,1,164,10,6,180,218,0.787,0.826
"17661","Potosí","Cotagaita","U.E. El Porvenir A De Totora I",3,2,0,3,137,1,18,0,0,164,7,8,179,224,0.835,0.799
"17662","Potosí","Cotagaita","U.E. El Porvenir A De Totora I",4,2,0,4,125,1,20,1,0,157,12,9,178,218,0.796,0.817
"17663","Potosí","Cotagaita","U.E. 6 de Junio",1,0,2,0,185,0,8,0,0,196,1,1,198,216,0.944,0.917
"17664","Potosí","Cotagaita","U.E. Collpa Uno",1,0,2,10,151,3,37,0,0,204,12,5,221,230,0.74,0.961
"17665","Potosí","Cotagaita","U.E. Tupac Katari",2,2,2,0,145,1,10,0,1,163,4,7,174,224,0.89,0.777
"17666","Potosí","Vitiche","U.E. Tomas Frias",34,1,3,1,97,5,18,1,0,160,6,12,178,210,0.606,0.848
"17667","Potosí","Vitiche","U.E. Tomas Frias",30,3,3,3,91,5,17,3,1,156,6,3,165,223,0.583,0.74
"17668","Potosí","Vitiche","U.E. Ayoma Baja",5,1,0,0,134,1,17,0,0,158,2,4,164,215,0.848,0.763
"17669","Potosí","Vitiche","U.E. Primo Martinez",63,0,0,1,70,3,12,4,1,154,6,8,168,191,0.455,0.88
"17670","Potosí","Vitiche","U.E. Juan Pellegrini",6,3,0,0,135,7,11,0,0,162,1,4,167,217,0.833,0.77
"17671","Potosí","Vitiche","U.E. Juan Pellegrini",1,3,1,0,138,1,13,0,0,157,2,1,160,207,0.879,0.773
"17672","Potosí","Vitiche","U.E. Estumilla",3,2,0,1,130,9,13,1,0,159,5,1,165,202,0.818,0.817
"17673","Potosí","Vitiche","U.E. San Miguel de Tusquiña",4,4,3,1,133,4,14,1,0,164,2,2,168,204,0.811,0.824
"17674","Potosí","Vitiche","U.E. San Miguel de Tusquiña",7,3,0,3,164,4,14,0,1,196,4,3,203,225,0.837,0.902
"17675","Potosí","Vitiche","U.E. Manuel Mora De Peckajsi",5,0,2,2,143,2,13,0,0,167,4,6,177,215,0.856,0.823
"17676","Potosí","Vitiche","U.E. Fray Angello Stellini de Calvi",1,2,0,0,147,3,21,0,2,176,5,3,184,222,0.835,0.829
"17677","Potosí","Vitiche","U.E. Eric Federico Smith",10,1,1,1,132,0,18,0,1,164,5,7,176,182,0.805,0.967
"17678","Potosí","Sacaca","Col. Jose Alonzo De Ibañez",35,2,10,4,90,6,13,3,2,165,6,11,182,215,0.545,0.847
"17679","Potosí","Sacaca","Col. Jose Alonzo De Ibañez",53,2,8,0,85,2,7,0,1,158,9,17,184,211,0.538,0.872
"17680","Potosí","Sacaca","Col. Jose Alonzo De Ibañez",21,1,18,0,108,2,12,0,0,162,9,19,190,213,0.667,0.892
"17681","Potosí","Sacaca","Col. Jose Alonzo De Ibañez",30,3,26,1,89,5,10,0,1,165,4,20,189,216,0.539,0.875
"17682","Potosí","Sacaca","Col. Jose Alonzo De Ibañez",23,4,21,0,104,5,12,1,1,171,6,8,185,216,0.608,0.856
"17683","Potosí","Sacaca","Col. Jose Alonzo De Ibañez",24,0,31,1,87,1,9,1,0,154,12,15,181,207,0.565,0.874
"17684","Potosí","Sacaca","Col. Jose Alonzo De Ibañez",32,0,13,1,97,6,11,2,0,162,7,25,194,225,0.599,0.862
"17685","Potosí","Sacaca","Col. Jose Alonzo De Ibañez",18,1,18,0,96,6,20,2,0,161,5,17,183,220,0.596,0.832
"17686","Potosí","Sacaca","Esc. Sillu Sillu",0,0,0,0,206,0,0,0,0,206,0,10,216,221,1,0.977
"17687","Potosí","Sacaca","Esc. Sillu Sillu",0,0,0,0,211,0,0,0,0,211,0,0,211,216,1,0.977
"17688","Potosí","Sacaca","Esc. Jaruma",3,2,46,0,125,2,7,2,0,187,7,20,214,217,0.668,0.986
"17689","Potosí","Sacaca","Esc. Carcoma",0,0,0,1,200,0,0,0,0,201,0,1,202,217,0.995,0.931
"17690","Potosí","Sacaca","Esc. Carcoma",0,0,0,0,198,0,0,0,0,198,0,2,200,217,1,0.922
"17691","Potosí","Sacaca","Esc. Iturata",1,0,0,0,206,0,2,1,0,210,0,12,222,222,0.981,1
"17692","Potosí","Sacaca","Esc. Layupampa",1,3,1,2,155,0,4,0,1,167,13,16,196,214,0.928,0.916
"17693","Potosí","Sacaca","Esc. Layupampa",2,2,5,2,121,0,16,3,0,151,12,7,170,187,0.801,0.909
"17694","Potosí","Sacaca","Esc. Laytoco",0,0,0,0,193,7,3,0,0,203,0,2,205,215,0.951,0.953
"17695","Potosí","Sacaca","Tarhua Chapi",0,1,0,0,153,0,4,1,2,161,10,26,197,215,0.95,0.916
"17696","Potosí","Sacaca","Tarhua Chapi",0,3,0,1,183,2,3,1,0,193,4,12,209,223,0.948,0.937
"17697","Potosí","Sacaca","Tarhua Chapi",2,0,0,0,150,3,6,1,0,162,3,9,174,188,0.926,0.926
"17698","Potosí","Sacaca","Esc. Charca",4,1,9,1,142,2,11,2,0,172,4,21,197,215,0.826,0.916
"17699","Potosí","Sacaca","Esc. de Ovejeria",0,1,5,1,183,5,1,0,0,196,2,2,200,214,0.934,0.935
"17700","Potosí","Sacaca","Esc. de Ovejeria",0,0,3,0,202,3,2,1,0,211,0,7,218,224,0.957,0.973
"17701","Potosí","Sacaca","Esc. de Ovejeria",1,0,3,0,216,0,0,0,0,220,1,0,221,221,0.982,1
"17702","Potosí","Sacaca","Esc. Vila Vila",0,2,0,0,210,0,4,0,0,216,1,1,218,218,0.972,1
"17703","Potosí","Sacaca","Esc. Vila Vila",0,0,0,0,218,0,0,0,0,218,0,5,223,224,1,0.996
"17704","Potosí","Sacaca","Esc. Vila Vila",1,0,0,0,223,0,0,0,0,224,0,2,226,229,0.996,0.987
"17705","Potosí","Sacaca","Sacani",8,0,2,1,179,1,14,0,1,206,1,6,213,221,0.869,0.964
"17706","Potosí","Sacaca","Sacani",0,0,3,0,164,1,5,0,1,174,0,11,185,191,0.943,0.969
"17707","Potosí","Sacaca","U.E. Jayu Jayu",1,0,4,1,171,0,1,2,0,180,7,8,195,197,0.95,0.99
"17708","Potosí","Sacaca","U.E. Bolivia",0,1,2,1,158,1,3,1,0,167,2,5,174,185,0.946,0.941
"17709","Potosí","Sacaca","U.E. Qachari",0,0,0,0,233,2,1,0,0,236,0,1,237,237,0.987,1
"17710","Potosí","Sacaca","U.E.Pichuya",1,0,0,0,253,0,1,0,0,255,1,0,256,256,0.992,1
"17711","Potosí","Caripuyo","Esc. Eduardo Avaroa",19,5,1,0,125,5,6,1,1,163,11,27,201,224,0.767,0.897
"17712","Potosí","Caripuyo","Esc. Eduardo Avaroa",5,4,3,1,141,0,13,0,0,167,14,17,198,218,0.844,0.908
"17713","Potosí","Caripuyo","Esc. Eduardo Avaroa",14,2,2,3,116,3,8,3,0,151,15,27,193,220,0.768,0.877
"17714","Potosí","Caripuyo","Esc. Eduardo Avaroa",15,0,2,4,129,2,6,1,1,160,15,6,181,224,0.806,0.808
"17715","Potosí","Caripuyo","Esc. Cotana",0,2,1,1,155,5,8,1,1,174,1,4,179,213,0.891,0.84
"17716","Potosí","Caripuyo","Esc. Chojlla",5,0,0,0,164,2,19,0,0,190,3,8,201,211,0.863,0.953
"17717","Potosí","Caripuyo","Esc. Huanacoma",8,4,3,1,130,4,7,7,1,165,9,21,195,215,0.788,0.907
"17718","Potosí","Caripuyo","Esc. Huanacoma",8,4,1,1,136,2,11,1,1,165,4,17,186,199,0.824,0.935
"17719","Potosí","Caripuyo","Esc. Jancko Jancko",1,0,4,1,146,2,12,1,2,169,3,8,180,202,0.864,0.891
"17720","Potosí","Caripuyo","Esc. Juntavi",2,2,0,0,160,2,9,3,0,178,13,12,203,221,0.899,0.919
"17721","Potosí","Caripuyo","Esc. Juntavi",0,4,2,0,160,2,16,1,0,185,2,2,189,215,0.865,0.879
"17722","Potosí","Caripuyo","U.E. Koakoani",0,1,2,2,225,1,13,1,0,245,1,7,253,258,0.918,0.981
"17723","Potosí","Caripuyo","U.E. Queñuani",4,1,4,2,145,2,29,1,0,188,13,3,204,211,0.771,0.967
"17724","Potosí","Tupiza","U. E. Antofagasta",83,3,0,1,79,10,17,1,4,198,3,6,207,239,0.399,0.866
"17725","Potosí","Tupiza","U. E. Antofagasta",71,0,1,2,80,10,21,0,3,188,6,18,212,235,0.426,0.902
"17726","Potosí","Tupiza","U. E. Antofagasta",69,1,1,3,91,5,20,0,4,194,2,9,205,225,0.469,0.911
"17727","Potosí","Tupiza","U. E. Antofagasta",55,2,0,1,86,10,16,4,5,179,1,11,191,219,0.48,0.872
"17728","Potosí","Tupiza","U. E. Antofagasta",64,0,2,2,83,4,20,0,1,176,8,10,194,215,0.472,0.902
"17729","Potosí","Tupiza","U. E. Antofagasta",56,2,1,4,92,9,12,1,2,179,8,11,198,224,0.514,0.884
"17730","Potosí","Tupiza","U. E. Antofagasta",50,0,1,0,98,8,16,1,2,176,1,11,188,218,0.557,0.862
"17731","Potosí","Tupiza","U. E. Antofagasta",74,2,1,0,76,4,24,1,2,184,2,10,196,223,0.413,0.879
"17732","Potosí","Tupiza","U. E. Antofagasta",52,0,0,3,106,6,8,1,3,179,2,11,192,222,0.592,0.865
"17733","Potosí","Tupiza","U. E. Antofagasta",78,0,1,0,93,4,16,0,4,196,3,12,211,233,0.474,0.906
"17734","Potosí","Tupiza","U. E. Antofagasta",76,0,4,2,68,6,20,1,1,178,1,5,184,209,0.382,0.88
"17735","Potosí","Tupiza","U. E. 26 de Agosto",37,0,1,1,94,8,22,1,1,165,3,19,187,216,0.57,0.866
"17736","Potosí","Tupiza","U. E. 26 de Agosto",49,0,0,0,106,9,14,1,2,181,5,12,198,221,0.586,0.896
"17737","Potosí","Tupiza","U. E. 26 de Agosto",41,1,3,0,94,6,16,0,2,163,7,13,183,215,0.577,0.851
"17738","Potosí","Tupiza","U. E. 26 de Agosto",39,1,1,0,108,10,19,1,3,182,3,11,196,220,0.593,0.891
"17739","Potosí","Tupiza","U. E. 26 de Agosto",42,1,2,0,120,6,22,0,2,195,4,9,208,228,0.615,0.912
"17740","Potosí","Tupiza","U. E. 26 de Agosto",41,0,1,2,117,3,24,0,1,189,2,4,195,225,0.619,0.867
"17741","Potosí","Tupiza","U. E. 26 de Agosto",43,0,0,2,105,4,31,1,1,187,3,16,206,221,0.561,0.932
"17742","Potosí","Tupiza","U. E. 26 de Agosto",28,0,0,1,107,8,25,1,1,171,5,8,184,223,0.626,0.825
"17743","Potosí","Tupiza","U. E. 26 de Agosto",36,0,0,1,103,3,21,1,1,166,1,16,183,218,0.62,0.839
"17744","Potosí","Tupiza","U. E. 26 de Agosto",40,0,2,1,107,5,24,2,3,184,2,18,204,228,0.582,0.895
"17745","Potosí","Tupiza","U. E. 26 de Agosto",47,1,3,2,96,6,24,0,2,181,4,11,196,221,0.53,0.887
"17746","Potosí","Tupiza","U. E. 26 de Agosto",35,0,3,4,98,7,25,0,2,174,3,14,191,220,0.563,0.868
"17747","Potosí","Tupiza","U. E. 26 de Agosto",37,1,1,0,88,5,32,2,1,167,7,19,193,219,0.527,0.881
"17748","Potosí","Tupiza","U. E. 26 de Agosto",38,0,3,4,92,8,22,3,2,172,4,10,186,220,0.535,0.845
"17749","Potosí","Tupiza","U. E. 26 de Agosto",44,0,4,1,89,13,26,0,3,180,6,13,199,225,0.494,0.884
"17750","Potosí","Tupiza","U. E. 26 de Agosto",26,0,1,0,120,9,21,2,1,180,2,9,191,221,0.667,0.864
"17751","Potosí","Tupiza","U. E. 26 de Agosto",43,0,4,1,107,8,21,2,0,186,0,16,202,224,0.575,0.902
"17752","Potosí","Tupiza","U. E. 26 de Agosto",43,0,1,1,120,3,17,2,2,189,6,6,201,224,0.635,0.897
"17753","Potosí","Tupiza","U. E. 26 de Agosto",33,1,2,0,114,3,30,1,3,187,4,14,205,227,0.61,0.903
"17754","Potosí","Tupiza","U. E. 26 de Agosto",33,0,1,0,120,4,21,1,1,181,3,11,195,233,0.663,0.837
"17755","Potosí","Tupiza","U. E. 26 de Agosto",33,0,1,0,112,9,36,2,1,194,2,11,207,236,0.577,0.877
"17756","Potosí","Tupiza","U. E. 26 de Agosto",32,1,0,1,109,8,38,2,2,193,8,11,212,240,0.565,0.883
"17757","Potosí","Tupiza","U. E. 26 de Agosto",34,1,1,0,110,7,31,1,4,189,3,9,201,227,0.582,0.885
"17758","Potosí","Tupiza","U. E. 7 de Noviembre",75,1,3,1,74,3,14,1,3,175,4,11,190,226,0.423,0.841
"17759","Potosí","Tupiza","U. E. 7 de Noviembre",82,0,0,0,77,5,16,2,0,182,2,8,192,227,0.423,0.846
"17760","Potosí","Tupiza","U. E. 7 de Noviembre",70,2,0,1,100,5,13,0,2,193,1,6,200,224,0.518,0.893
"17761","Potosí","Tupiza","U. E. 7 de Noviembre",77,0,4,1,68,4,12,1,3,170,5,16,191,224,0.4,0.853
"17762","Potosí","Tupiza","U. E. 7 de Noviembre",82,2,3,1,70,3,17,0,1,179,3,11,193,222,0.391,0.869
"17763","Potosí","Tupiza","U. E. 7 de Noviembre",88,1,0,1,67,8,17,4,3,189,1,4,194,222,0.354,0.874
"17764","Potosí","Tupiza","U. E. 7 de Noviembre",55,0,2,1,95,7,17,1,4,182,4,13,199,223,0.522,0.892
"17765","Potosí","Tupiza","U. E. 7 de Noviembre",81,0,0,1,73,6,11,1,2,175,4,6,185,214,0.417,0.864
"17766","Potosí","Tupiza","U. E. 7 de Noviembre",86,0,0,1,80,5,10,2,4,188,1,6,195,223,0.426,0.874
"17767","Potosí","Tupiza","U. E. 7 de Noviembre",78,2,4,3,63,3,25,1,0,179,5,15,199,229,0.352,0.869
"17768","Potosí","Tupiza","U. E. 7 de Noviembre",89,0,0,1,70,4,14,3,3,184,5,6,195,225,0.38,0.867
"17769","Potosí","Tupiza","U. E. 7 de Noviembre",70,0,0,2,64,10,13,0,1,160,7,16,183,225,0.4,0.813
"17770","Potosí","Tupiza","U. E. Maria Rita Romano",35,0,0,1,104,5,18,0,3,166,5,16,187,218,0.627,0.858
"17771","Potosí","Tupiza","U. E. Maria Rita Romano",53,0,0,1,94,4,17,1,2,172,5,12,189,223,0.547,0.848
"17772","Potosí","Tupiza","U. E. Maria Rita Romano",40,0,2,1,95,5,30,1,2,176,5,17,198,225,0.54,0.88
"17773","Potosí","Tupiza","U. E. Maria Rita Romano",42,0,2,0,106,4,16,0,3,173,3,7,183,218,0.613,0.839
"17774","Potosí","Tupiza","U. E. Maria Rita Romano",41,1,1,2,101,8,22,0,4,180,5,11,196,219,0.561,0.895
"17775","Potosí","Tupiza","U. E. Maria Rita Romano",38,0,2,0,100,9,16,1,2,168,9,16,193,218,0.595,0.885
"17776","Potosí","Tupiza","U. E. Maria Rita Romano",46,0,0,4,95,5,26,2,0,178,8,11,197,222,0.534,0.887
"17777","Potosí","Tupiza","U. E. Maria Rita Romano",54,0,0,2,100,5,19,1,0,181,1,17,199,228,0.552,0.873
"17778","Potosí","Tupiza","U. E. Maria Rita Romano",58,2,2,1,85,7,25,0,2,182,0,9,191,218,0.467,0.876
"17779","Potosí","Tupiza","Ins. Tec. José Luis San Juan Garcia",83,0,2,2,72,2,12,0,3,176,2,13,191,219,0.409,0.872
"17780","Potosí","Tupiza","Ins. Tec. José Luis San Juan Garcia",81,0,2,0,56,5,10,2,5,161,3,16,180,213,0.348,0.845
"17781","Potosí","Tupiza","Ins. Tec. José Luis San Juan Garcia",78,2,0,0,68,9,12,1,2,172,1,9,182,219,0.395,0.831
"17782","Potosí","Tupiza","Ins. Tec. José Luis San Juan Garcia",74,0,0,0,73,7,14,0,3,171,4,15,190,225,0.427,0.844
"17783","Potosí","Tupiza","Ins. Tec. José Luis San Juan Garcia",68,0,0,0,77,11,12,4,1,173,3,6,182,208,0.445,0.875
"17784","Potosí","Tupiza","Ins. Tec. José Luis San Juan Garcia",86,0,0,0,61,7,20,0,1,175,1,12,188,220,0.349,0.855
"17785","Potosí","Tupiza","Ins. Tec. José Luis San Juan Garcia",85,0,2,0,70,6,11,0,1,175,0,8,183,218,0.4,0.839
"17786","Potosí","Tupiza","Ins. Tec. José Luis San Juan Garcia",71,0,1,1,86,4,11,1,1,176,1,15,192,219,0.489,0.877
"17787","Potosí","Tupiza","Ins. Tec. José Luis San Juan Garcia",71,1,2,1,69,8,14,1,3,170,0,10,180,213,0.406,0.845
"17788","Potosí","Tupiza","Ins. Tec. José Luis San Juan Garcia",92,1,0,1,72,8,12,2,2,190,2,7,199,226,0.379,0.881
"17789","Potosí","Tupiza","Ins. Tec. José Luis San Juan Garcia",80,2,0,0,62,2,18,1,0,165,2,15,182,222,0.376,0.82
"17790","Potosí","Tupiza","Ins. Tec. José Luis San Juan Garcia",90,0,0,0,75,4,7,2,5,183,3,10,196,219,0.41,0.895
"17791","Potosí","Tupiza","Ins. Tec. José Luis San Juan Garcia",101,1,0,0,60,4,10,0,2,178,4,6,188,216,0.337,0.87
"17792","Potosí","Tupiza","Veterinaria Sub Sede UATF",74,0,0,0,88,4,18,1,4,189,4,17,210,235,0.466,0.894
"17793","Potosí","Tupiza","Veterinaria Sub Sede UATF",65,1,0,0,81,7,13,0,5,172,4,9,185,212,0.471,0.873
"17794","Potosí","Tupiza","Veterinaria Sub Sede UATF",53,5,0,1,83,4,13,0,3,162,0,17,179,213,0.512,0.84
"17795","Potosí","Tupiza","Veterinaria Sub Sede UATF",70,0,1,2,68,14,19,0,1,175,4,11,190,211,0.389,0.9
"17796","Potosí","Tupiza","Veterinaria Sub Sede UATF",60,0,0,1,88,8,11,1,2,171,4,6,181,209,0.515,0.866
"17797","Potosí","Tupiza","U. E. Bolivia de Tupiza",39,1,5,2,108,7,36,0,2,200,3,8,211,239,0.54,0.883
"17798","Potosí","Tupiza","U. E. Bolivia de Tupiza",40,1,1,2,114,3,33,0,2,196,6,10,212,236,0.582,0.898
"17799","Potosí","Tupiza","U. E. Bolivia de Tupiza",34,0,2,0,120,7,22,1,1,187,3,11,201,228,0.642,0.882
"17800","Potosí","Tupiza","U. E. Bolivia de Tupiza",49,3,2,1,99,9,24,1,3,191,3,11,205,229,0.518,0.895
"17801","Potosí","Tupiza","U. E. Bolivia de Tupiza",31,2,1,2,107,8,14,3,1,169,3,10,182,217,0.633,0.839
"17802","Potosí","Tupiza","U. E. Bolivia de Tupiza",47,1,1,1,99,9,11,0,1,170,2,12,184,214,0.582,0.86
"17803","Potosí","Tupiza","U. E. Bolivia de Tupiza",32,1,0,0,106,7,18,3,2,169,4,10,183,211,0.627,0.867
"17804","Potosí","Tupiza","U. E. Bolivia de Tupiza",26,1,1,2,92,8,20,0,2,152,6,12,170,203,0.605,0.837
"17805","Potosí","Tupiza","Esc. Villa Fatima Andres De Santa Cruz",63,1,3,1,75,8,23,4,0,178,3,14,195,215,0.421,0.907
"17806","Potosí","Tupiza","Esc. Villa Fatima Andres De Santa Cruz",53,0,2,1,96,3,18,0,3,176,6,9,191,214,0.545,0.893
"17807","Potosí","Tupiza","Esc. Villa Fatima Andres De Santa Cruz",45,1,1,1,87,4,28,2,2,171,4,10,185,217,0.509,0.853
"17808","Potosí","Tupiza","Esc. Villa Fatima Andres De Santa Cruz",49,1,2,1,106,7,23,1,3,193,3,8,204,226,0.549,0.903
"17809","Potosí","Tupiza","Esc. Villa Fatima Andres De Santa Cruz",55,0,2,1,98,3,17,0,1,177,4,12,193,215,0.554,0.898
"17810","Potosí","Tupiza","Esc. Villa Fatima Andres De Santa Cruz",61,1,0,2,86,2,21,0,2,175,6,14,195,220,0.491,0.886
"17811","Potosí","Tupiza","Esc. Villa Fatima Andres De Santa Cruz",46,1,1,0,103,5,23,0,3,182,6,25,213,237,0.566,0.899
"17812","Potosí","Tupiza","Esc. Villa Fatima Andres De Santa Cruz",47,1,1,1,98,6,25,3,7,189,5,9,203,235,0.519,0.864
"17813","Potosí","Tupiza","Esc. Villa Fatima Andres De Santa Cruz",52,0,1,2,105,9,26,0,3,198,2,8,208,234,0.53,0.889
"17814","Potosí","Tupiza","Esc. Villa Fatima Andres De Santa Cruz",43,1,1,1,105,9,24,2,1,187,7,14,208,234,0.561,0.889
"17815","Potosí","Tupiza","U. E. Paul Harris De Palala",35,0,1,2,123,7,22,1,3,194,25,10,229,229,0.634,1
"17816","Potosí","Tupiza","U. E. Genoveva Ríos",20,0,1,1,135,9,30,1,3,200,5,11,216,238,0.675,0.908
"17817","Potosí","Tupiza","U. E. Genoveva Ríos",17,1,0,0,114,3,28,1,3,167,4,15,186,205,0.683,0.907
"17818","Potosí","Tupiza","U. E. Tocloca",10,1,0,1,128,4,7,0,1,152,7,6,165,201,0.842,0.821
"17819","Potosí","Tupiza","U. E. Simón Bolívar de Esmoraca",10,2,0,0,133,3,20,3,2,173,6,14,193,213,0.769,0.906
"17820","Potosí","Tupiza","U. E. Suipacha",6,1,1,1,132,7,12,3,1,164,9,5,178,216,0.805,0.824
"17821","Potosí","Tupiza","U. E. Suipacha",7,3,0,0,128,9,5,1,0,153,9,12,174,208,0.837,0.837
"17822","Potosí","Tupiza","U. E. Salvador Revilla",9,0,0,0,132,5,6,1,0,153,8,9,170,211,0.863,0.806
"17823","Potosí","Tupiza","U. E. Reynecillas",13,1,0,0,131,3,2,0,2,152,1,7,160,196,0.862,0.816
"17824","Potosí","Tupiza","U. E. Bolivia de Supira",6,3,1,2,130,2,9,2,2,157,10,6,173,191,0.828,0.906
"17825","Potosí","Tupiza","U. E. Jose Luis San Juan Garcia de Quiriza",4,0,2,0,159,2,15,0,0,182,4,2,188,213,0.874,0.883
"17826","Potosí","Tupiza","U. E. Espicaya",7,1,1,1,107,6,26,0,2,151,7,11,169,206,0.709,0.82
"17827","Potosí","Tupiza","U. E. Chacopampa",4,0,0,0,145,4,8,0,0,161,3,7,171,220,0.901,0.777
"17828","Potosí","Tupiza","U. E. Gral. Rufino Carrasco",4,2,5,0,148,2,14,1,1,177,7,7,191,222,0.836,0.86
"17829","Potosí","Tupiza","U. E. Juana Azurduy De Padilla",28,4,3,1,117,2,14,10,5,184,1,12,197,220,0.636,0.895
"17830","Potosí","Tupiza","U. E. Juana Azurduy De Padilla",40,0,2,0,108,2,13,1,5,171,3,20,194,218,0.632,0.89
"17831","Potosí","Tupiza","U. E. San Juan Salo",5,1,0,0,168,2,11,0,5,192,6,4,202,225,0.875,0.898
"17832","Potosí","Tupiza","U. E. Mochara",3,1,1,1,187,2,7,1,1,204,7,12,223,240,0.917,0.929
"17833","Potosí","Tupiza","U. E. 6 de Junio de Charaja",5,0,1,0,154,17,12,0,5,194,6,13,213,231,0.794,0.922
"17834","Potosí","Atocha","Coleg. Gregorio Pacheco",46,1,0,0,109,7,20,0,3,186,5,3,194,217,0.586,0.894
"17835","Potosí","Atocha","Coleg. Gregorio Pacheco",51,2,3,1,100,9,16,0,4,186,2,7,195,224,0.538,0.871
"17836","Potosí","Atocha","Coleg. Gregorio Pacheco",52,1,1,1,109,10,11,0,1,186,5,10,201,221,0.586,0.91
"17837","Potosí","Atocha","Coleg. Gregorio Pacheco",56,0,0,1,85,5,14,2,1,164,5,14,183,212,0.518,0.863
"17838","Potosí","Atocha","Esc. Eduardo Avaroa",51,2,0,0,95,9,15,2,3,177,6,8,191,213,0.537,0.897
"17839","Potosí","Atocha","Esc. Eduardo Avaroa",38,2,1,1,110,10,13,1,3,179,3,16,198,223,0.615,0.888
"17840","Potosí","Atocha","Esc. Eduardo Avaroa",43,2,1,0,108,7,17,0,3,181,6,10,197,224,0.597,0.879
"17841","Potosí","Atocha","Unidad Educativa Telamayu",37,0,1,0,131,6,9,2,3,189,10,9,208,224,0.693,0.929
"17842","Potosí","Atocha","Unidad Educativa Telamayu",35,0,1,0,121,5,18,0,1,181,9,10,200,224,0.669,0.893
"17843","Potosí","Atocha","Esc. de Animas",27,0,0,2,146,8,16,0,0,199,8,5,212,229,0.734,0.926
"17844","Potosí","Atocha","Esc. de Animas",31,0,3,2,134,5,15,0,1,191,6,13,210,220,0.702,0.955
"17845","Potosí","Atocha","Esc. de Animas",36,1,3,0,129,7,10,1,1,188,8,15,211,228,0.686,0.925
"17846","Potosí","Atocha","Esc. de Siete Suyos",35,0,1,0,132,2,20,0,3,193,6,13,212,227,0.684,0.934
"17847","Potosí","Atocha","Esc. de Siete Suyos",16,2,2,3,127,10,23,3,2,188,8,8,204,227,0.676,0.899
"17848","Potosí","Atocha","Esc. Portugalete",6,0,2,1,178,1,13,0,0,201,3,6,210,225,0.886,0.933
"17849","Potosí","Atocha","Col. Chorolque",13,0,3,2,151,6,17,0,3,195,6,5,206,226,0.774,0.912
"17850","Potosí","Atocha","Col. Chorolque",14,0,2,0,157,4,9,1,0,187,3,17,207,219,0.84,0.945
"17851","Potosí","Atocha","Col. Chorolque",17,0,1,0,144,5,14,0,1,182,15,11,208,225,0.791,0.924
"17852","Potosí","Atocha","Col. Chorolque",20,0,1,1,154,4,13,2,5,200,4,5,209,227,0.77,0.921
"17853","Potosí","Atocha","Col. Chorolque",16,0,5,0,153,8,10,0,2,194,10,5,209,228,0.789,0.917
"17854","Potosí","Atocha","Esc. Julio Urquieta",19,0,3,0,140,2,20,0,5,189,4,15,208,222,0.741,0.937
"17855","Potosí","Atocha","Esc. Julio Urquieta",24,0,1,1,141,4,28,0,0,199,6,10,215,231,0.709,0.931
"17856","Potosí","Colcha K","U.E. Ricardo Rodriguez",52,0,1,1,79,7,51,1,6,198,1,10,209,234,0.399,0.893
"17857","Potosí","Colcha K","U.E. Ricardo Rodriguez",43,2,1,1,88,4,55,3,4,201,2,11,214,231,0.438,0.926
"17858","Potosí","Colcha K","U.E. Ricardo Rodriguez",35,2,2,2,91,3,48,1,2,186,2,18,206,230,0.489,0.896
"17859","Potosí","Colcha K","U.E. Ricardo Rodriguez",51,2,1,2,81,1,54,0,3,195,3,11,209,231,0.415,0.905
"17860","Potosí","Colcha K","U.E. Ricardo Rodriguez",47,1,0,2,89,4,49,0,2,194,4,6,204,226,0.459,0.903
"17861","Potosí","Colcha K","U.E. Ricardo Rodriguez",43,1,1,0,78,4,63,0,2,192,4,10,206,230,0.406,0.896
"17862","Potosí","Colcha K","U.E. Ricardo Rodriguez",35,1,1,0,87,6,71,1,5,207,5,8,220,233,0.42,0.944
"17863","Potosí","Colcha K","U.E. Ricardo Rodriguez",51,2,1,1,94,1,44,2,3,199,2,5,206,244,0.472,0.844
"17864","Potosí","Colcha K","U.E. Eduardo Abaroa - 300 - Culpina K",56,1,1,1,50,1,75,1,2,188,4,8,200,226,0.266,0.885
"17865","Potosí","Colcha K","U.E. Eduardo Abaroa - 300 - Culpina K",40,2,3,4,63,7,87,2,0,208,8,6,222,243,0.303,0.914
"17866","Potosí","Colcha K","U.E. Nuevo Amanecer",50,2,1,4,121,8,25,0,1,212,1,6,219,230,0.571,0.952
"17867","Potosí","Colcha K","U.E. Nuevo Amanecer",57,1,0,2,116,9,19,0,0,204,8,4,216,233,0.569,0.927
"17868","Potosí","Colcha K","U.E. Nuevo Amanecer",43,0,4,2,124,5,20,1,0,199,5,9,213,237,0.623,0.899
"17869","Potosí","Colcha K","Esc. Antofagasta",33,3,5,4,82,5,53,0,3,188,3,7,198,219,0.436,0.904
"17870","Potosí","Colcha K","U.E. Antofagasta",41,4,3,2,64,21,52,0,1,188,5,7,200,223,0.34,0.897
"17871","Potosí","Colcha K","U.E. 2 de Agosto",14,2,0,5,108,5,68,1,3,206,3,1,210,249,0.524,0.843
"17872","Potosí","Colcha K","U.E. Eduardo Abaroa de Villa Mar",26,2,4,1,94,5,52,1,0,185,11,7,203,227,0.508,0.894
"17873","Potosí","Colcha K","U.E. Tomas Frias",4,1,3,1,114,16,27,1,4,171,5,15,191,216,0.667,0.884
"17874","Potosí","Colcha K","U.E. Jose Ballivian",37,4,2,1,105,4,62,0,0,215,6,16,237,252,0.488,0.94
"17875","Potosí","Colcha K","U.E. Buenas Nuevas De Vinto K",62,1,3,1,91,7,30,2,0,197,6,14,217,234,0.462,0.927
"17876","Potosí","San Pedro de Quemes","U.E. Cecilio Veliz",40,2,2,1,118,3,5,1,0,172,6,7,185,228,0.686,0.811
"17877","Potosí","San Pablo","Esc. Quetena Chico",35,3,4,6,81,14,51,1,8,203,6,7,216,229,0.399,0.943
"17878","Potosí","San Antonio de Esmoruco","Esc. Central Calama",6,4,1,1,135,4,13,0,5,169,7,16,192,220,0.799,0.873
"17879","Potosí","Puna (Villa Talavera)","Esc. Jose Maria Linares",33,2,9,3,72,7,21,2,2,151,8,15,174,211,0.477,0.825
"17880","Potosí","Puna (Villa Talavera)","Esc. Jose Maria Linares",53,0,4,1,84,9,13,1,0,165,12,9,186,220,0.509,0.845
"17881","Potosí","Puna (Villa Talavera)","Coleg. Litoral",25,4,3,2,87,7,33,0,3,164,7,10,181,216,0.53,0.838
"17882","Potosí","Puna (Villa Talavera)","Coleg. Litoral",40,3,3,2,82,6,28,0,0,164,7,14,185,219,0.5,0.845
"17883","Potosí","Puna (Villa Talavera)","Esc. Yaspaci",19,0,5,4,96,6,15,1,5,151,3,7,161,213,0.636,0.756
"17884","Potosí","Puna (Villa Talavera)","U.E. Belen",19,3,9,2,100,2,34,1,1,171,9,7,187,218,0.585,0.858
"17885","Potosí","Puna (Villa Talavera)","U.E. Belen",16,5,6,3,99,5,34,0,2,170,7,5,182,219,0.582,0.831
"17886","Potosí","Puna (Villa Talavera)","U.E. Miculpaya",32,3,4,1,97,15,16,0,0,168,10,10,188,206,0.577,0.913
"17887","Potosí","Puna (Villa Talavera)","U.E. Miculpaya",20,2,3,0,119,3,15,2,1,165,5,7,177,210,0.721,0.843
"17888","Potosí","Puna (Villa Talavera)","U.E. Jose Alonso De Ibañez",17,2,3,0,123,3,8,1,3,160,7,17,184,213,0.769,0.864
"17889","Potosí","Puna (Villa Talavera)","U.E. 20 de Octubre",24,1,7,0,119,2,25,0,1,179,5,8,192,216,0.665,0.889
"17890","Potosí","Puna (Villa Talavera)","U.E. Otavi Simon Bolivar",12,1,5,2,125,5,17,0,2,169,5,3,177,213,0.74,0.831
"17891","Potosí","Puna (Villa Talavera)","U.E. Mariscal Andres De Santa Cruz de Kepallo",5,2,3,0,118,2,30,1,0,161,5,7,173,216,0.733,0.801
"17892","Potosí","Puna (Villa Talavera)","U.E. Mariscal Andres De Santa Cruz de Kepallo",17,1,8,0,113,4,22,0,2,167,5,5,177,218,0.677,0.812
"17893","Potosí","Puna (Villa Talavera)","Esc. De Nuqui",19,2,5,3,97,5,18,1,1,151,9,9,169,205,0.642,0.824
"17894","Potosí","Puna (Villa Talavera)","U.E. San Miguel de Huaycaya",19,1,19,1,73,2,53,0,6,174,7,4,185,214,0.42,0.864
"17895","Potosí","Puna (Villa Talavera)","Esc. Sepulturas",8,2,6,3,102,4,40,0,1,166,10,11,187,216,0.614,0.866
"17896","Potosí","Puna (Villa Talavera)","U.E. Raul Perez De Alkatuyo",23,1,12,1,73,8,44,2,1,165,8,10,183,216,0.442,0.847
"17897","Potosí","Puna (Villa Talavera)","U.E. Raul Perez De Alkatuyo",28,2,13,3,78,4,26,0,0,154,8,18,180,211,0.506,0.853
"17898","Potosí","Puna (Villa Talavera)","U.E. MOLINO PAMPA - 531 - Molino Pampa",11,1,4,2,118,3,13,2,0,154,4,2,160,202,0.766,0.792
"17899","Potosí","Puna (Villa Talavera)","U.E. Gerardo Maldini de Chacabuco (Estacion Chinoli)",14,3,5,2,127,5,11,3,1,171,6,9,186,219,0.743,0.849
"17900","Potosí","Puna (Villa Talavera)","U.E. Jose Maria Linares A",15,2,7,0,126,5,14,1,2,172,5,7,184,220,0.733,0.836
"17901","Potosí","Puna (Villa Talavera)","U. E. Marcelino Aguirre",7,3,1,3,167,0,13,2,0,196,24,8,228,240,0.852,0.95
"17902","Potosí","Caiza D","Normal Rural Caiza D",43,1,5,0,80,18,17,0,3,167,6,13,186,214,0.479,0.869
"17903","Potosí","Caiza D","Normal Rural Caiza D",43,2,6,2,86,9,21,0,1,170,2,8,180,210,0.506,0.857
"17904","Potosí","Caiza D","Normal Rural Caiza D",49,2,3,0,90,8,32,1,1,186,2,6,194,218,0.484,0.89
"17905","Potosí","Caiza D","Normal Rural Caiza D",44,3,7,1,80,6,24,1,2,168,6,10,184,210,0.476,0.876
"17906","Potosí","Caiza D","Normal Rural Caiza D",46,1,5,0,84,7,25,2,1,171,2,5,178,203,0.491,0.877
"17907","Potosí","Caiza D","Esc. Tuctapari",16,4,2,3,98,2,25,2,0,152,8,16,176,202,0.645,0.871
"17908","Potosí","Caiza D","Col. Franz Tamayo",31,4,12,1,68,13,44,0,3,176,10,13,199,227,0.386,0.877
"17909","Potosí","Caiza D","Col. Franz Tamayo",37,3,18,2,68,12,40,0,0,180,7,10,197,218,0.378,0.904
"17910","Potosí","Caiza D","U.E. 21 de Septiembre de la Lava",17,3,5,0,85,9,42,5,0,166,2,8,176,208,0.512,0.846
"17911","Potosí","Caiza D","U.E. 21 de Septiembre de la Lava",13,4,0,2,96,5,41,0,0,161,9,10,180,214,0.596,0.841
"17912","Potosí","Caiza D","U.E. San Bartolome",22,4,11,3,64,7,36,1,3,151,20,11,182,211,0.424,0.863
"17913","Potosí","Caiza D","U.E. Fragua",6,0,2,0,148,2,12,0,0,170,1,4,175,205,0.871,0.854
"17914","Potosí","Caiza D","U.E. Mcal. Antonio Jose De Sucre De Tres Cruces",23,0,9,0,121,4,27,3,3,190,8,7,205,228,0.637,0.899
"17915","Potosí","Caiza D","U.E. Mcal. Antonio Jose De Sucre De Tres Cruces",22,2,8,1,95,4,42,1,2,177,8,11,196,223,0.537,0.879
"17916","Potosí","Caiza D","U.E. Mcal. Antonio Jose De Sucre De Tres Cruces",8,2,9,2,121,3,40,0,0,185,2,4,191,223,0.654,0.857
"17917","Potosí","Caiza D","U.E. Mcal. Antonio Jose De Sucre De Tres Cruces",11,1,4,1,121,3,33,0,2,176,3,14,193,221,0.688,0.873
"17918","Potosí","Caiza D","U.E. Mcal. Antonio Jose De Sucre De Tres Cruces",18,2,11,3,110,3,32,0,3,182,5,12,199,230,0.604,0.865
"17919","Potosí","Ckochas","Esc. Duraznos",5,2,0,1,129,6,10,3,0,156,2,6,164,201,0.827,0.816
"17920","Potosí","Ckochas","Esc. Seccional",2,3,2,0,143,0,5,0,1,156,6,19,181,223,0.917,0.812
"17921","Potosí","Ckochas","Esc. Seccional",2,4,1,0,136,5,2,2,3,155,3,16,174,221,0.877,0.787
"17922","Potosí","Ckochas","Esc. De Mojon Ckasa",1,1,2,0,150,1,12,1,1,169,4,6,179,216,0.888,0.829
"17923","Potosí","Ckochas","Esc. De Mojon Ckasa",9,2,2,3,131,3,9,0,0,159,6,13,178,206,0.824,0.864
"17924","Potosí","Ckochas","Esc. De Calapaya",15,4,5,2,106,3,23,2,1,161,13,8,182,221,0.658,0.824
"17925","Potosí","Ckochas","Esc. Ckochas",20,0,4,1,116,4,26,0,0,171,12,8,191,219,0.678,0.872
"17926","Potosí","Ckochas","Esc. Ckochas",18,0,3,1,125,4,14,3,1,169,5,12,186,218,0.74,0.853
"17927","Potosí","Ckochas","Esc. Ckochas",14,2,1,1,132,2,22,0,0,174,4,9,187,217,0.759,0.862
"17928","Potosí","Ckochas","U.E. Franz Tamayo",13,0,3,2,160,5,11,1,1,196,3,8,207,219,0.816,0.945
"17929","Potosí","Ckochas","Esc. Media Luna",3,4,1,0,175,1,4,0,1,189,5,4,198,230,0.926,0.861
"17930","Potosí","Ckochas","Esc. Seucochi",4,1,2,1,157,1,4,5,0,175,5,12,192,227,0.897,0.846
"17931","Potosí","Ckochas","Esc. Seucochi",1,1,2,2,155,2,10,0,0,173,6,12,191,234,0.896,0.816
"17932","Potosí","Ckochas","U.E. Alejandro Coronado",13,2,3,0,109,3,27,0,1,158,6,7,171,203,0.69,0.842
"17933","Potosí","Ckochas","U.E. Eusebio Baltazar Flores",1,0,2,1,171,2,6,1,0,184,4,9,197,229,0.929,0.86
"17934","Potosí","Ckochas","Esc. Seccional Uyuni",6,3,1,1,150,9,16,1,1,188,4,6,198,222,0.798,0.892
"17935","Potosí","Ckochas","U.E. Rodeo Pampa",2,0,1,3,161,3,3,1,0,174,10,15,199,210,0.925,0.948
"17936","Potosí","Uyuni","Sub Sede Univ. Economia",56,0,5,5,80,11,24,0,4,185,4,8,197,227,0.432,0.868
"17937","Potosí","Uyuni","Sub Sede Univ. Economia",43,2,6,1,68,5,35,2,3,165,8,12,185,226,0.412,0.819
"17938","Potosí","Uyuni","Sub Sede Univ. Economia",47,1,1,2,84,7,19,4,2,167,6,20,193,227,0.503,0.85
"17939","Potosí","Uyuni","Sub Sede Univ. Economia",48,0,1,0,103,7,20,0,7,186,3,9,198,226,0.554,0.876
"17940","Potosí","Uyuni","Sub Sede Univ. Economia",39,1,4,3,97,6,29,1,3,183,5,9,197,225,0.53,0.876
"17941","Potosí","Uyuni","Sub Sede Univ. Economia",38,0,0,4,84,9,40,1,4,180,6,13,199,224,0.467,0.888
"17942","Potosí","Uyuni","Sub Sede Univ. Economia",55,1,0,2,87,6,21,0,2,174,6,17,197,229,0.5,0.86
"17943","Potosí","Uyuni","Sub Sede Univ. Economia",51,0,6,1,84,11,26,0,1,180,4,7,191,223,0.467,0.857
"17944","Potosí","Uyuni","Sub Sede Univ. Economia",51,0,1,2,75,7,31,1,1,169,4,10,183,220,0.444,0.832
"17945","Potosí","Uyuni","Sub Sede Univ. Economia",70,1,1,2,68,9,32,1,1,185,6,7,198,229,0.368,0.865
"17946","Potosí","Uyuni","U.E. Uyuni A",75,1,4,1,83,4,18,0,1,187,5,13,205,230,0.444,0.891
"17947","Potosí","Uyuni","U.E. Uyuni A",67,1,2,0,52,5,26,0,3,156,7,24,187,222,0.333,0.842
"17948","Potosí","Uyuni","U.E. Uyuni A",81,1,3,3,67,8,17,0,2,182,4,3,189,221,0.368,0.855
"17949","Potosí","Uyuni","U.E. Uyuni A",66,0,3,1,72,11,33,0,4,190,2,17,209,228,0.379,0.917
"17950","Potosí","Uyuni","U.E. Uyuni A",62,0,4,2,68,11,25,1,1,174,3,9,186,222,0.391,0.838
"17951","Potosí","Uyuni","U.E. Uyuni A",69,1,0,2,65,17,24,0,3,181,7,6,194,223,0.359,0.87
"17952","Potosí","Uyuni","U.E. Uyuni A",69,0,4,4,74,10,31,0,3,195,4,9,208,226,0.379,0.92
"17953","Potosí","Uyuni","U.E. Uyuni A",90,0,1,3,63,3,12,3,1,176,4,7,187,220,0.358,0.85
"17954","Potosí","Uyuni","U.E. Uyuni A",79,2,4,3,77,5,23,0,0,193,2,6,201,224,0.399,0.897
"17955","Potosí","Uyuni","U.E. Uyuni A",79,1,5,1,65,3,23,1,1,179,4,3,186,219,0.363,0.849
"17956","Potosí","Uyuni","U.E. Potosi",53,0,5,2,74,12,35,1,4,186,3,4,193,224,0.398,0.862
"17957","Potosí","Uyuni","U.E. Potosi",60,2,2,1,72,6,30,0,2,175,4,13,192,223,0.411,0.861
"17958","Potosí","Uyuni","U.E. Potosi",58,0,4,3,63,12,24,1,4,169,5,14,188,230,0.373,0.817
"17959","Potosí","Uyuni","U.E. Potosi",66,1,3,1,75,4,24,0,2,176,3,13,192,224,0.426,0.857
"17960","Potosí","Uyuni","U.E. Potosi",62,3,2,1,70,14,29,0,4,185,1,18,204,229,0.378,0.891
"17961","Potosí","Uyuni","U.E. Potosi",74,1,1,1,54,6,31,1,4,173,3,16,192,223,0.312,0.861
"17962","Potosí","Uyuni","U.E. Potosi",60,0,2,2,81,8,16,1,2,172,4,20,196,224,0.471,0.875
"17963","Potosí","Uyuni","U.E. Jaime De Zudañes",70,0,2,1,62,8,32,1,6,182,1,13,196,225,0.341,0.871
"17964","Potosí","Uyuni","U.E. Jaime De Zudañes",72,0,0,0,58,5,35,3,0,173,2,8,183,230,0.335,0.796
"17965","Potosí","Uyuni","U.E. Jaime De Zudañes",69,1,3,1,61,2,35,2,4,178,1,14,193,226,0.343,0.854
"17966","Potosí","Uyuni","U.E. Jaime De Zudañes",76,1,5,2,72,8,19,0,2,185,3,9,197,224,0.389,0.879
"17967","Potosí","Uyuni","U.E. Jaime De Zudañes",56,0,1,2,66,3,30,1,1,160,8,7,175,233,0.412,0.751
"17968","Potosí","Uyuni","U.E. Jaime De Zudañes",66,1,3,0,76,6,22,1,1,176,3,13,192,230,0.432,0.835
"17969","Potosí","Uyuni","U.E. Jaime De Zudañes",76,0,2,2,75,5,31,1,0,192,4,6,202,233,0.391,0.867
"17970","Potosí","Uyuni","U.E. Jaime De Zudañes",81,0,2,3,60,2,27,0,3,178,1,5,184,223,0.337,0.825
"17971","Potosí","Uyuni","U.E. Jaime De Zudañes",73,0,5,5,64,5,31,1,3,187,1,6,194,226,0.342,0.858
"17972","Potosí","Uyuni","U.E. Jaime De Zudañes",56,2,1,1,69,7,28,0,1,165,7,14,186,226,0.418,0.823
"17973","Potosí","Uyuni","U.E. Jaime De Zudañes",66,1,1,1,70,9,28,1,1,178,4,11,193,229,0.393,0.843
"17974","Potosí","Uyuni","U.E. Jaime De Zudañes",67,0,3,1,68,0,28,1,2,170,2,9,181,229,0.4,0.79
"17975","Potosí","Uyuni","U.E. Jaime De Zudañes",79,1,1,3,61,6,23,3,2,179,5,10,194,228,0.341,0.851
"17976","Potosí","Uyuni","U.E. Jaime De Zudañes",59,0,1,0,76,6,27,1,2,172,5,8,185,230,0.442,0.804
"17977","Potosí","Uyuni","U.E. Jaime De Zudañes",82,0,2,0,66,5,25,0,1,181,1,7,189,224,0.365,0.844
"17978","Potosí","Uyuni","U.E. Jaime De Zudañes",85,0,2,0,57,6,26,0,3,179,4,11,194,229,0.318,0.847
"17979","Potosí","Uyuni","U.E. Antonio Quijarro",68,2,1,1,71,6,29,1,1,180,4,5,189,221,0.394,0.855
"17980","Potosí","Uyuni","U.E. Antonio Quijarro",60,1,2,0,68,8,31,1,7,178,3,12,193,230,0.382,0.839
"17981","Potosí","Uyuni","U.E. Antonio Quijarro",65,1,6,1,68,5,26,0,4,176,4,12,192,227,0.386,0.846
"17982","Potosí","Uyuni","U.E. Antonio Quijarro",72,1,2,0,66,11,30,5,0,187,1,9,197,228,0.353,0.864
"17983","Potosí","Uyuni","U.E. Antonio Quijarro",81,0,2,1,63,5,25,0,4,181,3,7,191,223,0.348,0.857
"17984","Potosí","Uyuni","U.E. Antonio Quijarro",58,1,2,4,60,10,33,0,3,171,4,14,189,228,0.351,0.829
"17985","Potosí","Uyuni","U.E. Antonio Quijarro",64,0,6,2,77,13,25,1,2,190,3,15,208,228,0.405,0.912
"17986","Potosí","Uyuni","U.E. Antonio Quijarro",68,2,6,0,69,7,28,0,3,183,1,6,190,224,0.377,0.848
"17987","Potosí","Uyuni","U.E. Antonio Quijarro",56,1,6,2,70,8,27,0,4,174,5,6,185,220,0.402,0.841
"17988","Potosí","Uyuni","U.E. Antonio Quijarro",63,2,4,2,69,6,26,0,4,176,3,8,187,229,0.392,0.817
"17989","Potosí","Uyuni","U.E. Antonio Quijarro",54,2,4,0,74,7,36,1,4,182,1,13,196,228,0.407,0.86
"17990","Potosí","Uyuni","U.E. Antonio Quijarro",69,1,2,1,73,7,41,1,5,200,2,9,211,232,0.365,0.909
"17991","Potosí","Uyuni","U.E. Antonio Quijarro",58,0,2,0,68,7,40,0,6,181,5,11,197,227,0.376,0.868
"17992","Potosí","Uyuni","U.E. Antonio Quijarro",60,1,3,2,67,6,31,0,2,172,6,15,193,229,0.39,0.843
"17993","Potosí","Uyuni","U.E. Antonio Quijarro",57,1,5,2,69,7,32,0,4,177,6,10,193,231,0.39,0.835
"17994","Potosí","Uyuni","U.E. Miraflores",59,1,1,0,84,8,48,2,1,204,3,10,217,237,0.412,0.916
"17995","Potosí","Uyuni","U.E. Miraflores",50,0,2,0,84,8,49,1,4,198,6,14,218,240,0.424,0.908
"17996","Potosí","Uyuni","U.E. Miraflores",43,3,0,0,87,9,59,0,3,204,4,9,217,240,0.426,0.904
"17997","Potosí","Uyuni","U.E. Juana Azurduy De Padilla - 25493 - Uyuni",64,0,4,0,75,5,48,0,3,199,1,7,207,236,0.377,0.877
"17998","Potosí","Uyuni","U.E. Juana Azurduy De Padilla - 25493 - Uyuni",56,0,4,1,81,9,35,1,2,189,1,17,207,240,0.429,0.863
"17999","Potosí","Uyuni","U.E. Juana Azurduy De Padilla - 25493 - Uyuni",76,0,2,0,64,8,33,0,3,186,2,13,201,238,0.344,0.845
"18000","Potosí","Uyuni","U.E. Juana Azurduy De Padilla - 25493 - Uyuni",64,0,0,0,79,6,33,1,2,185,4,10,199,239,0.427,0.833
"18001","Potosí","Uyuni","U.E. Mariscal De Ayacucho",13,2,0,3,120,5,9,2,4,158,5,16,179,208,0.759,0.861
"18002","Potosí","Uyuni","U.E. Katarina Krsul",40,1,1,4,85,13,25,1,3,173,11,11,195,219,0.491,0.89
"18003","Potosí","Uyuni","U.E. Katarina Krsul",39,4,2,5,93,10,23,2,3,181,8,6,195,225,0.514,0.867
"18004","Potosí","Uyuni","U.E. Katarina Krsul",35,3,2,1,84,18,33,0,2,178,5,18,201,223,0.472,0.901
"18005","Potosí","Uyuni","U.E. Rio Mulato",20,3,4,3,89,12,47,1,1,180,8,14,202,217,0.494,0.931
"18006","Potosí","Uyuni","U.E. Rio Mulato",27,2,5,3,88,8,42,1,3,179,7,9,195,211,0.492,0.924
"18007","Potosí","Uyuni","U.E. Ricardo Rodriguez",11,2,1,2,114,14,23,1,5,173,10,12,195,222,0.659,0.878
"18008","Potosí","Uyuni","U.E. Pulacayo A",55,1,2,4,89,6,13,1,3,174,7,11,192,216,0.511,0.889
"18009","Potosí","Uyuni","U.E. Eduardo Avaroa",47,1,5,4,86,19,20,1,1,184,4,12,200,217,0.467,0.922
"18010","Potosí","Uyuni","U.E. German Busch",58,0,2,2,91,7,28,1,3,192,3,2,197,228,0.474,0.864
"18011","Potosí","Uyuni","U.E. German Busch",61,1,2,1,77,8,35,1,2,188,8,9,205,238,0.41,0.861
"18012","Potosí","Uyuni","U.E. Mariscal Braun",7,1,2,1,138,4,25,1,3,182,6,15,203,215,0.758,0.944
"18013","Potosí","Uyuni","U.E. Gualberto Villarroel",14,2,2,3,99,2,50,1,4,177,5,10,192,218,0.559,0.881
"18014","Potosí","Uyuni","U.E. Juan Sanjinez",27,1,2,0,100,10,40,2,2,184,4,4,192,220,0.543,0.873
"18015","Potosí","Uyuni","U.E. Juan Sanjinez",18,3,8,3,105,7,22,0,2,168,7,12,187,220,0.625,0.85
"18016","Potosí","Tomave","U.E. Franz Tamayo - 385 - Calazaya",44,1,1,1,85,12,11,2,2,159,7,6,172,203,0.535,0.847
"18017","Potosí","Tomave","U.E. Mariscal Jose De Sucre",22,2,7,3,98,11,30,0,3,176,6,6,188,220,0.557,0.855
"18018","Potosí","Tomave","U.E. Mariscal Jose De Sucre",24,3,4,2,92,11,38,1,7,182,9,11,202,225,0.505,0.898
"18019","Potosí","Tomave","U.E. Mariscal Jose De Sucre",27,3,6,3,77,8,33,0,17,174,11,13,198,223,0.443,0.888
"18020","Potosí","Tomave","U.E. German Busch - 389 - Tauro",10,3,6,3,157,5,15,0,2,201,1,2,204,233,0.781,0.876
"18021","Potosí","Tomave","Esc. Mariscal Sucre",38,1,3,2,98,5,18,3,0,168,5,15,188,221,0.583,0.851
"18022","Potosí","Tomave","Esc. Mariscal Sucre",23,4,7,4,95,6,25,1,2,167,10,10,187,221,0.569,0.846
"18023","Potosí","Tomave","Col. Elizardo Perez A",14,1,0,2,121,15,26,2,2,183,7,6,196,216,0.661,0.907
"18024","Potosí","Tomave","Col. Elizardo Perez A",14,0,4,2,115,6,32,4,2,179,7,14,200,220,0.642,0.909
"18025","Potosí","Tomave","Col. Elizardo Perez A",11,4,1,6,121,11,30,0,4,188,10,10,208,224,0.644,0.929
"18026","Potosí","Tomave","U.E. Simon Bolivar - 399 - Tacora",7,1,1,0,168,4,6,0,0,187,0,18,205,208,0.898,0.986
"18027","Potosí","Tomave","U.E. Tomas Frias",25,2,15,13,86,15,23,1,5,185,9,9,203,221,0.465,0.919
"18028","Potosí","Tomave","U.E. Franz Tamayo - 475 - Pelca",20,1,4,0,132,14,16,0,3,190,4,10,204,219,0.695,0.932
"18029","Potosí","Tomave","Col. Simon Rodriguez Carreño",46,0,2,1,82,12,14,1,16,174,3,9,186,208,0.471,0.894
"18030","Potosí","Porco","U.E. Santa Rosa",91,2,0,2,41,7,48,0,4,195,3,13,211,231,0.21,0.913
"18031","Potosí","Porco","U.E. Santa Rosa",86,2,1,0,46,8,46,1,0,190,5,12,207,236,0.242,0.877
"18032","Potosí","Porco","U.E. Santa Rosa",105,3,1,2,47,6,28,2,2,196,4,6,206,228,0.24,0.904
"18033","Potosí","Porco","U.E. Santa Rosa",84,0,3,3,55,10,29,0,1,185,6,15,206,231,0.297,0.892
"18034","Potosí","Porco","U.E. Santa Rosa",93,0,2,2,43,10,43,0,3,196,4,9,209,234,0.219,0.893
"18035","Potosí","Porco","U.E. Santa Rosa",91,3,1,4,53,11,30,2,3,198,3,7,208,224,0.268,0.929
"18036","Potosí","Porco","U.E. Santa Rosa",105,0,2,3,41,11,29,1,3,195,1,7,203,232,0.21,0.875
"18037","Potosí","Porco","U.E. Santa Rosa",74,0,1,1,34,6,34,0,1,151,6,11,168,188,0.225,0.894
"18038","Potosí","Porco","U.E. Jose Maria Linares",101,0,0,3,41,13,23,1,3,185,5,10,200,228,0.222,0.877
"18039","Potosí","Porco","U.E. Jose Maria Linares",102,0,1,4,42,12,30,1,3,195,5,11,211,232,0.215,0.909
"18040","Potosí","Porco","U.E. Jose Maria Linares",111,4,2,4,35,3,27,1,7,194,6,11,211,232,0.18,0.909
"18041","Potosí","Porco","U.E. Jose Maria Linares",94,2,4,1,43,12,36,0,5,197,6,9,212,236,0.218,0.898
"18042","Potosí","Porco","U.E. Jose Maria Linares",99,1,4,1,39,12,41,1,2,200,2,8,210,231,0.195,0.909
"18043","Potosí","Porco","U.E. Jose Maria Linares",93,2,2,3,39,9,30,2,2,182,2,11,195,220,0.214,0.886
"18044","Potosí","Porco","Esc. Agua Castilla",89,2,3,1,44,12,32,1,3,187,4,12,203,226,0.235,0.898
"18045","Potosí","Porco","Esc. Agua Castilla",88,1,1,2,51,6,36,0,4,189,6,17,212,231,0.27,0.918
"18046","Potosí","Porco","Esc. Agua Castilla",101,0,3,1,53,5,26,1,4,194,2,8,204,230,0.273,0.887
"18047","Potosí","Porco","Esc. Agua Castilla",98,0,3,1,43,3,32,1,6,187,4,19,210,233,0.23,0.901
"18048","Potosí","Porco","Esc. Agua Castilla",110,1,1,0,37,6,26,0,2,183,6,14,203,221,0.202,0.919
"18049","Potosí","Arampampa","Esc. Arampampa",25,3,2,0,120,3,8,0,2,163,8,8,179,222,0.736,0.806
"18050","Potosí","Arampampa","Esc. Sarcuri",0,0,0,0,169,1,0,0,0,170,0,0,170,207,0.994,0.821
"18051","Potosí","Arampampa","Esc. Santiago",8,0,1,0,151,1,1,0,0,162,7,3,172,223,0.932,0.771
"18052","Potosí","Acasio","Esc. Jose Rivero",21,0,4,2,113,2,8,2,0,152,8,8,168,211,0.743,0.796
"18053","Potosí","Acasio","Esc. Jose Rivero",19,1,3,3,135,2,5,1,2,171,3,9,183,215,0.789,0.851
"18054","Potosí","Acasio","Esc. Jose Rivero",24,0,6,3,132,2,7,2,0,176,8,14,198,234,0.75,0.846
"18055","Potosí","Acasio","Esc. Churitaca",2,6,0,0,164,0,2,2,1,177,7,6,190,226,0.927,0.841
"18056","Potosí","Acasio","Esc. Churitaca",3,2,1,1,166,0,4,1,0,178,4,2,184,211,0.933,0.872
"18057","Potosí","Acasio","Esc. Taconi Yambata",2,0,2,0,148,0,2,1,0,155,7,2,164,217,0.955,0.756
"18058","Potosí","Acasio","Esc. Tuquiza",2,0,3,1,165,0,1,1,0,173,9,3,185,213,0.954,0.869
"18059","Potosí","Acasio","Esc. Piriquina",6,1,2,0,159,0,0,1,0,169,1,11,181,212,0.941,0.854
"18060","Potosí","Llica","U.E. Franz Tamayo - Recinto 426 - Llica",31,0,3,0,114,3,23,0,1,175,2,6,183,224,0.651,0.817
"18061","Potosí","Llica","U.E. Franz Tamayo - Recinto 426 - Llica",36,1,6,2,105,6,19,0,7,182,1,7,190,221,0.577,0.86
"18062","Potosí","Llica","U.E. Franz Tamayo - Recinto 426 - Llica",21,0,2,1,127,6,15,0,3,175,3,6,184,225,0.726,0.818
"18063","Potosí","Llica","U.E. Franz Tamayo - Recinto 426 - Llica",14,1,2,1,139,4,19,1,2,183,2,7,192,227,0.76,0.846
"18064","Potosí","Llica","U.E. Franz Tamayo - Recinto 426 - Llica",30,0,5,2,111,7,26,0,1,182,12,9,203,231,0.61,0.879
"18065","Potosí","Llica","U.E. Franz Tamayo - Recinto 426 - Llica",17,0,2,1,116,4,20,0,2,162,1,8,171,221,0.716,0.774
"18066","Potosí","Tahua","U.E. John F. Kennedy",23,0,0,1,144,3,8,0,0,179,8,7,194,218,0.804,0.89
"18067","Potosí","Villazón","U.E. Alonso De Ibañez",20,2,2,0,117,2,17,0,3,163,1,12,176,222,0.718,0.793
"18068","Potosí","Villazón","U.E. Alonso De Ibañez",16,0,1,0,116,4,22,2,0,161,5,7,173,228,0.72,0.759
"18069","Potosí","Villazón","U.E. Alonso De Ibañez",15,2,1,0,123,5,15,1,2,164,7,12,183,222,0.75,0.824
"18070","Potosí","Villazón","U.E. Alonso De Ibañez",16,1,1,1,106,4,27,1,1,158,3,5,166,218,0.671,0.761
"18071","Potosí","Villazón","U.E. Alonso De Ibañez",18,0,1,0,105,10,26,0,0,160,4,1,165,226,0.656,0.73
"18072","Potosí","Villazón","U.E. Alonso De Ibañez",15,1,0,0,115,4,26,0,1,162,8,8,178,230,0.71,0.774
"18073","Potosí","Villazón","U.E. Alonso De Ibañez",15,2,5,3,105,3,21,0,1,155,8,10,173,221,0.677,0.783
"18074","Potosí","Villazón","U.E. Alonso De Ibañez",23,0,0,0,101,3,28,1,1,157,6,11,174,228,0.643,0.763
"18075","Potosí","Villazón","U.E. Alonso De Ibañez",17,1,1,1,115,4,23,1,1,164,3,17,184,227,0.701,0.811
"18076","Potosí","Villazón","U.E. Alonso De Ibañez",14,0,1,1,117,1,24,0,1,159,5,14,178,228,0.736,0.781
"18077","Potosí","Villazón","U.E. Alonso De Ibañez",23,2,3,0,100,3,24,1,1,157,6,10,173,224,0.637,0.772
"18078","Potosí","Villazón","U.E. Alonso De Ibañez",24,0,0,1,102,4,25,0,2,158,8,13,179,233,0.646,0.768
"18079","Potosí","Villazón","U.E. 1ro de Mayo",26,1,3,0,115,3,19,0,3,170,2,15,187,227,0.676,0.824
"18080","Potosí","Villazón","U.E. 1ro de Mayo",25,1,3,1,117,3,28,0,1,179,5,8,192,223,0.654,0.861
"18081","Potosí","Villazón","U.E. 1ro de Mayo",21,1,0,0,125,3,18,0,2,170,5,16,191,226,0.735,0.845
"18082","Potosí","Villazón","U.E. 1ro de Mayo",24,1,1,0,119,3,31,0,0,179,4,7,190,226,0.665,0.841
"18083","Potosí","Villazón","U.E. 1ro de Mayo",21,0,3,1,117,10,17,0,1,170,5,21,196,229,0.688,0.856
"18084","Potosí","Villazón","U.E. 1ro de Mayo",25,2,4,1,113,3,23,0,2,173,3,15,191,224,0.653,0.853
"18085","Potosí","Villazón","U.E. 1ro de Mayo",27,0,3,1,129,6,18,0,3,187,5,9,201,224,0.69,0.897
"18086","Potosí","Villazón","U.E. 1ro de Mayo",31,2,1,0,117,6,21,2,0,180,2,11,193,233,0.65,0.828
"18087","Potosí","Villazón","U.E. 1ro de Mayo",31,1,2,0,112,4,29,0,3,182,5,7,194,224,0.615,0.866
"18088","Potosí","Villazón","U.E. 1ro de Mayo",18,0,1,0,123,2,26,0,1,171,5,9,185,231,0.719,0.801
"18089","Potosí","Villazón","U.E. 1ro de Mayo",13,0,3,1,118,8,30,1,2,176,2,13,191,223,0.67,0.857
"18090","Potosí","Villazón","U.E. 1ro de Mayo",22,0,2,0,121,9,19,0,2,175,4,10,189,224,0.691,0.844
"18091","Potosí","Villazón","U.E. 1ro de Mayo",16,1,0,0,123,1,34,0,0,175,10,11,196,228,0.703,0.86
"18092","Potosí","Villazón","U.E. 1ro de Mayo",24,2,2,0,109,3,24,0,4,168,6,14,188,228,0.649,0.825
"18093","Potosí","Villazón","U.E. 1ro de Mayo",29,1,2,0,112,2,23,0,3,172,5,10,187,226,0.651,0.827
"18094","Potosí","Villazón","U.E. 1ro de Mayo",22,1,0,0,125,2,30,1,1,182,3,17,202,225,0.687,0.898
"18095","Potosí","Villazón","U.E. 1ro de Mayo",22,1,0,1,130,3,21,0,2,180,8,16,204,232,0.722,0.879
"18096","Potosí","Villazón","U.E. 1ro de Mayo",23,0,2,1,110,5,27,0,1,169,1,19,189,220,0.651,0.859
"18097","Potosí","Villazón","U.E. 1ro de Mayo",26,2,4,1,112,6,28,2,1,182,1,10,193,226,0.615,0.854
"18098","Potosí","Villazón","U.E. 1ro de Mayo",22,1,1,0,125,3,30,1,2,185,4,8,197,234,0.676,0.842
"18099","Potosí","Villazón","U.E. 1ro de Mayo",23,1,2,2,135,4,30,0,0,197,2,5,204,235,0.685,0.868
"18100","Potosí","Villazón","U.E. 1ro de Mayo",22,0,3,0,140,2,24,1,1,193,1,6,200,236,0.725,0.847
"18101","Potosí","Villazón","Esc. Cornelio Saavedra",52,0,1,0,93,3,13,0,1,163,6,12,181,220,0.571,0.823
"18102","Potosí","Villazón","Esc. Cornelio Saavedra",59,0,1,1,84,3,17,0,1,166,3,9,178,224,0.506,0.795
"18103","Potosí","Villazón","Esc. Cornelio Saavedra",34,0,6,0,98,3,27,0,5,173,2,7,182,221,0.566,0.824
"18104","Potosí","Villazón","Esc. Cornelio Saavedra",49,0,1,0,90,4,24,0,0,168,2,7,177,227,0.536,0.78
"18105","Potosí","Villazón","Esc. Cornelio Saavedra",34,0,2,0,93,4,23,1,0,157,4,15,176,219,0.592,0.804
"18106","Potosí","Villazón","Esc. Cornelio Saavedra",41,0,3,0,93,3,15,0,1,156,3,6,165,212,0.596,0.778
"18107","Potosí","Villazón","Esc. Cornelio Saavedra",43,1,3,0,103,3,19,0,1,173,3,5,181,222,0.595,0.815
"18108","Potosí","Villazón","Esc. Cornelio Saavedra",37,0,3,0,117,4,19,1,2,183,0,5,188,227,0.639,0.828
"18109","Potosí","Villazón","Esc. Cornelio Saavedra",59,0,0,1,83,2,23,1,0,169,2,5,176,223,0.491,0.789
"18110","Potosí","Villazón","Esc. Cornelio Saavedra",51,1,3,0,86,10,12,0,3,166,1,2,169,221,0.518,0.765
"18111","Potosí","Villazón","Esc. Cornelio Saavedra",49,2,1,1,89,6,26,0,1,175,4,9,188,229,0.509,0.821
"18112","Potosí","Villazón","Esc. Cornelio Saavedra",63,0,1,2,76,8,13,2,2,167,2,7,176,225,0.455,0.782
"18113","Potosí","Villazón","Esc. Cornelio Saavedra",43,1,1,0,92,3,16,0,1,157,1,11,169,218,0.586,0.775
"18114","Potosí","Villazón","Esc. Max Fernandez",42,0,2,1,115,9,14,0,1,184,3,4,191,230,0.625,0.83
"18115","Potosí","Villazón","Esc. Max Fernandez",27,1,0,0,100,10,22,0,4,164,6,13,183,220,0.61,0.832
"18116","Potosí","Villazón","Esc. Max Fernandez",24,0,2,3,110,4,28,1,1,173,1,19,193,227,0.636,0.85
"18117","Potosí","Villazón","Esc. Max Fernandez",25,1,0,0,117,7,25,0,1,176,5,12,193,227,0.665,0.85
"18118","Potosí","Villazón","Esc. Max Fernandez",20,0,2,0,121,7,26,1,2,179,4,8,191,231,0.676,0.827
"18119","Potosí","Villazón","Esc. Max Fernandez",40,0,6,0,106,4,20,0,1,177,5,10,192,225,0.599,0.853
"18120","Potosí","Villazón","Esc. Max Fernandez",23,2,2,0,110,4,22,3,2,168,5,13,186,229,0.655,0.812
"18121","Potosí","Villazón","Esc. Max Fernandez",28,0,4,1,108,11,12,2,0,166,5,9,180,220,0.651,0.818
"18122","Potosí","Villazón","Esc. Max Fernandez",36,4,2,1,104,2,21,0,1,171,1,19,191,227,0.608,0.841
"18123","Potosí","Villazón","Esc. Max Fernandez",32,1,2,2,115,6,17,0,4,179,4,5,188,228,0.642,0.825
"18124","Potosí","Villazón","Esc. Max Fernandez",23,0,2,0,111,2,23,0,1,162,2,18,182,220,0.685,0.827
"18125","Potosí","Villazón","Colegio 9 de Abril",39,0,1,1,105,11,23,1,1,182,6,8,196,233,0.577,0.841
"18126","Potosí","Villazón","Colegio 9 de Abril",52,3,3,2,91,5,16,0,1,173,4,4,181,225,0.526,0.804
"18127","Potosí","Villazón","Colegio 9 de Abril",38,0,2,2,99,6,24,0,0,171,3,12,186,233,0.579,0.798
"18128","Potosí","Villazón","Colegio 9 de Abril",38,0,2,0,95,5,20,0,1,161,0,8,169,223,0.59,0.758
"18129","Potosí","Villazón","Colegio 9 de Abril",48,2,2,0,94,5,20,0,3,174,7,12,193,225,0.54,0.858
"18130","Potosí","Villazón","Colegio 9 de Abril",46,1,2,2,103,2,17,0,0,173,3,10,186,228,0.595,0.816
"18131","Potosí","Villazón","Colegio 9 de Abril",43,0,2,0,95,6,22,1,2,171,2,15,188,233,0.556,0.807
"18132","Potosí","Villazón","Colegio 9 de Abril",49,0,1,1,104,6,16,0,1,178,0,7,185,227,0.584,0.815
"18133","Potosí","Villazón","Colegio 9 de Abril",35,0,2,0,106,4,20,0,0,167,0,16,183,230,0.635,0.796
"18134","Potosí","Villazón","Colegio 9 de Abril",44,0,1,0,89,2,24,1,1,162,6,8,176,227,0.549,0.775
"18135","Potosí","Villazón","Colegio 9 de Abril",42,0,0,0,93,7,24,0,0,166,5,14,185,227,0.56,0.815
"18136","Potosí","Villazón","Colegio 9 de Abril",48,1,0,0,103,5,19,1,0,177,1,11,189,230,0.582,0.822
"18137","Potosí","Villazón","Colegio 9 de Abril",46,0,1,1,101,5,16,1,1,172,6,14,192,228,0.587,0.842
"18138","Potosí","Villazón","Colegio 9 de Abril",35,0,1,3,118,0,18,1,1,177,3,5,185,224,0.667,0.826
"18139","Potosí","Villazón","Esc. Daniel Campos",12,1,0,0,154,4,32,0,1,204,7,9,220,240,0.755,0.917
"18140","Potosí","Villazón","Esc. Daniel Campos",23,0,0,0,129,7,42,0,3,204,4,7,215,237,0.632,0.907
"18141","Potosí","Villazón","Esc. Daniel Campos",10,1,0,1,144,5,40,0,1,202,4,10,216,236,0.713,0.915
"18142","Potosí","Villazón","Esc. Daniel Campos",18,1,0,1,135,1,26,0,4,186,5,11,202,226,0.726,0.894
"18143","Potosí","Villazón","Esc. Daniel Campos",20,1,0,1,121,3,25,1,1,173,5,8,186,223,0.699,0.834
"18144","Potosí","Villazón","Esc. Daniel Campos",25,4,2,0,127,1,19,0,0,178,8,11,197,228,0.713,0.864
"18145","Potosí","Villazón","Esc. Daniel Campos",29,1,4,1,117,4,15,0,1,172,9,8,189,229,0.68,0.825
"18146","Potosí","Villazón","Esc. Daniel Campos",19,0,0,2,136,6,18,1,1,183,3,10,196,226,0.743,0.867
"18147","Potosí","Villazón","Esc. Daniel Campos",18,1,2,1,126,5,19,1,3,176,3,15,194,227,0.716,0.855
"18148","Potosí","Villazón","Esc. Daniel Campos",16,1,2,0,125,2,20,0,2,168,4,11,183,222,0.744,0.824
"18149","Potosí","Villazón","Esc. Daniel Campos",14,0,0,1,122,6,19,0,1,163,3,13,179,223,0.748,0.803
"18150","Potosí","Villazón","Esc. Daniel Campos",34,2,2,0,104,4,13,0,3,162,5,17,184,222,0.642,0.829
"18151","Potosí","Villazón","Esc. Daniel Campos",21,1,2,0,128,2,14,2,2,172,2,8,182,216,0.744,0.843
"18152","Potosí","Villazón","Esc. Daniel Campos",19,2,0,1,103,3,24,1,3,156,4,8,168,215,0.66,0.781
"18153","Potosí","Villazón","Esc. Daniel Campos",20,0,2,1,113,7,25,1,0,169,6,11,186,225,0.669,0.827
"18154","Potosí","Villazón","Esc. Daniel Campos",27,1,2,0,114,3,15,0,2,164,7,5,176,215,0.695,0.819
"18155","Potosí","Villazón","Col. Modesto Omiste",47,0,1,0,91,8,8,0,0,155,6,6,167,219,0.587,0.763
"18156","Potosí","Villazón","Col. Modesto Omiste",50,2,2,0,89,5,11,1,1,161,1,11,173,215,0.553,0.805
"18157","Potosí","Villazón","Col. Modesto Omiste",51,0,2,0,85,4,23,0,0,165,6,6,177,225,0.515,0.787
"18158","Potosí","Villazón","Col. Modesto Omiste",61,1,1,0,73,4,17,0,1,158,4,5,167,226,0.462,0.739
"18159","Potosí","Villazón","Col. Modesto Omiste",48,0,2,1,78,4,14,2,3,152,6,9,167,223,0.513,0.749
"18160","Potosí","Villazón","Col. Modesto Omiste",61,0,2,1,88,4,21,0,0,177,2,13,192,233,0.497,0.824
"18161","Potosí","Villazón","Col. Modesto Omiste",56,0,0,0,82,2,27,0,0,167,7,7,181,228,0.491,0.794
"18162","Potosí","Villazón","Col. Modesto Omiste",53,1,0,1,69,10,23,4,2,163,2,9,174,225,0.423,0.773
"18163","Potosí","Villazón","Col. Modesto Omiste",59,0,3,2,81,3,13,0,3,164,2,9,175,224,0.494,0.781
"18164","Potosí","Villazón","Col. Modesto Omiste",72,0,2,0,62,10,10,0,0,156,1,8,165,225,0.397,0.733
"18165","Potosí","Villazón","Col. Modesto Omiste",48,1,4,0,87,5,15,0,1,161,2,9,172,223,0.54,0.771
"18166","Potosí","Villazón","U.E. Mariscal Sucre",36,0,1,0,129,3,31,0,1,201,4,8,213,236,0.642,0.903
"18167","Potosí","Villazón","U.E. Mariscal Sucre",36,1,1,0,126,7,37,1,0,209,4,5,218,236,0.603,0.924
"18168","Potosí","Villazón","Esc. Berque",1,1,1,2,157,4,10,1,0,177,4,4,185,221,0.887,0.837
"18169","Potosí","Villazón","Nucleo De Mojo",8,2,1,1,149,9,8,0,2,180,4,6,190,212,0.828,0.896
"18170","Potosí","Villazón","Esc. Seccional Chagua",3,1,0,1,153,9,0,0,0,167,2,3,172,227,0.916,0.758
"18171","Potosí","Villazón","Esc. Sargento M. Paredes",4,1,2,0,161,3,4,1,0,176,6,9,191,227,0.915,0.841
"18172","Potosí","Villazón","Coleg. Franz Tamayo",3,1,0,1,158,7,13,1,1,185,2,4,191,224,0.854,0.853
"18173","Potosí","Villazón","Esc. San Pedro de Sococha",9,0,0,1,152,1,7,2,1,173,1,4,178,228,0.879,0.781
"18174","Potosí","Villazón","Esc. Lizardo Perez",13,0,3,2,146,5,10,0,1,180,6,15,201,226,0.811,0.889
"18175","Potosí","Villazón","Esc. Yuruma",16,0,3,1,138,8,3,1,1,171,7,10,188,209,0.807,0.9
"18176","Potosí","Villazón","U.E. Mantacillas",6,0,0,0,160,6,25,1,2,200,7,18,225,238,0.8,0.945
"18177","Potosí","San Agustín","Esc. San Agustin",14,0,4,4,129,8,22,0,0,181,3,1,185,219,0.713,0.845
"18178","Potosí","San Agustín","U.E. Litoral",22,0,3,2,104,6,43,1,3,184,3,4,191,214,0.565,0.893
"18179","Tarija","Tarija","U.E. San Mateo",68,3,1,0,77,4,30,2,1,186,7,18,211,233,0.414,0.906
"18180","Tarija","Tarija","U.E. San Mateo",70,0,1,1,72,4,46,1,0,195,2,13,210,235,0.369,0.894
"18181","Tarija","Tarija","U.E. San Mateo",58,2,2,0,92,3,38,3,2,200,1,11,212,230,0.46,0.922
"18182","Tarija","Tarija","U.E. San Mateo",72,1,1,2,72,5,31,7,1,192,8,8,208,230,0.375,0.904
"18183","Tarija","Tarija","U.E. San Mateo",58,0,1,1,91,8,34,3,4,200,4,8,212,234,0.455,0.906
"18184","Tarija","Tarija","U.E. San Mateo",56,1,0,2,99,13,24,3,4,202,1,8,211,232,0.49,0.909
"18185","Tarija","Tarija","U.E. San Mateo",62,1,1,3,93,6,22,1,0,189,5,10,204,234,0.492,0.872
"18186","Tarija","Tarija","U.E. San Mateo",64,0,1,0,77,5,36,7,2,192,2,10,204,230,0.401,0.887
"18187","Tarija","Tarija","U.E. Monte Cercado",95,1,1,1,34,12,5,3,1,153,8,13,174,199,0.222,0.874
"18188","Tarija","Tarija","U.E. Yesera Norte",24,0,1,1,96,6,16,15,4,163,5,10,178,221,0.589,0.805
"18189","Tarija","Tarija","U.E. Yesera Centro",30,3,2,3,104,11,12,20,1,186,12,7,205,227,0.559,0.903
"18190","Tarija","Tarija","U.E. Yesera Sud",61,3,3,1,55,8,10,14,0,155,19,15,189,222,0.355,0.851
"18191","Tarija","Tarija","U.E. Junacas Sud",21,1,4,2,94,7,4,15,4,152,17,17,186,215,0.618,0.865
"18192","Tarija","Tarija","U.E. Papachacra",21,1,2,2,89,12,17,12,3,159,16,11,186,209,0.56,0.89
"18193","Tarija","Tarija","U.E. Santa Ana La Nueva",68,3,0,3,78,8,19,10,1,190,10,13,213,232,0.411,0.918
"18194","Tarija","Tarija","U.E. Santa Ana La Nueva",50,1,2,2,74,13,9,6,1,158,11,7,176,218,0.468,0.807
"18195","Tarija","Tarija","U.E. Gamoneda",22,2,0,0,131,7,7,5,3,177,3,16,196,215,0.74,0.912
"18196","Tarija","Tarija","U.E. La Pintada",63,1,0,0,100,8,17,4,0,193,9,9,211,231,0.518,0.913
"18197","Tarija","Tarija","U.E. La Pintada",75,2,3,0,77,14,9,3,0,183,4,13,200,223,0.421,0.897
"18198","Tarija","Tarija","U.E. La Pintada",63,0,0,2,83,9,25,3,1,186,5,11,202,220,0.446,0.918
"18199","Tarija","Tarija","U.E. La Pintada",71,3,0,1,84,14,23,4,1,201,6,9,216,229,0.418,0.943
"18200","Tarija","Tarija","U.E. Oscar Zamora",32,2,0,1,104,4,9,5,0,157,11,8,176,218,0.662,0.807
"18201","Tarija","Tarija","U.E. Oscar Zamora",27,1,0,6,104,2,7,4,1,152,3,11,166,224,0.684,0.741
"18202","Tarija","Tarija","U.E. Oscar Zamora",37,1,0,2,91,4,16,5,0,156,18,9,183,215,0.583,0.851
"18203","Tarija","Tarija","U.E. Tolomosita",31,2,1,2,114,11,9,2,0,172,12,13,197,224,0.663,0.879
"18204","Tarija","Tarija","U.E. San Jacinto Sud",42,2,0,1,97,19,12,6,0,179,13,11,203,227,0.542,0.894
"18205","Tarija","Tarija","U.E. San Jacinto Sud",42,0,1,2,93,17,8,5,0,168,8,12,188,228,0.554,0.825
"18206","Tarija","Tarija","U.E. Luis De Fuentes",34,2,2,2,100,12,15,6,1,174,5,3,182,225,0.575,0.809
"18207","Tarija","Tarija","U.E. San Lazaro de Guerra Huayco",26,0,1,1,127,4,14,2,1,176,8,11,195,224,0.722,0.871
"18208","Tarija","Tarija","U.E. San Lazaro de Guerra Huayco",28,0,0,0,119,6,12,5,1,171,5,9,185,225,0.696,0.822
"18209","Tarija","Tarija","U.E. San Lazaro de Guerra Huayco",25,1,1,1,126,4,24,1,1,184,7,9,200,233,0.685,0.858
"18210","Tarija","Tarija","U.E. San Lazaro de Guerra Huayco",21,1,2,0,131,6,5,2,1,169,7,5,181,225,0.775,0.804
"18211","Tarija","Tarija","U.E. San Lazaro de Guerra Huayco",22,1,0,0,124,7,9,9,1,173,9,13,195,228,0.717,0.855
"18212","Tarija","Tarija","U.E. San Lazaro de Guerra Huayco",30,1,3,1,122,5,13,1,0,176,7,10,193,231,0.693,0.835
"18213","Tarija","Tarija","U.E. San Lazaro de Guerra Huayco",27,2,0,3,119,4,10,3,0,168,8,9,185,229,0.708,0.808
"18214","Tarija","Tarija","U.E. San Lazaro de Guerra Huayco",20,1,0,1,115,3,10,1,0,151,4,16,171,220,0.762,0.777
"18215","Tarija","Tarija","U.E. San Andres",39,1,0,2,108,9,19,3,0,181,1,9,191,223,0.597,0.857
"18216","Tarija","Tarija","U.E. San Andres",31,0,0,1,119,7,12,4,0,174,5,9,188,230,0.684,0.817
"18217","Tarija","Tarija","U.E. San Andres",34,0,1,2,120,5,11,2,0,175,3,10,188,226,0.686,0.832
"18218","Tarija","Tarija","U.E. San Andres",32,0,2,1,104,2,16,4,0,161,5,17,183,220,0.646,0.832
"18219","Tarija","Tarija","U.E. San Andres",30,0,1,1,123,7,11,3,1,177,4,9,190,229,0.695,0.83
"18220","Tarija","Tarija","U.E. San Andres",32,1,1,0,115,8,20,1,2,180,3,16,199,229,0.639,0.869
"18221","Tarija","Tarija","U.E. San Andres",32,1,0,1,115,6,11,4,0,170,4,20,194,231,0.676,0.84
"18222","Tarija","Tarija","U.E. Bella Vista",20,1,1,1,111,6,14,14,2,170,10,8,188,226,0.653,0.832
"18223","Tarija","Tarija","U.E. Bella Vista",21,2,0,2,111,8,6,9,0,159,4,15,178,223,0.698,0.798
"18224","Tarija","Tarija","U.E. Pinos Sud",11,2,1,0,120,5,10,3,0,152,10,13,175,215,0.789,0.814
"18225","Tarija","Tarija","U.E. Pinos Sud",9,0,0,5,142,9,5,3,1,174,5,6,185,236,0.816,0.784
"18226","Tarija","Tarija","U.E. Nacional San Luis",132,0,0,0,27,4,11,15,0,189,1,3,193,225,0.143,0.858
"18227","Tarija","Tarija","U.E. Nacional San Luis",142,0,0,0,16,3,12,9,1,183,1,1,185,219,0.087,0.845
"18228","Tarija","Tarija","U.E. Nacional San Luis",134,0,0,0,25,5,7,7,0,178,1,3,182,220,0.14,0.827
"18229","Tarija","Tarija","U.E. Nacional San Luis",139,0,1,0,24,9,10,6,1,190,0,7,197,226,0.126,0.872
"18230","Tarija","Tarija","U.E. Nacional San Luis",152,0,0,0,21,4,11,5,1,194,2,6,202,233,0.108,0.867
"18231","Tarija","Tarija","U.E. Nacional San Luis",134,1,0,1,18,3,6,12,0,175,2,8,185,222,0.103,0.833
"18232","Tarija","Tarija","U.E. Nacional San Luis",128,0,3,1,24,5,11,10,1,183,0,1,184,225,0.131,0.818
"18233","Tarija","Tarija","U.E. Nacional San Luis",133,0,0,1,36,3,6,6,0,185,0,3,188,218,0.195,0.862
"18234","Tarija","Tarija","U.E. Nacional San Luis",138,0,1,0,24,7,5,7,0,182,2,5,189,226,0.132,0.836
"18235","Tarija","Tarija","U.E. Narciso Campero",125,0,0,2,26,3,9,11,1,177,1,2,180,221,0.147,0.814
"18236","Tarija","Tarija","U.E. Narciso Campero",143,0,1,1,26,1,1,4,0,177,0,2,179,215,0.147,0.833
"18237","Tarija","Tarija","U.E. Narciso Campero",118,1,0,0,26,1,13,11,1,171,2,7,180,212,0.152,0.849
"18238","Tarija","Tarija","U.E. Narciso Campero",122,0,0,2,28,3,7,9,1,172,1,2,175,216,0.163,0.81
"18239","Tarija","Tarija","U.E. Narciso Campero",128,0,0,1,30,5,8,11,0,183,0,4,187,223,0.164,0.839
"18240","Tarija","Tarija","U.E. Maria Laura Justiniano",131,0,0,0,23,7,9,6,0,176,1,6,183,217,0.131,0.843
"18241","Tarija","Tarija","U.E. Maria Laura Justiniano",144,0,1,4,21,5,8,6,0,189,1,1,191,222,0.111,0.86
"18242","Tarija","Tarija","U.E. Maria Laura Justiniano",129,0,1,2,27,6,14,7,1,187,0,2,189,219,0.144,0.863
"18243","Tarija","Tarija","U.E. Maria Laura Justiniano",146,0,0,0,27,3,8,3,0,187,1,2,190,216,0.144,0.88
"18244","Tarija","Tarija","U.E. Maria Laura Justiniano",137,0,1,1,22,5,10,8,1,185,0,4,189,214,0.119,0.883
"18245","Tarija","Tarija","U.E. Maria Laura Justiniano",139,0,0,0,30,3,13,12,1,198,0,1,199,228,0.152,0.873
"18246","Tarija","Tarija","U.E. Maria Laura Justiniano",153,0,0,1,20,5,8,12,0,199,0,1,200,219,0.101,0.913
"18247","Tarija","Tarija","U.E. Maria Laura Justiniano",153,0,1,0,23,5,6,2,1,191,1,6,198,222,0.12,0.892
"18248","Tarija","Tarija","U.E. Maria Laura Justiniano",142,0,1,0,25,1,10,5,0,184,1,2,187,222,0.136,0.842
"18249","Tarija","Tarija","U.E. Maria Laura Justiniano",150,1,0,2,26,2,6,5,0,192,1,3,196,225,0.135,0.871
"18250","Tarija","Tarija","U.E. Liceo Campero",143,0,0,1,33,2,3,9,1,192,2,4,198,224,0.172,0.884
"18251","Tarija","Tarija","U.E. Liceo Campero",141,0,1,2,32,3,8,5,0,192,0,3,195,219,0.167,0.89
"18252","Tarija","Tarija","U.E. Liceo Campero",133,0,2,0,34,1,6,7,1,184,1,6,191,222,0.185,0.86
"18253","Tarija","Tarija","U.E. Liceo Campero",143,0,0,1,34,8,2,7,1,196,1,3,200,224,0.173,0.893
"18254","Tarija","Tarija","U.E. Liceo Campero",146,0,0,1,20,7,8,3,2,187,1,5,193,225,0.107,0.858
"18255","Tarija","Tarija","U.E. Liceo Campero",139,0,0,0,25,6,14,6,0,190,1,6,197,229,0.132,0.86
"18256","Tarija","Tarija","U.A.J.M.S Campus",110,0,0,0,45,3,34,2,1,195,2,6,203,231,0.231,0.879
"18257","Tarija","Tarija","U.A.J.M.S Campus",105,0,0,0,46,3,27,3,0,184,3,4,191,229,0.25,0.834
"18258","Tarija","Tarija","U.A.J.M.S Campus",124,0,0,0,42,2,29,2,2,201,0,6,207,226,0.209,0.916
"18259","Tarija","Tarija","U.A.J.M.S Campus",101,0,0,1,42,5,33,1,1,184,3,7,194,223,0.228,0.87
"18260","Tarija","Tarija","U.A.J.M.S Campus",118,1,0,1,42,6,28,2,1,199,1,6,206,232,0.211,0.888
"18261","Tarija","Tarija","U.A.J.M.S Campus",108,0,1,0,40,1,44,1,0,195,2,8,205,233,0.205,0.88
"18262","Tarija","Tarija","U.A.J.M.S Campus",106,0,1,0,47,1,41,5,2,203,2,1,206,232,0.232,0.888
"18263","Tarija","Tarija","U.A.J.M.S Campus",122,0,0,2,42,5,24,4,2,201,0,5,206,227,0.209,0.907
"18264","Tarija","Tarija","U.A.J.M.S Campus",126,0,2,1,29,3,36,0,0,197,0,7,204,234,0.147,0.872
"18265","Tarija","Tarija","U.A.J.M.S Campus",120,3,1,0,32,7,25,2,1,191,0,3,194,230,0.168,0.843
"18266","Tarija","Tarija","U.A.J.M.S Campus",114,0,1,0,44,3,26,3,1,192,2,1,195,226,0.229,0.863
"18267","Tarija","Tarija","U.E. Rosa Arce",128,1,1,1,33,7,9,4,0,184,2,5,191,223,0.179,0.857
"18268","Tarija","Tarija","U.E. Rosa Arce",158,0,0,0,18,5,4,5,0,190,1,6,197,222,0.095,0.887
"18269","Tarija","Tarija","U.E. Rosa Arce",143,1,2,1,35,6,12,5,0,205,1,3,209,228,0.171,0.917
"18270","Tarija","Tarija","U.E. Rosa Arce",138,0,0,0,21,3,14,14,0,190,1,5,196,226,0.111,0.867
"18271","Tarija","Tarija","U.E. Rosa Arce",140,1,0,0,34,5,6,9,0,195,0,3,198,226,0.174,0.876
"18272","Tarija","Tarija","U.E. Rosa Arce",131,1,0,0,32,9,15,9,1,198,0,5,203,225,0.162,0.902
"18273","Tarija","Tarija","U.E. Rosa Arce",149,0,0,2,27,6,10,6,0,200,1,4,205,222,0.135,0.923
"18274","Tarija","Tarija","U.E. Rosa Arce",139,0,0,0,33,9,7,4,1,193,0,7,200,226,0.171,0.885
"18275","Tarija","Tarija","U.E. Rosa Arce",128,0,0,1,35,4,12,5,1,186,2,6,194,220,0.188,0.882
"18276","Tarija","Tarija","U.E. Rosa Arce",142,0,0,0,21,10,10,5,1,189,1,1,191,222,0.111,0.86
"18277","Tarija","Tarija","U.E. Rosa Arce",118,1,1,0,31,8,10,4,0,173,0,1,174,194,0.179,0.897
"18278","Tarija","Tarija","U.E. Carmen Echazu",128,0,1,1,28,4,14,5,0,181,1,6,188,219,0.155,0.858
"18279","Tarija","Tarija","U.E. Carmen Echazu",137,2,0,0,28,9,10,3,1,190,1,6,197,225,0.147,0.876
"18280","Tarija","Tarija","U.E. Carmen Echazu",135,0,1,1,28,3,15,7,0,190,0,1,191,216,0.147,0.884
"18281","Tarija","Tarija","U.E. Carmen Echazu",134,1,0,0,24,8,12,7,1,187,1,8,196,221,0.128,0.887
"18282","Tarija","Tarija","U.E. Carmen Echazu",137,1,0,1,24,6,7,5,0,181,3,4,188,217,0.133,0.866
"18283","Tarija","Tarija","U.E. Carmen Echazu",133,1,0,0,33,8,12,5,0,192,1,2,195,221,0.172,0.882
"18284","Tarija","Tarija","U.E. Carmen Echazu",149,0,0,0,21,2,11,3,0,186,2,4,192,216,0.113,0.889
"18285","Tarija","Tarija","U.E. San Roque",146,0,1,1,32,1,11,4,0,196,0,2,198,229,0.163,0.865
"18286","Tarija","Tarija","U.E. San Roque",139,1,0,2,25,6,14,3,0,190,0,5,195,217,0.132,0.899
"18287","Tarija","Tarija","U.E. San Roque",125,0,0,1,29,2,11,8,1,177,3,8,188,222,0.164,0.847
"18288","Tarija","Tarija","U.E. San Roque",138,1,0,0,31,3,13,5,0,191,1,5,197,220,0.162,0.895
"18289","Tarija","Tarija","U.E. San Roque",146,0,0,2,25,7,9,5,0,194,3,4,201,225,0.129,0.893
"18290","Tarija","Tarija","U.E. San Roque",128,0,1,1,36,5,11,6,0,188,2,3,193,225,0.191,0.858
"18291","Tarija","Tarija","U.E. San Roque",130,0,0,0,33,5,9,6,0,183,1,5,189,219,0.18,0.863
"18292","Tarija","Tarija","U.E. San Roque",130,2,1,4,35,1,17,7,1,198,1,1,200,229,0.177,0.873
"18293","Tarija","Tarija","U.E. San Roque",115,0,0,1,40,6,17,8,1,188,0,3,191,219,0.213,0.872
"18294","Tarija","Tarija","U.E. San Roque",134,0,0,1,32,5,14,2,0,188,1,7,196,233,0.17,0.841
"18295","Tarija","Tarija","U.E. San Roque",119,1,0,0,31,7,15,6,0,179,1,6,186,219,0.173,0.849
"18296","Tarija","Tarija","U.E. San Roque",130,1,0,0,36,6,4,6,2,185,1,7,193,224,0.195,0.862
"18297","Tarija","Tarija","U.E. San Roque",121,0,0,2,39,6,11,8,0,187,0,3,190,229,0.209,0.83
"18298","Tarija","Tarija","U.E. San Roque",135,1,0,2,31,5,6,2,0,182,1,8,191,222,0.17,0.86
"18299","Tarija","Tarija","U.E. Avelina Raña",100,1,0,0,57,9,21,5,0,193,1,8,202,230,0.295,0.878
"18300","Tarija","Tarija","U.E. Avelina Raña",110,3,1,0,40,1,16,8,2,181,1,8,190,222,0.221,0.856
"18301","Tarija","Tarija","U.E. Avelina Raña",116,0,1,3,36,4,16,7,1,184,2,4,190,223,0.196,0.852
"18302","Tarija","Tarija","U.E. Avelina Raña",118,1,0,0,43,3,18,5,1,189,5,8,202,226,0.228,0.894
"18303","Tarija","Tarija","U.E. Avelina Raña",110,1,0,2,47,1,23,9,0,193,0,7,200,225,0.244,0.889
"18304","Tarija","Tarija","U.E. Avelina Raña",128,0,0,0,29,3,12,6,1,179,1,8,188,214,0.162,0.879
"18305","Tarija","Tarija","U.E. Avelina Raña",125,1,0,0,41,10,14,5,0,196,2,3,201,226,0.209,0.889
"18306","Tarija","Tarija","U.E. Avelina Raña",111,2,0,0,44,9,15,6,0,187,1,4,192,225,0.235,0.853
"18307","Tarija","Tarija","U.E. Avelina Raña",115,1,2,1,37,6,15,3,1,181,3,0,184,218,0.204,0.844
"18308","Tarija","Tarija","U.E. Avelina Raña",111,1,0,1,63,2,13,5,1,197,0,6,203,227,0.32,0.894
"18309","Tarija","Tarija","U.E. Avelina Raña",127,1,0,1,30,8,17,3,1,188,2,6,196,227,0.16,0.863
"18310","Tarija","Tarija","U.E. Avelina Raña",96,0,0,0,52,6,19,4,0,177,4,6,187,223,0.294,0.839
"18311","Tarija","Tarija","U.E. Avelina Raña",119,0,0,2,37,8,15,9,0,190,0,3,193,221,0.195,0.873
"18312","Tarija","Tarija","U.E. Avelina Raña",116,0,1,0,38,8,14,3,1,181,1,14,196,220,0.21,0.891
"18313","Tarija","Tarija","U.E. Avelina Raña",108,0,0,3,45,3,25,5,0,189,1,8,198,224,0.238,0.884
"18314","Tarija","Tarija","U.E. Avelina Raña",115,0,1,1,38,5,17,4,0,181,2,6,189,216,0.21,0.875
"18315","Tarija","Tarija","U.E. Fe y Alegria",117,1,0,0,47,4,26,4,1,200,0,6,206,227,0.235,0.907
"18316","Tarija","Tarija","U.E. Fe y Alegria",94,0,1,2,61,6,23,6,1,194,1,12,207,231,0.314,0.896
"18317","Tarija","Tarija","U.E. Fe y Alegria",98,0,1,0,52,6,22,2,3,184,2,7,193,229,0.283,0.843
"18318","Tarija","Tarija","U.E. Fe y Alegria",119,1,0,1,44,7,22,5,0,199,1,4,204,224,0.221,0.911
"18319","Tarija","Tarija","U.E. Fe y Alegria",109,0,0,0,48,7,15,3,0,182,3,11,196,217,0.264,0.903
"18320","Tarija","Tarija","U.E. Fe y Alegria",86,0,0,1,75,6,24,2,0,194,3,5,202,230,0.387,0.878
"18321","Tarija","Tarija","U.E. Fe y Alegria",72,0,1,3,59,7,27,2,0,171,1,10,182,222,0.345,0.82
"18322","Tarija","Tarija","U.E. Fe y Alegria",91,1,2,1,64,4,31,4,1,199,4,2,205,231,0.322,0.887
"18323","Tarija","Tarija","U.E. Fe y Alegria",101,1,0,0,60,6,23,5,2,198,2,8,208,227,0.303,0.916
"18324","Tarija","Tarija","U.E. Fe y Alegria",114,1,1,1,46,7,15,4,0,189,1,8,198,228,0.243,0.868
"18325","Tarija","Tarija","U.E. Fe y Alegria",110,0,0,0,47,7,25,6,1,196,3,7,206,231,0.24,0.892
"18326","Tarija","Tarija","U.E. Fe y Alegria",86,0,1,0,57,6,28,3,1,182,3,10,195,224,0.313,0.871
"18327","Tarija","Tarija","U.E. Fe y Alegria",90,0,0,0,68,7,21,2,0,188,2,7,197,227,0.362,0.868
"18328","Tarija","Tarija","U.E. Fe y Alegria",100,0,0,0,54,7,28,4,1,194,2,5,201,221,0.278,0.91
"18329","Tarija","Tarija","U.E. Fe y Alegria",76,1,3,1,60,10,24,4,2,181,2,9,192,221,0.331,0.869
"18330","Tarija","Tarija","U.E. Fe y Alegria",104,0,0,1,60,8,13,5,0,191,1,9,201,233,0.314,0.863
"18331","Tarija","Tarija","U.E. Fe y Alegria",76,1,3,2,63,6,29,1,4,185,1,8,194,224,0.341,0.866
"18332","Tarija","Tarija","U.E. Fe y Alegria",88,2,1,2,53,3,34,4,3,190,3,12,205,230,0.279,0.891
"18333","Tarija","Tarija","U.E. Fe y Alegria",101,0,2,1,54,7,18,5,1,189,4,9,202,225,0.286,0.898
"18334","Tarija","Tarija","U.E. Fe y Alegria",115,0,0,0,45,3,26,2,0,191,4,9,204,225,0.236,0.907
"18335","Tarija","Tarija","U.E. Fe y Alegria",119,0,1,1,45,4,21,2,0,193,3,10,206,231,0.233,0.892
"18336","Tarija","Tarija","U.E. Fe y Alegria",111,0,1,0,44,9,27,4,0,196,2,10,208,232,0.224,0.897
"18337","Tarija","Tarija","U.E. Fe y Alegria",104,1,0,0,54,5,31,2,0,197,1,7,205,226,0.274,0.907
"18338","Tarija","Tarija","U.E. Fe y Alegria",95,1,0,0,38,3,19,4,1,161,0,9,170,194,0.236,0.876
"18339","Tarija","Tarija","U.E. Belgrano",123,0,0,0,46,2,17,8,0,196,1,4,201,230,0.235,0.874
"18340","Tarija","Tarija","U.E. Belgrano",146,1,1,0,32,1,8,4,2,195,1,8,204,229,0.164,0.891
"18341","Tarija","Tarija","U.E. Belgrano",125,0,0,2,38,5,9,3,0,182,3,8,193,229,0.209,0.843
"18342","Tarija","Tarija","U.E. Belgrano",139,0,1,2,32,4,13,4,0,195,0,2,197,228,0.164,0.864
"18343","Tarija","Tarija","U.E. Belgrano",130,0,2,1,38,3,16,3,0,193,0,4,197,227,0.197,0.868
"18344","Tarija","Tarija","U.E. Belgrano",141,0,0,1,32,2,13,2,1,192,0,10,202,228,0.167,0.886
"18345","Tarija","Tarija","U.E. Belgrano",89,0,2,0,59,5,24,5,0,184,3,12,199,226,0.321,0.881
"18346","Tarija","Tarija","U.E. Belgrano",133,0,0,0,29,7,19,4,0,192,4,5,201,225,0.151,0.893
"18347","Tarija","Tarija","U.E. Belgrano",129,0,0,0,34,2,23,5,0,193,3,3,199,226,0.176,0.881
"18348","Tarija","Tarija","U.E. Belgrano",134,0,0,2,38,6,17,3,0,200,1,6,207,225,0.19,0.92
"18349","Tarija","Tarija","U.E. Belgrano",137,0,0,0,33,5,15,5,0,195,4,3,202,230,0.169,0.878
"18350","Tarija","Tarija","U.E. Belgrano",140,0,0,0,29,10,10,3,0,192,2,5,199,226,0.151,0.881
"18351","Tarija","Tarija","U.E. Belgrano",119,0,1,0,40,5,12,5,2,184,3,9,196,225,0.217,0.871
"18352","Tarija","Tarija","U.E. Belgrano",143,0,0,0,24,3,14,2,0,186,3,10,199,229,0.129,0.869
"18353","Tarija","Tarija","U.E. Belgrano",122,0,1,1,37,3,11,4,1,180,1,6,187,218,0.206,0.858
"18354","Tarija","Tarija","U.E. Belgrano",120,0,2,1,40,3,14,1,0,181,0,9,190,223,0.221,0.852
"18355","Tarija","Tarija","U.E. Belgrano",145,0,1,0,31,5,18,4,0,204,1,3,208,231,0.152,0.9
"18356","Tarija","Tarija","U.E. Belgrano",127,1,1,0,32,4,4,5,1,175,1,9,185,218,0.183,0.849
"18357","Tarija","Tarija","U.E. Belgrano",136,0,0,0,39,5,17,1,0,198,1,3,202,229,0.197,0.882
"18358","Tarija","Tarija","U.E. Belgrano",140,0,0,1,20,5,27,5,0,198,2,1,201,228,0.101,0.882
"18359","Tarija","Tarija","U.E. Belgrano",136,0,0,0,27,5,19,0,0,187,2,4,193,223,0.144,0.865
"18360","Tarija","Tarija","U.E. Belgrano",137,1,1,0,35,5,18,2,0,199,1,7,207,227,0.176,0.912
"18361","Tarija","Tarija","U.E. Belgrano",118,0,0,3,35,8,20,2,0,186,2,9,197,227,0.188,0.868
"18362","Tarija","Tarija","U.E. Belgrano",143,0,0,1,26,3,12,11,0,196,2,4,202,227,0.133,0.89
"18363","Tarija","Tarija","U.E. Belgrano",132,0,1,1,41,3,14,4,1,197,1,8,206,234,0.208,0.88
"18364","Tarija","Tarija","U.E. Belgrano",132,2,0,2,35,4,18,0,1,194,0,6,200,225,0.18,0.889
"18365","Tarija","Tarija","U.E. Belgrano",118,0,0,2,33,8,10,4,0,175,2,9,186,224,0.189,0.83
"18366","Tarija","Tarija","U.E. Belgrano",149,0,0,1,25,5,7,6,1,194,4,1,199,223,0.129,0.892
"18367","Tarija","Tarija","U.E. Belgrano",134,0,0,2,33,6,21,7,1,204,0,3,207,227,0.162,0.912
"18368","Tarija","Tarija","U.E. Eulogio Ruiz",79,0,1,1,87,3,24,3,1,199,2,6,207,232,0.437,0.892
"18369","Tarija","Tarija","U.E. Eulogio Ruiz",88,0,0,2,70,6,31,2,0,199,2,6,207,234,0.352,0.885
"18370","Tarija","Tarija","U.E. Eulogio Ruiz",79,0,1,1,68,7,41,0,1,198,2,8,208,231,0.343,0.9
"18371","Tarija","Tarija","U.E. Eulogio Ruiz",67,3,2,0,70,8,39,4,0,193,2,9,204,230,0.363,0.887
"18372","Tarija","Tarija","U.E. Eulogio Ruiz",65,0,0,0,81,3,48,3,5,205,0,6,211,228,0.395,0.925
"18373","Tarija","Tarija","U.E. Eulogio Ruiz",45,2,2,0,83,2,37,3,0,174,4,23,201,235,0.477,0.855
"18374","Tarija","Tarija","U.E. Eulogio Ruiz",62,1,0,2,88,2,39,2,1,197,3,3,203,230,0.447,0.883
"18375","Tarija","Tarija","U.E. Eulogio Ruiz",61,0,1,1,64,6,38,8,0,179,2,6,187,223,0.358,0.839
"18376","Tarija","Tarija","U.E. Eulogio Ruiz",56,1,1,2,78,2,44,4,0,188,1,9,198,228,0.415,0.868
"18377","Tarija","Tarija","U.E. Eulogio Ruiz",83,1,0,1,66,11,30,4,0,196,3,11,210,233,0.337,0.901
"18378","Tarija","Tarija","U.E. Eulogio Ruiz",59,0,1,0,86,2,47,1,0,196,5,5,206,233,0.439,0.884
"18379","Tarija","Tarija","U.E. Eulogio Ruiz",65,0,1,1,84,4,39,3,1,198,2,8,208,235,0.424,0.885
"18380","Tarija","Tarija","U.E. Eulogio Ruiz",56,1,2,0,82,3,34,3,1,182,3,7,192,226,0.451,0.85
"18381","Tarija","Tarija","U.E. Eulogio Ruiz",77,2,1,1,79,2,23,4,1,190,2,5,197,227,0.416,0.868
"18382","Tarija","Tarija","U.E. Eulogio Ruiz",65,1,1,0,85,3,37,3,1,196,1,6,203,232,0.434,0.875
"18383","Tarija","Tarija","U.E. Eulogio Ruiz",77,0,0,0,68,1,36,1,2,185,2,11,198,234,0.368,0.846
"18384","Tarija","Tarija","U.E. Eulogio Ruiz",47,0,3,0,81,5,50,1,1,188,1,9,198,229,0.431,0.865
"18385","Tarija","Tarija","U.E. Eulogio Ruiz",64,0,0,1,88,3,33,4,2,195,1,4,200,228,0.451,0.877
"18386","Tarija","Tarija","U.E. Eulogio Ruiz",84,1,1,0,65,7,32,4,0,194,4,8,206,235,0.335,0.877
"18387","Tarija","Tarija","U.E. Eulogio Ruiz",85,1,2,0,64,6,38,3,1,200,1,8,209,232,0.32,0.901
"18388","Tarija","Tarija","U.E. Eulogio Ruiz",68,0,3,1,84,7,29,2,0,194,2,11,207,230,0.433,0.9
"18389","Tarija","Tarija","U.E. Eulogio Ruiz",77,12,0,1,62,7,37,3,0,199,1,2,202,229,0.312,0.882
"18390","Tarija","Tarija","U.E. Eulogio Ruiz",31,0,21,2,63,9,25,9,0,160,35,8,203,227,0.394,0.894
"18391","Tarija","Tarija","U.E. Tarija",70,0,0,3,68,6,37,6,0,190,7,9,206,234,0.358,0.88
"18392","Tarija","Tarija","U.E. Tarija",71,1,0,1,87,7,31,4,0,202,3,7,212,235,0.431,0.902
"18393","Tarija","Tarija","U.E. Tarija",51,1,0,1,77,7,48,2,1,188,3,14,205,238,0.41,0.861
"18394","Tarija","Tarija","U.E. Tarija",63,0,0,1,82,6,32,2,2,188,2,14,204,235,0.436,0.868
"18395","Tarija","Tarija","U.E. Tarija",50,1,0,0,98,2,45,6,1,203,2,2,207,229,0.483,0.904
"18396","Tarija","Tarija","U.E. Tarija",77,0,1,1,77,7,32,6,1,202,5,6,213,235,0.381,0.906
"18397","Tarija","Tarija","U.E. Tarija",62,1,0,0,90,10,33,3,1,200,4,10,214,231,0.45,0.926
"18398","Tarija","Tarija","U.E. Tarija",66,0,0,0,70,10,42,2,1,191,6,13,210,231,0.366,0.909
"18399","Tarija","Tarija","U.E. Tarija",58,0,2,1,79,5,42,2,0,189,3,10,202,239,0.418,0.845
"18400","Tarija","Tarija","U.E. Tarija",61,0,1,2,100,3,36,2,1,206,2,7,215,239,0.485,0.9
"18401","Tarija","Tarija","U.E. Tarija",69,1,1,0,90,1,43,2,1,208,0,9,217,239,0.433,0.908
"18402","Tarija","Tarija","U.E. Tarija",88,2,0,1,77,5,32,3,0,208,3,5,216,237,0.37,0.911
"18403","Tarija","Tarija","U.E. Tarija",56,1,1,0,81,7,47,2,1,196,6,9,211,234,0.413,0.902
"18404","Tarija","Tarija","U.E. Tarija",66,0,2,0,74,5,36,4,3,190,4,8,202,234,0.389,0.863
"18405","Tarija","Tarija","U.E. Tarija",58,0,0,0,78,8,39,5,0,188,6,9,203,230,0.415,0.883
"18406","Tarija","Tarija","U.E. Tarija",69,0,0,2,85,4,38,4,1,203,6,10,219,236,0.419,0.928
"18407","Tarija","Tarija","U.E. Tarija",68,2,0,1,78,11,37,2,0,199,2,10,211,238,0.392,0.887
"18408","Tarija","Tarija","U.E. Tarija",65,1,0,1,76,8,45,4,0,200,2,10,212,236,0.38,0.898
"18409","Tarija","Tarija","C.E.B.A.",83,1,0,2,70,7,30,4,0,197,3,9,209,233,0.355,0.897
"18410","Tarija","Tarija","C.E.B.A.",70,0,2,1,77,7,31,2,0,190,3,8,201,233,0.405,0.863
"18411","Tarija","Tarija","C.E.B.A.",63,0,2,1,88,5,33,5,1,198,13,2,213,236,0.444,0.903
"18412","Tarija","Tarija","C.E.B.A.",82,1,0,1,74,4,30,5,1,198,0,5,203,231,0.374,0.879
"18413","Tarija","Tarija","C.E.B.A.",59,1,0,0,94,5,34,3,0,196,1,8,205,232,0.48,0.884
"18414","Tarija","Tarija","C.E.B.A.",68,2,0,3,69,3,40,4,1,190,5,8,203,232,0.363,0.875
"18415","Tarija","Tarija","C.E.B.A.",69,0,1,0,74,3,22,8,2,179,2,15,196,230,0.413,0.852
"18416","Tarija","Tarija","C.E.B.A.",75,0,1,1,76,1,31,2,0,187,3,9,199,228,0.406,0.873
"18417","Tarija","Tarija","C.E.B.A.",72,1,0,1,82,6,38,0,0,200,3,9,212,230,0.41,0.922
"18418","Tarija","Tarija","C.E.B.A.",65,1,0,0,88,4,38,2,0,198,1,9,208,229,0.444,0.908
"18419","Tarija","Tarija","C.E.B.A.",82,2,0,1,62,8,34,2,3,194,8,4,206,232,0.32,0.888
"18420","Tarija","Tarija","C.E.B.A.",71,4,0,0,80,3,33,3,0,194,3,11,208,227,0.412,0.916
"18421","Tarija","Tarija","C.E.B.A.",68,1,0,0,85,1,22,7,1,185,3,10,198,230,0.459,0.861
"18422","Tarija","Tarija","C.E.B.A.",70,0,0,1,72,5,32,1,1,182,3,12,197,229,0.396,0.86
"18423","Tarija","Tarija","C.E.B.A.",93,1,0,0,58,6,26,1,1,186,3,8,197,231,0.312,0.853
"18424","Tarija","Tarija","C.E.B.A.",67,0,0,0,72,2,43,1,1,186,1,18,205,235,0.387,0.872
"18425","Tarija","Tarija","C.E.B.A.",79,0,1,0,68,7,33,6,0,194,2,10,206,225,0.351,0.916
"18426","Tarija","Tarija","U.E. Hermann Gmeiner",39,2,0,2,84,4,44,7,2,184,4,14,202,228,0.457,0.886
"18427","Tarija","Tarija","U.E. Hermann Gmeiner",51,0,1,4,89,4,30,1,0,180,2,19,201,229,0.494,0.878
"18428","Tarija","Tarija","U.E. Hermann Gmeiner",45,0,0,2,89,1,41,3,1,182,6,14,202,228,0.489,0.886
"18429","Tarija","Tarija","U.E. Hermann Gmeiner",42,2,1,0,94,5,38,1,0,183,0,14,197,232,0.514,0.849
"18430","Tarija","Tarija","U.E. Hermann Gmeiner",40,0,1,0,83,3,41,2,0,170,4,18,192,233,0.488,0.824
"18431","Tarija","Tarija","U.E. Hermann Gmeiner",48,1,0,1,91,3,42,1,1,188,4,12,204,228,0.484,0.895
"18432","Tarija","Tarija","U.E. Hermann Gmeiner",34,1,0,2,110,4,33,0,1,185,4,7,196,226,0.595,0.867
"18433","Tarija","Tarija","U.E. Hermann Gmeiner",46,2,0,2,80,5,45,3,8,191,1,8,200,230,0.419,0.87
"18434","Tarija","Tarija","U.E. Hermann Gmeiner",65,0,2,0,77,10,29,4,2,189,1,19,209,231,0.407,0.905
"18435","Tarija","Tarija","U.E. Hermann Gmeiner",44,1,0,3,82,3,38,1,2,174,7,20,201,233,0.471,0.863
"18436","Tarija","Tarija","U.E. Hermann Gmeiner",55,1,0,0,76,5,44,2,1,184,4,9,197,230,0.413,0.857
"18437","Tarija","Tarija","U.E. Hermann Gmeiner",63,0,2,5,78,5,24,2,1,180,3,8,191,233,0.433,0.82
"18438","Tarija","Tarija","U.E. Hermann Gmeiner",38,1,0,1,87,3,49,1,1,181,2,14,197,230,0.481,0.857
"18439","Tarija","Tarija","U.E. Hermann Gmeiner",48,2,1,1,76,4,44,0,2,178,1,11,190,229,0.427,0.83
"18440","Tarija","Tarija","U.E. Hermann Gmeiner",36,1,0,1,93,11,48,4,0,194,1,11,206,230,0.479,0.896
"18441","Tarija","Tarija","U.E. Hermann Gmeiner",46,0,0,1,91,5,39,2,0,184,8,8,200,229,0.495,0.873
"18442","Tarija","Tarija","U.E. Hermann Gmeiner",50,0,0,0,86,6,31,4,1,178,3,12,193,231,0.483,0.835
"18443","Tarija","Tarija","U.E. Hermann Gmeiner",67,1,2,2,70,4,36,4,2,188,5,9,202,227,0.372,0.89
"18444","Tarija","Tarija","U.E. Hermann Gmeiner",42,3,2,1,86,4,39,2,0,179,5,16,200,232,0.48,0.862
"18445","Tarija","Tarija","U.E. Hermann Gmeiner",21,0,0,1,102,3,55,4,1,187,3,7,197,225,0.545,0.876
"18446","Tarija","Tarija","U.E. Hermann Gmeiner",42,3,0,2,100,1,35,1,4,188,3,8,199,225,0.532,0.884
"18447","Tarija","Tarija","U.E. Hermann Gmeiner",67,0,0,0,76,8,34,2,0,187,1,10,198,234,0.406,0.846
"18448","Tarija","Tarija","U.E. Hermann Gmeiner",52,0,1,2,95,2,47,1,1,201,1,10,212,228,0.473,0.93
"18449","Tarija","Tarija","U.E. Hermann Gmeiner",50,0,1,2,85,3,42,1,2,186,5,10,201,230,0.457,0.874
"18450","Tarija","Tarija","U.E. Hermann Gmeiner",51,1,1,1,72,4,43,1,1,175,2,11,188,228,0.411,0.825
"18451","Tarija","Tarija","U.E. Hermann Gmeiner",34,0,0,2,99,5,46,0,0,186,4,13,203,224,0.532,0.906
"18452","Tarija","Tarija","U.E. Ignacia Nazaria March",64,1,0,0,86,6,31,5,1,194,3,14,211,236,0.443,0.894
"18453","Tarija","Tarija","U.E. Ignacia Nazaria March",93,1,0,0,63,7,37,2,0,203,2,7,212,231,0.31,0.918
"18454","Tarija","Tarija","U.E. Ignacia Nazaria March",67,1,0,1,98,5,33,2,1,208,3,7,218,233,0.471,0.936
"18455","Tarija","Tarija","U.E. Ignacia Nazaria March",61,1,1,1,91,2,39,3,0,199,3,11,213,235,0.457,0.906
"18456","Tarija","Tarija","U.E. Ignacia Nazaria March",38,1,2,1,103,1,42,6,1,195,2,9,206,232,0.528,0.888
"18457","Tarija","Tarija","U.E. Ignacia Nazaria March",61,1,0,0,82,3,49,4,0,200,5,9,214,235,0.41,0.911
"18458","Tarija","Tarija","U.E. Ignacia Nazaria March",63,2,1,0,85,6,51,3,0,211,2,2,215,234,0.403,0.919
"18459","Tarija","Tarija","U.E. Ignacia Nazaria March",83,1,0,1,74,6,35,5,0,205,0,10,215,234,0.361,0.919
"18460","Tarija","Tarija","U.E. Ignacia Nazaria March",54,1,0,1,91,2,37,5,1,192,0,14,206,232,0.474,0.888
"18461","Tarija","Tarija","U.E. Ignacia Nazaria March",73,0,1,1,82,3,34,2,2,198,1,9,208,231,0.414,0.9
"18462","Tarija","Tarija","U.E. Ignacia Nazaria March",66,2,1,0,72,7,42,1,0,191,5,13,209,232,0.377,0.901
"18463","Tarija","Tarija","U.E. Ignacia Nazaria March",87,0,0,0,59,5,41,3,2,197,2,11,210,235,0.299,0.894
"18464","Tarija","Tarija","U.E. Ignacia Nazaria March",53,0,1,2,92,6,33,0,1,188,3,16,207,228,0.489,0.908
"18465","Tarija","Tarija","U.E. Ignacia Nazaria March",54,0,0,2,108,2,42,2,0,210,2,8,220,234,0.514,0.94
"18466","Tarija","Tarija","U.E. Ignacia Nazaria March",63,2,0,1,103,6,28,3,0,206,2,8,216,236,0.5,0.915
"18467","Tarija","Tarija","U.E. Ignacia Nazaria March",66,1,1,0,80,6,35,4,0,193,5,11,209,232,0.415,0.901
"18468","Tarija","Tarija","U.E. Ignacia Nazaria March",87,0,0,0,86,5,34,2,1,215,4,5,224,237,0.4,0.945
"18469","Tarija","Tarija","U.E. Ignacia Nazaria March",57,0,0,1,93,5,41,1,1,199,1,14,214,235,0.467,0.911
"18470","Tarija","Tarija","U.E. Ignacia Nazaria March",70,1,0,1,87,5,48,3,0,215,6,5,226,236,0.405,0.958
"18471","Tarija","Tarija","U.E. Humberto Portocarrero 1",44,1,0,5,101,4,51,3,2,211,1,12,224,238,0.479,0.941
"18472","Tarija","Tarija","U.E. Humberto Portocarrero 1",53,0,2,0,92,5,58,1,1,212,1,12,225,240,0.434,0.938
"18473","Tarija","Tarija","U.E. Humberto Portocarrero 1",51,0,0,2,109,4,39,0,1,206,6,6,218,239,0.529,0.912
"18474","Tarija","Tarija","U.E. Aniceto Arce",138,0,0,2,44,1,32,1,2,220,1,6,227,238,0.2,0.954
"18475","Tarija","Tarija","U.E. Jose Manuel Avila",106,0,0,0,68,2,27,4,0,207,0,3,210,227,0.329,0.925
"18476","Tarija","Tarija","U.E. Jose Manuel Avila",124,2,1,0,33,11,17,3,0,191,2,6,199,232,0.173,0.858
"18477","Tarija","Tarija","U.E. Jose Manuel Avila",109,0,0,1,37,7,32,3,0,189,1,5,195,222,0.196,0.878
"18478","Tarija","Tarija","U.E. Jose Manuel Avila",111,1,1,0,46,7,19,2,0,187,1,3,191,231,0.246,0.827
"18479","Tarija","Tarija","U.E. Jose Manuel Avila",118,1,0,0,31,13,35,5,0,203,0,7,210,230,0.153,0.913
"18480","Tarija","Tarija","U.E. Jose Manuel Avila",131,0,0,0,41,8,21,2,0,203,1,7,211,236,0.202,0.894
"18481","Tarija","Tarija","U.E. Jose Manuel Avila",117,1,0,0,38,4,21,7,0,188,0,15,203,230,0.202,0.883
"18482","Tarija","Tarija","U.E. Jose Manuel Avila",131,0,0,2,29,5,13,6,1,187,2,8,197,227,0.155,0.868
"18483","Tarija","Tarija","U.E. Jose Manuel Avila",117,1,1,1,40,5,16,7,1,189,3,6,198,220,0.212,0.9
"18484","Tarija","Tarija","U.E. Jose Manuel Avila",91,0,0,0,62,6,28,3,3,193,1,6,200,227,0.321,0.881
"18485","Tarija","Tarija","U.E. Jose Manuel Avila",113,0,0,2,44,6,31,3,2,201,1,7,209,232,0.219,0.901
"18486","Tarija","Tarija","U.E. Jose Manuel Avila",117,0,0,0,44,7,21,1,0,190,1,13,204,224,0.232,0.911
"18487","Tarija","Tarija","U.E. Jose Manuel Avila",110,1,1,0,46,6,26,4,1,195,1,6,202,221,0.236,0.914
"18488","Tarija","Tarija","U.E. Jose Manuel Avila",133,2,0,1,36,3,16,1,0,192,5,6,203,229,0.188,0.886
"18489","Tarija","Tarija","U.E. Jose Manuel Avila",91,0,1,1,58,4,25,2,1,183,3,14,200,227,0.317,0.881
"18490","Tarija","Tarija","U.E. Jose Manuel Avila",128,0,1,2,33,1,14,8,0,187,0,7,194,223,0.176,0.87
"18491","Tarija","Tarija","U.E. Jose Manuel Avila",127,1,1,1,31,6,21,2,0,190,1,12,203,226,0.163,0.898
"18492","Tarija","Tarija","U.E. Jose Manuel Avila",135,0,1,0,29,4,18,5,0,192,4,12,208,227,0.151,0.916
"18493","Tarija","Tarija","U.E. Jose Manuel Avila",105,0,0,1,51,6,28,2,0,193,3,10,206,229,0.264,0.9
"18494","Tarija","Tarija","U.E. Jose Manuel Avila",110,0,2,1,42,10,18,7,2,192,3,10,205,229,0.219,0.895
"18495","Tarija","Tarija","U.E. Jose Manuel Avila",109,0,0,1,60,6,13,6,0,195,1,7,203,225,0.308,0.902
"18496","Tarija","Tarija","U.E. Jose Manuel Avila",110,1,0,0,47,4,20,7,5,194,1,3,198,217,0.242,0.912
"18497","Tarija","Tarija","U.E. Jose Manuel Avila",93,1,0,1,64,4,18,6,0,187,1,7,195,227,0.342,0.859
"18498","Tarija","Tarija","U.E. Jose Manuel Avila",113,0,0,0,39,5,24,5,0,186,2,12,200,222,0.21,0.901
"18499","Tarija","Tarija","U.E. Jose Manuel Avila",122,0,0,1,40,2,17,7,0,189,1,7,197,225,0.212,0.876
"18500","Tarija","Tarija","U.E. Jose Manuel Avila",112,1,0,1,40,8,15,6,2,185,3,12,200,231,0.216,0.866
"18501","Tarija","Tarija","U.E. Jose Manuel Avila",121,1,1,1,45,7,16,1,1,194,0,7,201,229,0.232,0.878
"18502","Tarija","Tarija","U.E. Jose Manuel Avila",124,0,0,1,37,6,15,4,1,188,1,12,201,224,0.197,0.897
"18503","Tarija","Tarija","U.E. Jose Manuel Avila",114,2,1,0,44,5,20,4,1,191,3,5,199,220,0.23,0.905
"18504","Tarija","Tarija","U.E. Jose Manuel Avila",105,0,0,1,57,5,22,3,2,195,2,2,199,228,0.292,0.873
"18505","Tarija","Tarija","U.E. Jose Manuel Avila",107,1,0,0,35,7,20,7,0,177,0,11,188,222,0.198,0.847
"18506","Tarija","Tarija","U.E. Jose Manuel Avila",124,2,2,0,39,5,25,4,0,201,0,7,208,234,0.194,0.889
"18507","Tarija","Tarija","U.E. Jose Manuel Avila",117,2,0,0,30,4,23,9,0,185,3,10,198,224,0.162,0.884
"18508","Tarija","Tarija","U.E. Jose Manuel Avila",98,0,0,0,46,6,18,7,0,175,2,12,189,222,0.263,0.851
"18509","Tarija","Tarija","U.E. Jose Manuel Avila",120,1,0,2,40,4,13,2,0,182,1,12,195,231,0.22,0.844
"18510","Tarija","Tarija","U.E. Jose Manuel Avila",117,0,1,3,46,4,17,4,1,193,1,7,201,228,0.238,0.882
"18511","Tarija","Tarija","U.E. Jose Manuel Avila",111,0,0,0,39,4,34,3,0,191,2,8,201,227,0.204,0.885
"18512","Tarija","Tarija","U.E. Jose Manuel Avila",122,1,2,1,36,3,14,5,0,184,2,8,194,224,0.196,0.866
"18513","Tarija","Tarija","U.E. Jose Manuel Avila",138,1,0,1,33,5,10,3,1,192,1,11,204,229,0.172,0.891
"18514","Tarija","Tarija","U.E. Jose Manuel Avila",99,0,0,0,41,11,39,3,1,194,2,13,209,230,0.211,0.909
"18515","Tarija","Tarija","U.E. Jose Manuel Avila",142,0,0,1,25,6,18,7,0,199,1,6,206,226,0.126,0.912
"18516","Tarija","Tarija","U.E. Nuestra Señora Del Rosario",105,1,1,1,54,1,25,4,3,195,5,3,203,231,0.277,0.879
"18517","Tarija","Tarija","U.E. Nuestra Señora Del Rosario",78,0,1,0,68,3,40,4,1,195,5,5,205,230,0.349,0.891
"18518","Tarija","Tarija","U.E. Nuestra Señora Del Rosario",73,3,0,1,59,4,36,5,1,182,4,11,197,224,0.324,0.879
"18519","Tarija","Tarija","U.E. Nuestra Señora Del Rosario",73,1,1,2,58,5,42,0,0,182,3,13,198,230,0.319,0.861
"18520","Tarija","Tarija","U.E. Nuestra Señora Del Rosario",86,2,2,1,63,5,30,6,0,195,2,13,210,232,0.323,0.905
"18521","Tarija","Tarija","U.E. Nuestra Señora Del Rosario",78,1,1,2,73,2,32,3,1,193,3,6,202,234,0.378,0.863
"18522","Tarija","Tarija","U.E. Nuestra Señora Del Rosario",82,1,0,1,64,7,29,6,2,192,2,7,201,227,0.333,0.885
"18523","Tarija","Tarija","U.E. Nuestra Señora Del Rosario",99,1,1,1,56,8,29,1,3,199,3,9,211,230,0.281,0.917
"18524","Tarija","Tarija","U.E. Nuestra Señora Del Rosario",65,0,0,0,72,3,45,4,0,189,2,8,199,229,0.381,0.869
"18525","Tarija","Tarija","U.E. Nuestra Señora Del Rosario",93,1,0,1,52,7,26,3,2,185,2,10,197,226,0.281,0.872
"18526","Tarija","Tarija","U.E. Nuestra Señora Del Rosario",103,1,1,0,50,2,27,4,2,190,4,10,204,227,0.263,0.899
"18527","Tarija","Tarija","U.E. Nuestra Señora Del Rosario",90,0,1,0,57,5,45,0,1,199,1,8,208,230,0.286,0.904
"18528","Tarija","Tarija","U.E. Julio Calvo",66,1,1,0,85,3,26,4,0,186,4,14,204,231,0.457,0.883
"18529","Tarija","Tarija","U.E. Julio Calvo",75,1,0,1,75,3,28,3,3,189,4,13,206,232,0.397,0.888
"18530","Tarija","Tarija","U.E. Julio Calvo",76,1,0,0,76,8,24,2,1,188,2,9,199,223,0.404,0.892
"18531","Tarija","Tarija","U.E. Julio Calvo",79,1,0,1,77,7,27,4,1,197,5,3,205,231,0.391,0.887
"18532","Tarija","Tarija","U.E. Julio Calvo",82,2,1,0,59,4,35,4,2,189,0,11,200,231,0.312,0.866
"18533","Tarija","Tarija","U.E. Julio Calvo",74,0,1,0,55,9,33,1,0,173,6,13,192,225,0.318,0.853
"18534","Tarija","Tarija","U.E. Julio Calvo",79,0,0,0,71,2,23,7,0,182,3,11,196,228,0.39,0.86
"18535","Tarija","Tarija","U.E. Julio Calvo",70,0,1,0,81,6,21,6,0,185,5,2,192,223,0.438,0.861
"18536","Tarija","Tarija","U.E. Julio Calvo",55,2,0,1,98,0,34,1,4,195,4,11,210,228,0.503,0.921
"18537","Tarija","Tarija","U.E. Julio Calvo",53,0,2,0,93,3,40,3,1,195,4,6,205,229,0.477,0.895
"18538","Tarija","Tarija","U.E. Julio Calvo",47,0,1,1,92,5,35,5,1,187,2,6,195,227,0.492,0.859
"18539","Tarija","Tarija","U.E. Julio Calvo",53,0,1,2,82,5,40,7,0,190,1,13,204,234,0.432,0.872
"18540","Tarija","Tarija","U.E. Julio Calvo",61,1,0,0,74,7,31,4,2,180,1,20,201,228,0.411,0.882
"18541","Tarija","Tarija","U.E. Julio Calvo",78,1,0,0,68,9,28,1,2,187,8,6,201,223,0.364,0.901
"18542","Tarija","Tarija","U.E. Julio Calvo",82,2,0,2,73,2,37,3,2,203,0,5,208,228,0.36,0.912
"18543","Tarija","Tarija","U.E. Julio Calvo",104,0,1,2,58,9,26,2,1,203,2,4,209,229,0.286,0.913
"18544","Tarija","Tarija","U.E. Julio Calvo",85,2,1,1,54,5,23,3,1,175,5,10,190,227,0.309,0.837
"18545","Tarija","Tarija","U.E. Julio Calvo",68,1,1,2,82,6,28,2,3,193,0,17,210,231,0.425,0.909
"18546","Tarija","Tarija","U.E. Julio Calvo",78,1,0,0,71,8,24,0,3,185,5,11,201,230,0.384,0.874
"18547","Tarija","Tarija","U.E. Julio Calvo",82,1,0,1,70,3,42,2,2,203,5,10,218,233,0.345,0.936
"18548","Tarija","Tarija","U.E. Julio Calvo",63,0,2,0,109,5,26,6,0,211,2,7,220,232,0.517,0.948
"18549","Tarija","Tarija","U.E. Julio Calvo",54,0,1,2,85,3,45,1,0,191,1,11,203,233,0.445,0.871
"18550","Tarija","Tarija","U.E. Julio Calvo",77,1,0,0,74,3,41,3,0,199,2,9,210,232,0.372,0.905
"18551","Tarija","Tarija","U.E. Julio Calvo",70,0,1,0,96,5,24,6,1,203,2,6,211,231,0.473,0.913
"18552","Tarija","Tarija","U.E. Julio Calvo",93,0,0,0,60,5,30,3,2,193,2,10,205,228,0.311,0.899
"18553","Tarija","Tarija","U.E. Julio Calvo",60,0,0,0,92,5,28,3,1,189,0,11,200,228,0.487,0.877
"18554","Tarija","Tarija","U.E. Julio Calvo",36,1,1,1,108,5,33,0,2,187,1,7,195,227,0.578,0.859
"18555","Tarija","Tarija","U.E. Julio Calvo",57,2,2,0,91,5,39,2,1,199,3,10,212,231,0.457,0.918
"18556","Tarija","Tarija","U.E. Julio Calvo",74,0,0,0,73,6,23,0,1,177,4,17,198,227,0.412,0.872
"18557","Tarija","Tarija","U.E. Julio Calvo",95,0,1,1,72,7,16,6,1,199,3,9,211,230,0.362,0.917
"18558","Tarija","Tarija","U.E. Julio Calvo",82,0,0,0,76,11,21,5,1,196,0,10,206,231,0.388,0.892
"18559","Tarija","Tarija","U.E. Julio Calvo",57,0,1,0,72,6,46,2,0,184,2,13,199,224,0.391,0.888
"18560","Tarija","Tarija","U.E. Julio Calvo",85,0,0,1,80,4,25,0,2,197,3,7,207,228,0.406,0.908
"18561","Tarija","Tarija","U.E. Julio Calvo",68,0,1,0,84,9,26,1,0,189,1,8,198,229,0.444,0.865
"18562","Tarija","Tarija","U.E. Julio Calvo",81,0,0,4,68,4,28,9,0,194,2,9,205,229,0.351,0.895
"18563","Tarija","Tarija","U.E. Julio Calvo",69,0,1,2,79,4,34,5,1,195,1,7,203,235,0.405,0.864
"18564","Tarija","Tarija","U.E. Julio Calvo",71,1,0,1,88,1,30,4,1,197,3,13,213,233,0.447,0.914
"18565","Tarija","Tarija","U.E. Lourdes",57,1,0,2,97,5,43,2,1,208,5,12,225,238,0.466,0.945
"18566","Tarija","Tarija","U.E. Lourdes",55,1,0,0,106,9,42,2,0,215,2,8,225,237,0.493,0.949
"18567","Tarija","Tarija","U.E. Lourdes",85,0,2,0,75,9,41,5,2,219,2,5,226,239,0.342,0.946
"18568","Tarija","Tarija","U.E. Lourdes",59,0,1,0,87,6,46,5,1,205,2,14,221,236,0.424,0.936
"18569","Tarija","Tarija","U.E. Lourdes",68,1,2,0,112,1,36,1,2,223,1,7,231,238,0.502,0.971
"18570","Tarija","Tarija","U.E. Lourdes",55,0,1,1,121,4,25,5,1,213,5,3,221,235,0.568,0.94
"18571","Tarija","Tarija","U.E. Lourdes",73,0,1,0,87,1,46,1,0,209,4,14,227,238,0.416,0.954
"18572","Tarija","Tarija","U.E. Lourdes",71,0,2,1,65,3,30,1,0,173,0,3,176,187,0.376,0.941
"18573","Tarija","Tarija","U.E. Juana Azurduy De Padilla",132,0,0,0,40,7,13,4,1,197,0,6,203,231,0.203,0.879
"18574","Tarija","Tarija","U.E. Juana Azurduy De Padilla",139,0,1,0,35,5,13,6,1,200,0,7,207,233,0.175,0.888
"18575","Tarija","Tarija","U.E. Juana Azurduy De Padilla",143,0,0,1,26,10,18,1,1,200,1,8,209,229,0.13,0.913
"18576","Tarija","Tarija","U.E. Juana Azurduy De Padilla",116,1,0,0,48,6,17,6,0,194,1,13,208,229,0.247,0.908
"18577","Tarija","Tarija","U.E. Juana Azurduy De Padilla",104,1,1,0,57,4,17,6,2,192,3,5,200,222,0.297,0.901
"18578","Tarija","Tarija","U.E. Juana Azurduy De Padilla",130,0,1,0,37,11,20,2,2,203,1,8,212,229,0.182,0.926
"18579","Tarija","Tarija","U.E. Juana Azurduy De Padilla",131,0,0,0,34,8,18,8,0,199,0,9,208,232,0.171,0.897
"18580","Tarija","Tarija","U.E. Juana Azurduy De Padilla",121,1,1,0,61,8,16,5,1,214,0,7,221,230,0.285,0.961
"18581","Tarija","Tarija","U.E. Juana Azurduy De Padilla",126,2,1,0,45,5,15,2,0,196,0,13,209,227,0.23,0.921
"18582","Tarija","Tarija","U.E. Juana Azurduy De Padilla",137,1,0,0,38,4,9,5,2,196,2,7,205,230,0.194,0.891
"18583","Tarija","Tarija","U.E. Juana Azurduy De Padilla",110,0,0,0,38,7,19,6,2,182,2,8,192,226,0.209,0.85
"18584","Tarija","Tarija","U.E. Juana Azurduy De Padilla",133,1,2,0,37,8,18,4,1,204,0,5,209,224,0.181,0.933
"18585","Tarija","Tarija","U.E. Juana Azurduy De Padilla",141,1,0,0,31,4,17,6,1,201,1,7,209,228,0.154,0.917
"18586","Tarija","Tarija","U.E. Juana Azurduy De Padilla",149,0,2,0,27,5,20,3,1,207,0,1,208,225,0.13,0.924
"18587","Tarija","Tarija","U.E. Juana Azurduy De Padilla",146,0,0,0,33,1,18,2,0,200,1,5,206,229,0.165,0.9
"18588","Tarija","Tarija","U.E. Esteban Migliaci",119,0,0,1,42,9,21,7,0,199,2,6,207,232,0.211,0.892
"18589","Tarija","Tarija","U.E. Esteban Migliaci",103,0,0,2,44,2,25,6,0,182,2,18,202,232,0.242,0.871
"18590","Tarija","Tarija","U.E. Esteban Migliaci",118,0,1,0,53,2,19,5,0,198,2,6,206,223,0.268,0.924
"18591","Tarija","Tarija","U.E. Esteban Migliaci",115,0,0,0,61,3,19,3,0,201,1,10,212,232,0.303,0.914
"18592","Tarija","Tarija","U.E. Esteban Migliaci",109,0,0,0,49,5,20,3,0,186,5,10,201,224,0.263,0.897
"18593","Tarija","Tarija","U.E. Esteban Migliaci",88,2,1,1,53,7,27,2,0,181,3,7,191,227,0.293,0.841
"18594","Tarija","Tarija","U.E. Esteban Migliaci",86,0,0,0,60,7,25,8,1,187,2,12,201,227,0.321,0.885
"18595","Tarija","Tarija","U.E. Esteban Migliaci",117,0,0,0,50,11,19,2,0,199,0,14,213,227,0.251,0.938
"18596","Tarija","Tarija","U.E. Esteban Migliaci",109,0,0,0,46,2,31,2,0,190,3,16,209,225,0.242,0.929
"18597","Tarija","Tarija","U.E. Esteban Migliaci",109,1,0,1,53,7,25,3,1,200,5,7,212,232,0.265,0.914
"18598","Tarija","Tarija","U.E. Esteban Migliaci",123,0,1,2,40,10,20,4,0,200,2,7,209,230,0.2,0.909
"18599","Tarija","Tarija","U.E. Esteban Migliaci",117,1,2,2,37,2,32,4,0,197,2,10,209,229,0.188,0.913
"18600","Tarija","Tarija","U.E. Esteban Migliaci",122,2,0,1,38,10,16,4,0,193,2,8,203,228,0.197,0.89
"18601","Tarija","Tarija","U.E. Esteban Migliaci",105,0,0,0,54,5,22,5,2,193,1,11,205,228,0.28,0.899
"18602","Tarija","Tarija","U.E. Esteban Migliaci",102,0,0,0,65,4,24,5,1,201,3,5,209,226,0.323,0.925
"18603","Tarija","Tarija","U.E. Esteban Migliaci",110,0,1,2,50,3,19,6,0,191,4,11,206,234,0.262,0.88
"18604","Tarija","Tarija","U.E. Esteban Migliaci",122,2,0,1,35,8,19,4,0,191,5,8,204,231,0.183,0.883
"18605","Tarija","Tarija","U.E. Esteban Migliaci",125,2,1,1,38,8,23,5,0,203,1,11,215,235,0.187,0.915
"18606","Tarija","Tarija","U.E. Esteban Migliaci",110,0,0,1,59,5,24,3,0,202,1,8,211,232,0.292,0.909
"18607","Tarija","Tarija","U.E. Esteban Migliaci",125,0,0,0,51,3,19,3,1,202,1,2,205,229,0.252,0.895
"18608","Tarija","Tarija","U.E. Esteban Migliaci",122,2,1,1,39,5,17,2,0,189,5,7,201,224,0.206,0.897
"18609","Tarija","Tarija","U.E. Esteban Migliaci",123,1,1,3,39,5,15,5,0,192,3,9,204,228,0.203,0.895
"18610","Tarija","Tarija","U.E. Esteban Migliaci",112,0,1,2,53,5,16,6,0,195,1,11,207,224,0.272,0.924
"18611","Tarija","Tarija","U.E. Esteban Migliaci",114,2,1,2,47,4,18,5,0,193,5,8,206,230,0.244,0.896
"18612","Tarija","Tarija","U.E. Esteban Migliaci",128,1,0,1,30,8,11,12,0,191,0,10,201,228,0.157,0.882
"18613","Tarija","Tarija","U.E. Esteban Migliaci",114,1,0,0,50,4,15,3,4,191,6,13,210,232,0.262,0.905
"18614","Tarija","Tarija","U.E. Esteban Migliaci",112,1,0,0,53,2,23,5,3,199,1,12,212,233,0.266,0.91
"18615","Tarija","Tarija","U.E. Santa Ana",87,0,0,0,85,6,38,6,0,222,2,4,228,237,0.383,0.962
"18616","Tarija","Tarija","U.E. Santa Ana",94,0,1,0,75,3,25,2,1,201,1,12,214,235,0.373,0.911
"18617","Tarija","Tarija","U.E. Santa Ana",104,0,1,0,66,4,34,5,0,214,1,8,223,239,0.308,0.933
"18618","Tarija","Tarija","U.E. Santa Ana",109,0,1,0,67,6,27,4,0,214,1,9,224,237,0.313,0.945
"18619","Tarija","Tarija","U.E. Santa Ana",100,0,0,1,71,1,41,2,1,217,2,10,229,237,0.327,0.966
"18620","Tarija","Tarija","U.E. Juan XXIII",128,0,2,0,35,9,17,3,1,195,0,6,201,226,0.179,0.889
"18621","Tarija","Tarija","U.E. Juan XXIII",135,1,0,0,37,1,18,6,0,198,1,5,204,228,0.187,0.895
"18622","Tarija","Tarija","U.E. Juan XXIII",141,0,0,2,35,4,9,5,0,196,0,7,203,224,0.179,0.906
"18623","Tarija","Tarija","U.E. Juan XXIII",127,1,1,2,40,6,11,5,0,193,0,13,206,224,0.207,0.92
"18624","Tarija","Tarija","U.E. Juan XXIII",137,0,0,2,28,0,15,7,0,189,1,6,196,231,0.148,0.848
"18625","Tarija","Tarija","U.E. Juan XXIII",136,0,1,0,37,5,10,8,0,197,1,10,208,230,0.188,0.904
"18626","Tarija","Tarija","U.E. Juan XXIII",152,1,1,0,25,7,10,6,0,202,2,7,211,231,0.124,0.913
"18627","Tarija","Tarija","U.E. Juan XXIII",125,0,0,1,40,5,15,5,0,191,0,9,200,219,0.209,0.913
"18628","Tarija","Tarija","U.E. Juan XXIII",122,0,2,1,39,0,26,5,0,195,0,9,204,230,0.2,0.887
"18629","Tarija","Tarija","U.E. Juan XXIII",142,0,0,1,27,3,14,7,0,194,1,2,197,223,0.139,0.883
"18630","Tarija","Tarija","U.E. Juan XXIII",121,0,1,1,42,4,15,3,0,187,1,5,193,224,0.225,0.862
"18631","Tarija","Tarija","U.E. Juan XXIII",131,0,2,0,36,5,20,5,2,201,0,7,208,230,0.179,0.904
"18632","Tarija","Tarija","U.E. Juan XXIII",142,0,0,0,29,5,13,3,3,195,0,12,207,230,0.149,0.9
"18633","Tarija","Tarija","U.E. Juan XXIII",120,0,1,2,33,4,28,4,1,193,1,4,198,221,0.171,0.896
"18634","Tarija","Tarija","U.E. Juan XXIII",120,0,2,0,44,4,21,5,1,197,2,7,206,227,0.223,0.907
"18635","Tarija","Tarija","U.E. Juan XXIII",146,0,1,1,23,4,17,7,2,201,3,5,209,231,0.114,0.905
"18636","Tarija","Tarija","U.E. Juan XXIII",137,1,0,4,19,2,20,9,1,193,4,4,201,225,0.098,0.893
"18637","Tarija","Tarija","U.E. Juan XXIII",141,1,1,0,23,10,13,3,0,192,3,9,204,228,0.12,0.895
"18638","Tarija","Tarija","U.E. Juan XXIII",142,0,1,1,33,4,19,5,0,205,3,7,215,230,0.161,0.935
"18639","Tarija","Tarija","U.E. Juan XXIII",145,1,1,1,31,0,15,7,1,202,3,4,209,227,0.153,0.921
"18640","Tarija","Tarija","U.E. Octavio Campero Echazu",75,2,2,0,82,3,26,6,3,199,2,11,212,233,0.412,0.91
"18641","Tarija","Tarija","U.E. Octavio Campero Echazu",101,1,1,0,61,4,30,1,0,199,1,5,205,231,0.307,0.887
"18642","Tarija","Tarija","U.E. Octavio Campero Echazu",79,0,0,0,67,3,39,2,0,190,0,11,201,227,0.353,0.885
"18643","Tarija","Tarija","U.E. Octavio Campero Echazu",97,0,1,2,56,10,23,2,0,191,4,7,202,228,0.293,0.886
"18644","Tarija","Tarija","U.E. Octavio Campero Echazu",77,1,0,5,71,4,32,0,0,190,2,9,201,224,0.374,0.897
"18645","Tarija","Tarija","U.E. Octavio Campero Echazu",104,0,1,0,58,5,19,3,0,190,4,9,203,227,0.305,0.894
"18646","Tarija","Tarija","U.E. Octavio Campero Echazu",51,0,1,3,92,5,23,1,1,177,6,12,195,225,0.52,0.867
"18647","Tarija","Tarija","U.E. Octavio Campero Echazu",60,1,1,2,84,5,29,4,0,186,2,12,200,227,0.452,0.881
"18648","Tarija","Tarija","U.E. Octavio Campero Echazu",83,2,0,0,57,7,35,3,1,188,3,12,203,225,0.303,0.902
"18649","Tarija","Tarija","U.E. Octavio Campero Echazu",99,0,0,1,71,4,21,4,0,200,3,11,214,231,0.355,0.926
"18650","Tarija","Tarija","U.E. Octavio Campero Echazu",88,0,0,0,61,8,28,5,1,191,1,8,200,233,0.319,0.858
"18651","Tarija","Tarija","U.E. Octavio Campero Echazu",102,0,0,0,61,8,21,5,0,197,1,5,203,226,0.31,0.898
"18652","Tarija","Tarija","U.E. Octavio Campero Echazu",85,0,0,0,75,4,28,2,2,196,3,5,204,226,0.383,0.903
"18653","Tarija","Tarija","U.E. Octavio Campero Echazu",87,1,2,1,76,3,29,2,3,204,1,11,216,234,0.373,0.923
"18654","Tarija","Tarija","U.E. Octavio Campero Echazu",68,0,1,0,75,7,30,0,1,182,4,15,201,229,0.412,0.878
"18655","Tarija","Tarija","U.E. Octavio Campero Echazu",101,0,1,2,67,2,24,2,0,199,1,7,207,227,0.337,0.912
"18656","Tarija","Tarija","U.E. Octavio Campero Echazu",67,0,2,0,71,5,41,4,0,190,5,14,209,227,0.374,0.921
"18657","Tarija","Tarija","U.E. Octavio Campero Echazu",88,0,2,0,67,7,30,7,1,202,2,8,212,231,0.332,0.918
"18658","Tarija","Tarija","U.E. Octavio Campero Echazu",91,0,0,1,63,6,21,2,1,185,1,10,196,227,0.341,0.863
"18659","Tarija","Tarija","U.E. Octavio Campero Echazu",78,0,0,0,63,3,30,3,0,177,1,17,195,225,0.356,0.867
"18660","Tarija","Tarija","U.E. Octavio Campero Echazu",70,1,0,0,79,6,35,0,2,193,3,5,201,229,0.409,0.878
"18661","Tarija","Tarija","U.E. Octavio Campero Echazu",71,0,3,1,77,4,28,4,5,193,1,8,202,227,0.399,0.89
"18662","Tarija","Tarija","U.E. Octavio Campero Echazu",93,0,0,0,68,6,26,1,0,194,2,12,208,234,0.351,0.889
"18663","Tarija","Tarija","U.E. Octavio Campero Echazu",98,1,2,0,48,9,36,1,1,196,4,8,208,230,0.245,0.904
"18664","Tarija","Tarija","U.E. Octavio Campero Echazu",91,2,3,0,64,6,31,6,1,204,2,8,214,235,0.314,0.911
"18665","Tarija","Tarija","U.E. Octavio Campero Echazu",98,0,0,0,62,9,19,7,0,195,3,6,204,233,0.318,0.876
"18666","Tarija","Tarija","U.E. Octavio Campero Echazu",84,0,1,1,61,2,26,2,2,179,2,7,188,217,0.341,0.866
"18667","Tarija","Tarija","U.E. Octavio Campero Echazu",108,0,0,1,52,6,18,2,0,187,4,14,205,229,0.278,0.895
"18668","Tarija","Tarija","U.E. Octavio Campero Echazu",84,0,0,2,68,7,27,4,2,194,3,8,205,229,0.351,0.895
"18669","Tarija","Tarija","U.E. Pampa Galana",84,0,0,2,68,2,21,8,2,187,4,9,200,228,0.364,0.877
"18670","Tarija","Tarija","U.E. Pampa Galana",88,0,0,1,61,2,26,5,1,184,6,16,206,228,0.332,0.904
"18671","Tarija","Tarija","U.E. Pampa Galana",84,0,2,1,62,8,28,4,1,190,3,12,205,234,0.326,0.876
"18672","Tarija","Tarija","U.E. Pampa Galana",78,1,2,0,69,3,30,5,3,191,3,14,208,227,0.361,0.916
"18673","Tarija","Tarija","U.E. Pampa Galana",97,2,1,0,60,8,21,5,1,195,2,17,214,230,0.308,0.93
"18674","Tarija","Tarija","U.E. Pampa Galana",90,1,0,0,59,10,26,6,1,193,7,7,207,228,0.306,0.908
"18675","Tarija","Tarija","U.E. Pampa Galana",87,2,0,1,78,7,26,5,0,206,2,9,217,229,0.379,0.948
"18676","Tarija","Tarija","U.E. Pampa Galana",78,0,3,0,84,3,24,7,3,202,3,5,210,232,0.416,0.905
"18677","Tarija","Tarija","U.E. Pampa Galana",88,0,3,2,68,6,24,4,5,200,4,10,214,232,0.34,0.922
"18678","Tarija","Tarija","U.E. Pampa Galana",85,0,0,1,70,6,31,4,0,197,3,14,214,230,0.355,0.93
"18679","Tarija","Tarija","U.E. Pampa Galana",104,0,0,0,60,6,22,8,2,202,5,12,219,235,0.297,0.932
"18680","Tarija","Tarija","U.E. Pampa Galana",100,1,0,0,61,3,26,2,0,193,7,17,217,235,0.316,0.923
"18681","Tarija","Tarija","U.E. Pampa Galana",87,2,0,0,57,4,37,4,1,192,2,13,207,227,0.297,0.912
"18682","Tarija","Tarija","U.E. Pampa Galana",91,1,0,0,66,4,32,6,1,201,3,8,212,232,0.328,0.914
"18683","Tarija","Tarija","U.E. La Paz",99,2,4,0,52,4,20,5,0,186,5,17,208,231,0.28,0.9
"18684","Tarija","Tarija","U.E. La Paz",100,1,0,0,51,5,27,7,1,192,1,9,202,231,0.266,0.874
"18685","Tarija","Tarija","U.E. La Paz",110,0,0,0,62,7,13,9,1,202,1,11,214,235,0.307,0.911
"18686","Tarija","Tarija","U.E. La Paz",94,0,3,3,64,5,15,4,1,189,5,10,204,232,0.339,0.879
"18687","Tarija","Tarija","U.E. La Paz",96,0,1,0,66,3,30,2,0,198,2,9,209,235,0.333,0.889
"18688","Tarija","Tarija","U.E. La Paz",94,0,2,1,57,6,35,3,0,198,4,15,217,234,0.288,0.927
"18689","Tarija","Tarija","U.E. La Paz",123,0,1,0,37,11,24,5,1,202,1,11,214,231,0.183,0.926
"18690","Tarija","Tarija","U.E. La Paz",103,1,0,0,49,11,25,7,1,197,6,13,216,235,0.249,0.919
"18691","Tarija","Tarija","U.E. La Paz",115,1,1,2,39,3,23,5,1,190,6,11,207,228,0.205,0.908
"18692","Tarija","Tarija","U.E. La Paz",113,3,0,0,44,2,26,4,1,193,5,9,207,230,0.228,0.9
"18693","Tarija","Tarija","U.E. La Paz",98,0,2,0,52,8,23,7,0,190,4,17,211,234,0.274,0.902
"18694","Tarija","Tarija","U.E. La Paz",111,0,0,0,51,3,16,2,1,184,3,19,206,227,0.277,0.907
"18695","Tarija","Tarija","U.E. La Paz",85,0,1,0,72,4,35,5,0,202,5,7,214,232,0.356,0.922
"18696","Tarija","Tarija","U.E. La Paz",87,0,2,0,58,5,28,6,0,186,3,12,201,230,0.312,0.874
"18697","Tarija","Tarija","U.E. La Paz",110,3,2,0,52,6,23,6,0,202,1,11,214,236,0.257,0.907
"18698","Tarija","Tarija","U.E. La Paz",96,0,1,2,51,5,34,7,0,196,3,8,207,229,0.26,0.904
"18699","Tarija","Tarija","U.E. La Paz",92,0,2,0,61,6,31,2,0,194,4,12,210,230,0.314,0.913
"18700","Tarija","Tarija","U.E. La Paz",108,2,0,2,43,8,24,4,1,192,3,17,212,235,0.224,0.902
"18701","Tarija","Tarija","U.E. La Paz",115,0,0,0,40,7,24,1,2,189,4,10,203,228,0.212,0.89
"18702","Tarija","Tarija","U.E. La Paz",98,2,3,1,33,10,34,12,1,194,1,18,213,236,0.17,0.903
"18703","Tarija","Tarija","U.E. La Paz",113,1,0,0,34,12,28,2,1,191,1,14,206,230,0.178,0.896
"18704","Tarija","Tarija","U.E. La Paz",128,1,0,2,33,11,19,6,2,202,1,11,214,233,0.163,0.918
"18705","Tarija","Tarija","U.E. Alberto Baldivieso",66,0,1,0,95,8,42,0,2,214,4,5,223,239,0.444,0.933
"18706","Tarija","Tarija","U.E. Alberto Baldivieso",66,1,1,1,103,4,37,5,1,219,3,5,227,239,0.47,0.95
"18707","Tarija","Tarija","U.E. Eduardo Orozco Alfaro",103,1,0,0,74,5,25,5,1,214,4,6,224,234,0.346,0.957
"18708","Tarija","Tarija","U.E. Eduardo Orozco Alfaro",80,0,1,0,67,7,25,7,1,188,4,19,211,234,0.356,0.902
"18709","Tarija","Tarija","U.E. Eduardo Orozco Alfaro",88,0,1,1,60,10,29,2,1,192,1,15,208,230,0.312,0.904
"18710","Tarija","Tarija","U.E. Eduardo Orozco Alfaro",93,1,1,0,71,5,32,3,0,206,5,9,220,236,0.345,0.932
"18711","Tarija","Tarija","U.E. Eduardo Orozco Alfaro",78,0,1,0,83,5,29,5,1,202,2,15,219,232,0.411,0.944
"18712","Tarija","Tarija","U.E. Eduardo Orozco Alfaro",81,0,1,2,70,10,32,5,0,201,4,7,212,233,0.348,0.91
"18713","Tarija","Tarija","U.E. Eduardo Orozco Alfaro",65,1,2,1,78,9,22,9,1,188,2,20,210,233,0.415,0.901
"18714","Tarija","Tarija","U.E. Eduardo Orozco Alfaro",96,0,0,0,58,6,29,5,2,196,4,16,216,232,0.296,0.931
"18715","Tarija","Tarija","U.E. Eduardo Orozco Alfaro",101,0,0,4,60,7,21,7,0,200,1,13,214,231,0.3,0.926
"18716","Tarija","Tarija","U.E. Eduardo Orozco Alfaro",90,0,0,0,72,10,29,2,1,204,4,6,214,234,0.353,0.915
"18717","Tarija","Tarija","U.E. Castelfort Castellanos",124,1,2,0,40,4,16,5,1,193,4,17,214,230,0.207,0.93
"18718","Tarija","Tarija","U.E. Castelfort Castellanos",128,0,0,0,33,3,19,3,1,187,3,11,201,231,0.176,0.87
"18719","Tarija","Tarija","U.E. Castelfort Castellanos",127,2,1,0,37,8,23,2,0,200,3,2,205,233,0.185,0.88
"18720","Tarija","Tarija","U.E. Castelfort Castellanos",114,1,2,1,37,8,26,3,1,193,1,12,206,229,0.192,0.9
"18721","Tarija","Tarija","U.E. Castelfort Castellanos",117,1,1,0,48,3,16,4,0,190,1,13,204,225,0.253,0.907
"18722","Tarija","Tarija","U.E. Castelfort Castellanos",119,0,2,1,37,7,23,4,0,193,1,5,199,226,0.192,0.881
"18723","Tarija","Tarija","U.E. Castelfort Castellanos",111,0,1,0,40,0,20,7,0,179,4,12,195,227,0.223,0.859
"18724","Tarija","Tarija","U.E. Castelfort Castellanos",144,1,1,1,26,11,13,4,0,201,1,8,210,230,0.129,0.913
"18725","Tarija","Tarija","U.E. Castelfort Castellanos",119,2,0,1,37,3,25,8,1,196,3,11,210,231,0.189,0.909
"18726","Tarija","Tarija","U.E. Castelfort Castellanos",119,1,0,0,41,8,20,5,1,195,1,6,202,232,0.21,0.871
"18727","Tarija","Tarija","U.E. Castelfort Castellanos",114,0,0,2,49,5,21,5,1,197,3,8,208,231,0.249,0.9
"18728","Tarija","Tarija","U.E. Castelfort Castellanos",106,1,0,0,47,8,18,6,0,186,4,12,202,229,0.253,0.882
"18729","Tarija","Tarija","U.E. Castelfort Castellanos",116,0,0,1,28,8,20,2,0,175,4,13,192,224,0.16,0.857
"18730","Tarija","Tarija","U.E. Castelfort Castellanos",109,1,0,1,40,9,21,3,3,187,2,12,201,227,0.214,0.885
"18731","Tarija","Tarija","U.E. Castelfort Castellanos",104,2,0,0,46,12,27,7,0,198,5,11,214,230,0.232,0.93
"18732","Tarija","Tarija","U.E. Castelfort Castellanos",125,0,0,1,39,2,12,8,0,187,1,11,199,227,0.209,0.877
"18733","Tarija","Tarija","U.E. Castelfort Castellanos",118,0,0,4,40,8,16,8,1,195,5,8,208,231,0.205,0.9
"18734","Tarija","Tarija","U.E. Castelfort Castellanos",128,0,0,0,23,10,17,8,0,186,3,13,202,230,0.124,0.878
"18735","Tarija","Tarija","U.E. Castelfort Castellanos",115,0,1,1,44,3,18,3,1,186,2,8,196,226,0.237,0.867
"18736","Tarija","Tarija","(Cárcel) Penal de Morros Blancos",67,1,1,0,85,5,27,3,1,190,8,13,211,236,0.447,0.894
"18737","Tarija","Tarija","U.E. Víctor Varas Reyes",111,0,1,1,62,5,29,3,0,212,0,16,228,238,0.292,0.958
"18738","Tarija","Tarija","U.E. Víctor Varas Reyes",114,0,1,0,55,10,33,3,0,216,0,11,227,237,0.255,0.958
"18739","Tarija","Tarija","U.E. Víctor Varas Reyes",134,1,1,2,50,12,30,9,1,240,4,7,251,257,0.208,0.977
"18740","Tarija","Tarija","U.E. El Portillo",69,0,1,0,86,10,27,1,3,197,1,12,210,237,0.437,0.886
"18741","Tarija","Tarija","U.E. El Portillo",68,3,1,1,86,8,32,2,2,203,2,14,219,232,0.424,0.944
"18742","Tarija","Tarija","U.E. El Portillo",78,2,0,1,75,6,31,5,0,198,2,15,215,231,0.379,0.931
"18743","Tarija","Tarija","U.E. El Portillo",82,0,0,0,72,10,34,5,0,203,4,6,213,233,0.355,0.914
"18744","Tarija","Tarija","U.E. El Portillo",58,1,1,1,90,6,28,5,0,190,6,12,208,235,0.474,0.885
"18745","Tarija","Tarija","U.E. El Portillo",70,0,2,1,92,10,22,1,0,198,4,8,210,230,0.465,0.913
"18746","Tarija","Tarija","U.E. El Portillo",77,1,0,1,67,10,27,6,1,190,7,18,215,232,0.353,0.927
"18747","Tarija","Tarija","U.E. El Portillo",70,1,0,0,71,8,40,7,1,198,2,11,211,235,0.359,0.898
"18748","Tarija","Tarija","U.E. San Jorge",104,0,0,0,48,6,34,2,2,196,0,10,206,233,0.245,0.884
"18749","Tarija","Tarija","U.E. San Jorge",105,0,0,0,40,9,25,7,0,186,5,9,200,228,0.215,0.877
"18750","Tarija","Tarija","U.E. San Jorge",123,0,0,0,45,4,17,8,1,198,0,15,213,230,0.227,0.926
"18751","Tarija","Tarija","U.E. San Jorge",113,1,2,0,48,4,22,5,1,196,1,8,205,230,0.245,0.891
"18752","Tarija","Tarija","U.E. San Jorge",104,2,0,1,61,6,21,6,0,201,4,5,210,232,0.303,0.905
"18753","Tarija","Tarija","U.E. San Jorge",89,0,0,0,58,2,33,7,1,190,7,11,208,233,0.305,0.893
"18754","Tarija","Tarija","U.E. San Jorge",110,0,0,0,43,9,29,6,1,198,2,5,205,227,0.217,0.903
"18755","Tarija","Tarija","U.E. San Jorge",120,0,0,0,40,7,31,0,0,198,2,9,209,233,0.202,0.897
"18756","Tarija","Tarija","U.E. San Jorge",123,0,1,2,36,5,19,3,1,190,6,10,206,231,0.189,0.892
"18757","Tarija","Tarija","U.E. San Jorge",118,1,0,2,41,7,27,5,0,201,4,6,211,231,0.204,0.913
"18758","Tarija","Tarija","U.E. San Jorge",115,3,1,0,64,6,12,4,0,205,2,10,217,232,0.312,0.935
"18759","Tarija","Tarija","U.E. San Jorge",100,0,0,1,54,10,19,6,0,190,1,10,201,234,0.284,0.859
"18760","Tarija","Tarija","U.E. San Jorge",97,2,0,0,49,3,41,2,0,194,0,8,202,223,0.253,0.906
"18761","Tarija","Tarija","U.E. San Jorge",115,0,1,1,30,8,26,4,1,186,2,7,195,225,0.161,0.867
"18762","Tarija","Tarija","U.E. San Jorge",111,2,1,3,45,5,23,5,1,196,2,7,205,233,0.23,0.88
"18763","Tarija","Tarija","U.E. San Jorge",121,1,0,1,33,10,33,4,0,203,2,6,211,230,0.163,0.917
"18764","Tarija","Tarija","U.E. San Jorge",103,0,1,0,53,4,35,3,1,200,2,1,203,225,0.265,0.902
"18765","Tarija","Tarija","U.E. San Jorge",128,1,1,0,41,4,19,2,3,199,1,9,209,228,0.206,0.917
"18766","Tarija","Tarija","U.E. San Jorge",114,3,0,1,53,8,22,2,0,203,0,12,215,235,0.261,0.915
"18767","Tarija","Tarija","U.E. San Jorge",113,0,0,1,42,12,26,6,0,200,2,4,206,232,0.21,0.888
"18768","Tarija","Tarija","U.E. San Jorge",114,1,0,1,47,4,31,5,0,203,3,5,211,231,0.232,0.913
"18769","Tarija","Tarija","U.E. San Jorge",95,0,0,0,64,7,27,7,1,201,5,11,217,232,0.318,0.935
"18770","Tarija","Tarija","U.E. San Jorge",108,0,0,1,54,4,24,11,2,204,1,5,210,234,0.265,0.897
"18771","Tarija","Tarija","U.E. San Geronimo",103,0,0,0,50,2,15,1,0,171,4,11,186,233,0.292,0.798
"18772","Tarija","Tarija","U.E. San Geronimo",119,0,1,0,36,4,12,7,0,179,0,9,188,235,0.201,0.8
"18773","Tarija","Tarija","U.E. San Geronimo",121,1,0,2,39,4,12,2,0,181,1,4,186,230,0.215,0.809
"18774","Tarija","Tarija","U.E. San Geronimo",112,0,0,1,37,2,22,1,0,175,1,7,183,233,0.211,0.785
"18775","Tarija","Tarija","U.E. San Geronimo",81,0,1,0,50,2,17,2,1,154,3,5,162,233,0.325,0.695
"18776","Tarija","Tarija","U.E. San Geronimo",79,0,0,1,46,6,28,1,1,162,1,2,165,230,0.284,0.717
"18777","Tarija","Tarija","U.E. San Geronimo",115,0,1,1,32,8,16,1,0,174,1,8,183,229,0.184,0.799
"18778","Tarija","Tarija","U.E. San Geronimo",94,0,0,0,36,3,27,3,1,164,1,8,173,229,0.22,0.755
"18779","Tarija","Tarija","U.E. San Geronimo",120,0,2,1,41,1,18,1,1,185,1,2,188,227,0.222,0.828
"18780","Tarija","Tarija","U.E. San Geronimo",82,1,1,0,51,2,21,5,1,164,1,3,168,232,0.311,0.724
"18781","Tarija","Tarija","U.E. San Geronimo",100,0,0,1,48,2,16,1,0,168,1,1,170,231,0.286,0.736
"18782","Tarija","Tarija","U.E. San Geronimo",92,0,0,1,44,5,18,4,1,165,3,7,175,224,0.267,0.781
"18783","Tarija","Tarija","U.E. San Geronimo",111,0,1,0,39,5,19,5,0,180,2,5,187,232,0.217,0.806
"18784","Tarija","Tarija","U.E. San Geronimo",104,0,1,0,46,4,15,6,2,178,0,5,183,230,0.258,0.796
"18785","Tarija","Tarija","U.E. San Geronimo",77,0,1,0,58,1,14,3,0,154,1,3,158,230,0.377,0.687
"18786","Tarija","Tarija","U.E. San Geronimo",107,1,1,2,30,6,16,3,1,167,2,4,173,234,0.18,0.739
"18787","Tarija","Tarija","U.E. San Geronimo",105,0,0,1,43,6,11,1,0,167,1,12,180,231,0.257,0.779
"18788","Tarija","Tarija","U.E. San Geronimo",105,0,0,1,47,2,18,5,1,179,2,4,185,233,0.263,0.794
"18789","Tarija","Tarija","U.E. San Geronimo",112,0,0,0,48,3,21,4,1,189,0,9,198,236,0.254,0.839
"18790","Tarija","Tarija","U.E. San Geronimo",104,1,1,0,46,7,15,2,0,176,1,5,182,228,0.261,0.798
"18791","Tarija","Tarija","U.E. San Geronimo",89,0,1,0,42,2,15,9,0,158,0,3,161,216,0.266,0.745
"18792","Tarija","Tarija","U.E. San Luis",116,2,0,1,44,4,18,12,0,197,3,6,206,230,0.223,0.896
"18793","Tarija","Tarija","U.E. San Luis",104,0,0,2,54,6,16,10,0,192,8,9,209,227,0.281,0.921
"18794","Tarija","Tarija","U.E. San Luis",108,1,1,2,47,5,14,8,0,186,3,13,202,230,0.253,0.878
"18795","Tarija","Tarija","U.E. San Luis",94,4,0,1,59,9,27,6,1,201,3,3,207,227,0.294,0.912
"18796","Tarija","Tarija","U.E. San Luis",103,0,0,0,59,2,21,7,0,192,6,6,204,224,0.307,0.911
"18797","Tarija","Tarija","U.E. San Luis",101,2,1,0,57,5,14,6,0,186,2,15,203,227,0.306,0.894
"18798","Tarija","Tarija","U.E. San Luis",115,0,0,1,54,7,21,10,0,208,2,6,216,231,0.26,0.935
"18799","Tarija","Tarija","U.E. San Luis",100,0,0,0,61,6,17,7,1,192,2,8,202,229,0.318,0.882
"18800","Tarija","Tarija","U.E. Los Callejones",113,1,0,2,47,15,12,8,0,198,2,3,203,228,0.237,0.89
"18801","Tarija","Tarija","U.E. Los Callejones",108,0,1,0,57,8,15,7,0,196,2,9,207,233,0.291,0.888
"18802","Tarija","Tarija","U.E. Los Callejones",113,1,0,2,53,8,15,8,0,200,1,6,207,232,0.265,0.892
"18803","Tarija","Tarija","U.E. Los Callejones",84,2,0,1,63,13,20,6,3,192,1,10,203,230,0.328,0.883
"18804","Tarija","Tarija","U.E. Los Callejones",111,1,2,0,37,13,14,3,2,183,3,11,197,227,0.202,0.868
"18805","Tarija","Tarija","U.E. Bancario",130,0,0,2,39,0,12,10,0,193,3,2,198,224,0.202,0.884
"18806","Tarija","Tarija","U.E. Bancario",130,0,0,2,31,5,13,8,1,190,4,5,199,230,0.163,0.865
"18807","Tarija","Tarija","U.E. Bancario",139,0,0,0,34,9,22,6,0,210,2,2,214,235,0.162,0.911
"18808","Tarija","Tarija","U.E. Bancario",122,1,1,0,34,3,23,7,0,191,2,4,197,227,0.178,0.868
"18809","Tarija","Tarija","U.E. San Blas",85,0,2,5,63,10,27,3,1,196,4,10,210,230,0.321,0.913
"18810","Tarija","Tarija","U.E. San Blas",65,1,0,2,61,18,28,4,0,179,7,14,200,224,0.341,0.893
"18811","Tarija","Tarija","U.E. San Blas",69,2,0,0,60,15,24,7,0,177,0,11,188,207,0.339,0.908
"18812","Tarija","Tarija","U.E. 6 de Junio",92,0,0,2,56,12,22,6,0,190,3,14,207,229,0.295,0.904
"18813","Tarija","Tarija","U.E. 6 de Junio",87,3,1,2,53,21,20,4,0,191,3,10,204,232,0.277,0.879
"18814","Tarija","Tarija","U.E. 6 de Junio",102,0,0,1,60,12,17,1,0,193,3,5,201,227,0.311,0.885
"18815","Tarija","Tarija","U.E. 6 de Junio",71,0,1,1,73,18,18,1,0,183,4,9,196,230,0.399,0.852
"18816","Tarija","Tarija","U.E. 6 de Junio",87,2,1,0,57,22,20,5,0,194,0,14,208,226,0.294,0.92
"18817","Tarija","Tarija","U.E. 6 de Junio",92,2,0,0,50,23,15,5,2,189,3,14,206,226,0.265,0.912
"18818","Tarija","Tarija","U.E. Juan Pablo II",78,0,1,0,81,2,36,3,0,201,3,6,210,232,0.403,0.905
"18819","Tarija","Tarija","U.E. Juan Pablo II",95,0,0,1,61,6,22,3,0,188,4,7,199,228,0.324,0.873
"18820","Tarija","Tarija","U.E. Juan Pablo II",88,1,0,0,74,8,23,3,3,200,1,10,211,232,0.37,0.909
"18821","Tarija","Tarija","U.E. Juan Pablo II",88,0,3,0,73,4,27,5,1,201,0,12,213,232,0.363,0.918
"18822","Tarija","Tarija","U.E. Juan Pablo II",64,0,0,1,102,6,32,2,1,208,1,7,216,232,0.49,0.931
"18823","Tarija","Tarija","U.E. Juan Pablo II",77,1,1,0,85,2,30,3,0,199,2,8,209,231,0.427,0.905
"18824","Tarija","Tarija","U.E. Juan Pablo II",98,0,0,0,66,5,24,5,0,198,1,11,210,229,0.333,0.917
"18825","Tarija","Tarija","U.E. Juan Pablo II",74,0,0,1,78,5,29,1,0,188,1,15,204,232,0.415,0.879
"18826","Tarija","Tarija","U.E. Juan Pablo II",110,0,1,0,57,4,20,5,1,198,1,13,212,230,0.288,0.922
"18827","Tarija","Tarija","U.E. Juan Pablo II",101,0,0,0,70,1,20,8,1,201,0,9,210,233,0.348,0.901
"18828","Tarija","Tarija","U.E. Juan Pablo II",98,0,0,2,72,2,17,6,0,197,3,10,210,232,0.365,0.905
"18829","Tarija","Tarija","U.E. Juan Pablo II",68,2,1,1,74,3,36,3,1,189,1,23,213,230,0.392,0.926
"18830","Tarija","Tarija","U.E. Juan Pablo II",87,0,1,0,66,3,26,3,1,187,3,16,206,229,0.353,0.9
"18831","Tarija","Tarija","U.E. Juan Pablo II",108,0,0,1,67,4,23,3,0,206,3,11,220,234,0.325,0.94
"18832","Tarija","Tarija","U.E. Juan Pablo II",80,1,0,0,74,3,29,4,1,192,1,18,211,232,0.385,0.909
"18833","Tarija","Tarija","U.E. Juan Pablo II",91,0,1,1,70,5,17,5,1,191,4,11,206,233,0.366,0.884
"18834","Tarija","Tarija","U.E. Juan Pablo II",112,1,0,1,53,5,20,5,0,197,2,9,208,233,0.269,0.893
"18835","Tarija","Tarija","U.E. Juan Pablo II",91,1,2,1,60,5,29,2,1,192,1,13,206,227,0.312,0.907
"18836","Tarija","Tarija","U.E. Juan Pablo II",77,0,0,0,71,9,25,5,2,189,4,12,205,234,0.376,0.876
"18837","Tarija","Tarija","U.E. Juan Pablo II",104,0,1,3,52,6,24,7,2,199,0,17,216,233,0.261,0.927
"18838","Tarija","Tarija","U.E. J. Naval Monzon",99,0,1,1,54,11,27,2,1,196,3,5,204,228,0.276,0.895
"18839","Tarija","Tarija","U.E. J. Naval Monzon",104,0,0,2,63,9,19,11,1,209,2,3,214,232,0.301,0.922
"18840","Tarija","Tarija","U.E. J. Naval Monzon",89,1,1,0,62,4,36,3,0,196,3,8,207,229,0.316,0.904
"18841","Tarija","Tarija","U.E. J. Naval Monzon",63,0,1,1,102,4,23,4,0,198,4,7,209,228,0.515,0.917
"18842","Tarija","Tarija","U.E. J. Naval Monzon",76,0,1,2,85,4,16,10,3,197,3,10,210,229,0.431,0.917
"18843","Tarija","Tarija","U.E. J. Naval Monzon",93,0,1,1,63,6,32,5,0,201,3,9,213,236,0.313,0.903
"18844","Tarija","Tarija","U.E. J. Naval Monzon",95,2,0,1,69,3,22,13,1,206,2,7,215,234,0.335,0.919
"18845","Tarija","Tarija","U.E. J. Naval Monzon",85,0,1,2,66,5,31,11,0,201,0,8,209,227,0.328,0.921
"18846","Tarija","Tarija","U.E. J. Naval Monzon",88,1,1,0,82,6,18,6,2,204,3,8,215,230,0.402,0.935
"18847","Tarija","Tarija","U.E. J. Naval Monzon",69,1,0,0,94,1,31,7,0,203,5,12,220,233,0.463,0.944
"18848","Tarija","Tarija","U.E. J. Naval Monzon",88,0,1,0,72,6,21,9,0,197,2,6,205,227,0.365,0.903
"18849","Tarija","Tarija","U.E. J. Naval Monzon",70,2,0,2,89,5,27,1,0,196,4,8,208,226,0.454,0.92
"18850","Tarija","Tarija","U.E. J. Naval Monzon",104,0,0,0,64,8,20,3,1,200,2,7,209,228,0.32,0.917
"18851","Tarija","Tarija","U.E. J. Naval Monzon",100,3,0,0,63,8,26,3,1,204,2,10,216,232,0.309,0.931
"18852","Tarija","Tarija","U.E. J. Naval Monzon",109,1,0,0,64,6,18,6,0,204,1,5,210,232,0.314,0.905
"18853","Tarija","Tarija","U.E. J. Naval Monzon",93,1,0,0,74,9,20,2,2,201,1,13,215,230,0.368,0.935
"18854","Tarija","Tarija","U.E. J. Naval Monzon",79,3,0,1,72,3,21,6,0,185,4,11,200,227,0.389,0.881
"18855","Tarija","Tarija","U.E. Teresa De Calcuta",92,0,2,0,66,3,20,4,2,189,2,6,197,222,0.349,0.887
"18856","Tarija","Tarija","U.E. Teresa De Calcuta",101,0,0,1,53,13,20,4,4,196,2,7,205,226,0.27,0.907
"18857","Tarija","Tarija","U.E. Teresa De Calcuta",100,1,1,1,57,6,27,4,0,197,2,10,209,230,0.289,0.909
"18858","Tarija","Tarija","U.E. Teresa De Calcuta",100,0,2,1,58,10,12,6,0,189,2,13,204,230,0.307,0.887
"18859","Tarija","Tarija","U.E. Teresa De Calcuta",113,0,0,2,54,8,20,4,0,201,1,5,207,226,0.269,0.916
"18860","Tarija","Tarija","U.E. Teresa De Calcuta",101,0,1,0,66,6,22,4,2,202,0,7,209,227,0.327,0.921
"18861","Tarija","Tarija","U.E. Teresa De Calcuta",77,0,0,1,71,6,33,5,1,194,1,14,209,229,0.366,0.913
"18862","Tarija","Tarija","U.E. Teresa De Calcuta",85,1,2,1,65,5,25,4,1,189,1,8,198,225,0.344,0.88
"18863","Tarija","Tarija","U.E. Teresa De Calcuta",83,3,0,1,72,4,20,3,0,186,2,16,204,228,0.387,0.895
"18864","Tarija","Tarija","U.E. Teresa De Calcuta",108,2,0,0,59,5,20,2,0,196,1,9,206,231,0.301,0.892
"18865","Tarija","Tarija","U.E. Teresa De Calcuta",92,0,0,1,54,8,25,6,1,187,2,22,211,227,0.289,0.93
"18866","Tarija","Tarija","U.E. Bolivia",127,0,1,0,49,4,14,5,0,200,2,10,212,232,0.245,0.914
"18867","Tarija","Tarija","U.E. Bolivia",140,1,0,1,40,5,6,1,2,196,2,7,205,227,0.204,0.903
"18868","Tarija","Tarija","U.E. Bolivia",139,0,0,1,41,3,14,5,0,203,0,4,207,231,0.202,0.896
"18869","Tarija","Tarija","U.E. Bolivia",125,0,1,1,40,5,13,2,3,190,3,10,203,231,0.211,0.879
"18870","Tarija","Tarija","U.E. Bolivia",138,0,0,1,29,3,19,3,0,193,1,7,201,228,0.15,0.882
"18871","Tarija","Tarija","U.E. Bolivia",93,0,1,0,50,5,23,8,3,183,3,16,202,227,0.273,0.89
"18872","Tarija","Tarija","U.E. Bolivia",141,2,0,1,36,8,15,2,0,205,1,4,210,229,0.176,0.917
"18873","Tarija","Tarija","U.E. Bolivia",130,0,1,1,38,11,16,3,0,200,0,3,203,225,0.19,0.902
"18874","Tarija","Tarija","U.E. Bolivia",143,0,0,0,38,3,17,1,1,203,4,3,210,232,0.187,0.905
"18875","Tarija","Tarija","U.E. Bolivia",125,1,0,0,39,9,14,3,1,192,3,5,200,220,0.203,0.909
"18876","Tarija","Tarija","U.E. Bolivia",127,0,0,3,40,7,12,3,1,193,1,7,201,225,0.207,0.893
"18877","Tarija","Tarija","U.E. Bolivia",123,2,1,1,36,5,16,8,2,194,2,8,204,229,0.186,0.891
"18878","Tarija","Tarija","U.E. Bolivia",116,0,2,0,40,3,20,3,0,184,0,15,199,223,0.217,0.892
"18879","Tarija","Tarija","U.E. Bolivia",150,0,0,0,32,6,11,9,0,208,1,5,214,231,0.154,0.926
"18880","Tarija","Tarija","U.E. Bolivia",125,0,1,2,29,10,15,2,0,184,0,15,199,229,0.158,0.869
"18881","Tarija","Tarija","U.E. Bolivia",125,0,1,0,48,7,13,3,0,197,2,13,212,229,0.244,0.926
"18882","Tarija","Tarija","U.E. Bolivia",107,0,0,0,43,5,17,7,2,181,2,23,206,228,0.238,0.904
"18883","Tarija","Tarija","U.E. Bolivia",148,0,0,0,35,8,12,3,1,207,1,3,211,229,0.169,0.921
"18884","Tarija","Tarija","U.E. Bolivia",131,0,0,0,35,3,11,9,1,190,1,8,199,224,0.184,0.888
"18885","Tarija","Tarija","U.E. Bolivia",147,0,0,1,23,3,15,3,0,192,0,11,203,228,0.12,0.89
"18886","Tarija","Tarija","U.E. Bolivia",140,0,1,1,36,6,13,6,1,204,2,3,209,228,0.176,0.917
"18887","Tarija","Tarija","U.E. Bolivia",140,0,0,0,26,8,17,6,0,197,2,7,206,229,0.132,0.9
"18888","Tarija","Tarija","U.E. Bolivia",141,0,2,1,43,2,18,3,0,210,0,10,220,234,0.205,0.94
"18889","Tarija","Tarija","Centro de Capacitacion Municipal",110,1,0,0,52,8,24,1,0,196,2,12,210,236,0.265,0.89
"18890","Tarija","Tarija","Centro de Capacitacion Municipal",135,1,0,0,42,5,14,6,0,203,3,6,212,234,0.207,0.906
"18891","Tarija","Tarija","Centro de Capacitacion Municipal",112,1,0,0,42,6,25,5,0,191,2,10,203,228,0.22,0.89
"18892","Tarija","Tarija","Centro de Capacitacion Municipal",118,0,0,0,43,7,16,4,1,189,4,16,209,233,0.228,0.897
"18893","Tarija","Tarija","Salon Capacitacion Barrio Catedral",108,2,1,0,60,4,23,1,1,200,3,7,210,230,0.3,0.913
"18894","Tarija","Tarija","Salon Capacitacion Barrio Catedral",101,0,2,0,63,5,29,3,2,205,3,6,214,228,0.307,0.939
"18895","Tarija","Tarija","Salon Capacitacion Barrio Catedral",106,0,1,1,56,3,22,3,2,194,3,10,207,235,0.289,0.881
"18896","Tarija","Tarija","Salon Capacitacion Barrio Catedral",106,0,0,1,72,6,15,5,0,205,2,1,208,231,0.351,0.9
"18897","Tarija","Tarija","U.E. Carmen Mealla",118,1,0,0,45,6,16,6,0,192,1,5,198,226,0.234,0.876
"18898","Tarija","Tarija","U.E. Carmen Mealla",113,0,0,1,42,5,20,7,0,188,1,10,199,228,0.223,0.873
"18899","Tarija","Tarija","U.E. Carmen Mealla",99,1,1,2,59,5,16,6,0,189,1,11,201,231,0.312,0.87
"18900","Tarija","Tarija","U.E. Carmen Mealla",112,0,1,1,43,9,10,7,1,184,4,9,197,227,0.234,0.868
"18901","Tarija","Tarija","U.E. Carmen Mealla",130,1,0,2,28,1,18,7,2,189,2,7,198,228,0.148,0.868
"18902","Tarija","Tarija","U.E. Carmen Mealla",109,0,0,0,46,6,20,3,0,184,2,7,193,225,0.25,0.858
"18903","Tarija","Tarija","U.E. Carmen Mealla",105,0,0,0,45,10,14,4,0,178,1,8,187,220,0.253,0.85
"18904","Tarija","Tarija","U.E. Carmen Mealla",91,2,0,1,49,9,18,12,0,182,1,9,192,225,0.269,0.853
"18905","Tarija","Tarija","U.E. Carmen Mealla",120,1,0,0,49,2,22,9,0,203,4,5,212,234,0.241,0.906
"18906","Tarija","Tarija","U.E. Churquis",21,4,3,1,119,1,5,5,0,159,10,17,186,222,0.748,0.838
"18907","Tarija","Tarija","U.E. Audelio Quifre",34,4,1,2,109,4,7,7,0,168,13,23,204,233,0.649,0.876
"18908","Tarija","Tarija","U.E. San Francisco De Asis",85,0,0,2,81,11,24,4,3,210,3,9,222,230,0.386,0.965
"18909","Tarija","Tarija","U.E. San Francisco De Asis",93,1,1,0,41,22,27,5,3,193,6,12,211,224,0.212,0.942
"18910","Tarija","Tarija","U.E. 15 de Abril",91,2,0,0,48,10,10,7,2,170,8,12,190,224,0.282,0.848
"18911","Tarija","Tarija","U.E. San Pedro de Sola",17,1,1,1,150,1,14,2,1,188,1,14,203,209,0.798,0.971
"18912","Tarija","Padcaya","U.E. Aniceto Arce",92,0,0,1,71,6,15,2,2,189,9,8,206,226,0.376,0.912
"18913","Tarija","Padcaya","U.E. Aniceto Arce",60,0,0,1,103,10,11,6,1,192,3,11,206,224,0.536,0.92
"18914","Tarija","Padcaya","U.E. Aniceto Arce",100,3,0,0,67,3,16,0,1,190,4,13,207,228,0.353,0.908
"18915","Tarija","Padcaya","U.E. Aniceto Arce",76,0,0,0,91,4,17,6,0,194,2,14,210,231,0.469,0.909
"18916","Tarija","Padcaya","U.E. Aniceto Arce",100,0,0,0,68,6,13,3,0,190,9,8,207,225,0.358,0.92
"18917","Tarija","Padcaya","U.E. Aniceto Arce",67,0,0,1,81,11,16,3,1,180,3,11,194,224,0.45,0.866
"18918","Tarija","Padcaya","U.E. Aniceto Arce",104,1,2,2,57,6,16,4,0,192,3,12,207,225,0.297,0.92
"18919","Tarija","Padcaya","U.E. Aniceto Arce",74,0,1,1,82,5,20,1,2,186,4,9,199,236,0.441,0.843
"18920","Tarija","Padcaya","U.E. Aniceto Arce",97,1,0,0,69,6,23,1,0,197,3,5,205,226,0.35,0.907
"18921","Tarija","Padcaya","U.E. Aniceto Arce",92,1,0,0,68,2,21,5,0,189,2,8,199,224,0.36,0.888
"18922","Tarija","Padcaya","U.E. Eloy Aparicio",28,1,0,3,122,4,13,3,2,176,3,12,191,222,0.693,0.86
"18923","Tarija","Padcaya","U.E. Eloy Aparicio",21,0,0,1,159,4,15,2,0,202,0,8,210,228,0.787,0.921
"18924","Tarija","Padcaya","U.E. Eloy Aparicio",15,0,1,0,135,2,7,2,2,164,6,9,179,205,0.823,0.873
"18925","Tarija","Padcaya","U.E. Orozas Arriba",18,2,1,0,120,8,13,2,0,164,12,17,193,225,0.732,0.858
"18926","Tarija","Padcaya","U.E. Orozas Arriba",21,0,0,0,151,7,5,3,0,187,5,14,206,232,0.807,0.888
"18927","Tarija","Padcaya","U.E. La Merced",53,1,1,1,92,4,8,1,1,162,12,9,183,212,0.568,0.863
"18928","Tarija","Padcaya","U.E. Rio Negro",34,2,2,0,95,7,40,0,1,181,8,8,197,226,0.525,0.872
"18929","Tarija","Padcaya","U.E. Oscar Hiza Bastias",32,1,0,1,118,13,11,1,1,178,2,11,191,226,0.663,0.845
"18930","Tarija","Padcaya","U.E. Oscar Hiza Bastias",26,1,0,2,124,11,16,5,1,186,2,9,197,227,0.667,0.868
"18931","Tarija","Padcaya","U.E. Anzelmo Ontiveros",22,1,0,1,133,5,22,3,0,187,2,0,189,219,0.711,0.863
"18932","Tarija","Padcaya","U.E. Anzelmo Ontiveros",26,1,0,1,141,7,12,1,0,189,3,7,199,225,0.746,0.884
"18933","Tarija","Padcaya","Nucleo  San Telmo/Primero De Mayo",53,0,1,1,93,9,19,1,3,180,8,7,195,224,0.517,0.871
"18934","Tarija","Padcaya","Nucleo 9 de Octubre",22,2,0,1,142,0,10,2,1,180,4,7,191,228,0.789,0.838
"18935","Tarija","Padcaya","U.E. San Antonio de Macoya",46,1,2,5,45,7,40,3,3,152,8,16,176,223,0.296,0.789
"18936","Tarija","Padcaya","U.E. Simon Bolivar de Rejara",0,1,0,0,179,3,4,2,0,189,4,5,198,228,0.947,0.868
"18937","Tarija","Padcaya","U.E. Camacho",17,1,0,1,162,1,9,2,0,193,2,7,202,221,0.839,0.914
"18938","Tarija","Padcaya","U.E. Camacho",19,1,2,1,147,7,7,0,0,184,4,8,196,223,0.799,0.879
"18939","Tarija","Padcaya","Esc. Seccional Queñahuayco",13,0,0,1,169,0,18,0,0,201,4,5,210,226,0.841,0.929
"18940","Tarija","Padcaya","U.E. Blanca Navajas",25,0,0,2,132,7,18,0,1,185,1,8,194,221,0.714,0.878
"18941","Tarija","Padcaya","U.E. Blanca Navajas",17,1,0,0,127,14,24,4,0,187,3,6,196,229,0.679,0.856
"18942","Tarija","Padcaya","U.E. Canchas Mayu",16,1,0,2,144,2,15,2,1,183,4,1,188,226,0.787,0.832
"18943","Tarija","Padcaya","Esc. Tacuara Simon Bolivar",6,0,0,0,150,0,5,3,1,165,1,6,172,207,0.909,0.831
"18944","Tarija","Padcaya","U.E. Virgen De Chaguaya",36,1,0,0,105,10,8,3,1,164,3,10,177,214,0.64,0.827
"18945","Tarija","Padcaya","U.E. Rosillas II",45,1,0,0,100,3,12,3,0,164,8,11,183,222,0.61,0.824
"18946","Tarija","Padcaya","U.E. Rosillas II",73,1,0,0,84,10,9,5,1,183,4,13,200,227,0.459,0.881
"18947","Tarija","Padcaya","U.E. Pampa Grande",34,3,1,1,87,12,8,7,2,155,9,11,175,228,0.561,0.768
"18948","Tarija","Padcaya","U.E. San Jose de Marañuelo",1,2,1,1,163,2,7,0,1,178,8,7,193,207,0.916,0.932
"18949","Tarija","Padcaya","U.E. 2 de Agosto",8,3,0,1,152,3,9,2,0,178,6,11,195,227,0.854,0.859
"18950","Tarija","Padcaya","U.E. La Huerta",13,1,0,1,161,0,12,2,1,191,4,13,208,235,0.843,0.885
"18951","Tarija","Padcaya","U.E. Abra de San Miguel",49,2,1,1,120,11,12,1,1,198,6,5,209,229,0.606,0.913
"18952","Tarija","Bermejo","U.E. Guido Villagomez",67,0,0,1,75,4,25,7,1,180,0,7,187,231,0.417,0.81
"18953","Tarija","Bermejo","U.E. Guido Villagomez",85,0,0,1,71,8,19,1,0,185,6,11,202,236,0.384,0.856
"18954","Tarija","Bermejo","U.E. Guido Villagomez",72,0,0,0,88,3,22,3,1,189,2,8,199,229,0.466,0.869
"18955","Tarija","Bermejo","U.E. Guido Villagomez",80,1,1,0,83,3,29,4,0,201,3,3,207,231,0.413,0.896
"18956","Tarija","Bermejo","U.E. Guido Villagomez",48,1,1,0,90,4,38,1,0,183,5,12,200,229,0.492,0.873
"18957","Tarija","Bermejo","U.E. Guido Villagomez",65,0,1,0,81,1,24,6,1,179,4,10,193,230,0.453,0.839
"18958","Tarija","Bermejo","U.E. Guido Villagomez",75,1,0,1,78,1,21,7,2,186,3,8,197,231,0.419,0.853
"18959","Tarija","Bermejo","U.E. Guido Villagomez",75,2,2,1,88,3,22,3,1,197,5,7,209,232,0.447,0.901
"18960","Tarija","Bermejo","U.E. Guido Villagomez",77,0,2,0,79,4,24,3,0,189,4,9,202,229,0.418,0.882
"18961","Tarija","Bermejo","U.E. Guido Villagomez",81,2,1,1,75,3,23,6,1,193,3,3,199,228,0.389,0.873
"18962","Tarija","Bermejo","U.E. Guido Villagomez",76,0,0,2,62,2,29,1,0,172,2,12,186,228,0.36,0.816
"18963","Tarija","Bermejo","U.E. Guido Villagomez",58,0,0,1,94,2,22,1,0,178,5,8,191,229,0.528,0.834
"18964","Tarija","Bermejo","U.E. Guido Villagomez",75,0,0,2,78,3,19,4,0,181,4,10,195,228,0.431,0.855
"18965","Tarija","Bermejo","U.E. Guido Villagomez",74,0,0,1,97,1,22,0,2,197,2,14,213,234,0.492,0.91
"18966","Tarija","Bermejo","U.E. Guido Villagomez",71,2,0,0,82,4,15,5,1,180,4,8,192,229,0.456,0.838
"18967","Tarija","Bermejo","U.E. Guido Villagomez",75,1,0,0,77,3,29,2,0,187,9,8,204,233,0.412,0.876
"18968","Tarija","Bermejo","U.E. 8 e Septiembre",70,1,0,1,82,6,22,4,0,186,4,6,196,230,0.441,0.852
"18969","Tarija","Bermejo","U.E. 8 e Septiembre",64,0,1,0,75,8,27,3,0,178,5,11,194,232,0.421,0.836
"18970","Tarija","Bermejo","U.E. 8 e Septiembre",50,1,1,1,82,6,38,3,0,182,7,5,194,228,0.451,0.851
"18971","Tarija","Bermejo","U.E. 8 e Septiembre",53,0,0,1,90,2,30,1,0,177,10,16,203,230,0.508,0.883
"18972","Tarija","Bermejo","U.E. 8 e Septiembre",84,1,0,0,65,3,14,3,0,170,8,11,189,231,0.382,0.818
"18973","Tarija","Bermejo","U.E. 8 e Septiembre",68,1,1,0,86,8,18,2,0,184,3,7,194,231,0.467,0.84
"18974","Tarija","Bermejo","U.E. 8 e Septiembre",54,0,1,1,77,7,28,2,1,171,6,12,189,229,0.45,0.825
"18975","Tarija","Bermejo","U.E. 8 e Septiembre",68,0,0,0,84,6,23,0,0,181,0,5,186,230,0.464,0.809
"18976","Tarija","Bermejo","U.E. 8 e Septiembre",54,2,0,3,91,3,20,3,1,177,4,19,200,227,0.514,0.881
"18977","Tarija","Bermejo","U.E. 8 e Septiembre",67,0,1,1,81,2,22,2,0,176,2,8,186,227,0.46,0.819
"18978","Tarija","Bermejo","U.E. 8 e Septiembre",66,1,1,0,76,4,28,1,1,178,7,5,190,226,0.427,0.841
"18979","Tarija","Bermejo","U.E. 25 de Mayo - 11 - Bermejo",86,0,2,0,64,1,21,4,0,178,5,4,187,224,0.36,0.835
"18980","Tarija","Bermejo","U.E. 25 de Mayo - 11 - Bermejo",100,1,0,1,55,4,14,2,0,177,2,7,186,223,0.311,0.834
"18981","Tarija","Bermejo","U.E. 25 de Mayo - 11 - Bermejo",82,0,1,0,62,3,30,3,1,182,3,6,191,230,0.341,0.83
"18982","Tarija","Bermejo","U.E. 25 de Mayo - 11 - Bermejo",77,0,1,0,74,1,25,1,1,180,3,8,191,227,0.411,0.841
"18983","Tarija","Bermejo","U.E. 25 de Mayo - 11 - Bermejo",78,0,0,0,68,2,24,6,0,178,4,3,185,225,0.382,0.822
"18984","Tarija","Bermejo","U.E. 25 de Mayo - 11 - Bermejo",69,1,0,1,75,4,26,7,0,183,1,10,194,225,0.41,0.862
"18985","Tarija","Bermejo","U.E. 25 de Mayo - 11 - Bermejo",101,0,0,0,60,2,15,2,2,182,2,8,192,229,0.33,0.838
"18986","Tarija","Bermejo","U.E. 25 de Mayo - 11 - Bermejo",86,0,0,2,64,4,19,3,0,178,2,7,187,221,0.36,0.846
"18987","Tarija","Bermejo","U.E. 25 de Mayo - 11 - Bermejo",78,2,1,0,63,2,29,2,1,178,6,5,189,221,0.354,0.855
"18988","Tarija","Bermejo","U.E. 25 de Mayo - 11 - Bermejo",74,1,0,1,67,4,21,3,2,173,2,6,181,222,0.387,0.815
"18989","Tarija","Bermejo","U.E. 25 de Mayo - 11 - Bermejo",91,0,0,1,61,1,18,2,0,174,2,6,182,226,0.351,0.805
"18990","Tarija","Bermejo","U.E. 25 de Mayo - 11 - Bermejo",84,0,1,1,64,3,14,6,1,174,3,7,184,225,0.368,0.818
"18991","Tarija","Bermejo","U.E. 25 de Mayo - 11 - Bermejo",83,1,0,0,73,5,24,0,1,187,6,3,196,229,0.39,0.856
"18992","Tarija","Bermejo","U.E. 25 de Mayo - 11 - Bermejo",78,0,2,1,73,1,15,6,0,176,2,4,182,228,0.415,0.798
"18993","Tarija","Bermejo","U.E. 25 de Mayo - 11 - Bermejo",100,1,0,0,61,1,15,1,1,180,2,8,190,224,0.339,0.848
"18994","Tarija","Bermejo","U.E. 25 de Mayo - 11 - Bermejo",78,2,1,0,71,3,25,2,2,184,1,3,188,228,0.386,0.825
"18995","Tarija","Bermejo","U.E. 25 de Mayo - 11 - Bermejo",88,1,0,3,64,1,24,0,1,182,3,9,194,228,0.352,0.851
"18996","Tarija","Bermejo","U.E. 25 de Mayo - 11 - Bermejo",59,1,0,1,68,0,19,3,0,151,3,4,158,180,0.45,0.878
"18997","Tarija","Bermejo","U.E. Eduardo Avaroa",85,0,2,0,69,4,20,0,2,182,6,5,193,227,0.379,0.85
"18998","Tarija","Bermejo","U.E. Eduardo Avaroa",90,1,0,0,57,1,24,4,2,179,2,7,188,226,0.318,0.832
"18999","Tarija","Bermejo","U.E. Eduardo Avaroa",75,1,1,0,77,1,24,3,2,184,3,12,199,222,0.418,0.896
"19000","Tarija","Bermejo","U.E. Eduardo Avaroa",74,0,1,0,81,2,18,1,0,177,2,10,189,223,0.458,0.848
"19001","Tarija","Bermejo","U.E. Eduardo Avaroa",55,0,1,0,91,5,34,1,0,187,2,10,199,225,0.487,0.884
"19002","Tarija","Bermejo","U.E. Eduardo Avaroa",74,1,2,1,83,2,20,4,0,187,3,8,198,226,0.444,0.876
"19003","Tarija","Bermejo","U.E. Eduardo Avaroa",77,1,0,0,66,2,27,3,0,176,2,11,189,222,0.375,0.851
"19004","Tarija","Bermejo","U.E. Eduardo Avaroa",80,0,1,2,66,1,25,3,0,178,3,13,194,226,0.371,0.858
"19005","Tarija","Bermejo","U.E. Eduardo Avaroa",69,1,0,0,73,3,31,1,1,179,6,11,196,226,0.408,0.867
"19006","Tarija","Bermejo","U.E. Eduardo Avaroa",56,2,1,1,72,5,38,3,0,178,3,5,186,226,0.404,0.823
"19007","Tarija","Bermejo","U.E. Eduardo Avaroa",66,0,1,1,80,3,24,5,0,180,5,8,193,227,0.444,0.85
"19008","Tarija","Bermejo","U.E. Eduardo Avaroa",76,0,1,0,79,1,23,1,1,182,3,4,189,224,0.434,0.844
"19009","Tarija","Bermejo","U.E. Eduardo Avaroa",72,0,0,1,60,6,26,3,1,169,3,8,180,225,0.355,0.8
"19010","Tarija","Bermejo","U.E. Eduardo Avaroa",73,0,1,1,77,1,23,2,1,179,6,7,192,230,0.43,0.835
"19011","Tarija","Bermejo","U.E. Eduardo Avaroa",80,1,0,1,62,4,19,5,0,172,7,11,190,220,0.36,0.864
"19012","Tarija","Bermejo","U.E. Eduardo Avaroa",63,1,0,1,72,2,27,5,2,173,5,11,189,228,0.416,0.829
"19013","Tarija","Bermejo","U.E. Eduardo Avaroa",72,1,0,0,74,6,18,2,0,173,6,10,189,226,0.428,0.836
"19014","Tarija","Bermejo","U.E. Eduardo Avaroa",71,0,0,0,81,5,24,5,0,186,2,10,198,226,0.435,0.876
"19015","Tarija","Bermejo","U.E. Mscal. Andres De Santa Cruz",80,2,1,1,60,4,15,2,0,165,1,8,174,224,0.364,0.777
"19016","Tarija","Bermejo","U.E. Mscal. Andres De Santa Cruz",83,0,0,2,66,0,20,1,0,172,2,5,179,229,0.384,0.782
"19017","Tarija","Bermejo","U.E. Mscal. Andres De Santa Cruz",74,0,2,0,69,4,26,4,0,179,2,4,185,225,0.385,0.822
"19018","Tarija","Bermejo","U.E. Mscal. Andres De Santa Cruz",83,0,0,0,72,1,24,2,0,182,1,6,189,225,0.396,0.84
"19019","Tarija","Bermejo","U.E. Mscal. Andres De Santa Cruz",75,2,1,0,62,6,20,7,1,174,3,14,191,226,0.356,0.845
"19020","Tarija","Bermejo","U.E. Mscal. Andres De Santa Cruz",74,0,1,0,58,4,21,4,1,163,1,9,173,226,0.356,0.765
"19021","Tarija","Bermejo","U.E. Mscal. Andres De Santa Cruz",63,1,0,0,83,4,27,1,2,181,2,1,184,231,0.459,0.797
"19022","Tarija","Bermejo","U.E. Mscal. Andres De Santa Cruz",79,0,4,1,67,1,23,4,0,179,4,5,188,217,0.374,0.866
"19023","Tarija","Bermejo","U.E. Mscal. Andres De Santa Cruz",90,1,1,0,70,4,20,1,0,187,3,4,194,230,0.374,0.843
"19024","Tarija","Bermejo","U.E. Mscal. Andres De Santa Cruz",78,0,0,1,66,2,21,4,1,173,1,8,182,223,0.382,0.816
"19025","Tarija","Bermejo","U.E. Mscal. Andres De Santa Cruz",77,0,0,3,69,1,23,1,1,175,4,8,187,227,0.394,0.824
"19026","Tarija","Bermejo","U.E. Mscal. Andres De Santa Cruz",79,1,0,0,53,4,22,3,0,162,1,5,168,215,0.327,0.781
"19027","Tarija","Bermejo","U.E. Octavio Campero Echazu (Bermejo)",79,0,0,1,68,3,23,3,0,177,7,12,196,232,0.384,0.845
"19028","Tarija","Bermejo","U.E. Octavio Campero Echazu (Bermejo)",67,0,0,2,71,3,18,3,1,165,1,15,181,229,0.43,0.79
"19029","Tarija","Bermejo","U.E. Octavio Campero Echazu (Bermejo)",77,0,1,0,78,8,24,1,1,190,1,10,201,231,0.411,0.87
"19030","Tarija","Bermejo","U.E. Octavio Campero Echazu (Bermejo)",72,0,0,0,83,3,25,2,0,185,2,8,195,228,0.449,0.855
"19031","Tarija","Bermejo","U.E. Octavio Campero Echazu (Bermejo)",55,2,1,0,82,2,23,1,2,168,2,8,178,221,0.488,0.805
"19032","Tarija","Bermejo","U.E. Octavio Campero Echazu (Bermejo)",71,0,0,1,80,2,33,0,2,189,7,6,202,232,0.423,0.871
"19033","Tarija","Bermejo","U.E. Octavio Campero Echazu (Bermejo)",99,0,0,0,64,5,19,1,0,188,4,5,197,228,0.34,0.864
"19034","Tarija","Bermejo","U.E. Octavio Campero Echazu (Bermejo)",76,0,0,1,75,4,17,5,1,179,3,12,194,231,0.419,0.84
"19035","Tarija","Bermejo","U.E. Octavio Campero Echazu (Bermejo)",81,0,0,0,64,5,23,0,1,174,3,17,194,224,0.368,0.866
"19036","Tarija","Bermejo","U.E. Octavio Campero Echazu (Bermejo)",74,0,0,2,78,2,21,4,0,181,2,17,200,229,0.431,0.873
"19037","Tarija","Bermejo","U.E. Octavio Campero Echazu (Bermejo)",67,1,1,0,92,4,15,2,4,186,3,14,203,228,0.495,0.89
"19038","Tarija","Bermejo","U.E. Octavio Campero Echazu (Bermejo)",70,0,0,3,77,5,23,3,1,182,4,15,201,231,0.423,0.87
"19039","Tarija","Bermejo","U.E. Octavio Campero Echazu (Bermejo)",70,0,1,1,79,2,15,12,0,180,3,10,193,229,0.439,0.843
"19040","Tarija","Bermejo","U.E. Octavio Campero Echazu (Bermejo)",79,2,0,2,69,5,21,1,1,180,5,10,195,226,0.383,0.863
"19041","Tarija","Bermejo","U.E. Octavio Campero Echazu (Bermejo)",79,0,1,0,65,8,21,4,0,178,3,13,194,227,0.365,0.855
"19042","Tarija","Bermejo","U.E. Octavio Campero Echazu (Bermejo)",78,2,0,1,70,3,24,2,0,180,3,11,194,231,0.389,0.84
"19043","Tarija","Bermejo","U.E. Octavio Campero Echazu (Bermejo)",76,1,0,1,68,4,22,2,0,174,5,8,187,228,0.391,0.82
"19044","Tarija","Bermejo","U.E. Octavio Campero Echazu (Bermejo)",66,0,0,1,67,3,19,5,1,162,3,9,174,212,0.414,0.821
"19045","Tarija","Bermejo","U.E. Aulio Araoz",62,1,1,0,74,6,25,2,0,171,4,11,186,225,0.433,0.827
"19046","Tarija","Bermejo","U.E. Aulio Araoz",52,0,1,2,94,5,25,0,2,181,4,15,200,232,0.519,0.862
"19047","Tarija","Bermejo","U.E. Aulio Araoz",50,0,2,1,101,0,33,1,2,190,4,8,202,231,0.532,0.874
"19048","Tarija","Bermejo","U.E. Aulio Araoz",61,1,0,1,66,5,40,3,0,177,6,13,196,228,0.373,0.86
"19049","Tarija","Bermejo","U.E. Aulio Araoz",51,1,0,1,91,4,23,0,1,172,4,16,192,232,0.529,0.828
"19050","Tarija","Bermejo","U.E. Aulio Araoz",35,0,1,0,114,1,39,1,0,191,1,12,204,235,0.597,0.868
"19051","Tarija","Bermejo","U.E. Aulio Araoz",69,1,0,0,85,3,26,1,1,186,7,12,205,235,0.457,0.872
"19052","Tarija","Bermejo","U.E. Aulio Araoz",54,0,0,0,85,2,42,3,0,186,9,10,205,232,0.457,0.884
"19053","Tarija","Bermejo","U.E. Aulio Araoz",52,0,0,0,82,6,29,2,1,172,5,14,191,235,0.477,0.813
"19054","Tarija","Bermejo","U.E. Aulio Araoz",67,0,0,1,82,2,29,3,1,185,6,9,200,229,0.443,0.873
"19055","Tarija","Bermejo","U.E. Antonio Jose De Sucre",66,0,0,2,89,2,28,1,1,189,5,12,206,233,0.471,0.884
"19056","Tarija","Bermejo","U.E. Antonio Jose De Sucre",49,0,0,0,93,1,47,3,1,194,3,9,206,233,0.479,0.884
"19057","Tarija","Bermejo","U.E. Antonio Jose De Sucre",64,0,0,0,85,5,29,2,1,186,3,13,202,235,0.457,0.86
"19058","Tarija","Bermejo","U.E. Antonio Jose De Sucre",63,0,1,1,91,4,35,1,0,196,5,6,207,234,0.464,0.885
"19059","Tarija","Bermejo","U.E. Antonio Jose De Sucre",43,2,0,0,112,5,17,5,0,184,4,10,198,234,0.609,0.846
"19060","Tarija","Bermejo","U.E. Antonio Jose De Sucre",65,1,0,1,82,8,29,3,0,189,3,7,199,231,0.434,0.861
"19061","Tarija","Bermejo","U.E. Bolivia",35,0,0,0,117,4,36,0,1,193,2,12,207,239,0.606,0.866
"19062","Tarija","Bermejo","U.E. Bolivia",42,0,1,0,117,1,41,0,1,203,5,9,217,238,0.576,0.912
"19063","Tarija","Bermejo","U.E. Bolivia",29,0,1,0,125,3,27,1,2,188,4,14,206,239,0.665,0.862
"19064","Tarija","Bermejo","U.E. Moto Mendez",45,0,1,1,119,8,7,5,2,188,4,8,200,230,0.633,0.87
"19065","Tarija","Bermejo","U.E. Flor De Oro",24,1,1,0,84,7,37,7,0,161,8,9,178,215,0.522,0.828
"19066","Tarija","Bermejo","U.E. Arrozales",58,0,0,1,99,2,17,3,1,181,10,9,200,226,0.547,0.885
"19067","Tarija","Bermejo","U.E. Barredero",12,2,1,0,160,2,11,1,0,189,9,4,202,228,0.847,0.886
"19068","Tarija","Bermejo","U.E. Colonia Linares",24,0,0,1,149,2,11,5,0,192,8,4,204,232,0.776,0.879
"19069","Tarija","Bermejo","U.E. Colonia Linares",15,0,0,0,129,1,16,1,0,162,8,8,178,227,0.796,0.784
"19070","Tarija","Bermejo","U.E. Colonia Linares",20,1,0,0,145,1,11,1,1,180,4,7,191,224,0.806,0.853
"19071","Tarija","Bermejo","U.E. Campo Grande (Arce)",23,2,3,0,112,5,17,4,0,166,7,9,182,233,0.675,0.781
"19072","Tarija","Bermejo","U.E. Campo Grande (Arce)",20,3,2,0,130,3,12,6,1,177,7,15,199,230,0.734,0.865
"19073","Tarija","Bermejo","U.E. La Esperanza",58,0,0,0,119,1,18,4,0,200,7,15,222,239,0.595,0.929
"19074","Tarija","Bermejo","U.E. La Esperanza",49,2,1,0,125,5,27,1,2,212,4,5,221,235,0.59,0.94
"19075","Tarija","Bermejo","U.E. La Esperanza",38,1,0,0,101,6,21,1,1,169,7,12,188,208,0.598,0.904
"19076","Tarija","Yacuiba","U.E. Club De Leones (Básico Y Medio)",99,0,1,0,51,3,28,0,1,183,3,9,195,229,0.279,0.852
"19077","Tarija","Yacuiba","U.E. Club De Leones (Básico Y Medio)",101,0,0,0,53,4,22,3,1,184,3,4,191,225,0.288,0.849
"19078","Tarija","Yacuiba","U.E. Club De Leones (Básico Y Medio)",98,0,1,1,53,1,14,3,1,172,5,12,189,224,0.308,0.844
"19079","Tarija","Yacuiba","U.E. Club De Leones (Básico Y Medio)",96,1,0,4,53,3,25,0,0,182,2,10,194,225,0.291,0.862
"19080","Tarija","Yacuiba","U.E. Club De Leones (Básico Y Medio)",88,0,1,0,67,1,26,2,0,185,2,8,195,229,0.362,0.852
"19081","Tarija","Yacuiba","U.E. Club De Leones (Básico Y Medio)",80,0,2,0,66,4,22,0,3,177,3,12,192,229,0.373,0.838
"19082","Tarija","Yacuiba","U.E. Club De Leones (Básico Y Medio)",90,1,0,1,50,4,28,1,3,178,2,10,190,227,0.281,0.837
"19083","Tarija","Yacuiba","U.E. Club De Leones (Básico Y Medio)",96,2,1,1,53,2,23,5,1,184,1,6,191,224,0.288,0.853
"19084","Tarija","Yacuiba","U.E. Club De Leones (Básico Y Medio)",105,0,2,0,54,2,20,3,0,186,4,9,199,230,0.29,0.865
"19085","Tarija","Yacuiba","U.E. Club De Leones (Básico Y Medio)",89,1,7,0,54,5,19,1,4,180,1,9,190,225,0.3,0.844
"19086","Tarija","Yacuiba","U.E. Club De Leones (Básico Y Medio)",99,0,2,0,58,3,25,2,1,190,2,6,198,226,0.305,0.876
"19087","Tarija","Yacuiba","U.E. Club De Leones (Básico Y Medio)",85,2,0,0,71,4,17,2,4,185,0,7,192,220,0.384,0.873
"19088","Tarija","Yacuiba","U.E. Club De Leones (Básico Y Medio)",100,1,0,2,47,3,23,1,1,178,1,6,185,226,0.264,0.819
"19089","Tarija","Yacuiba","U.E. Club De Leones (Básico Y Medio)",102,3,0,0,55,2,27,3,0,192,4,2,198,231,0.286,0.857
"19090","Tarija","Yacuiba","U.E. Club De Leones (Básico Y Medio)",105,0,0,0,47,2,18,4,1,177,4,4,185,223,0.266,0.83
"19091","Tarija","Yacuiba","U.E. Club De Leones (Básico Y Medio)",91,1,0,0,60,3,21,1,3,180,1,12,193,230,0.333,0.839
"19092","Tarija","Yacuiba","U.E. Club De Leones (Básico Y Medio)",94,2,0,0,72,5,14,4,0,191,1,5,197,224,0.377,0.879
"19093","Tarija","Yacuiba","U.E. Club De Leones (Básico Y Medio)",106,1,1,0,56,1,20,1,0,186,4,1,191,230,0.301,0.83
"19094","Tarija","Yacuiba","U.E. Club De Leones (Básico Y Medio)",109,0,0,0,49,7,21,4,0,190,5,3,198,225,0.258,0.88
"19095","Tarija","Yacuiba","U.E. Club De Leones (Básico Y Medio)",93,0,2,1,52,5,22,1,1,177,2,5,184,230,0.294,0.8
"19096","Tarija","Yacuiba","U.E. Club De Leones (Básico Y Medio)",98,0,2,0,50,4,33,0,0,187,3,5,195,230,0.267,0.848
"19097","Tarija","Yacuiba","U.E. Club De Leones (Básico Y Medio)",110,0,1,0,45,3,17,2,0,178,3,4,185,218,0.253,0.849
"19098","Tarija","Yacuiba","U.E. Club De Leones (Básico Y Medio)",90,0,0,0,51,3,31,1,4,180,2,5,187,231,0.283,0.81
"19099","Tarija","Yacuiba","U.E. Juana Azurduy De Padilla (Yacuiba)",88,0,0,0,68,2,24,1,2,185,2,5,192,221,0.368,0.869
"19100","Tarija","Yacuiba","U.E. Juana Azurduy De Padilla (Yacuiba)",89,0,0,0,48,2,28,0,1,168,2,17,187,227,0.286,0.824
"19101","Tarija","Yacuiba","U.E. Juana Azurduy De Padilla (Yacuiba)",92,1,0,0,56,3,16,4,2,174,5,8,187,219,0.322,0.854
"19102","Tarija","Yacuiba","U.E. Juana Azurduy De Padilla (Yacuiba)",93,0,1,0,59,5,21,1,1,181,6,7,194,223,0.326,0.87
"19103","Tarija","Yacuiba","U.E. Juana Azurduy De Padilla (Yacuiba)",56,0,0,1,76,1,28,1,3,166,2,7,175,219,0.458,0.799
"19104","Tarija","Yacuiba","U.E. Juana Azurduy De Padilla (Yacuiba)",82,1,0,0,68,2,23,1,2,179,1,5,185,226,0.38,0.819
"19105","Tarija","Yacuiba","U.E. Juana Azurduy De Padilla (Yacuiba)",83,0,0,1,61,3,20,1,1,170,4,8,182,215,0.359,0.847
"19106","Tarija","Yacuiba","U.E. Juana Azurduy De Padilla (Yacuiba)",101,0,0,1,67,2,16,0,1,188,6,6,200,229,0.356,0.873
"19107","Tarija","Yacuiba","U.E. Juana Azurduy De Padilla (Yacuiba)",64,1,0,1,84,2,38,2,1,193,6,6,205,230,0.435,0.891
"19108","Tarija","Yacuiba","U.E. Juana Azurduy De Padilla (Yacuiba)",60,0,3,1,70,1,28,0,1,164,7,16,187,222,0.427,0.842
"19109","Tarija","Yacuiba","U.E. Juana Azurduy De Padilla (Yacuiba)",69,1,0,1,82,5,24,2,1,185,2,3,190,225,0.443,0.844
"19110","Tarija","Yacuiba","U.E. Juana Azurduy De Padilla (Yacuiba)",76,1,0,0,72,3,32,3,0,187,1,6,194,223,0.385,0.87
"19111","Tarija","Yacuiba","U.E. Juana Azurduy De Padilla (Yacuiba)",79,0,0,0,70,2,29,1,1,182,3,6,191,227,0.385,0.841
"19112","Tarija","Yacuiba","U.E. Juana Azurduy De Padilla (Yacuiba)",79,1,0,0,66,9,29,2,0,186,0,7,193,221,0.355,0.873
"19113","Tarija","Yacuiba","U.E. Juana Azurduy De Padilla (Yacuiba)",90,0,0,1,42,2,15,0,1,151,2,32,185,224,0.278,0.826
"19114","Tarija","Yacuiba","U.E. Juana Azurduy De Padilla (Yacuiba)",76,0,0,1,55,2,25,2,0,161,3,10,174,222,0.342,0.784
"19115","Tarija","Yacuiba","U.E. Juana Azurduy De Padilla (Yacuiba)",81,2,4,0,56,3,18,2,0,166,2,5,173,220,0.337,0.786
"19116","Tarija","Yacuiba","U.E. Juana Azurduy De Padilla (Yacuiba)",86,0,0,0,64,4,22,1,0,177,3,11,191,225,0.362,0.849
"19117","Tarija","Yacuiba","U.E. Liceo Gran Chaco",89,1,1,0,61,3,16,4,2,177,3,7,187,228,0.345,0.82
"19118","Tarija","Yacuiba","U.E. Liceo Gran Chaco",83,1,0,0,74,2,17,2,0,179,4,6,189,228,0.413,0.829
"19119","Tarija","Yacuiba","U.E. Liceo Gran Chaco",80,1,0,0,76,4,20,1,2,184,2,1,187,227,0.413,0.824
"19120","Tarija","Yacuiba","U.E. Liceo Gran Chaco",80,1,0,1,71,4,13,2,2,174,3,3,180,220,0.408,0.818
"19121","Tarija","Yacuiba","U.E. Liceo Gran Chaco",77,2,2,0,74,4,21,2,0,182,2,10,194,231,0.407,0.84
"19122","Tarija","Yacuiba","U.E. Liceo Gran Chaco",70,1,2,1,53,2,19,5,4,157,4,7,168,217,0.338,0.774
"19123","Tarija","Yacuiba","U.E. Liceo Gran Chaco",87,0,0,1,74,6,15,5,0,188,1,4,193,229,0.394,0.843
"19124","Tarija","Yacuiba","U.E. Liceo Gran Chaco",74,0,0,1,79,3,14,2,3,176,4,5,185,227,0.449,0.815
"19125","Tarija","Yacuiba","U.E. Liceo Gran Chaco",92,1,0,1,66,5,11,4,0,180,1,2,183,229,0.367,0.799
"19126","Tarija","Yacuiba","U.E. Miguel Estensoro",77,3,0,0,65,1,24,1,0,171,2,6,179,221,0.38,0.81
"19127","Tarija","Yacuiba","U.E. Miguel Estensoro",83,0,0,0,73,3,12,4,2,177,0,7,184,216,0.412,0.852
"19128","Tarija","Yacuiba","U.E. Miguel Estensoro",92,1,0,2,69,3,14,2,2,185,0,5,190,226,0.373,0.841
"19129","Tarija","Yacuiba","U.E. Miguel Estensoro",100,2,0,0,60,2,11,0,1,176,1,5,182,220,0.341,0.827
"19130","Tarija","Yacuiba","U.E. Miguel Estensoro",102,1,0,0,56,3,15,3,0,180,0,10,190,221,0.311,0.86
"19131","Tarija","Yacuiba","U.E. Miguel Estensoro",88,0,1,0,55,2,26,4,2,178,1,4,183,224,0.309,0.817
"19132","Tarija","Yacuiba","U.E. Miguel Estensoro",100,0,0,0,54,5,16,2,0,177,0,4,181,223,0.305,0.812
"19133","Tarija","Yacuiba","U.E. Miguel Estensoro",110,0,1,0,47,5,18,2,1,184,1,3,188,230,0.255,0.817
"19134","Tarija","Yacuiba","U.E. Miguel Estensoro",102,0,0,0,54,6,16,3,1,182,1,2,185,229,0.297,0.808
"19135","Tarija","Yacuiba","U.E. Miguel Estensoro",75,0,1,1,69,4,23,1,0,174,0,3,177,221,0.397,0.801
"19136","Tarija","Yacuiba","U.E. Miguel Estensoro",99,2,0,0,54,5,16,0,1,177,1,4,182,227,0.305,0.802
"19137","Tarija","Yacuiba","U.E. Miguel Estensoro",78,0,0,0,60,7,27,6,2,180,3,2,185,223,0.333,0.83
"19138","Tarija","Yacuiba","U.E. Miguel Estensoro",96,1,0,0,51,6,16,2,0,172,2,7,181,224,0.297,0.808
"19139","Tarija","Yacuiba","U.E. Miguel Estensoro",94,0,0,0,55,4,20,2,0,175,1,9,185,225,0.314,0.822
"19140","Tarija","Yacuiba","U.E. Miguel Estensoro",102,0,0,2,54,2,20,1,2,183,3,6,192,223,0.295,0.861
"19141","Tarija","Yacuiba","U.E. Miguel Estensoro",84,2,0,1,66,6,17,2,3,181,1,6,188,221,0.365,0.851
"19142","Tarija","Yacuiba","U.E. Miguel Estensoro",94,2,0,3,47,2,11,2,4,165,3,7,175,217,0.285,0.806
"19143","Tarija","Yacuiba","U.E. Miguel Estensoro",99,0,0,0,56,2,17,5,0,179,4,6,189,228,0.313,0.829
"19144","Tarija","Yacuiba","U.E. Miguel Estensoro",91,2,0,0,58,4,15,2,0,172,4,4,180,220,0.337,0.818
"19145","Tarija","Yacuiba","U.E. Miguel Estensoro",99,1,1,0,47,3,17,3,1,172,3,12,187,229,0.273,0.817
"19146","Tarija","Yacuiba","U.E. Miguel Estensoro",99,0,0,0,62,4,11,2,0,178,3,7,188,226,0.348,0.832
"19147","Tarija","Yacuiba","U.E. Miguel Estensoro",99,0,0,0,56,4,22,1,0,182,3,4,189,231,0.308,0.818
"19148","Tarija","Yacuiba","U.E. Nestor Paz Galarza",59,0,0,1,94,4,28,1,4,191,1,8,200,232,0.492,0.862
"19149","Tarija","Yacuiba","U.E. Nestor Paz Galarza",85,2,4,0,58,0,35,1,5,190,2,10,202,230,0.305,0.878
"19150","Tarija","Yacuiba","U.E. Nestor Paz Galarza",75,0,2,0,72,5,36,1,0,191,4,10,205,233,0.377,0.88
"19151","Tarija","Yacuiba","U.E. Nestor Paz Galarza",46,0,1,1,89,5,33,0,3,178,5,11,194,231,0.5,0.84
"19152","Tarija","Yacuiba","U.E. Nestor Paz Galarza",78,1,0,1,66,2,42,0,0,190,4,13,207,229,0.347,0.904
"19153","Tarija","Yacuiba","U.E. Nestor Paz Galarza",80,1,0,0,85,1,27,0,1,195,2,6,203,226,0.436,0.898
"19154","Tarija","Yacuiba","U.E. Nestor Paz Galarza",59,0,1,0,80,4,35,2,3,184,7,6,197,222,0.435,0.887
"19155","Tarija","Yacuiba","U.E. Nestor Paz Galarza",43,0,1,0,93,1,34,1,0,173,6,11,190,228,0.538,0.833
"19156","Tarija","Yacuiba","U.E. Nestor Paz Galarza",69,1,0,0,69,2,42,3,1,187,4,6,197,234,0.369,0.842
"19157","Tarija","Yacuiba","U.E. Nestor Paz Galarza",73,2,0,0,82,3,25,3,3,191,3,6,200,229,0.429,0.873
"19158","Tarija","Yacuiba","U.E. Nestor Paz Galarza",51,0,1,1,102,1,27,3,3,189,3,10,202,228,0.54,0.886
"19159","Tarija","Yacuiba","U.E. Nestor Paz Galarza",70,0,2,0,68,5,30,1,0,176,4,14,194,230,0.386,0.843
"19160","Tarija","Yacuiba","U.E. Nestor Paz Galarza",76,0,1,0,79,2,34,1,1,194,2,2,198,232,0.407,0.853
"19161","Tarija","Yacuiba","U.E. Nestor Paz Galarza",64,0,3,1,67,1,44,1,4,185,6,6,197,225,0.362,0.876
"19162","Tarija","Yacuiba","U.E. Nestor Paz Galarza",61,1,1,0,73,1,23,1,1,162,2,7,171,199,0.451,0.859
"19163","Tarija","Yacuiba","U.E. Yacuiba",63,0,0,3,92,4,26,0,0,188,4,6,198,234,0.489,0.846
"19164","Tarija","Yacuiba","U.E. Yacuiba",56,0,1,0,81,1,42,0,6,187,5,10,202,231,0.433,0.874
"19165","Tarija","Yacuiba","U.E. Yacuiba",76,0,0,2,82,2,23,0,3,188,6,10,204,228,0.436,0.895
"19166","Tarija","Yacuiba","U.E. Yacuiba",72,1,0,1,82,5,34,1,1,197,0,5,202,232,0.416,0.871
"19167","Tarija","Yacuiba","U.E. Yacuiba",50,3,2,1,95,4,26,2,3,186,5,8,199,229,0.511,0.869
"19168","Tarija","Yacuiba","U.E. Yacuiba",59,0,0,0,87,3,24,1,1,175,8,12,195,228,0.497,0.855
"19169","Tarija","Yacuiba","U.E. Yacuiba",65,0,2,0,95,1,27,1,1,192,3,4,199,226,0.495,0.881
"19170","Tarija","Yacuiba","U.E. Yacuiba",72,1,1,1,82,2,32,1,2,194,2,9,205,233,0.423,0.88
"19171","Tarija","Yacuiba","U.E. Yacuiba",58,2,0,0,93,5,30,1,2,191,4,5,200,228,0.487,0.877
"19172","Tarija","Yacuiba","U.E. Yacuiba",70,0,0,1,83,1,24,0,0,179,4,5,188,223,0.464,0.843
"19173","Tarija","Yacuiba","U.E. Yacuiba",73,1,0,0,74,3,27,2,2,182,1,11,194,229,0.407,0.847
"19174","Tarija","Yacuiba","U.E. Yacuiba",51,0,0,1,88,1,34,3,1,179,3,7,189,226,0.492,0.836
"19175","Tarija","Yacuiba","U.E. Yacuiba",69,1,0,0,78,1,37,1,0,187,5,5,197,232,0.417,0.849
"19176","Tarija","Yacuiba","U.E. Yacuiba",61,2,0,0,82,6,30,4,2,187,4,15,206,230,0.439,0.896
"19177","Tarija","Yacuiba","U.E. Yacuiba",70,1,1,0,80,6,28,0,6,192,2,3,197,228,0.417,0.864
"19178","Tarija","Yacuiba","U.E. Yacuiba",49,1,0,1,97,3,36,2,0,189,4,5,198,226,0.513,0.876
"19179","Tarija","Yacuiba","U.E. Yacuiba",77,0,1,1,66,6,31,1,1,184,4,5,193,224,0.359,0.862
"19180","Tarija","Yacuiba","U.E. Yacuiba",95,0,1,1,61,5,39,1,1,204,6,4,214,234,0.299,0.915
"19181","Tarija","Yacuiba","U.E. Yacuiba",73,1,0,0,70,3,23,5,1,176,2,16,194,229,0.398,0.847
"19182","Tarija","Yacuiba","U.E. Yacuiba",82,1,3,1,59,2,30,0,3,181,6,10,197,231,0.326,0.853
"19183","Tarija","Yacuiba","U.E. Yacuiba",82,1,0,1,74,3,21,0,2,184,7,10,201,231,0.402,0.87
"19184","Tarija","Yacuiba","U.E. Yacuiba",68,0,0,2,85,6,32,1,2,196,2,9,207,240,0.434,0.863
"19185","Tarija","Yacuiba","U.E. Jose Manuel Belgrano (Yacuiba)",87,0,0,0,68,6,26,8,2,197,0,3,200,231,0.345,0.866
"19186","Tarija","Yacuiba","U.E. Jose Manuel Belgrano (Yacuiba)",92,0,0,1,63,7,16,2,3,184,0,5,189,221,0.342,0.855
"19187","Tarija","Yacuiba","U.E. Jose Manuel Belgrano (Yacuiba)",91,0,0,1,65,5,25,1,0,188,1,4,193,228,0.346,0.846
"19188","Tarija","Yacuiba","U.E. Jose Manuel Belgrano (Yacuiba)",92,0,1,1,66,3,21,3,1,188,0,6,194,227,0.351,0.855
"19189","Tarija","Yacuiba","U.E. Jose Manuel Belgrano (Yacuiba)",73,0,1,1,78,0,24,1,5,183,0,5,188,228,0.426,0.825
"19190","Tarija","Yacuiba","U.E. Jose Manuel Belgrano (Yacuiba)",91,0,0,1,63,3,24,2,1,185,1,4,190,220,0.341,0.864
"19191","Tarija","Yacuiba","U.E. Jose Manuel Belgrano (Yacuiba)",94,0,0,0,54,7,24,1,5,185,1,6,192,228,0.292,0.842
"19192","Tarija","Yacuiba","U.E. Jose Manuel Belgrano (Yacuiba)",98,2,0,1,51,3,19,3,3,180,0,6,186,226,0.283,0.823
"19193","Tarija","Yacuiba","U.E. Jose Manuel Belgrano (Yacuiba)",90,0,0,1,63,4,27,3,2,190,3,4,197,236,0.332,0.835
"19194","Tarija","Yacuiba","U.E. Jose Manuel Belgrano (Yacuiba)",78,0,0,0,71,2,28,2,4,185,2,2,189,223,0.384,0.848
"19195","Tarija","Yacuiba","U.E. Jose Manuel Belgrano (Yacuiba)",103,1,0,3,43,4,19,7,1,181,5,4,190,227,0.238,0.837
"19196","Tarija","Yacuiba","U.E. Jose Manuel Belgrano (Yacuiba)",84,0,0,0,74,2,17,1,1,179,1,6,186,227,0.413,0.819
"19197","Tarija","Yacuiba","U.E. Jose Manuel Belgrano (Yacuiba)",79,0,0,0,83,2,17,1,0,182,1,9,192,228,0.456,0.842
"19198","Tarija","Yacuiba","U.E. Jose Manuel Belgrano (Yacuiba)",114,0,0,0,61,5,15,3,1,199,2,5,206,232,0.307,0.888
"19199","Tarija","Yacuiba","U.E. Jose Manuel Belgrano (Yacuiba)",93,1,1,1,50,3,22,2,0,173,0,9,182,219,0.289,0.831
"19200","Tarija","Yacuiba","U.E. Jose Manuel Belgrano (Yacuiba)",108,1,0,0,54,4,14,2,2,185,2,3,190,223,0.292,0.852
"19201","Tarija","Yacuiba","U.E. Jose Manuel Belgrano (Yacuiba)",103,1,0,0,58,6,18,3,1,190,3,1,194,227,0.305,0.855
"19202","Tarija","Yacuiba","U.E. Jose Manuel Belgrano (Yacuiba)",87,2,1,1,62,1,18,1,3,176,2,5,183,217,0.352,0.843
"19203","Tarija","Yacuiba","U.E. Mariscal Sucre",70,1,0,0,84,6,35,1,1,198,3,3,204,237,0.424,0.861
"19204","Tarija","Yacuiba","U.E. Mariscal Sucre",60,0,1,1,88,4,34,2,4,194,4,7,205,236,0.454,0.869
"19205","Tarija","Yacuiba","U.E. Mariscal Sucre",78,1,2,0,78,5,30,1,2,197,7,4,208,237,0.396,0.878
"19206","Tarija","Yacuiba","U.E. Mariscal Sucre",63,0,4,0,80,3,33,0,2,185,1,10,196,235,0.432,0.834
"19207","Tarija","Yacuiba","U.E. Mariscal Sucre",96,0,3,1,66,4,32,2,1,205,2,5,212,237,0.322,0.895
"19208","Tarija","Yacuiba","U.E. Mariscal Sucre",68,0,1,1,79,4,33,1,2,189,4,5,198,236,0.418,0.839
"19209","Tarija","Yacuiba","U.E. German Busch",86,0,0,1,64,7,36,3,2,199,1,8,208,238,0.322,0.874
"19210","Tarija","Yacuiba","U.E. German Busch",76,0,0,1,70,2,33,3,3,188,3,7,198,233,0.372,0.85
"19211","Tarija","Yacuiba","U.E. German Busch",83,2,1,0,64,3,40,0,0,193,3,8,204,233,0.332,0.876
"19212","Tarija","Yacuiba","U.E. German Busch",88,0,1,0,63,3,26,4,0,185,2,9,196,231,0.341,0.848
"19213","Tarija","Yacuiba","U.E. German Busch",86,1,0,0,68,1,30,1,1,188,4,2,194,232,0.362,0.836
"19214","Tarija","Yacuiba","U.E. German Busch",91,1,0,0,56,4,32,2,0,186,0,3,189,233,0.301,0.811
"19215","Tarija","Yacuiba","U.E. German Busch",77,2,0,0,80,2,22,1,2,186,3,6,195,237,0.43,0.823
"19216","Tarija","Yacuiba","U.E. German Busch",73,1,0,0,72,8,39,2,0,195,2,6,203,234,0.369,0.868
"19217","Tarija","Yacuiba","U.E. German Busch",101,0,0,0,67,3,27,1,1,200,5,8,213,237,0.335,0.899
"19218","Tarija","Yacuiba","U.E. Oliverio Pelichelli",88,3,0,0,77,3,23,1,1,196,1,3,200,231,0.393,0.866
"19219","Tarija","Yacuiba","U.E. Oliverio Pelichelli",60,0,0,0,89,5,39,2,2,197,2,4,203,230,0.452,0.883
"19220","Tarija","Yacuiba","U.E. Oliverio Pelichelli",78,1,0,0,77,9,21,2,0,188,2,2,192,228,0.41,0.842
"19221","Tarija","Yacuiba","U.E. Oliverio Pelichelli",63,2,0,1,81,6,37,1,2,193,1,11,205,234,0.42,0.876
"19222","Tarija","Yacuiba","U.E. Oliverio Pelichelli",72,2,1,1,68,7,30,0,1,182,3,11,196,230,0.374,0.852
"19223","Tarija","Yacuiba","U.E. Oliverio Pelichelli",74,1,1,1,81,4,23,0,0,185,3,6,194,234,0.438,0.829
"19224","Tarija","Yacuiba","U.E. Oliverio Pelichelli",66,1,3,0,79,3,30,2,2,186,0,10,196,234,0.425,0.838
"19225","Tarija","Yacuiba","U.E. José Mariano Serrano",92,0,0,0,65,2,21,2,2,184,2,9,195,222,0.353,0.878
"19226","Tarija","Yacuiba","U.E. José Mariano Serrano",110,2,1,0,44,4,8,2,1,172,2,6,180,214,0.256,0.841
"19227","Tarija","Yacuiba","U.E. José Mariano Serrano",100,0,0,0,64,2,14,3,1,184,0,3,187,227,0.348,0.824
"19228","Tarija","Yacuiba","U.E. José Mariano Serrano",92,1,0,1,60,4,18,0,4,180,3,3,186,227,0.333,0.819
"19229","Tarija","Yacuiba","U.E. José Mariano Serrano",106,1,0,1,42,6,15,4,1,176,4,3,183,223,0.239,0.821
"19230","Tarija","Yacuiba","U.E. José Mariano Serrano",110,0,0,0,55,3,16,1,1,186,5,5,196,228,0.296,0.86
"19231","Tarija","Yacuiba","U.E. José Mariano Serrano",107,1,0,0,56,3,24,1,3,195,0,7,202,229,0.287,0.882
"19232","Tarija","Yacuiba","U.E. José Mariano Serrano",112,0,0,1,46,2,16,3,1,181,2,7,190,222,0.254,0.856
"19233","Tarija","Yacuiba","U.E. José Mariano Serrano",101,1,0,0,69,1,12,4,1,189,1,4,194,226,0.365,0.858
"19234","Tarija","Yacuiba","U.E. José Mariano Serrano",100,1,0,0,50,4,20,3,1,179,1,6,186,220,0.279,0.845
"19235","Tarija","Yacuiba","U.E. José Mariano Serrano",108,0,1,0,59,1,19,3,0,191,1,5,197,228,0.309,0.864
"19236","Tarija","Yacuiba","U.E. José Mariano Serrano",113,0,1,0,48,3,16,1,0,182,0,6,188,218,0.264,0.862
"19237","Tarija","Yacuiba","U.E. San Isidro",70,1,0,1,75,4,26,1,2,180,6,12,198,223,0.417,0.888
"19238","Tarija","Yacuiba","U.E. San Isidro",70,0,1,0,87,6,28,3,1,196,6,10,212,227,0.444,0.934
"19239","Tarija","Yacuiba","U.E. San Isidro",65,1,0,0,95,3,31,1,0,196,4,10,210,230,0.485,0.913
"19240","Tarija","Yacuiba","U.E. San Isidro",60,2,0,2,102,0,28,1,0,195,6,13,214,232,0.523,0.922
"19241","Tarija","Yacuiba","U.E. San Isidro",69,0,1,1,75,3,46,2,1,198,6,5,209,232,0.379,0.901
"19242","Tarija","Yacuiba","U.E. San Isidro",47,2,0,1,99,5,26,1,1,182,6,11,199,223,0.544,0.892
"19243","Tarija","Yacuiba","U.E. San Isidro",53,2,0,0,94,2,36,1,2,190,2,8,200,233,0.495,0.858
"19244","Tarija","Yacuiba","U.E. San Isidro",67,1,2,0,100,3,18,1,2,194,6,12,212,235,0.515,0.902
"19245","Tarija","Yacuiba","U.E. San Isidro",66,2,0,0,86,1,24,1,0,180,8,11,199,230,0.478,0.865
"19246","Tarija","Yacuiba","U.E. San Isidro",60,1,0,0,99,2,28,2,3,195,9,7,211,232,0.508,0.909
"19247","Tarija","Yacuiba","U.E. San Isidro",48,0,1,0,101,2,25,1,4,182,5,8,195,234,0.555,0.833
"19248","Tarija","Yacuiba","U.E. San Isidro",63,0,1,0,101,2,23,1,3,194,8,9,211,241,0.521,0.876
"19249","Tarija","Yacuiba","U.E. Campo Grande (Gran Chaco)",67,1,1,2,91,3,31,1,2,199,1,8,208,231,0.457,0.9
"19250","Tarija","Yacuiba","U.E. Campo Grande (Gran Chaco)",56,1,0,0,101,3,16,0,2,179,3,11,193,227,0.564,0.85
"19251","Tarija","Yacuiba","U.E. Campo Grande (Gran Chaco)",55,0,2,1,99,3,28,4,3,195,2,9,206,229,0.508,0.9
"19252","Tarija","Yacuiba","U.E. Campo Grande (Gran Chaco)",61,1,0,0,92,1,30,2,0,187,2,6,195,231,0.492,0.844
"19253","Tarija","Yacuiba","U.E. Campo Grande (Gran Chaco)",69,0,2,0,85,4,25,0,1,186,6,5,197,227,0.457,0.868
"19254","Tarija","Yacuiba","U.E. Campo Grande (Gran Chaco)",78,1,0,2,83,2,27,3,1,197,1,8,206,231,0.421,0.892
"19255","Tarija","Yacuiba","U.E. Campo Grande (Gran Chaco)",79,0,0,0,83,2,21,1,0,186,7,12,205,231,0.446,0.887
"19256","Tarija","Yacuiba","U.E. Campo Grande (Gran Chaco)",58,1,1,2,97,3,28,2,3,195,4,7,206,230,0.497,0.896
"19257","Tarija","Yacuiba","U.E. Campo Grande (Gran Chaco)",65,0,0,0,77,4,32,2,1,181,6,10,197,228,0.425,0.864
"19258","Tarija","Yacuiba","U.E. Campo Grande (Gran Chaco)",59,1,0,1,116,3,21,0,3,204,6,11,221,234,0.569,0.944
"19259","Tarija","Yacuiba","U.E. Simon Bolivar",33,1,0,0,100,4,25,4,2,169,6,10,185,227,0.592,0.815
"19260","Tarija","Yacuiba","U.E. Simon Bolivar",38,1,0,2,106,2,23,1,1,174,2,10,186,230,0.609,0.809
"19261","Tarija","Yacuiba","U.E. Simon Bolivar",33,0,1,1,116,6,23,1,0,181,3,7,191,229,0.641,0.834
"19262","Tarija","Yacuiba","U.E. Simon Bolivar",35,0,0,0,110,5,29,1,2,182,8,8,198,235,0.604,0.843
"19263","Tarija","Yacuiba","U.E. Simon Bolivar",33,1,0,0,105,3,22,1,0,165,4,8,177,228,0.636,0.776
"19264","Tarija","Yacuiba","U.E. Simon Bolivar",24,1,1,1,111,4,33,3,1,179,1,5,185,228,0.62,0.811
"19265","Tarija","Yacuiba","U.E. Simon Bolivar",44,0,2,0,109,3,26,2,0,186,5,5,196,228,0.586,0.86
"19266","Tarija","Yacuiba","U.E. Simon Bolivar",34,0,0,1,112,1,19,2,0,169,2,8,179,228,0.663,0.785
"19267","Tarija","Yacuiba","U.E. Simon Bolivar",40,1,0,0,103,3,24,4,0,175,4,7,186,224,0.589,0.83
"19268","Tarija","Yacuiba","U.E. Simon Bolivar",43,0,0,2,89,5,28,2,0,169,2,5,176,230,0.527,0.765
"19269","Tarija","Yacuiba","U.E. Simon Bolivar",22,2,0,1,112,5,38,1,2,183,1,5,189,227,0.612,0.833
"19270","Tarija","Yacuiba","U.E. Simon Bolivar",39,0,2,0,96,5,25,4,1,172,2,8,182,224,0.558,0.812
"19271","Tarija","Yacuiba","U.E. Simon Bolivar",33,0,2,1,109,2,25,2,0,174,2,6,182,231,0.626,0.788
"19272","Tarija","Yacuiba","U.E. Simon Bolivar",38,0,0,3,109,1,25,1,0,177,7,2,186,230,0.616,0.809
"19273","Tarija","Yacuiba","U.E. Simon Bolivar",22,2,0,0,109,1,29,5,2,170,4,10,184,227,0.641,0.811
"19274","Tarija","Yacuiba","U.E. Simon Bolivar",33,0,1,0,110,3,29,0,0,176,5,4,185,230,0.625,0.804
"19275","Tarija","Yacuiba","U.E. Simon Bolivar",16,0,1,0,123,1,35,0,0,176,2,6,184,234,0.699,0.786
"19276","Tarija","Yacuiba","U.E. Simon Bolivar",33,1,0,1,94,6,24,2,2,163,6,8,177,232,0.577,0.763
"19277","Tarija","Yacuiba","U.E. Simon Bolivar",39,0,0,0,101,3,21,1,2,167,2,7,176,224,0.605,0.786
"19278","Tarija","Yacuiba","U.E. Simon Bolivar",38,1,1,0,102,2,17,3,3,167,1,8,176,229,0.611,0.769
"19279","Tarija","Yacuiba","U.E. Simon Bolivar",57,3,1,1,86,3,18,8,1,178,7,5,190,231,0.483,0.823
"19280","Tarija","Yacuiba","U.E. Simon Bolivar",31,3,0,1,107,4,21,2,4,173,5,6,184,230,0.618,0.8
"19281","Tarija","Yacuiba","U.E. Heroes del Chaco",66,0,0,0,82,4,10,4,0,166,5,5,176,228,0.494,0.772
"19282","Tarija","Yacuiba","U.E. Heroes del Chaco",43,0,0,0,99,2,14,3,2,163,5,4,172,223,0.607,0.771
"19283","Tarija","Yacuiba","U.E. Heroes del Chaco",52,0,0,1,98,2,12,2,4,171,0,4,175,232,0.573,0.754
"19284","Tarija","Yacuiba","U.E. Heroes del Chaco",50,0,0,0,96,2,19,3,3,173,7,5,185,228,0.555,0.811
"19285","Tarija","Yacuiba","U.E. Heroes del Chaco",73,2,0,0,77,4,9,5,0,170,3,3,176,232,0.453,0.759
"19286","Tarija","Yacuiba","U.E. Heroes del Chaco",53,1,1,0,91,2,9,1,2,160,4,3,167,223,0.569,0.749
"19287","Tarija","Yacuiba","U.E. Heroes del Chaco",60,0,0,1,75,2,16,4,1,159,5,2,166,223,0.472,0.744
"19288","Tarija","Yacuiba","U.E. Heroes del Chaco",35,0,1,0,103,3,22,5,1,170,2,4,176,229,0.606,0.769
"19289","Tarija","Yacuiba","U.E. Heroes del Chaco",56,1,1,0,75,6,20,3,1,163,1,6,170,225,0.46,0.756
"19290","Tarija","Yacuiba","U.E. Heroes del Chaco",52,1,0,3,82,5,11,1,0,155,7,2,164,217,0.529,0.756
"19291","Tarija","Yacuiba","U.E. Heroes del Chaco",51,0,1,0,81,2,14,1,1,151,2,5,158,225,0.536,0.702
"19292","Tarija","Yacuiba","U.E. Heroes del Chaco",36,0,1,1,94,1,15,4,3,155,3,8,166,223,0.606,0.744
"19293","Tarija","Yacuiba","U.E. Heroes del Chaco",50,1,0,1,94,8,11,1,1,167,3,4,174,227,0.563,0.767
"19294","Tarija","Yacuiba","U.E. Heroes del Chaco",58,1,0,1,75,4,13,4,0,156,6,8,170,228,0.481,0.746
"19295","Tarija","Yacuiba","U.E. Heroes del Chaco",53,3,0,0,86,5,16,1,1,165,2,3,170,225,0.521,0.756
"19296","Tarija","Yacuiba","U.E. Heroes del Chaco",56,0,0,0,80,6,10,4,0,156,5,3,164,221,0.513,0.742
"19297","Tarija","Yacuiba","U.E. Heroes del Chaco",73,0,0,0,86,1,13,2,0,175,4,4,183,237,0.491,0.772
"19298","Tarija","Yacuiba","U.E. Nacional Mixto El Palmar",66,3,0,0,102,5,10,0,2,188,8,5,201,230,0.543,0.874
"19299","Tarija","Yacuiba","U.E. Nacional Mixto El Palmar",54,1,0,0,84,5,17,2,2,165,9,11,185,219,0.509,0.845
"19300","Tarija","Yacuiba","U.E. Nacional Mixto El Palmar",97,1,1,2,66,1,12,1,2,183,6,8,197,228,0.361,0.864
"19301","Tarija","Yacuiba","U.E. Nacional Mixto El Palmar",69,2,0,1,88,1,17,2,0,180,3,15,198,228,0.489,0.868
"19302","Tarija","Yacuiba","U.E. Nacional Mixto El Palmar",74,0,1,1,80,3,20,0,0,179,3,10,192,225,0.447,0.853
"19303","Tarija","Yacuiba","U.E. Nacional Mixto El Palmar",86,0,0,1,67,8,26,5,3,196,6,4,206,225,0.342,0.916
"19304","Tarija","Yacuiba","U.E. Nacional Mixto El Palmar",62,2,0,0,106,4,20,0,1,195,5,10,210,230,0.544,0.913
"19305","Tarija","Yacuiba","U.E. Nacional Mixto El Palmar",91,0,0,0,75,6,14,1,0,187,5,9,201,227,0.401,0.885
"19306","Tarija","Yacuiba","U.E. Nacional Mixto El Palmar",84,2,0,1,77,6,20,2,1,193,3,4,200,227,0.399,0.881
"19307","Tarija","Yacuiba","U.E. 12 de Agosto",40,0,0,1,112,5,20,1,1,180,9,3,192,224,0.622,0.857
"19308","Tarija","Yacuiba","U.E. 12 de Agosto",55,0,0,0,100,4,17,2,2,180,2,11,193,224,0.556,0.862
"19309","Tarija","Yacuiba","U.E. 12 de Agosto",60,1,0,2,114,2,13,1,1,194,4,3,201,230,0.588,0.874
"19310","Tarija","Yacuiba","U.E. 12 de Agosto",65,2,0,0,91,3,30,2,2,195,7,6,208,227,0.467,0.916
"19311","Tarija","Yacuiba","U.E. Prof. Bautista Jurado",35,2,0,0,113,3,16,2,2,173,8,8,189,223,0.653,0.848
"19312","Tarija","Yacuiba","U.E. Prof. Bautista Jurado",35,3,0,2,104,4,19,2,0,169,11,8,188,217,0.615,0.866
"19313","Tarija","Yacuiba","U.E. Prof. Bautista Jurado",57,0,1,0,126,1,17,2,0,204,6,6,216,232,0.618,0.931
"19314","Tarija","Yacuiba","U.E. Prof. Bautista Jurado",41,0,0,2,110,2,22,5,2,184,6,8,198,224,0.598,0.884
"19315","Tarija","Yacuiba","U.E. Prof. Bautista Jurado",45,0,2,2,125,3,8,1,0,186,7,2,195,229,0.672,0.852
"19316","Tarija","Yacuiba","U.E. San Francisco De Inti",24,0,0,1,146,2,16,4,0,193,7,6,206,226,0.756,0.912
"19317","Tarija","Yacuiba","U.E. San Francisco De Inti",37,1,1,0,125,3,21,0,1,189,4,2,195,227,0.661,0.859
"19318","Tarija","Yacuiba","U.E. 4 de Mayo",22,0,0,0,153,2,19,0,0,196,7,5,208,232,0.781,0.897
"19319","Tarija","Yacuiba","U.E. 4 de Mayo",38,0,1,2,120,5,32,0,0,198,8,1,207,228,0.606,0.908
"19320","Tarija","Yacuiba","U.E. 4 de Mayo",12,0,0,0,153,0,22,1,0,188,2,7,197,228,0.814,0.864
"19321","Tarija","Yacuiba","U.E. 4 de Mayo",32,0,1,1,115,3,24,0,1,177,9,9,195,234,0.65,0.833
"19322","Tarija","Yacuiba","U.E. 4 de Mayo",33,2,0,1,90,5,33,1,2,167,10,7,184,208,0.539,0.885
"19323","Tarija","Yacuiba","U.E. Heroes de Boqueron",32,2,2,0,90,3,21,0,1,151,4,3,158,229,0.596,0.69
"19324","Tarija","Yacuiba","U.E. Heroes de Boqueron",44,2,1,0,99,4,17,0,0,167,2,5,174,230,0.593,0.757
"19325","Tarija","Yacuiba","U.E. Sachapera",29,2,1,0,154,1,11,1,0,199,5,7,211,232,0.774,0.909
"19326","Tarija","Yacuiba","U.E. Sachapera",16,0,1,0,167,0,8,1,1,194,9,10,213,232,0.861,0.918
"19327","Tarija","Yacuiba","U.E. Sachapera",26,1,1,1,142,2,16,2,0,191,6,7,204,230,0.743,0.887
"19328","Tarija","Yacuiba","U.E. Crevaux Sud",42,1,0,2,111,2,3,2,0,163,15,12,190,229,0.681,0.83
"19329","Tarija","Yacuiba","U.E. Crevaux Sud",28,0,0,0,125,2,5,1,1,162,10,12,184,227,0.772,0.811
"19330","Tarija","Yacuiba","U.E. Crevaux Sud",32,0,2,0,127,3,1,1,1,167,1,7,175,219,0.76,0.799
"19331","Tarija","Yacuiba","U.E. Crevaux Sud",57,0,0,0,105,2,2,1,0,167,9,8,184,222,0.629,0.829
"19332","Tarija","Yacuiba","U.E. Alcides D`Orbigni",19,0,1,0,152,1,2,1,0,176,4,2,182,223,0.864,0.816
"19333","Tarija","Yacuiba","U.E. Villa El Carmen",24,1,0,4,133,2,27,0,0,191,7,7,205,232,0.696,0.884
"19334","Tarija","Yacuiba","U.E. Villa El Carmen",28,1,1,2,121,2,39,2,0,196,9,3,208,233,0.617,0.893
"19335","Tarija","Yacuiba","U.E. Villa El Carmen",18,4,3,2,123,4,39,0,0,193,8,5,206,230,0.637,0.896
"19336","Tarija","Yacuiba","U.E. Villa El Carmen",26,1,3,2,112,0,36,4,2,186,5,9,200,225,0.602,0.889
"19337","Tarija","Yacuiba","U.E. Villa El Carmen",38,3,3,0,104,2,40,3,0,193,11,6,210,230,0.539,0.913
"19338","Tarija","Yacuiba","U.E. Villa El Carmen",35,1,3,1,107,2,38,1,1,189,10,4,203,217,0.566,0.935
"19339","Tarija","Yacuiba","U.E. Cañon Oculto",28,0,1,2,118,4,28,3,4,188,9,12,209,234,0.628,0.893
"19340","Tarija","Yacuiba","U.E. 27 de Mayo",34,0,2,0,101,1,27,0,3,168,7,5,180,232,0.601,0.776
"19341","Tarija","Yacuiba","U.E. 27 de Mayo",42,0,0,0,96,4,22,2,1,167,1,11,179,235,0.575,0.762
"19342","Tarija","Yacuiba","U.E. 27 de Mayo",37,1,0,1,106,1,22,3,3,174,5,7,186,232,0.609,0.802
"19343","Tarija","Yacuiba","U.E. 27 de Mayo",30,0,0,0,103,3,27,0,1,164,4,11,179,228,0.628,0.785
"19344","Tarija","Yacuiba","U.E. Timboy Tiguazu",37,3,0,0,150,2,10,2,1,205,8,13,226,248,0.732,0.911
"19345","Tarija","Yacuiba","U.E. Tierras Nuevas",12,1,0,1,148,1,15,0,1,179,5,10,194,227,0.827,0.855
"19346","Tarija","Yacuiba","U.E. Tierras Nuevas",17,1,1,0,160,1,11,0,0,191,8,3,202,229,0.838,0.882
"19347","Tarija","Yacuiba","U.E. Tierras Nuevas",6,0,1,1,161,0,13,0,1,183,3,19,205,227,0.88,0.903
"19348","Tarija","Yacuiba","U.E. Tierras Nuevas",21,1,0,0,139,0,28,1,2,192,9,10,211,230,0.724,0.917
"19349","Tarija","Yacuiba","Escuela 27 de Mayo",49,0,0,0,132,2,13,0,2,198,5,7,210,230,0.667,0.913
"19350","Tarija","Yacuiba","U.E. Campo Grande “A”",43,3,1,2,129,8,19,1,4,210,8,15,233,238,0.614,0.979
"19351","Tarija","Yacuiba","U.E. Campo Grande “A”",64,0,0,0,111,6,28,2,1,212,7,15,234,240,0.524,0.975
"19352","Tarija","Yacuiba","U.E. Bella Vista de Caipitandy",80,1,2,0,107,1,31,1,1,224,2,5,231,240,0.478,0.963
"19353","Tarija","Yacuiba","U.E. Bella Vista de Caipitandy",90,1,0,0,97,3,19,5,0,215,1,9,225,238,0.451,0.945
"19354","Tarija","Yacuiba","U.E. Bella Vista de Caipitandy",86,0,1,0,90,6,26,2,1,212,5,10,227,237,0.425,0.958
"19355","Tarija","Caraparí","U.E. 3 de Mayo",69,1,0,0,111,3,13,0,1,198,5,11,214,233,0.561,0.918
"19356","Tarija","Caraparí","U.E. 3 de Mayo",79,0,1,0,85,5,7,1,3,181,5,6,192,229,0.47,0.838
"19357","Tarija","Caraparí","U.E. 3 de Mayo",78,0,0,1,97,4,4,0,0,184,4,9,197,228,0.527,0.864
"19358","Tarija","Caraparí","U.E. 3 de Mayo",60,1,0,1,115,5,11,0,1,194,4,7,205,230,0.593,0.891
"19359","Tarija","Caraparí","U.E. 3 de Mayo",61,0,0,2,101,2,6,1,0,173,4,17,194,232,0.584,0.836
"19360","Tarija","Caraparí","U.E. 3 de Mayo",60,0,0,1,109,4,14,2,0,190,3,6,199,233,0.574,0.854
"19361","Tarija","Caraparí","U.E. 3 de Mayo",77,0,0,0,87,3,16,3,0,186,2,8,196,230,0.468,0.852
"19362","Tarija","Caraparí","U.E. 3 de Mayo",84,1,0,0,97,5,17,1,0,205,2,2,209,234,0.473,0.893
"19363","Tarija","Caraparí","U.E. 3 de Mayo",64,2,0,0,93,2,23,3,0,187,1,6,194,230,0.497,0.843
"19364","Tarija","Caraparí","U.E. 3 de Mayo",75,0,0,0,99,5,12,2,2,195,1,3,199,235,0.508,0.847
"19365","Tarija","Caraparí","U.E. 3 de Mayo",75,1,0,0,104,8,13,0,0,201,0,6,207,232,0.517,0.892
"19366","Tarija","Caraparí","U.E. 3 de Mayo",80,0,1,2,89,4,23,1,0,200,1,5,206,230,0.445,0.896
"19367","Tarija","Caraparí","U.E. 3 de Mayo",58,0,1,0,109,2,15,0,1,186,5,9,200,236,0.586,0.847
"19368","Tarija","Caraparí","U.E. 3 de Mayo",74,0,0,0,86,3,9,2,0,174,3,10,187,232,0.494,0.806
"19369","Tarija","Caraparí","U.E. 3 de Mayo",69,0,0,0,108,5,17,0,1,200,2,9,211,234,0.54,0.902
"19370","Tarija","Caraparí","U.E. 3 de Mayo",58,0,0,0,105,1,20,1,0,185,4,7,196,227,0.568,0.863
"19371","Tarija","Caraparí","U.E. 3 de Mayo",69,1,0,0,97,3,16,2,1,189,1,7,197,231,0.513,0.853
"19372","Tarija","Caraparí","U.E. Celso Raffaelli",70,2,1,1,95,1,14,1,1,186,5,3,194,235,0.511,0.826
"19373","Tarija","Caraparí","U.E. Celso Raffaelli",60,2,0,0,107,6,3,0,1,179,7,6,192,228,0.598,0.842
"19374","Tarija","Caraparí","U.E. 15 de Abril",71,1,1,4,108,3,8,3,0,199,4,8,211,236,0.543,0.894
"19375","Tarija","Caraparí","U.E. Lidia Galarza",58,1,0,0,113,2,3,1,0,178,7,15,200,225,0.635,0.889
"19376","Tarija","Caraparí","U.E. Lidia Galarza",48,0,0,1,116,4,10,1,1,181,6,9,196,231,0.641,0.848
"19377","Tarija","Caraparí","U.E. Lidia Galarza",63,0,0,1,105,4,5,1,0,179,2,12,193,228,0.587,0.846
"19378","Tarija","Caraparí","U.E. Fray Quebracho",63,0,0,0,95,1,9,0,1,169,7,14,190,227,0.562,0.837
"19379","Tarija","Caraparí","U.E. Fray Quebracho",48,1,1,1,101,2,5,1,0,160,4,10,174,228,0.631,0.763
"19380","Tarija","Caraparí","U.E. Eustaquio Mendez/Fray Quebracho",71,0,0,1,88,10,9,2,2,183,10,13,206,226,0.481,0.912
"19381","Tarija","Caraparí","U.E. Eustaquio Mendez/Fray Quebracho",89,0,2,0,67,5,7,3,2,175,12,8,195,227,0.383,0.859
"19382","Tarija","Caraparí","U.E. Julio Ramos Valdez",62,1,0,2,98,3,14,2,1,183,6,8,197,225,0.536,0.876
"19383","Tarija","Caraparí","U.E. Julio Ramos Valdez",70,1,0,2,67,9,7,4,0,160,5,4,169,203,0.419,0.833
"19384","Tarija","Caraparí","U.E. Zapatera Norte",63,0,1,1,96,4,10,2,1,178,5,10,193,222,0.539,0.869
"19385","Tarija","Caraparí","U.E. Berety Chaco",38,1,0,2,127,1,6,0,0,175,8,17,200,229,0.726,0.873
"19386","Tarija","Caraparí","U.E. 6 de Agosto",47,1,1,0,127,4,6,1,1,188,4,12,204,219,0.676,0.932
"19387","Tarija","Caraparí","U.E. San Alberto",47,1,0,1,112,3,17,1,0,182,8,9,199,233,0.615,0.854
"19388","Tarija","Caraparí","U.E. San Alberto",57,0,0,0,92,6,28,0,1,184,5,8,197,229,0.5,0.86
"19389","Tarija","Caraparí","U.E. San Alberto",35,0,3,0,94,9,14,0,0,155,6,4,165,185,0.606,0.892
"19390","Tarija","Caraparí","U.E. Bolivia",63,2,0,2,79,5,23,2,0,176,3,12,191,203,0.449,0.941
"19391","Tarija","Villa Montes","U.E.  Julio Crevaux",116,1,2,0,44,7,14,2,0,186,1,6,193,228,0.237,0.846
"19392","Tarija","Villa Montes","U.E.  Julio Crevaux",98,0,0,0,53,3,17,2,0,173,1,6,180,226,0.306,0.796
"19393","Tarija","Villa Montes","U.E.  Julio Crevaux",113,0,2,0,48,6,15,3,0,187,0,10,197,229,0.257,0.86
"19394","Tarija","Villa Montes","U.E.  Julio Crevaux",91,0,0,0,66,3,13,0,1,174,4,8,186,230,0.379,0.809
"19395","Tarija","Villa Montes","U.E.  Julio Crevaux",109,0,2,1,49,8,11,1,2,183,1,7,191,230,0.268,0.83
"19396","Tarija","Villa Montes","U.E.  Julio Crevaux",101,0,1,0,55,6,15,1,1,180,5,5,190,229,0.306,0.83
"19397","Tarija","Villa Montes","U.E.  Julio Crevaux",110,1,2,1,36,3,27,2,0,182,1,3,186,224,0.198,0.83
"19398","Tarija","Villa Montes","U.E.  Julio Crevaux",101,2,1,0,50,7,15,1,1,178,1,5,184,224,0.281,0.821
"19399","Tarija","Villa Montes","U.E.  Julio Crevaux",99,0,1,0,63,8,14,1,0,186,4,4,194,226,0.339,0.858
"19400","Tarija","Villa Montes","U.E.  Julio Crevaux",123,1,1,0,50,7,8,1,2,193,0,7,200,225,0.259,0.889
"19401","Tarija","Villa Montes","U.E.  Julio Crevaux",99,0,0,0,44,2,13,1,2,161,2,3,166,220,0.273,0.755
"19402","Tarija","Villa Montes","U.E.  Julio Crevaux",105,1,2,1,47,8,17,1,1,183,1,3,187,219,0.257,0.854
"19403","Tarija","Villa Montes","U.E.  Julio Crevaux",121,0,1,0,42,5,9,6,1,185,1,4,190,229,0.227,0.83
"19404","Tarija","Villa Montes","U.E.  Julio Crevaux",111,1,1,0,54,4,10,4,0,185,2,3,190,228,0.292,0.833
"19405","Tarija","Villa Montes","U.E.  Julio Crevaux",86,1,1,0,51,6,16,7,3,171,1,4,176,205,0.298,0.859
"19406","Tarija","Villa Montes","U.E. Ismael Montes",116,1,0,1,45,5,15,0,2,185,5,2,192,233,0.243,0.824
"19407","Tarija","Villa Montes","U.E. Ismael Montes",104,1,2,0,49,2,16,3,2,179,5,10,194,229,0.274,0.847
"19408","Tarija","Villa Montes","U.E. Ismael Montes",111,0,2,0,45,5,20,2,1,186,3,9,198,235,0.242,0.843
"19409","Tarija","Villa Montes","U.E. Ismael Montes",115,2,1,0,52,3,12,1,0,186,4,8,198,234,0.28,0.846
"19410","Tarija","Villa Montes","U.E. Ismael Montes",107,0,0,0,58,6,15,6,2,194,2,7,203,234,0.299,0.868
"19411","Tarija","Villa Montes","U.E. Ismael Montes",121,0,0,1,58,3,15,3,1,202,5,2,209,235,0.287,0.889
"19412","Tarija","Villa Montes","U.E. Ismael Montes",120,0,2,0,47,6,15,4,1,195,1,4,200,228,0.241,0.877
"19413","Tarija","Villa Montes","U.E. Ismael Montes",81,1,1,1,80,5,16,1,0,186,4,5,195,230,0.43,0.848
"19414","Tarija","Villa Montes","U.E. Ismael Montes",110,0,0,0,58,6,12,3,1,190,1,2,193,231,0.305,0.835
"19415","Tarija","Villa Montes","U.E. Ismael Montes",103,2,2,0,57,6,22,4,2,198,2,9,209,231,0.288,0.905
"19416","Tarija","Villa Montes","U.E. Ismael Montes",113,1,1,0,64,0,13,1,1,194,4,3,201,230,0.33,0.874
"19417","Tarija","Villa Montes","U.E. Ismael Montes",115,0,1,0,51,7,16,3,1,194,7,1,202,232,0.263,0.871
"19418","Tarija","Villa Montes","U.E. Ismael Montes",112,1,3,0,58,5,6,3,0,188,6,7,201,227,0.309,0.885
"19419","Tarija","Villa Montes","U.E. Ismael Montes",105,0,2,0,48,6,12,1,2,176,2,11,189,228,0.273,0.829
"19420","Tarija","Villa Montes","U.E. Juana Azurduy De Padilla (V.M.)",133,1,1,1,44,2,12,2,0,196,2,7,205,230,0.224,0.891
"19421","Tarija","Villa Montes","U.E. Juana Azurduy De Padilla (V.M.)",118,1,1,0,55,7,18,1,0,201,4,6,211,228,0.274,0.925
"19422","Tarija","Villa Montes","U.E. Juana Azurduy De Padilla (V.M.)",103,1,1,1,55,6,23,1,0,191,6,9,206,227,0.288,0.907
"19423","Tarija","Villa Montes","U.E. Juana Azurduy De Padilla (V.M.)",105,1,0,0,57,4,31,0,1,199,2,8,209,230,0.286,0.909
"19424","Tarija","Villa Montes","U.E. Juana Azurduy De Padilla (V.M.)",106,1,0,0,44,7,26,3,2,189,2,8,199,225,0.233,0.884
"19425","Tarija","Villa Montes","U.E. Juana Azurduy De Padilla (V.M.)",121,1,1,0,33,6,16,1,2,181,3,9,193,228,0.182,0.846
"19426","Tarija","Villa Montes","U.E. Juana Azurduy De Padilla (V.M.)",116,0,0,0,43,4,9,4,2,178,5,12,195,217,0.242,0.899
"19427","Tarija","Villa Montes","U.E. Juana Azurduy De Padilla (V.M.)",90,1,0,1,53,1,29,7,2,184,0,4,188,224,0.288,0.839
"19428","Tarija","Villa Montes","U.E. Juana Azurduy De Padilla (V.M.)",114,1,1,0,51,9,21,2,0,199,4,6,209,231,0.256,0.905
"19429","Tarija","Villa Montes","U.E. Juana Azurduy De Padilla (V.M.)",126,0,1,0,43,8,21,1,0,200,2,7,209,231,0.215,0.905
"19430","Tarija","Villa Montes","U.E. Juana Azurduy De Padilla (V.M.)",102,1,1,0,57,6,25,4,1,197,2,8,207,227,0.289,0.912
"19431","Tarija","Villa Montes","U.E. Juana Azurduy De Padilla (V.M.)",115,0,3,0,37,8,23,3,1,190,4,5,199,225,0.195,0.884
"19432","Tarija","Villa Montes","U.E. Juana Azurduy De Padilla (V.M.)",130,0,2,0,36,8,19,1,1,197,2,6,205,233,0.183,0.88
"19433","Tarija","Villa Montes","U.E. Juana Azurduy De Padilla (V.M.)",93,0,1,1,68,10,10,2,0,185,2,13,200,228,0.368,0.877
"19434","Tarija","Villa Montes","U.E. Juana Azurduy De Padilla (V.M.)",120,0,1,0,44,5,17,2,0,189,4,9,202,227,0.233,0.89
"19435","Tarija","Villa Montes","U.E. Adela Hoyos",95,0,3,0,70,2,13,5,1,189,2,5,196,228,0.37,0.86
"19436","Tarija","Villa Montes","U.E. Adela Hoyos",120,0,1,2,58,4,14,3,0,202,2,2,206,231,0.287,0.892
"19437","Tarija","Villa Montes","U.E. Adela Hoyos",78,0,1,0,73,12,18,1,2,185,3,8,196,223,0.395,0.879
"19438","Tarija","Villa Montes","U.E. Adela Hoyos",104,1,0,0,55,9,11,2,1,183,2,6,191,231,0.301,0.827
"19439","Tarija","Villa Montes","U.E. Adela Hoyos",112,0,0,1,48,5,15,4,0,185,1,6,192,223,0.259,0.861
"19440","Tarija","Villa Montes","U.E. Adela Hoyos",105,0,1,0,60,3,12,1,1,183,1,3,187,226,0.328,0.827
"19441","Tarija","Villa Montes","U.E. Adela Hoyos",96,1,2,1,65,8,14,2,0,189,1,8,198,227,0.344,0.872
"19442","Tarija","Villa Montes","U.E. Adela Hoyos",82,1,0,1,69,7,16,1,0,177,5,6,188,226,0.39,0.832
"19443","Tarija","Villa Montes","U.E. Adela Hoyos",96,1,2,2,61,6,14,2,2,186,2,3,191,224,0.328,0.853
"19444","Tarija","Villa Montes","U.E. Adela Hoyos",98,0,0,0,83,7,6,2,0,196,1,1,198,228,0.423,0.868
"19445","Tarija","Villa Montes","U.E. Adela Hoyos",106,1,2,0,73,3,14,1,0,200,0,3,203,227,0.365,0.894
"19446","Tarija","Villa Montes","U.E. Adela Hoyos",102,1,1,1,62,5,9,1,1,183,2,6,191,231,0.339,0.827
"19447","Tarija","Villa Montes","U.E. Asamblea De Dios",93,0,2,0,69,11,18,2,0,195,2,6,203,232,0.354,0.875
"19448","Tarija","Villa Montes","U.E. Asamblea De Dios",84,1,1,0,66,6,21,5,0,184,6,8,198,223,0.359,0.888
"19449","Tarija","Villa Montes","U.E. Asamblea De Dios",84,2,2,0,82,4,11,0,0,185,3,6,194,232,0.443,0.836
"19450","Tarija","Villa Montes","U.E. Asamblea De Dios",80,1,2,0,72,5,19,3,0,182,8,8,198,229,0.396,0.865
"19451","Tarija","Villa Montes","U.E. Asamblea De Dios",68,0,0,0,74,7,29,0,0,178,8,6,192,227,0.416,0.846
"19452","Tarija","Villa Montes","U.E. Asamblea De Dios",85,1,1,0,77,5,19,4,0,192,5,9,206,229,0.401,0.9
"19453","Tarija","Villa Montes","U.E. Asamblea De Dios",85,0,0,2,69,5,15,2,0,178,7,10,195,227,0.388,0.859
"19454","Tarija","Villa Montes","U.E. Asamblea De Dios",79,3,1,1,67,3,26,2,1,183,7,13,203,228,0.366,0.89
"19455","Tarija","Villa Montes","U.E. Asamblea De Dios",87,0,2,0,71,6,7,2,0,175,7,9,191,228,0.406,0.838
"19456","Tarija","Villa Montes","U.E. Asamblea De Dios",70,1,1,1,85,8,19,5,0,190,1,9,200,230,0.447,0.87
"19457","Tarija","Villa Montes","U.E. Asamblea De Dios",102,1,2,0,63,2,25,1,0,196,3,2,201,230,0.321,0.874
"19458","Tarija","Villa Montes","U.E. Asamblea De Dios",69,1,1,1,89,11,14,3,0,189,1,10,200,231,0.471,0.866
"19459","Tarija","Villa Montes","U.E. Asamblea De Dios",75,2,0,1,68,4,25,1,1,177,6,6,189,231,0.384,0.818
"19460","Tarija","Villa Montes","U.E. Asamblea De Dios",67,0,2,0,89,10,20,1,0,189,7,4,200,231,0.471,0.866
"19461","Tarija","Villa Montes","U.E. Asamblea De Dios",82,1,4,0,70,8,10,2,1,178,5,4,187,228,0.393,0.82
"19462","Tarija","Villa Montes","U.E. Asamblea De Dios",88,0,3,1,69,5,15,1,0,182,5,9,196,229,0.379,0.856
"19463","Tarija","Villa Montes","U.E. Asamblea De Dios",73,1,2,0,90,6,19,3,0,194,4,5,203,230,0.464,0.883
"19464","Tarija","Villa Montes","U.E. Asamblea De Dios",96,3,0,1,65,9,19,1,0,194,4,7,205,233,0.335,0.88
"19465","Tarija","Villa Montes","U.E. Asamblea De Dios",83,0,0,0,84,5,17,1,0,190,4,10,204,227,0.442,0.899
"19466","Tarija","Villa Montes","U.E. Colorados De Bolivia",86,0,2,1,89,5,16,2,1,202,6,6,214,231,0.441,0.926
"19467","Tarija","Villa Montes","U.E. Colorados De Bolivia",64,1,1,1,91,8,16,4,1,187,6,7,200,227,0.487,0.881
"19468","Tarija","Villa Montes","U.E. Colorados De Bolivia",80,1,2,0,69,5,17,2,1,177,9,8,194,229,0.39,0.847
"19469","Tarija","Villa Montes","U.E. Colorados De Bolivia",72,2,1,3,94,3,20,1,0,196,3,6,205,234,0.48,0.876
"19470","Tarija","Villa Montes","U.E. Colorados De Bolivia",68,2,1,1,89,6,15,2,2,186,5,15,206,232,0.478,0.888
"19471","Tarija","Villa Montes","U.E. Colorados De Bolivia",79,0,2,0,83,2,25,3,1,195,2,6,203,227,0.426,0.894
"19472","Tarija","Villa Montes","U.E. Colorados De Bolivia",70,2,1,0,73,1,35,2,1,185,4,13,202,227,0.395,0.89
"19473","Tarija","Villa Montes","U.E. Colorados De Bolivia",78,1,2,0,80,5,23,2,1,192,7,7,206,233,0.417,0.884
"19474","Tarija","Villa Montes","U.E. Colorados De Bolivia",49,1,0,0,98,1,24,1,1,175,9,4,188,232,0.56,0.81
"19475","Tarija","Villa Montes","U.E. Colorados De Bolivia",68,1,0,2,82,3,28,2,0,186,8,8,202,224,0.441,0.902
"19476","Tarija","Villa Montes","U.E. Colorados De Bolivia",81,0,3,0,68,6,17,1,0,176,2,14,192,225,0.386,0.853
"19477","Tarija","Villa Montes","U.E. Colorados De Bolivia",71,0,1,0,76,10,22,3,3,186,2,13,201,234,0.409,0.859
"19478","Tarija","Villa Montes","U.E. Colorados De Bolivia",62,0,1,0,100,5,28,1,2,199,4,3,206,229,0.503,0.9
"19479","Tarija","Villa Montes","U.E. Colorados De Bolivia",79,2,1,2,88,2,13,2,1,190,6,7,203,230,0.463,0.883
"19480","Tarija","Villa Montes","U.E. Colorados De Bolivia",66,0,0,0,91,3,34,1,1,196,3,3,202,232,0.464,0.871
"19481","Tarija","Villa Montes","U.E. Colorados De Bolivia",69,3,1,1,83,5,25,1,1,189,4,9,202,233,0.439,0.867
"19482","Tarija","Villa Montes","U.E. Colorados De Bolivia",85,1,2,0,65,5,26,1,1,186,2,10,198,228,0.349,0.868
"19483","Tarija","Villa Montes","U.E. Colorados De Bolivia",63,0,0,0,91,6,13,3,1,177,3,7,187,212,0.514,0.882
"19484","Tarija","Villa Montes","Kinder Colorados de Bolivia",65,1,0,0,97,6,29,0,1,199,2,10,211,238,0.487,0.887
"19485","Tarija","Villa Montes","Kinder Colorados de Bolivia",69,1,2,0,94,1,16,2,3,188,3,5,196,238,0.5,0.824
"19486","Tarija","Villa Montes","Kinder Colorados de Bolivia",88,0,1,0,83,7,22,0,3,204,4,7,215,237,0.407,0.907
"19487","Tarija","Villa Montes","Kinder Colorados de Bolivia",85,1,1,0,86,4,24,1,0,202,2,12,216,237,0.426,0.911
"19488","Tarija","Villa Montes","Kinder Colorados de Bolivia",64,1,0,0,80,7,36,2,0,190,2,11,203,238,0.421,0.853
"19489","Tarija","Villa Montes","Kinder Colorados de Bolivia",70,0,2,0,80,5,26,5,2,190,5,11,206,238,0.421,0.866
"19490","Tarija","Villa Montes","Kinder Colorados de Bolivia",80,4,0,3,91,4,20,2,3,207,3,5,215,238,0.44,0.903
"19491","Tarija","Villa Montes","Kinder Colorados de Bolivia",85,1,2,0,80,2,27,2,0,199,7,8,214,236,0.402,0.907
"19492","Tarija","Villa Montes","Kinder Colorados de Bolivia",93,1,0,1,91,4,21,0,3,214,5,12,231,250,0.425,0.924
"19493","Tarija","Villa Montes","U.E. San Antonio (Villa Montes)",76,1,0,0,93,3,20,2,0,195,8,9,212,232,0.477,0.914
"19494","Tarija","Villa Montes","U.E. San Antonio (Villa Montes)",73,0,2,0,82,8,16,4,1,186,7,13,206,232,0.441,0.888
"19495","Tarija","Villa Montes","U.E. San Antonio (Villa Montes)",87,0,1,0,96,6,16,3,0,209,8,5,222,237,0.459,0.937
"19496","Tarija","Villa Montes","U.E. San Antonio (Villa Montes)",90,0,1,1,59,4,19,2,2,178,7,18,203,224,0.331,0.906
"19497","Tarija","Villa Montes","U.E. San Antonio (Villa Montes)",80,1,1,0,79,3,10,4,0,178,2,10,190,230,0.444,0.826
"19498","Tarija","Villa Montes","U.E. Capirendita",14,0,1,1,140,1,6,2,1,166,3,7,176,226,0.843,0.779
"19499","Tarija","Villa Montes","U.E. Capirendita",21,3,0,0,143,0,5,1,1,174,10,7,191,227,0.822,0.841
"19500","Tarija","Villa Montes","U.E. Capirendita",14,1,0,1,144,0,8,0,0,168,3,3,174,230,0.857,0.757
"19501","Tarija","Villa Montes","U.E. Cabo Juan",59,1,2,1,110,5,20,2,2,202,6,4,212,230,0.545,0.922
"19502","Tarija","Villa Montes","U.E. Cabo Juan",72,0,0,0,98,5,12,3,0,190,7,9,206,229,0.516,0.9
"19503","Tarija","Villa Montes","U.E. Cabo Juan",49,1,0,0,93,4,5,0,1,153,5,5,163,192,0.608,0.849
"19504","Tarija","Villa Montes","U.E. Teniente Victor Zeballos Claros",36,1,0,1,134,11,4,0,2,189,9,3,201,225,0.709,0.893
"19505","Tarija","Villa Montes","U.E. Teniente Victor Zeballos Claros",51,1,1,1,76,10,24,1,0,165,3,8,176,191,0.461,0.921
"19506","Tarija","Villa Montes","U.E. Rebeca Aguirre",78,0,0,0,87,2,15,3,0,185,3,6,194,221,0.47,0.878
"19507","Tarija","Villa Montes","U.E. Rebeca Aguirre",67,0,0,0,72,8,19,7,0,173,8,6,187,217,0.416,0.862
"19508","Tarija","Villa Montes","U.E. Rebeca Aguirre",87,1,1,0,73,3,14,5,1,185,5,1,191,226,0.395,0.845
"19509","Tarija","Villa Montes","Centro Comunal",32,1,0,1,129,2,13,2,2,182,5,5,192,230,0.709,0.835
"19510","Tarija","Villa Montes","Centro Comunal",42,1,1,1,115,6,12,5,0,183,12,7,202,218,0.628,0.927
"19511","Tarija","Villa Montes","U.E. Antonio Jose De Sucre",54,1,3,3,102,2,17,2,2,186,8,8,202,229,0.548,0.882
"19512","Tarija","Villa Montes","U.E. Aguaragüe",101,0,1,1,51,8,10,2,1,175,6,6,187,234,0.291,0.799
"19513","Tarija","Villa Montes","U.E. 27 de Mayo - Puesto García - 1",35,2,0,1,146,3,12,1,2,202,7,7,216,236,0.723,0.915
"19514","Tarija","Villa Montes","U.E. Chimeo",34,0,1,2,155,3,11,2,0,208,6,7,221,237,0.745,0.932
"19515","Tarija","Villa Montes","U.E. Ibopeiti",40,2,3,0,127,1,10,3,0,186,12,7,205,231,0.683,0.887
"19516","Tarija","Uriondo (Concepción)","Col. Delfin Pino Ichazu",76,1,1,1,78,4,10,5,1,177,5,10,192,225,0.441,0.853
"19517","Tarija","Uriondo (Concepción)","Col. Delfin Pino Ichazu",78,1,0,0,80,8,18,2,0,187,2,5,194,229,0.428,0.847
"19518","Tarija","Uriondo (Concepción)","Col. Delfin Pino Ichazu",61,0,0,0,84,7,26,6,0,184,1,13,198,220,0.457,0.9
"19519","Tarija","Uriondo (Concepción)","Col. Delfin Pino Ichazu",74,1,1,0,77,11,18,3,0,185,1,12,198,222,0.416,0.892
"19520","Tarija","Uriondo (Concepción)","Col. Delfin Pino Ichazu",69,0,0,1,80,4,16,4,0,174,1,16,191,225,0.46,0.849
"19521","Tarija","Uriondo (Concepción)","Col. Delfin Pino Ichazu",64,1,0,1,90,6,12,7,0,181,7,15,203,224,0.497,0.906
"19522","Tarija","Uriondo (Concepción)","Col. Delfin Pino Ichazu",93,0,1,1,63,8,20,4,1,191,3,7,201,227,0.33,0.885
"19523","Tarija","Uriondo (Concepción)","Col. Delfin Pino Ichazu",88,0,0,2,73,3,18,2,0,186,6,13,205,227,0.392,0.903
"19524","Tarija","Uriondo (Concepción)","Col. Delfin Pino Ichazu",83,1,0,0,71,6,15,2,0,178,4,12,194,226,0.399,0.858
"19525","Tarija","Uriondo (Concepción)","Col. Delfin Pino Ichazu",54,0,1,2,87,9,18,5,0,176,4,16,196,229,0.494,0.856
"19526","Tarija","Uriondo (Concepción)","U.E. Ancon Chico",35,1,0,1,123,10,14,5,1,190,5,10,205,229,0.647,0.895
"19527","Tarija","Uriondo (Concepción)","U.E. Ancon Chico",32,0,0,2,122,2,6,2,0,166,1,7,174,186,0.735,0.935
"19528","Tarija","Uriondo (Concepción)","U.E. La Choza",49,3,0,0,80,12,10,10,2,166,8,15,189,217,0.482,0.871
"19529","Tarija","Uriondo (Concepción)","U.E. La Choza",57,1,0,0,77,16,17,12,2,182,8,22,212,226,0.423,0.938
"19530","Tarija","Uriondo (Concepción)","U.E. La Choza",62,1,0,1,83,10,15,16,1,189,10,9,208,228,0.439,0.912
"19531","Tarija","Uriondo (Concepción)","U.E. Rosario Jaramillo",51,2,1,0,91,9,25,9,0,188,7,6,201,221,0.484,0.91
"19532","Tarija","Uriondo (Concepción)","U.E. Rosario Jaramillo",53,1,1,1,100,10,19,6,3,194,2,8,204,229,0.515,0.891
"19533","Tarija","Uriondo (Concepción)","U.E. Rosario Jaramillo",50,1,0,0,103,8,14,7,4,187,6,7,200,220,0.551,0.909
"19534","Tarija","Uriondo (Concepción)","U.E. Rosario Jaramillo",46,1,0,1,98,8,14,5,5,178,7,13,198,226,0.551,0.876
"19535","Tarija","Uriondo (Concepción)","U.E. Rosario Jaramillo",39,0,0,0,126,1,14,3,2,185,9,7,201,220,0.681,0.914
"19536","Tarija","Uriondo (Concepción)","U.E. Rosario Jaramillo",60,2,0,0,107,5,20,5,1,200,8,10,218,233,0.535,0.936
"19537","Tarija","Uriondo (Concepción)","U.E. Rosario Jaramillo",73,3,0,0,78,7,21,1,3,186,5,11,202,226,0.419,0.894
"19538","Tarija","Uriondo (Concepción)","U.E. Rosario Jaramillo",64,1,0,0,88,10,24,3,1,191,5,6,202,224,0.461,0.902
"19539","Tarija","Uriondo (Concepción)","U.E. Nuevo Amanecer",46,1,0,1,102,16,16,2,1,185,6,20,211,231,0.551,0.913
"19540","Tarija","Uriondo (Concepción)","U.E. Nuevo Amanecer",46,1,2,1,94,16,13,2,2,177,6,12,195,223,0.531,0.874
"19541","Tarija","Uriondo (Concepción)","U.E. Nuevo Amanecer",25,4,0,1,97,16,14,2,4,163,2,6,171,221,0.595,0.774
"19542","Tarija","Uriondo (Concepción)","U.E. Nuevo Amanecer",34,2,0,1,105,7,13,4,0,166,7,22,195,226,0.633,0.863
"19543","Tarija","Uriondo (Concepción)","U.E. Nuevo Amanecer",52,3,1,1,84,12,17,3,2,175,8,12,195,231,0.48,0.844
"19544","Tarija","Uriondo (Concepción)","U.E. Aniceto Arce",53,1,0,1,99,6,3,1,2,166,5,13,184,218,0.596,0.844
"19545","Tarija","Uriondo (Concepción)","U.E. Aniceto Arce",39,1,0,0,106,8,12,5,0,171,9,17,197,220,0.62,0.895
"19546","Tarija","Uriondo (Concepción)","U.E. Aniceto Arce",45,2,0,3,97,6,7,7,0,167,11,15,193,226,0.581,0.854
"19547","Tarija","Uriondo (Concepción)","U.E. Aniceto Arce",54,3,1,2,102,5,15,3,1,186,9,13,208,227,0.548,0.916
"19548","Tarija","Uriondo (Concepción)","U.E. Aniceto Arce",58,1,0,0,94,2,12,2,1,170,13,11,194,227,0.553,0.855
"19549","Tarija","Uriondo (Concepción)","Esc. Felipe Araoz",51,3,0,1,86,7,10,5,2,165,5,12,182,223,0.521,0.816
"19550","Tarija","Uriondo (Concepción)","U.E. 15 de Octubre",22,1,2,1,112,5,15,1,0,159,8,8,175,226,0.704,0.774
"19551","Tarija","Uriondo (Concepción)","U.E. 15 de Octubre",11,1,0,1,118,4,14,2,0,151,3,5,159,214,0.781,0.743
"19552","Tarija","Uriondo (Concepción)","U.E. La Compañia",26,1,0,1,134,3,24,4,2,195,3,12,210,229,0.687,0.917
"19553","Tarija","Uriondo (Concepción)","U.E. La Compañia",27,1,1,0,121,5,8,1,0,164,7,17,188,204,0.738,0.922
"19554","Tarija","Uriondo (Concepción)","U.E. 19 de Marzo",39,0,0,1,119,1,12,3,0,175,5,4,184,214,0.68,0.86
"19555","Tarija","Uriondo (Concepción)","U.E. Armando Gutierrez",35,1,2,0,139,9,16,6,1,209,14,12,235,239,0.665,0.983
"19556","Tarija","Uriondo (Concepción)","U.E. Armando Gutierrez",24,5,3,4,137,6,14,2,2,197,23,21,241,250,0.695,0.964
"19557","Tarija","Yunchará","Col. 6 de Abril",21,1,0,0,128,6,8,0,0,164,1,6,171,217,0.78,0.788
"19558","Tarija","Yunchará","U.E. Jose Ballivian",11,2,0,2,133,2,8,1,0,159,8,4,171,226,0.836,0.757
"19559","Tarija","Yunchará","U.E. Pasajes",7,2,0,0,152,1,18,2,0,182,5,6,193,217,0.835,0.889
"19560","Tarija","San Lorenzo","U.E. Eustaquio Mendez - 2 - San Lorenzo",103,1,0,1,43,8,13,4,2,175,6,9,190,216,0.246,0.88
"19561","Tarija","San Lorenzo","U.E. Eustaquio Mendez - 2 - San Lorenzo",96,1,0,1,58,6,6,6,0,174,4,9,187,224,0.333,0.835
"19562","Tarija","San Lorenzo","U.E. Eustaquio Mendez - 2 - San Lorenzo",87,1,0,0,69,1,16,2,0,176,6,14,196,227,0.392,0.863
"19563","Tarija","San Lorenzo","U.E. Eustaquio Mendez - 2 - San Lorenzo",80,1,0,0,66,11,18,2,0,178,2,15,195,229,0.371,0.852
"19564","Tarija","San Lorenzo","U.E. Eustaquio Mendez - 2 - San Lorenzo",97,0,0,0,47,4,12,5,1,166,5,5,176,222,0.283,0.793
"19565","Tarija","San Lorenzo","U.E. Eustaquio Mendez - 2 - San Lorenzo",105,2,1,2,61,1,15,4,1,192,1,9,202,230,0.318,0.878
"19566","Tarija","San Lorenzo","U.E. Eustaquio Mendez - 2 - San Lorenzo",100,0,1,0,42,14,16,0,0,173,4,11,188,231,0.243,0.814
"19567","Tarija","San Lorenzo","U.E. Eustaquio Mendez - 2 - San Lorenzo",95,0,1,1,67,11,13,1,0,189,6,6,201,228,0.354,0.882
"19568","Tarija","San Lorenzo","U.E. Eustaquio Mendez - 2 - San Lorenzo",80,0,3,1,69,2,11,3,0,169,6,5,180,226,0.408,0.796
"19569","Tarija","San Lorenzo","U.E. Eustaquio Mendez - 2 - San Lorenzo",95,3,0,0,67,8,8,2,0,183,5,4,192,223,0.366,0.861
"19570","Tarija","San Lorenzo","U.E. Eustaquio Mendez - 2 - San Lorenzo",89,1,0,0,63,6,8,3,1,171,4,7,182,221,0.368,0.824
"19571","Tarija","San Lorenzo","U.E. Eustaquio Mendez - 2 - San Lorenzo",93,2,1,0,55,4,16,4,0,175,3,10,188,228,0.314,0.825
"19572","Tarija","San Lorenzo","U.E. Eustaquio Mendez - 2 - San Lorenzo",86,0,1,1,79,5,11,2,0,185,2,13,200,229,0.427,0.873
"19573","Tarija","San Lorenzo","U.E. Eustaquio Mendez - 2 - San Lorenzo",93,1,0,1,61,5,12,2,0,175,6,7,188,225,0.349,0.836
"19574","Tarija","San Lorenzo","U.E. Tarija Cancha Sud",94,1,2,2,70,8,6,1,0,184,9,9,202,225,0.38,0.898
"19575","Tarija","San Lorenzo","U.E. Tarija Cancha Sud",74,1,1,0,82,10,10,4,1,183,6,16,205,228,0.448,0.899
"19576","Tarija","San Lorenzo","U.E. Tarija Cancha Sud",95,2,1,0,68,8,5,1,1,181,3,8,192,221,0.376,0.869
"19577","Tarija","San Lorenzo","U.E. Nestor Paz Zamora",65,0,0,0,75,7,27,5,0,179,11,8,198,232,0.419,0.853
"19578","Tarija","San Lorenzo","U.E. Nestor Paz Zamora",54,2,0,1,94,4,13,2,1,171,12,6,189,227,0.55,0.833
"19579","Tarija","San Lorenzo","U.E. Nestor Paz Zamora",48,2,0,2,98,8,9,4,1,172,6,10,188,226,0.57,0.832
"19580","Tarija","San Lorenzo","U.E. Simon Bolivar",116,2,1,0,54,8,13,5,0,199,7,3,209,221,0.271,0.946
"19581","Tarija","San Lorenzo","U.E. Simon Bolivar",97,1,1,0,53,9,15,10,1,187,4,15,206,230,0.283,0.896
"19582","Tarija","San Lorenzo","U.E. Simon Bolivar",108,1,1,1,46,9,10,12,2,190,4,19,213,230,0.242,0.926
"19583","Tarija","San Lorenzo","U.E. Simon Bolivar",109,2,0,1,58,10,11,11,1,203,4,9,216,230,0.286,0.939
"19584","Tarija","San Lorenzo","U.E. Juan Misael Saracho",91,1,0,3,72,5,18,3,0,193,5,12,210,226,0.373,0.929
"19585","Tarija","San Lorenzo","U.E. Juan Misael Saracho",76,2,1,2,80,5,17,2,0,185,10,11,206,228,0.432,0.904
"19586","Tarija","San Lorenzo","U.E. 15 de Abril Erquis",99,3,0,2,53,5,13,3,1,179,9,16,204,232,0.296,0.879
"19587","Tarija","San Lorenzo","U.E. 15 de Abril Erquis",67,1,0,2,93,4,20,0,0,187,1,13,201,228,0.497,0.882
"19588","Tarija","San Lorenzo","U.E. 15 de Abril Erquis",76,1,1,2,81,5,22,1,0,189,7,18,214,230,0.429,0.93
"19589","Tarija","San Lorenzo","U.E. 15 de Abril Erquis",54,0,2,5,100,11,14,2,0,188,5,10,203,228,0.532,0.89
"19590","Tarija","San Lorenzo","U.E. 15 de Abril Erquis",71,0,0,4,78,4,14,1,1,173,7,12,192,210,0.451,0.914
"19591","Tarija","San Lorenzo","U.E. Serapio Martinez",100,2,0,0,58,10,20,2,1,193,4,13,210,226,0.301,0.929
"19592","Tarija","San Lorenzo","U.E. Serapio Martinez",88,0,1,0,67,15,9,5,1,186,7,15,208,233,0.36,0.893
"19593","Tarija","San Lorenzo","U.E. Serapio Martinez",85,1,0,0,65,12,18,10,0,191,3,13,207,230,0.34,0.9
"19594","Tarija","San Lorenzo","U.E. Serapio Martinez",84,0,2,2,81,6,13,2,1,191,7,6,204,225,0.424,0.907
"19595","Tarija","San Lorenzo","U.E. Serapio Martinez",102,1,0,2,62,15,10,4,1,197,5,9,211,229,0.315,0.921
"19596","Tarija","San Lorenzo","U.E. Rancho Sud",111,0,0,1,55,7,12,5,0,191,2,11,204,227,0.288,0.899
"19597","Tarija","San Lorenzo","U.E. Rancho Sud",102,0,0,1,66,2,19,2,1,193,8,8,209,230,0.342,0.909
"19598","Tarija","San Lorenzo","U.E. Rancho Sud",71,0,0,2,66,7,12,4,1,163,3,6,172,185,0.405,0.93
"19599","Tarija","San Lorenzo","U.E. Osvaldo Galvez",31,1,0,1,121,1,21,5,0,181,6,3,190,227,0.669,0.837
"19600","Tarija","San Lorenzo","U.E. Osvaldo Galvez",25,0,2,0,115,6,18,7,1,174,3,5,182,221,0.661,0.824
"19601","Tarija","San Lorenzo","U.E. Osvaldo Galvez",43,1,0,1,100,5,16,5,1,172,13,7,192,222,0.581,0.865
"19602","Tarija","San Lorenzo","U.E. Eustaquio Mendez - 12 - Canasmoro",37,1,2,0,119,5,9,0,0,173,6,7,186,224,0.688,0.83
"19603","Tarija","San Lorenzo","U.E. Eustaquio Mendez - 12 - Canasmoro",55,1,0,1,119,2,9,2,0,189,6,13,208,226,0.63,0.92
"19604","Tarija","San Lorenzo","U.E. Eustaquio Mendez - 12 - Canasmoro",59,0,0,0,114,1,7,0,1,182,5,12,199,230,0.626,0.865
"19605","Tarija","San Lorenzo","U.E. Tomatas Grande",48,0,1,2,100,10,24,0,1,186,6,7,199,229,0.538,0.869
"19606","Tarija","San Lorenzo","U.E. Tomatas Grande",61,2,0,2,92,3,12,1,1,174,3,15,192,218,0.529,0.881
"19607","Tarija","San Lorenzo","U.E. Julio Sucre Sella Mendez",72,0,0,2,84,6,10,4,1,179,13,7,199,225,0.469,0.884
"19608","Tarija","San Lorenzo","U.E. Julio Sucre Sella Mendez",69,2,1,0,92,7,12,0,0,183,6,8,197,230,0.503,0.857
"19609","Tarija","San Lorenzo","U.E. Carachimayo Centro",39,0,2,1,92,7,8,6,2,157,14,10,181,229,0.586,0.79
"19610","Tarija","San Lorenzo","U.E. Angel Calabi Pasolinni",91,0,0,4,68,2,28,2,2,197,4,7,208,225,0.345,0.924
"19611","Tarija","San Lorenzo","U.E. Angel Calabi Pasolinni",77,2,0,0,81,1,22,5,0,188,5,5,198,231,0.431,0.857
"19612","Tarija","San Lorenzo","U.E. Angel Calabi Pasolinni",69,1,1,0,96,7,19,2,0,195,1,5,201,224,0.492,0.897
"19613","Tarija","San Lorenzo","U.E. Angel Calabi Pasolinni",87,0,0,0,70,7,30,1,1,196,5,7,208,229,0.357,0.908
"19614","Tarija","San Lorenzo","U.E. Angel Calabi Pasolinni",81,0,1,1,70,7,26,5,0,191,2,14,207,231,0.366,0.896
"19615","Tarija","San Lorenzo","U.E. Angel Calabi Pasolinni",69,1,0,0,98,5,17,1,1,192,4,6,202,225,0.51,0.898
"19616","Tarija","San Lorenzo","U.E. Angel Calabi Pasolinni",85,0,2,1,79,1,30,3,3,204,1,5,210,229,0.387,0.917
"19617","Tarija","San Lorenzo","U.E. Angel Calabi Pasolinni",110,2,0,0,55,8,16,4,1,196,3,10,209,230,0.281,0.909
"19618","Tarija","San Lorenzo","U.E. Angel Calabi Pasolinni",80,0,0,0,74,7,30,2,1,194,3,6,203,228,0.381,0.89
"19619","Tarija","San Lorenzo","U.E. Angel Calabi Pasolinni",108,1,0,0,60,5,12,5,0,191,1,8,200,218,0.314,0.917
"19620","Tarija","San Lorenzo","U.E. Bordo El Mollar",48,1,3,2,105,10,20,5,1,195,6,13,214,234,0.538,0.915
"19621","Tarija","San Lorenzo","U.E. Bordo El Mollar",46,2,0,1,102,15,26,3,0,195,6,9,210,234,0.523,0.897
"19622","Tarija","San Lorenzo","U.E. Bordo El Mollar",57,1,0,0,86,8,37,3,1,193,9,17,219,245,0.446,0.894
"19623","Tarija","El Puente","U.E. 1o. de Julio",68,2,1,1,86,3,25,2,0,188,2,5,195,221,0.457,0.882
"19624","Tarija","El Puente","U.E. 1o. de Julio",47,1,0,1,97,2,35,4,1,188,5,5,198,228,0.516,0.868
"19625","Tarija","El Puente","U.E. 1o. de Julio",58,1,0,3,112,2,27,1,0,204,0,6,210,231,0.549,0.909
"19626","Tarija","El Puente","U.E. 1o. de Julio",53,1,0,0,83,7,35,2,0,181,3,10,194,224,0.459,0.866
"19627","Tarija","El Puente","Centro Comunal",47,0,0,0,97,10,10,3,0,167,4,12,183,207,0.581,0.884
"19628","Tarija","El Puente","U.E. Franz Tamayo",31,1,0,1,118,4,10,2,0,167,5,6,178,222,0.707,0.802
"19629","Tarija","El Puente","U.E. Franz Tamayo",24,2,0,1,130,5,16,2,0,180,4,7,191,227,0.722,0.841
"19630","Tarija","El Puente","U.E. Franz Tamayo",28,2,0,2,118,7,17,4,0,178,6,8,192,226,0.663,0.85
"19631","Tarija","El Puente","U.E. Franz Tamayo",16,1,0,2,133,0,14,0,3,169,10,14,193,227,0.787,0.85
"19632","Tarija","El Puente","U.E. Franz Tamayo",14,1,0,0,142,3,11,1,1,173,3,2,178,220,0.821,0.809
"19633","Tarija","El Puente","U.E. Franz Tamayo",27,1,0,1,119,5,13,3,0,169,8,8,185,224,0.704,0.826
"19634","Tarija","El Puente","U.E. San Antonio (Mendez)",8,1,1,0,134,4,14,3,1,166,6,14,186,221,0.807,0.842
"19635","Tarija","El Puente","U.E. El Molino",8,1,0,1,147,3,5,1,0,166,6,14,186,220,0.886,0.845
"19636","Tarija","El Puente","U.E. Cumbre de Sama",23,0,1,0,128,4,19,3,1,179,2,8,189,221,0.715,0.855
"19637","Tarija","El Puente","U.E. Pueblo Nuevo",10,3,0,0,147,1,2,1,0,164,12,10,186,233,0.896,0.798
"19638","Tarija","El Puente","U.E. San Antonio de Curqui",40,1,1,1,107,11,20,1,0,182,3,5,190,234,0.588,0.812
"19639","Tarija","El Puente","U.E. Chorcoya Mendez",15,0,0,0,136,4,7,1,1,164,4,3,171,224,0.829,0.763
"19640","Tarija","El Puente","Sede Comunal",37,2,0,2,101,3,18,6,3,172,8,9,189,224,0.587,0.844
"19641","Tarija","Entre Ríos","U.E. Franz Tamayo",98,3,0,0,75,4,14,2,1,197,6,5,208,228,0.381,0.912
"19642","Tarija","Entre Ríos","U.E. Franz Tamayo",92,1,1,2,57,4,20,2,1,180,5,10,195,225,0.317,0.867
"19643","Tarija","Entre Ríos","U.E. Franz Tamayo",65,1,0,1,77,9,17,7,0,177,6,15,198,230,0.435,0.861
"19644","Tarija","Entre Ríos","U.E. Franz Tamayo",96,2,0,0,64,1,17,2,0,182,6,15,203,232,0.352,0.875
"19645","Tarija","Entre Ríos","U.E. Franz Tamayo",81,0,1,2,86,5,9,2,0,186,6,10,202,228,0.462,0.886
"19646","Tarija","Entre Ríos","U.E. Franz Tamayo",81,1,1,2,62,12,14,5,2,180,11,12,203,228,0.344,0.89
"19647","Tarija","Entre Ríos","U.E. Franz Tamayo",75,1,0,0,68,7,25,2,1,179,5,21,205,230,0.38,0.891
"19648","Tarija","Entre Ríos","U.E. Franz Tamayo",72,1,2,0,66,6,26,5,0,178,5,13,196,231,0.371,0.848
"19649","Tarija","Entre Ríos","U.E. Franz Tamayo",91,0,0,2,70,2,15,5,0,185,2,8,195,224,0.378,0.871
"19650","Tarija","Entre Ríos","U.E. Franz Tamayo",71,0,0,0,92,5,25,4,0,197,3,3,203,224,0.467,0.906
"19651","Tarija","Entre Ríos","U.E. Franz Tamayo",104,1,0,1,61,4,9,4,1,185,5,10,200,226,0.33,0.885
"19652","Tarija","Entre Ríos","U.E. Franz Tamayo",80,1,1,1,59,2,16,12,3,175,5,16,196,223,0.337,0.879
"19653","Tarija","Entre Ríos","U.E. Franz Tamayo",89,2,0,0,63,5,15,5,1,180,7,13,200,229,0.35,0.873
"19654","Tarija","Entre Ríos","U.E. Franz Tamayo",64,2,1,0,86,7,20,5,2,187,6,9,202,225,0.46,0.898
"19655","Tarija","Entre Ríos","U.E. Franz Tamayo",69,2,0,1,75,8,24,8,0,187,7,8,202,230,0.401,0.878
"19656","Tarija","Entre Ríos","U.E. Franz Tamayo",90,1,1,1,67,4,11,7,1,183,1,20,204,229,0.366,0.891
"19657","Tarija","Entre Ríos","U.E. Franz Tamayo",85,0,0,3,67,10,10,4,3,182,4,13,199,235,0.368,0.847
"19658","Tarija","Entre Ríos","U.E. Franz Tamayo",70,2,2,1,75,7,25,5,0,187,5,6,198,228,0.401,0.868
"19659","Tarija","Entre Ríos","U.E. Franz Tamayo",73,2,0,0,72,10,13,6,1,177,8,13,198,229,0.407,0.865
"19660","Tarija","Entre Ríos","U.E. Franz Tamayo",94,0,0,1,59,6,21,5,1,187,7,11,205,231,0.316,0.887
"19661","Tarija","Entre Ríos","U.E. Franz Tamayo",91,1,0,0,79,5,14,3,1,194,4,9,207,232,0.407,0.892
"19662","Tarija","Entre Ríos","U.E. Franz Tamayo",95,1,0,0,69,3,16,4,0,188,5,11,204,225,0.367,0.907
"19663","Tarija","Entre Ríos","U.E. Franz Tamayo",76,1,0,0,80,3,13,5,0,178,4,13,195,228,0.449,0.855
"19664","Tarija","Entre Ríos","U.E. Pajonal",59,1,1,1,87,5,15,1,1,171,6,11,188,218,0.509,0.862
"19665","Tarija","Entre Ríos","U.E. Cnl. Eustaquio Mendez",26,0,0,0,142,5,19,2,0,194,4,7,205,215,0.732,0.953
"19666","Tarija","Entre Ríos","U.E. Huaico Acerradero",15,5,0,0,143,4,9,3,1,180,8,8,196,228,0.794,0.86
"19667","Tarija","Entre Ríos","U.E. Profesor Rene Avila Bayon",25,5,0,7,108,7,18,4,1,175,11,7,193,227,0.617,0.85
"19668","Tarija","Entre Ríos","U.E. Profesor Rene Avila Bayon",18,3,1,2,114,0,17,2,3,160,15,12,187,226,0.713,0.827
"19669","Tarija","Entre Ríos","U.E. Profesor Rene Avila Bayon",27,4,1,3,128,4,12,2,3,184,2,10,196,225,0.696,0.871
"19670","Tarija","Entre Ríos","U.E. San Diego Centro",20,2,0,1,118,5,21,8,2,177,6,12,195,225,0.667,0.867
"19671","Tarija","Entre Ríos","U.E. Tarupayo",69,0,1,0,81,6,5,1,0,163,14,10,187,206,0.497,0.908
"19672","Tarija","Entre Ríos","U.E. Luis Vaca Gallardo",78,1,1,2,72,10,5,8,1,178,6,9,193,219,0.404,0.881
"19673","Tarija","Entre Ríos","U.E. Potrerillos (O Connor)",56,3,2,3,104,3,6,5,0,182,8,8,198,223,0.571,0.888
"19674","Tarija","Entre Ríos","U.E. Timboy",55,3,0,1,76,8,26,4,0,173,18,12,203,229,0.439,0.886
"19675","Tarija","Entre Ríos","U.E. Timboy",52,5,1,1,84,4,35,1,0,183,12,8,203,228,0.459,0.89
"19676","Tarija","Entre Ríos","U.E. Ñaurenda",34,3,0,0,124,1,10,1,0,173,8,1,182,230,0.717,0.791
"19677","Tarija","Entre Ríos","U.E. 12 de Abril",99,1,0,1,53,12,11,6,2,185,5,10,200,233,0.286,0.858
"19678","Tarija","Entre Ríos","U.E. 12 de Abril",105,0,2,2,67,8,4,4,1,193,10,10,213,248,0.347,0.859
"19679","Tarija","Entre Ríos","U.E. Prof. Emiliano Villarrubia",54,2,0,1,104,6,1,11,0,179,7,8,194,221,0.581,0.878
"19680","Tarija","Entre Ríos","U.E. Chiquiaca Centro",44,3,4,1,103,4,26,2,1,188,2,14,204,230,0.548,0.887
"19681","Tarija","Entre Ríos","U.E. Chiquiaca Centro",45,1,0,1,118,5,18,3,1,192,8,10,210,230,0.615,0.913
"19682","Tarija","Entre Ríos","U.E. Juan Saavedra Mealla",66,1,0,1,89,4,12,6,2,181,6,9,196,220,0.492,0.891
"19683","Tarija","Entre Ríos","U.E. Tte. Gualberto Villarroel",38,1,0,1,111,2,10,6,1,170,5,8,183,214,0.653,0.855
"19684","Tarija","Entre Ríos","U.E. Mistolar",60,2,1,2,96,8,1,2,1,173,9,29,211,237,0.555,0.89
"19685","Tarija","Entre Ríos","U.E. Sivingal",7,0,0,0,158,2,26,2,1,196,3,6,205,231,0.806,0.887
"19686","Tarija","Entre Ríos","U.E. Yukimbia",74,0,0,6,73,3,0,0,0,156,11,5,172,196,0.468,0.878
"19687","Santa Cruz","Santa Cruz de La Sierra","Escuela Canoto",155,0,0,1,26,11,7,2,0,202,0,4,206,221,0.129,0.932
"19688","Santa Cruz","Santa Cruz de La Sierra","Escuela Canoto",141,0,0,0,28,16,5,0,0,190,2,2,194,217,0.147,0.894
"19689","Santa Cruz","Santa Cruz de La Sierra","Escuela Canoto",141,1,0,1,31,12,10,0,0,196,0,3,199,223,0.158,0.892
"19690","Santa Cruz","Santa Cruz de La Sierra","Escuela Canoto",133,0,0,0,31,12,5,0,1,182,1,2,185,214,0.17,0.864
"19691","Santa Cruz","Santa Cruz de La Sierra","Escuela Canoto",147,1,0,1,25,15,10,1,0,200,0,3,203,224,0.125,0.906
"19692","Santa Cruz","Santa Cruz de La Sierra","Escuela Canoto",134,0,0,1,28,23,5,0,0,191,1,2,194,229,0.147,0.847
"19693","Santa Cruz","Santa Cruz de La Sierra","Escuela Canoto",133,0,0,0,21,13,7,1,0,175,1,1,177,204,0.12,0.868
"19694","Santa Cruz","Santa Cruz de La Sierra","Campus Universitario",123,0,0,2,23,9,11,0,2,170,0,5,175,218,0.135,0.803
"19695","Santa Cruz","Santa Cruz de La Sierra","Campus Universitario",132,0,0,0,21,13,7,0,0,173,0,2,175,213,0.121,0.822
"19696","Santa Cruz","Santa Cruz de La Sierra","Campus Universitario",142,0,0,0,21,13,10,1,0,187,1,4,192,224,0.112,0.857
"19697","Santa Cruz","Santa Cruz de La Sierra","Campus Universitario",126,1,0,0,26,5,7,1,1,167,0,0,167,201,0.156,0.831
"19698","Santa Cruz","Santa Cruz de La Sierra","Campus Universitario",125,0,0,0,18,14,9,4,0,170,0,1,171,211,0.106,0.81
"19699","Santa Cruz","Santa Cruz de La Sierra","Campus Universitario",144,0,1,0,14,10,6,3,0,178,0,4,182,209,0.079,0.871
"19700","Santa Cruz","Santa Cruz de La Sierra","Campus Universitario",136,0,0,1,19,10,3,0,0,169,1,6,176,213,0.112,0.826
"19701","Santa Cruz","Santa Cruz de La Sierra","Campus Universitario",126,1,0,1,23,13,2,1,1,168,1,2,171,218,0.137,0.784
"19702","Santa Cruz","Santa Cruz de La Sierra","Campus Universitario",131,1,0,3,27,9,12,3,0,186,1,3,190,219,0.145,0.868
"19703","Santa Cruz","Santa Cruz de La Sierra","Campus Universitario",132,2,0,0,16,11,5,2,1,169,0,0,169,216,0.095,0.782
"19704","Santa Cruz","Santa Cruz de La Sierra","Campus Universitario",141,0,0,1,21,6,4,2,0,175,1,4,180,218,0.12,0.826
"19705","Santa Cruz","Santa Cruz de La Sierra","Campus Universitario",139,0,0,1,17,12,10,3,0,182,1,2,185,214,0.093,0.864
"19706","Santa Cruz","Santa Cruz de La Sierra","Campus Universitario",149,0,1,0,25,11,5,1,0,192,1,1,194,221,0.13,0.878
"19707","Santa Cruz","Santa Cruz de La Sierra","Campus Universitario",134,0,0,0,21,17,5,1,0,178,0,6,184,220,0.118,0.836
"19708","Santa Cruz","Santa Cruz de La Sierra","Campus Universitario",132,0,1,1,25,11,5,1,0,176,0,4,180,214,0.142,0.841
"19709","Santa Cruz","Santa Cruz de La Sierra","Colegio Castulo Chavez",155,1,1,0,19,13,8,0,0,197,0,6,203,229,0.096,0.886
"19710","Santa Cruz","Santa Cruz de La Sierra","Colegio Castulo Chavez",136,0,0,0,27,18,3,0,0,184,1,4,189,221,0.147,0.855
"19711","Santa Cruz","Santa Cruz de La Sierra","Colegio Castulo Chavez",121,0,0,1,28,13,11,1,1,176,0,4,180,217,0.159,0.829
"19712","Santa Cruz","Santa Cruz de La Sierra","Colegio Castulo Chavez",142,0,0,0,17,14,6,6,0,185,1,2,188,213,0.092,0.883
"19713","Santa Cruz","Santa Cruz de La Sierra","Colegio Castulo Chavez",130,0,0,0,17,17,11,3,2,180,1,0,181,225,0.094,0.804
"19714","Santa Cruz","Santa Cruz de La Sierra","Colegio Castulo Chavez",129,0,0,2,16,24,12,0,0,183,3,0,186,224,0.087,0.83
"19715","Santa Cruz","Santa Cruz de La Sierra","Colegio Castulo Chavez",143,0,0,0,14,16,12,2,0,187,0,2,189,221,0.075,0.855
"19716","Santa Cruz","Santa Cruz de La Sierra","Colegio Castulo Chavez",140,0,0,0,17,24,9,0,0,190,1,1,192,220,0.089,0.873
"19717","Santa Cruz","Santa Cruz de La Sierra","Colegio Castulo Chavez",135,1,0,1,17,20,5,0,1,180,0,4,184,223,0.094,0.825
"19718","Santa Cruz","Santa Cruz de La Sierra","Colegio Castulo Chavez",146,0,0,0,20,18,9,0,0,193,0,3,196,223,0.104,0.879
"19719","Santa Cruz","Santa Cruz de La Sierra","Colegio Castulo Chavez",125,0,0,2,24,18,5,0,0,174,1,4,179,212,0.138,0.844
"19720","Santa Cruz","Santa Cruz de La Sierra","Colegio Castulo Chavez",144,0,1,0,23,13,6,1,1,189,1,5,195,222,0.122,0.878
"19721","Santa Cruz","Santa Cruz de La Sierra","Col. Hnas. Arredondo (Col. Jesus Peredo)",118,0,0,2,46,20,10,1,1,198,0,27,225,225,0.232,1
"19722","Santa Cruz","Santa Cruz de La Sierra","Col. Hnas. Arredondo (Col. Jesus Peredo)",138,0,1,1,35,12,8,1,1,197,0,2,199,225,0.178,0.884
"19723","Santa Cruz","Santa Cruz de La Sierra","Col. Hnas. Arredondo (Col. Jesus Peredo)",121,0,0,1,45,14,12,0,0,193,1,4,198,226,0.233,0.876
"19724","Santa Cruz","Santa Cruz de La Sierra","Col. Hnas. Arredondo (Col. Jesus Peredo)",106,0,0,0,56,10,13,2,0,187,1,10,198,230,0.299,0.861
"19725","Santa Cruz","Santa Cruz de La Sierra","Col. Hnas. Arredondo (Col. Jesus Peredo)",135,1,0,2,24,12,15,1,0,190,0,6,196,218,0.126,0.899
"19726","Santa Cruz","Santa Cruz de La Sierra","Col. Hnas. Arredondo (Col. Jesus Peredo)",114,1,0,0,57,16,12,0,1,201,0,4,205,225,0.284,0.911
"19727","Santa Cruz","Santa Cruz de La Sierra","Col. Hnas. Arredondo (Col. Jesus Peredo)",142,0,0,1,30,8,11,2,0,194,1,5,200,224,0.155,0.893
"19728","Santa Cruz","Santa Cruz de La Sierra","Col. Hnas. Arredondo (Col. Jesus Peredo)",151,1,0,0,18,17,7,1,0,195,0,4,199,221,0.092,0.9
"19729","Santa Cruz","Santa Cruz de La Sierra","Col. Hnas. Arredondo (Col. Jesus Peredo)",124,0,1,1,54,13,8,1,1,203,3,4,210,233,0.266,0.901
"19730","Santa Cruz","Santa Cruz de La Sierra","Col. Hnas. Arredondo (Col. Jesus Peredo)",123,0,0,1,29,16,10,4,0,183,1,5,189,224,0.158,0.844
"19731","Santa Cruz","Santa Cruz de La Sierra","Col. Hnas. Arredondo (Col. Jesus Peredo)",135,1,0,1,40,12,6,0,0,195,0,3,198,218,0.205,0.908
"19732","Santa Cruz","Santa Cruz de La Sierra","Col. Hnas. Arredondo (Col. Jesus Peredo)",142,0,0,1,38,9,9,1,0,200,0,3,203,228,0.19,0.89
"19733","Santa Cruz","Santa Cruz de La Sierra","Col. Hnas. Arredondo (Col. Jesus Peredo)",119,0,0,1,37,17,11,2,1,188,1,6,195,225,0.197,0.867
"19734","Santa Cruz","Santa Cruz de La Sierra","Col. Hnas. Arredondo (Col. Jesus Peredo)",141,1,0,2,31,11,6,1,0,193,1,3,197,223,0.161,0.883
"19735","Santa Cruz","Santa Cruz de La Sierra","Col. Hnas. Arredondo (Col. Jesus Peredo)",138,0,0,1,30,16,4,0,0,189,0,1,190,224,0.159,0.848
"19736","Santa Cruz","Santa Cruz de La Sierra","Col. Hnas. Arredondo (Col. Jesus Peredo)",126,0,0,0,44,9,16,2,1,198,1,2,201,226,0.222,0.889
"19737","Santa Cruz","Santa Cruz de La Sierra","Col. Hnas. Arredondo (Col. Jesus Peredo)",134,0,3,2,43,10,8,3,2,205,1,4,210,228,0.21,0.921
"19738","Santa Cruz","Santa Cruz de La Sierra","U.E. Pastorcito De Fátima (Don Bosco)",132,1,1,1,49,13,18,1,0,216,0,8,224,238,0.227,0.941
"19739","Santa Cruz","Santa Cruz de La Sierra","U.E. Pastorcito De Fátima (Don Bosco)",128,0,0,0,55,16,15,0,0,214,1,4,219,234,0.257,0.936
"19740","Santa Cruz","Santa Cruz de La Sierra","U.E. Pastorcito De Fátima (Don Bosco)",163,0,0,0,33,15,10,1,0,222,0,1,223,234,0.149,0.953
"19741","Santa Cruz","Santa Cruz de La Sierra","Col. San Martin De Porres",92,1,0,2,66,16,13,0,1,191,2,4,197,226,0.346,0.872
"19742","Santa Cruz","Santa Cruz de La Sierra","Col. San Martin De Porres",132,0,0,1,44,12,10,2,0,201,1,1,203,229,0.219,0.886
"19743","Santa Cruz","Santa Cruz de La Sierra","Col. San Martin De Porres",114,0,0,0,53,11,13,1,0,192,0,5,197,221,0.276,0.891
"19744","Santa Cruz","Santa Cruz de La Sierra","Col. San Martin De Porres",129,0,0,2,30,13,7,1,1,183,2,4,189,223,0.164,0.848
"19745","Santa Cruz","Santa Cruz de La Sierra","Col. San Martin De Porres",104,0,0,1,62,8,15,1,0,191,0,3,194,222,0.325,0.874
"19746","Santa Cruz","Santa Cruz de La Sierra","Col. San Martin De Porres",117,0,0,0,40,10,10,2,1,180,0,7,187,220,0.222,0.85
"19747","Santa Cruz","Santa Cruz de La Sierra","Col. San Martin De Porres",92,1,0,2,59,7,26,1,1,189,3,6,198,223,0.312,0.888
"19748","Santa Cruz","Santa Cruz de La Sierra","Col. San Martin De Porres",81,0,1,0,82,12,20,1,1,198,0,2,200,225,0.414,0.889
"19749","Santa Cruz","Santa Cruz de La Sierra","Col. San Martin De Porres",121,0,0,0,49,24,6,0,0,200,1,3,204,232,0.245,0.879
"19750","Santa Cruz","Santa Cruz de La Sierra","Col. San Martin De Porres",117,1,0,1,35,12,9,2,1,178,2,6,186,222,0.197,0.838
"19751","Santa Cruz","Santa Cruz de La Sierra","Col. San Martin De Porres",119,1,0,1,39,9,16,2,0,187,1,5,193,228,0.209,0.846
"19752","Santa Cruz","Santa Cruz de La Sierra","Col. San Martin De Porres",109,0,0,0,39,23,15,2,0,188,1,8,197,230,0.207,0.857
"19753","Santa Cruz","Santa Cruz de La Sierra","Col. San Martin De Porres",118,0,1,1,47,16,7,2,0,192,0,3,195,224,0.245,0.871
"19754","Santa Cruz","Santa Cruz de La Sierra","Col. San Martin De Porres",107,0,0,0,68,5,16,0,1,197,0,6,203,226,0.345,0.898
"19755","Santa Cruz","Santa Cruz de La Sierra","Col. San Martin De Porres",115,0,0,2,68,4,12,0,1,202,0,7,209,228,0.337,0.917
"19756","Santa Cruz","Santa Cruz de La Sierra","Col. San Martin De Porres",98,1,0,1,53,15,7,0,0,175,2,6,183,222,0.303,0.824
"19757","Santa Cruz","Santa Cruz de La Sierra","Col. San Martin De Porres",75,0,0,2,91,14,20,0,0,202,0,3,205,232,0.45,0.884
"19758","Santa Cruz","Santa Cruz de La Sierra","Col. San Martin De Porres",107,0,0,1,46,16,11,0,1,182,1,14,197,228,0.253,0.864
"19759","Santa Cruz","Santa Cruz de La Sierra","Col. San Martin De Porres",130,1,0,0,48,5,15,2,0,201,1,2,204,230,0.239,0.887
"19760","Santa Cruz","Santa Cruz de La Sierra","Col. San Martin De Porres",130,0,0,0,43,17,8,1,0,199,0,9,208,227,0.216,0.916
"19761","Santa Cruz","Santa Cruz de La Sierra","Col. San Martin De Porres",103,0,0,1,47,13,14,0,0,178,2,4,184,218,0.264,0.844
"19762","Santa Cruz","Santa Cruz de La Sierra","Col. San Martin De Porres",106,0,0,2,43,19,9,3,0,182,2,9,193,225,0.236,0.858
"19763","Santa Cruz","Santa Cruz de La Sierra","Col. San Martin De Porres",142,1,0,0,28,21,6,0,0,198,1,5,204,230,0.141,0.887
"19764","Santa Cruz","Santa Cruz de La Sierra","Col. San Martin De Porres",103,3,1,0,59,15,10,1,2,194,1,3,198,224,0.304,0.884
"19765","Santa Cruz","Santa Cruz de La Sierra","Col. San Martin De Porres",97,0,0,1,68,11,16,2,0,195,0,4,199,225,0.349,0.884
"19766","Santa Cruz","Santa Cruz de La Sierra","Col. San Martin De Porres",138,1,0,0,21,13,17,1,0,191,2,4,197,225,0.11,0.876
"19767","Santa Cruz","Santa Cruz de La Sierra","Col. San Martin De Porres",122,0,0,1,34,17,10,1,0,185,0,2,187,222,0.184,0.842
"19768","Santa Cruz","Santa Cruz de La Sierra","Col. San Martin De Porres",117,0,0,0,44,16,9,0,2,188,0,5,193,221,0.234,0.873
"19769","Santa Cruz","Santa Cruz de La Sierra","Col. San Martin De Porres",129,0,0,1,36,14,12,3,1,196,1,3,200,226,0.184,0.885
"19770","Santa Cruz","Santa Cruz de La Sierra","Col. San Martin De Porres",138,0,0,0,28,21,7,1,0,195,3,2,200,224,0.144,0.893
"19771","Santa Cruz","Santa Cruz de La Sierra","Col. San Martin De Porres",112,2,0,0,39,17,7,5,2,184,0,4,188,218,0.212,0.862
"19772","Santa Cruz","Santa Cruz de La Sierra","Col. San Martin De Porres",129,0,0,0,32,13,10,1,0,185,2,5,192,228,0.173,0.842
"19773","Santa Cruz","Santa Cruz de La Sierra","Col. San Martin De Porres",128,0,1,2,42,8,12,3,0,196,0,5,201,234,0.214,0.859
"19774","Santa Cruz","Santa Cruz de La Sierra","Col. San Martin De Porres",114,0,0,0,57,14,15,5,1,206,1,5,212,243,0.277,0.872
"19775","Santa Cruz","Santa Cruz de La Sierra","Esc. Rene Barrientos",135,0,2,3,32,11,3,0,0,186,1,4,191,225,0.172,0.849
"19776","Santa Cruz","Santa Cruz de La Sierra","Esc. Rene Barrientos",133,0,2,1,32,14,10,0,0,192,1,0,193,224,0.167,0.862
"19777","Santa Cruz","Santa Cruz de La Sierra","Esc. Rene Barrientos",117,0,0,1,42,19,7,0,1,187,0,3,190,222,0.225,0.856
"19778","Santa Cruz","Santa Cruz de La Sierra","Esc. Rene Barrientos",114,1,0,1,52,4,9,1,1,183,1,4,188,218,0.284,0.862
"19779","Santa Cruz","Santa Cruz de La Sierra","Esc. Rene Barrientos",127,0,0,0,27,9,4,0,0,167,0,13,180,199,0.162,0.905
"19780","Santa Cruz","Santa Cruz de La Sierra","Esc. Rene Barrientos",137,0,0,3,30,14,8,1,0,193,1,4,198,225,0.155,0.88
"19781","Santa Cruz","Santa Cruz de La Sierra","Esc. Rene Barrientos",123,0,0,0,35,21,7,0,0,186,0,6,192,224,0.188,0.857
"19782","Santa Cruz","Santa Cruz de La Sierra","Esc. Rene Barrientos",142,0,0,0,26,9,13,0,0,190,0,3,193,223,0.137,0.865
"19783","Santa Cruz","Santa Cruz de La Sierra","Esc. Rene Barrientos",118,1,0,0,45,9,13,2,1,189,1,0,190,220,0.238,0.864
"19784","Santa Cruz","Santa Cruz de La Sierra","Esc. Rene Barrientos",149,3,0,2,19,16,4,1,0,194,0,4,198,225,0.098,0.88
"19785","Santa Cruz","Santa Cruz de La Sierra","Esc. Rene Barrientos",139,1,0,0,30,12,9,2,0,193,3,3,199,224,0.155,0.888
"19786","Santa Cruz","Santa Cruz de La Sierra","Esc. Rene Barrientos",138,0,0,0,20,18,2,0,1,179,0,0,179,210,0.112,0.852
"19787","Santa Cruz","Santa Cruz de La Sierra","Esc. Rene Barrientos",126,0,2,1,36,11,6,1,1,184,0,3,187,220,0.196,0.85
"19788","Santa Cruz","Santa Cruz de La Sierra","Esc. Rene Barrientos",135,0,1,2,25,17,14,0,1,195,0,2,197,220,0.128,0.895
"19789","Santa Cruz","Santa Cruz de La Sierra","Esc. Rene Barrientos",140,1,0,0,29,10,2,1,0,183,0,3,186,220,0.158,0.845
"19790","Santa Cruz","Santa Cruz de La Sierra","Esc. Rene Barrientos",130,0,0,0,39,14,7,1,1,192,0,2,194,223,0.203,0.87
"19791","Santa Cruz","Santa Cruz de La Sierra","Esc. Rene Barrientos",122,0,0,0,30,16,8,2,1,179,0,5,184,219,0.168,0.84
"19792","Santa Cruz","Santa Cruz de La Sierra","Col. Mirette Sciaroni",144,0,0,1,6,23,2,1,0,177,1,1,179,220,0.034,0.814
"19793","Santa Cruz","Santa Cruz de La Sierra","Col. Mirette Sciaroni",144,0,0,2,9,16,7,2,0,180,2,5,187,221,0.05,0.846
"19794","Santa Cruz","Santa Cruz de La Sierra","Col. Mirette Sciaroni",141,1,1,2,22,17,5,1,1,191,1,6,198,221,0.115,0.896
"19795","Santa Cruz","Santa Cruz de La Sierra","Col. Mirette Sciaroni",162,0,0,4,13,16,1,0,0,196,0,3,199,228,0.066,0.873
"19796","Santa Cruz","Santa Cruz de La Sierra","Col. Mirette Sciaroni",136,0,0,3,19,19,7,0,0,184,0,3,187,220,0.103,0.85
"19797","Santa Cruz","Santa Cruz de La Sierra","Col. Mirette Sciaroni",159,0,0,2,11,13,5,0,0,190,0,8,198,224,0.058,0.884
"19798","Santa Cruz","Santa Cruz de La Sierra","Col. Mirette Sciaroni",157,0,0,1,9,11,3,1,0,182,0,3,185,221,0.049,0.837
"19799","Santa Cruz","Santa Cruz de La Sierra","Col. Mirette Sciaroni",164,0,0,0,14,14,8,1,0,201,1,1,203,222,0.07,0.914
"19800","Santa Cruz","Santa Cruz de La Sierra","Col. Mirette Sciaroni",162,0,0,0,13,9,8,0,0,192,0,2,194,221,0.068,0.878
"19801","Santa Cruz","Santa Cruz de La Sierra","Col. Mirette Sciaroni",147,0,0,3,19,12,9,0,0,190,0,8,198,225,0.1,0.88
"19802","Santa Cruz","Santa Cruz de La Sierra","Col. Mirette Sciaroni",147,0,1,2,15,11,7,1,1,185,0,5,190,214,0.081,0.888
"19803","Santa Cruz","Santa Cruz de La Sierra","Esc. Aponte Tineo (Esc. Gregorio Moreno)",157,0,0,0,14,21,5,2,0,199,0,1,200,221,0.07,0.905
"19804","Santa Cruz","Santa Cruz de La Sierra","Esc. Aponte Tineo (Esc. Gregorio Moreno)",149,0,0,0,15,17,9,1,0,191,0,5,196,223,0.079,0.879
"19805","Santa Cruz","Santa Cruz de La Sierra","Esc. Aponte Tineo (Esc. Gregorio Moreno)",150,0,0,2,17,15,4,0,1,189,0,8,197,221,0.09,0.891
"19806","Santa Cruz","Santa Cruz de La Sierra","Esc. Aponte Tineo (Esc. Gregorio Moreno)",146,0,0,1,10,24,4,1,0,186,0,8,194,223,0.054,0.87
"19807","Santa Cruz","Santa Cruz de La Sierra","Esc. Aponte Tineo (Esc. Gregorio Moreno)",152,0,0,0,15,15,5,1,0,188,1,9,198,230,0.08,0.861
"19808","Santa Cruz","Santa Cruz de La Sierra","Esc. Aponte Tineo (Esc. Gregorio Moreno)",146,0,0,1,18,22,8,3,0,198,0,0,198,227,0.091,0.872
"19809","Santa Cruz","Santa Cruz de La Sierra","Esc. Aponte Tineo (Esc. Gregorio Moreno)",154,0,0,2,13,19,7,0,0,195,1,1,197,227,0.067,0.868
"19810","Santa Cruz","Santa Cruz de La Sierra","Esc. Aponte Tineo (Esc. Gregorio Moreno)",153,0,0,0,10,12,10,1,0,186,0,3,189,216,0.054,0.875
"19811","Santa Cruz","Santa Cruz de La Sierra","Esc. Aponte Tineo (Esc. Gregorio Moreno)",148,0,0,0,14,18,4,3,0,187,3,3,193,221,0.075,0.873
"19812","Santa Cruz","Santa Cruz de La Sierra","Col. La Madre",127,0,2,2,51,6,15,0,1,204,0,3,207,224,0.25,0.924
"19813","Santa Cruz","Santa Cruz de La Sierra","Col. La Madre",112,0,0,0,58,16,8,1,0,195,1,2,198,230,0.297,0.861
"19814","Santa Cruz","Santa Cruz de La Sierra","Col. La Madre",151,0,1,0,24,14,8,0,1,199,0,6,205,226,0.121,0.907
"19815","Santa Cruz","Santa Cruz de La Sierra","Col. La Madre",130,0,0,0,51,17,11,2,0,211,1,2,214,233,0.242,0.918
"19816","Santa Cruz","Santa Cruz de La Sierra","Col. La Madre",92,1,1,0,66,17,26,1,0,204,2,5,211,229,0.324,0.921
"19817","Santa Cruz","Santa Cruz de La Sierra","Col. La Madre",97,0,0,0,62,17,19,0,0,195,1,8,204,230,0.318,0.887
"19818","Santa Cruz","Santa Cruz de La Sierra","Col. La Madre",112,0,2,0,41,23,13,1,1,193,1,3,197,227,0.212,0.868
"19819","Santa Cruz","Santa Cruz de La Sierra","Col. La Madre",119,0,0,0,50,15,11,0,1,196,0,6,202,228,0.255,0.886
"19820","Santa Cruz","Santa Cruz de La Sierra","Col. La Madre",99,0,1,0,45,11,22,0,4,182,1,10,193,227,0.247,0.85
"19821","Santa Cruz","Santa Cruz de La Sierra","Col. La Madre",109,0,0,0,42,17,18,1,2,189,0,9,198,227,0.222,0.872
"19822","Santa Cruz","Santa Cruz de La Sierra","Col. La Madre",108,1,0,0,64,12,15,0,1,201,1,6,208,230,0.318,0.904
"19823","Santa Cruz","Santa Cruz de La Sierra","Col. La Madre",118,0,1,2,34,17,20,0,1,193,1,3,197,226,0.176,0.872
"19824","Santa Cruz","Santa Cruz de La Sierra","Col. La Madre",119,0,0,0,55,10,10,1,1,196,1,7,204,227,0.281,0.899
"19825","Santa Cruz","Santa Cruz de La Sierra","Col. La Madre",127,0,0,1,46,17,9,0,0,200,1,3,204,224,0.23,0.911
"19826","Santa Cruz","Santa Cruz de La Sierra","Col. La Madre",134,2,0,3,35,20,13,2,0,209,0,4,213,229,0.167,0.93
"19827","Santa Cruz","Santa Cruz de La Sierra","Col. La Madre",100,1,1,0,65,15,19,1,1,203,0,7,210,229,0.32,0.917
"19828","Santa Cruz","Santa Cruz de La Sierra","Col. La Madre",129,0,0,0,42,12,9,1,1,194,1,8,203,231,0.216,0.879
"19829","Santa Cruz","Santa Cruz de La Sierra","Col. La Madre",145,1,0,1,31,13,13,0,0,204,0,7,211,229,0.152,0.921
"19830","Santa Cruz","Santa Cruz de La Sierra","Col. La Madre",124,0,2,0,32,17,13,1,0,189,0,5,194,219,0.169,0.886
"19831","Santa Cruz","Santa Cruz de La Sierra","Col. La Madre",122,0,0,0,51,10,17,2,2,204,0,2,206,228,0.25,0.904
"19832","Santa Cruz","Santa Cruz de La Sierra","Col. La Madre",129,0,0,2,40,14,11,3,1,200,2,5,207,230,0.2,0.9
"19833","Santa Cruz","Santa Cruz de La Sierra","Col. La Madre",117,0,0,1,64,11,18,2,0,213,2,1,216,243,0.3,0.889
"19834","Santa Cruz","Santa Cruz de La Sierra","Gladys Rivero De Jimenez",126,0,0,0,43,13,8,4,2,196,0,6,202,230,0.219,0.878
"19835","Santa Cruz","Santa Cruz de La Sierra","Gladys Rivero De Jimenez",105,0,0,0,60,14,11,0,1,191,0,6,197,225,0.314,0.876
"19836","Santa Cruz","Santa Cruz de La Sierra","Gladys Rivero De Jimenez",121,1,1,0,51,11,10,2,0,197,0,4,201,226,0.259,0.889
"19837","Santa Cruz","Santa Cruz de La Sierra","Gladys Rivero De Jimenez",91,0,0,1,58,19,30,0,0,199,0,8,207,228,0.291,0.908
"19838","Santa Cruz","Santa Cruz de La Sierra","Gladys Rivero De Jimenez",121,0,2,2,39,16,10,0,1,191,3,6,200,228,0.204,0.877
"19839","Santa Cruz","Santa Cruz de La Sierra","Gladys Rivero De Jimenez",99,0,3,1,47,13,16,1,1,181,2,16,199,227,0.26,0.877
"19840","Santa Cruz","Santa Cruz de La Sierra","Gladys Rivero De Jimenez",104,0,3,4,54,13,11,3,2,194,2,9,205,228,0.278,0.899
"19841","Santa Cruz","Santa Cruz de La Sierra","Gladys Rivero De Jimenez",116,0,0,0,41,15,18,5,1,196,2,6,204,229,0.209,0.891
"19842","Santa Cruz","Santa Cruz de La Sierra","Gladys Rivero De Jimenez",111,0,1,0,51,16,19,4,0,202,0,8,210,235,0.252,0.894
"19843","Santa Cruz","Santa Cruz de La Sierra","Gladys Rivero De Jimenez",138,0,1,2,27,20,8,2,0,198,2,6,206,228,0.136,0.904
"19844","Santa Cruz","Santa Cruz de La Sierra","Gladys Rivero De Jimenez",126,0,1,0,42,21,7,1,0,198,1,3,202,225,0.212,0.898
"19845","Santa Cruz","Santa Cruz de La Sierra","Gladys Rivero De Jimenez",132,0,0,2,24,23,11,1,0,193,2,9,204,225,0.124,0.907
"19846","Santa Cruz","Santa Cruz de La Sierra","Gladys Rivero De Jimenez",119,0,0,1,55,13,10,0,0,198,0,6,204,225,0.278,0.907
"19847","Santa Cruz","Santa Cruz de La Sierra","Gladys Rivero De Jimenez",122,0,0,1,29,24,21,0,0,197,0,9,206,227,0.147,0.907
"19848","Santa Cruz","Santa Cruz de La Sierra","Gladys Rivero De Jimenez",126,0,0,1,37,22,11,0,1,198,1,5,204,230,0.187,0.887
"19849","Santa Cruz","Santa Cruz de La Sierra","Gladys Rivero De Jimenez",137,0,1,0,44,18,9,1,0,210,0,1,211,232,0.21,0.909
"19850","Santa Cruz","Santa Cruz de La Sierra","Gladys Rivero De Jimenez",126,0,1,3,36,10,18,0,2,196,1,5,202,221,0.184,0.914
"19851","Santa Cruz","Santa Cruz de La Sierra","Esc. Bernardo Cadario(Col.Kurt Richter)",138,0,0,1,18,20,7,0,0,184,1,3,188,225,0.098,0.836
"19852","Santa Cruz","Santa Cruz de La Sierra","Esc. Bernardo Cadario(Col.Kurt Richter)",130,0,0,1,27,18,9,1,0,186,3,6,195,221,0.145,0.882
"19853","Santa Cruz","Santa Cruz de La Sierra","Esc. Bernardo Cadario(Col.Kurt Richter)",128,0,1,1,31,21,8,2,1,193,2,4,199,228,0.161,0.873
"19854","Santa Cruz","Santa Cruz de La Sierra","Esc. Bernardo Cadario(Col.Kurt Richter)",130,0,1,1,29,17,11,0,0,189,3,7,199,226,0.153,0.881
"19855","Santa Cruz","Santa Cruz de La Sierra","Esc. Bernardo Cadario(Col.Kurt Richter)",133,0,0,1,33,13,7,0,0,187,1,5,193,220,0.176,0.877
"19856","Santa Cruz","Santa Cruz de La Sierra","Esc. Bernardo Cadario(Col.Kurt Richter)",114,0,2,1,37,20,15,1,0,190,0,8,198,222,0.195,0.892
"19857","Santa Cruz","Santa Cruz de La Sierra","Esc. Bernardo Cadario(Col.Kurt Richter)",137,0,0,1,22,21,3,0,1,185,2,3,190,227,0.119,0.837
"19858","Santa Cruz","Santa Cruz de La Sierra","Esc. Bernardo Cadario(Col.Kurt Richter)",119,0,1,2,39,23,3,0,0,187,1,5,193,222,0.209,0.869
"19859","Santa Cruz","Santa Cruz de La Sierra","Esc. Bernardo Cadario(Col.Kurt Richter)",124,0,0,1,36,15,4,0,0,180,0,6,186,220,0.2,0.845
"19860","Santa Cruz","Santa Cruz de La Sierra","Esc. Bernardo Cadario(Col.Kurt Richter)",140,0,1,1,28,17,9,0,0,196,2,2,200,223,0.143,0.897
"19861","Santa Cruz","Santa Cruz de La Sierra","Esc. Bernardo Cadario(Col.Kurt Richter)",129,0,0,0,26,15,14,1,0,185,0,2,187,224,0.141,0.835
"19862","Santa Cruz","Santa Cruz de La Sierra","Esc. Bernardo Cadario(Col.Kurt Richter)",132,0,0,3,22,25,8,0,2,192,2,2,196,224,0.115,0.875
"19863","Santa Cruz","Santa Cruz de La Sierra","Esc. Bernardo Cadario(Col.Kurt Richter)",142,0,0,0,30,19,7,0,0,198,0,4,202,222,0.152,0.91
"19864","Santa Cruz","Santa Cruz de La Sierra","Esc. Bernardo Cadario(Col.Kurt Richter)",140,0,1,0,28,19,7,3,0,198,0,2,200,228,0.141,0.877
"19865","Santa Cruz","Santa Cruz de La Sierra","Esc. Bernardo Cadario(Col.Kurt Richter)",140,0,0,1,20,16,12,0,0,189,1,6,196,226,0.106,0.867
"19866","Santa Cruz","Santa Cruz de La Sierra","Modulo Educativo Jose Miguel De Velasco",164,1,0,2,13,17,4,0,1,202,2,4,208,226,0.064,0.92
"19867","Santa Cruz","Santa Cruz de La Sierra","Modulo Educativo Jose Miguel De Velasco",157,0,0,2,16,17,4,0,0,196,0,5,201,229,0.082,0.878
"19868","Santa Cruz","Santa Cruz de La Sierra","Modulo Educativo Jose Miguel De Velasco",137,0,0,0,27,18,7,1,0,190,1,5,196,222,0.142,0.883
"19869","Santa Cruz","Santa Cruz de La Sierra","Modulo Educativo Jose Miguel De Velasco",150,0,0,0,23,10,10,0,0,193,0,4,197,224,0.119,0.879
"19870","Santa Cruz","Santa Cruz de La Sierra","Modulo Educativo Jose Miguel De Velasco",136,0,0,1,40,16,8,1,2,204,1,3,208,225,0.196,0.924
"19871","Santa Cruz","Santa Cruz de La Sierra","Modulo Educativo Jose Miguel De Velasco",132,0,1,0,30,14,12,1,2,192,0,6,198,226,0.156,0.876
"19872","Santa Cruz","Santa Cruz de La Sierra","Modulo Educativo Jose Miguel De Velasco",131,0,0,0,33,18,7,0,0,189,1,7,197,226,0.175,0.872
"19873","Santa Cruz","Santa Cruz de La Sierra","Modulo Educativo Jose Miguel De Velasco",136,0,0,0,15,21,9,1,2,184,0,2,186,216,0.082,0.861
"19874","Santa Cruz","Santa Cruz de La Sierra","Modulo Educativo Jose Miguel De Velasco",152,0,0,1,25,15,5,0,1,199,1,2,202,223,0.126,0.906
"19875","Santa Cruz","Santa Cruz de La Sierra","Modulo Educativo Jose Miguel De Velasco",162,0,0,0,17,15,3,0,0,197,0,3,200,225,0.086,0.889
"19876","Santa Cruz","Santa Cruz de La Sierra","Modulo Educativo Jose Miguel De Velasco",116,0,1,0,44,15,9,0,0,185,2,2,189,222,0.238,0.851
"19877","Santa Cruz","Santa Cruz de La Sierra","Modulo Educativo Jose Miguel De Velasco",146,0,1,1,18,10,10,2,0,188,1,1,190,226,0.096,0.841
"19878","Santa Cruz","Santa Cruz de La Sierra","Modulo Educativo Jose Miguel De Velasco",140,0,0,0,21,16,8,3,1,189,0,3,192,223,0.111,0.861
"19879","Santa Cruz","Santa Cruz de La Sierra","Modulo Educativo Jose Miguel De Velasco",152,0,0,4,16,13,4,1,0,190,2,5,197,224,0.084,0.879
"19880","Santa Cruz","Santa Cruz de La Sierra","Modulo Educativo Jose Miguel De Velasco",137,2,2,2,24,18,10,2,0,197,0,1,198,225,0.122,0.88
"19881","Santa Cruz","Santa Cruz de La Sierra","Modulo Educativo Jose Miguel De Velasco",137,0,0,0,23,12,8,0,0,180,2,4,186,220,0.128,0.845
"19882","Santa Cruz","Santa Cruz de La Sierra","Modulo Educativo Jose Miguel De Velasco",143,0,0,0,22,21,6,0,0,192,0,2,194,224,0.115,0.866
"19883","Santa Cruz","Santa Cruz de La Sierra","Modulo Educativo Jose Miguel De Velasco",141,0,0,0,20,19,7,0,1,188,1,7,196,218,0.106,0.899
"19884","Santa Cruz","Santa Cruz de La Sierra","Modulo Educativo Jose Miguel De Velasco",149,0,0,0,14,15,7,1,0,186,2,9,197,221,0.075,0.891
"19885","Santa Cruz","Santa Cruz de La Sierra","Modulo Educativo Jose Miguel De Velasco",147,0,0,0,20,18,5,0,0,190,2,8,200,221,0.105,0.905
"19886","Santa Cruz","Santa Cruz de La Sierra","Modulo Educativo Jose Miguel De Velasco",146,0,0,3,26,17,8,0,0,200,1,3,204,227,0.13,0.899
"19887","Santa Cruz","Santa Cruz de La Sierra","Modulo Educativo Jose Miguel De Velasco",138,0,0,2,28,10,5,0,1,184,0,2,186,221,0.152,0.842
"19888","Santa Cruz","Santa Cruz de La Sierra","Escuela San Carlos",141,0,0,0,25,13,4,0,0,183,2,4,189,223,0.137,0.848
"19889","Santa Cruz","Santa Cruz de La Sierra","Escuela San Carlos",145,1,1,0,15,14,10,0,0,186,0,6,192,224,0.081,0.857
"19890","Santa Cruz","Santa Cruz de La Sierra","Escuela San Carlos",147,0,0,2,21,11,9,4,0,194,0,5,199,226,0.108,0.881
"19891","Santa Cruz","Santa Cruz de La Sierra","Escuela San Carlos",130,0,0,0,32,19,1,0,1,183,1,5,189,215,0.175,0.879
"19892","Santa Cruz","Santa Cruz de La Sierra","Escuela San Carlos",129,0,0,2,22,20,11,0,0,184,0,3,187,214,0.12,0.874
"19893","Santa Cruz","Santa Cruz de La Sierra","Escuela San Carlos",142,0,0,0,18,20,7,1,1,189,1,4,194,227,0.095,0.855
"19894","Santa Cruz","Santa Cruz de La Sierra","Escuela San Carlos",146,0,0,0,20,20,7,1,0,194,2,3,199,224,0.103,0.888
"19895","Santa Cruz","Santa Cruz de La Sierra","Escuela San Carlos",138,0,0,1,28,13,10,2,0,192,0,3,195,226,0.146,0.863
"19896","Santa Cruz","Santa Cruz de La Sierra","Escuela San Carlos",143,0,0,2,25,18,9,0,0,197,0,3,200,228,0.127,0.877
"19897","Santa Cruz","Santa Cruz de La Sierra","Escuela San Carlos",141,0,0,1,13,21,7,1,0,184,0,7,191,223,0.071,0.857
"19898","Santa Cruz","Santa Cruz de La Sierra","Escuela San Carlos",167,0,0,0,20,7,3,0,0,197,0,6,203,225,0.102,0.902
"19899","Santa Cruz","Santa Cruz de La Sierra","Escuela San Carlos",159,0,0,1,13,16,5,1,1,196,1,3,200,224,0.066,0.893
"19900","Santa Cruz","Santa Cruz de La Sierra","Escuela San Carlos",140,0,0,1,18,20,5,0,0,184,2,1,187,219,0.098,0.854
"19901","Santa Cruz","Santa Cruz de La Sierra","Escuela San Carlos",143,0,0,0,21,20,6,0,0,190,0,8,198,225,0.111,0.88
"19902","Santa Cruz","Santa Cruz de La Sierra","Escuela San Carlos",117,0,0,0,23,11,5,1,1,158,1,2,161,184,0.146,0.875
"19903","Santa Cruz","Santa Cruz de La Sierra","Esc. Villa Norte",154,0,0,0,23,10,8,2,0,197,1,5,203,226,0.117,0.898
"19904","Santa Cruz","Santa Cruz de La Sierra","Esc. Villa Norte",146,0,0,1,32,13,13,1,0,206,1,1,208,227,0.155,0.916
"19905","Santa Cruz","Santa Cruz de La Sierra","Esc. Villa Norte",139,1,0,0,27,12,8,0,0,187,0,2,189,219,0.144,0.863
"19906","Santa Cruz","Santa Cruz de La Sierra","Esc. Villa Norte",138,0,0,3,33,13,5,1,0,193,1,6,200,223,0.171,0.897
"19907","Santa Cruz","Santa Cruz de La Sierra","Esc. Villa Norte",157,0,0,1,21,19,3,0,0,201,1,1,203,223,0.104,0.91
"19908","Santa Cruz","Santa Cruz de La Sierra","Esc. Villa Norte",144,1,0,1,22,19,4,0,0,191,0,5,196,228,0.115,0.86
"19909","Santa Cruz","Santa Cruz de La Sierra","Esc. Villa Norte",139,0,1,0,30,16,7,3,1,197,0,4,201,225,0.152,0.893
"19910","Santa Cruz","Santa Cruz de La Sierra","Esc. Villa Norte",136,0,0,0,25,21,1,1,0,184,1,3,188,213,0.136,0.883
"19911","Santa Cruz","Santa Cruz de La Sierra","Col. Virgen De Cotoca",130,0,0,2,25,17,4,4,1,183,0,2,185,222,0.137,0.833
"19912","Santa Cruz","Santa Cruz de La Sierra","Col. Virgen De Cotoca",150,0,0,2,21,19,9,0,0,201,0,3,204,226,0.104,0.903
"19913","Santa Cruz","Santa Cruz de La Sierra","Col. Virgen De Cotoca",138,1,0,0,39,11,5,0,2,196,0,4,200,222,0.199,0.901
"19914","Santa Cruz","Santa Cruz de La Sierra","Col. Virgen De Cotoca",138,0,0,1,38,14,7,2,0,200,2,3,205,221,0.19,0.928
"19915","Santa Cruz","Santa Cruz de La Sierra","Col. Virgen De Cotoca",144,0,0,1,21,17,6,1,0,190,2,2,194,222,0.111,0.874
"19916","Santa Cruz","Santa Cruz de La Sierra","Col. Virgen De Cotoca",151,0,0,0,15,16,7,0,1,190,2,3,195,222,0.079,0.878
"19917","Santa Cruz","Santa Cruz de La Sierra","Col. Virgen De Cotoca",156,0,0,0,16,22,3,1,0,198,1,3,202,226,0.081,0.894
"19918","Santa Cruz","Santa Cruz de La Sierra","Col. Virgen De Cotoca",146,0,0,2,21,21,9,3,0,202,0,3,205,227,0.104,0.903
"19919","Santa Cruz","Santa Cruz de La Sierra","Col. Virgen De Cotoca",149,0,0,1,15,13,3,2,0,183,4,1,188,222,0.082,0.847
"19920","Santa Cruz","Santa Cruz de La Sierra","Col. Virgen De Cotoca",137,0,0,0,16,18,13,5,0,189,0,3,192,226,0.085,0.85
"19921","Santa Cruz","Santa Cruz de La Sierra","Col. Virgen De Cotoca",163,1,0,2,17,17,4,1,0,205,0,6,211,224,0.083,0.942
"19922","Santa Cruz","Santa Cruz de La Sierra","Col. Virgen De Cotoca",130,0,0,1,36,19,10,1,0,197,0,6,203,230,0.183,0.883
"19923","Santa Cruz","Santa Cruz de La Sierra","Col. Virgen De Cotoca",153,0,0,3,19,19,7,1,0,202,0,2,204,230,0.094,0.887
"19924","Santa Cruz","Santa Cruz de La Sierra","Col. Virgen De Cotoca",145,0,0,2,14,21,11,2,0,195,2,7,204,223,0.072,0.915
"19925","Santa Cruz","Santa Cruz de La Sierra","Col. Virgen De Cotoca",142,0,1,0,16,19,7,2,0,187,1,6,194,218,0.086,0.89
"19926","Santa Cruz","Santa Cruz de La Sierra","Col. Virgen De Cotoca",130,1,0,2,15,10,12,1,0,171,1,5,177,198,0.088,0.894
"19927","Santa Cruz","Santa Cruz de La Sierra","Unidad Educativa San Jorge Norte",145,0,0,0,28,20,13,3,0,209,0,3,212,229,0.134,0.926
"19928","Santa Cruz","Santa Cruz de La Sierra","Unidad Educativa San Jorge Norte",149,0,0,2,28,17,7,1,1,205,0,2,207,230,0.137,0.9
"19929","Santa Cruz","Santa Cruz de La Sierra","Unidad Educativa San Jorge Norte",121,0,0,0,30,19,7,2,0,179,2,5,186,220,0.168,0.845
"19930","Santa Cruz","Santa Cruz de La Sierra","Unidad Educativa San Jorge Norte",146,0,0,2,30,16,10,0,0,204,0,5,209,224,0.147,0.933
"19931","Santa Cruz","Santa Cruz de La Sierra","Unidad Educativa San Jorge Norte",154,1,0,0,19,13,6,1,0,194,4,8,206,231,0.098,0.892
"19932","Santa Cruz","Santa Cruz de La Sierra","Unidad Educativa San Jorge Norte",141,0,0,1,25,14,9,0,2,192,0,7,199,227,0.13,0.877
"19933","Santa Cruz","Santa Cruz de La Sierra","Unidad Educativa San Jorge Norte",134,0,0,0,24,25,8,1,0,192,0,9,201,229,0.125,0.878
"19934","Santa Cruz","Santa Cruz de La Sierra","Unidad Educativa San Jorge Norte",152,1,1,0,17,17,8,0,0,196,0,4,200,224,0.087,0.893
"19935","Santa Cruz","Santa Cruz de La Sierra","Unidad Educativa San Jorge Norte",136,1,0,0,29,14,9,0,0,189,0,4,193,226,0.153,0.854
"19936","Santa Cruz","Santa Cruz de La Sierra","Unidad Educativa San Jorge Norte",137,0,0,0,24,22,5,0,0,188,1,6,195,220,0.128,0.886
"19937","Santa Cruz","Santa Cruz de La Sierra","Unidad Educativa San Jorge Norte",140,0,0,0,21,21,7,1,1,191,0,6,197,230,0.11,0.857
"19938","Santa Cruz","Santa Cruz de La Sierra","U.E. Santa Ana",169,0,0,0,20,13,11,2,0,215,2,6,223,238,0.093,0.937
"19939","Santa Cruz","Santa Cruz de La Sierra","U.E. Santa Ana",158,0,0,0,23,19,12,1,1,214,2,6,222,233,0.107,0.953
"19940","Santa Cruz","Santa Cruz de La Sierra","Esc. German Busch",144,0,0,0,17,13,9,2,0,185,0,6,191,227,0.092,0.841
"19941","Santa Cruz","Santa Cruz de La Sierra","Esc. German Busch",161,2,0,1,15,14,2,1,0,196,2,8,206,228,0.077,0.904
"19942","Santa Cruz","Santa Cruz de La Sierra","Esc. German Busch",145,0,0,0,26,17,8,0,2,198,0,3,201,225,0.131,0.893
"19943","Santa Cruz","Santa Cruz de La Sierra","Esc. German Busch",148,0,0,0,21,12,5,0,0,186,0,5,191,222,0.113,0.86
"19944","Santa Cruz","Santa Cruz de La Sierra","Esc. German Busch",157,0,0,2,16,22,4,0,0,201,1,4,206,231,0.08,0.892
"19945","Santa Cruz","Santa Cruz de La Sierra","Esc. German Busch",141,0,0,1,16,17,7,0,0,182,1,7,190,217,0.088,0.876
"19946","Santa Cruz","Santa Cruz de La Sierra","Esc. German Busch",154,0,0,1,16,15,9,0,0,195,1,5,201,229,0.082,0.878
"19947","Santa Cruz","Santa Cruz de La Sierra","Esc. German Busch",143,0,0,0,29,20,8,0,2,202,1,5,208,226,0.144,0.92
"19948","Santa Cruz","Santa Cruz de La Sierra","Esc. German Busch",135,0,0,1,28,17,4,0,1,186,3,9,198,221,0.151,0.896
"19949","Santa Cruz","Santa Cruz de La Sierra","Esc. German Busch",138,0,0,4,18,23,13,2,0,198,1,1,200,227,0.091,0.881
"19950","Santa Cruz","Santa Cruz de La Sierra","Esc. German Busch",150,0,0,0,20,16,9,2,0,197,3,1,201,226,0.102,0.889
"19951","Santa Cruz","Santa Cruz de La Sierra","Esc. German Busch",143,0,0,0,23,19,7,4,0,196,1,7,204,227,0.117,0.899
"19952","Santa Cruz","Santa Cruz de La Sierra","Esc. German Busch",136,1,0,0,21,25,7,0,0,190,0,7,197,224,0.111,0.879
"19953","Santa Cruz","Santa Cruz de La Sierra","Naciones Unidas",139,1,0,1,21,18,11,1,0,192,2,4,198,224,0.109,0.884
"19954","Santa Cruz","Santa Cruz de La Sierra","Naciones Unidas",133,1,1,2,23,23,7,0,0,190,1,3,194,225,0.121,0.862
"19955","Santa Cruz","Santa Cruz de La Sierra","Naciones Unidas",127,1,1,1,33,18,9,1,1,192,4,3,199,225,0.172,0.884
"19956","Santa Cruz","Santa Cruz de La Sierra","Naciones Unidas",125,1,1,0,27,18,10,0,1,183,2,6,191,218,0.148,0.876
"19957","Santa Cruz","Santa Cruz de La Sierra","Naciones Unidas",107,0,0,0,53,19,16,1,0,196,1,4,201,227,0.27,0.885
"19958","Santa Cruz","Santa Cruz de La Sierra","Naciones Unidas",123,0,0,3,36,20,11,0,0,193,3,4,200,224,0.187,0.893
"19959","Santa Cruz","Santa Cruz de La Sierra","Naciones Unidas",123,0,1,0,34,18,7,0,1,184,1,13,198,230,0.185,0.861
"19960","Santa Cruz","Santa Cruz de La Sierra","Naciones Unidas",117,0,0,0,36,16,19,0,1,189,1,4,194,218,0.19,0.89
"19961","Santa Cruz","Santa Cruz de La Sierra","Naciones Unidas",119,0,0,1,32,16,19,1,0,188,0,6,194,227,0.17,0.855
"19962","Santa Cruz","Santa Cruz de La Sierra","Naciones Unidas",155,0,1,1,21,15,4,0,0,197,0,3,200,224,0.107,0.893
"19963","Santa Cruz","Santa Cruz de La Sierra","Naciones Unidas",131,1,0,4,22,12,11,3,0,184,1,10,195,224,0.12,0.871
"19964","Santa Cruz","Santa Cruz de La Sierra","Naciones Unidas",140,0,1,0,25,22,9,1,0,198,1,6,205,231,0.126,0.887
"19965","Santa Cruz","Santa Cruz de La Sierra","Naciones Unidas",125,0,0,1,39,12,8,3,0,188,2,11,201,231,0.207,0.87
"19966","Santa Cruz","Santa Cruz de La Sierra","Naciones Unidas",123,2,0,3,15,17,17,1,1,179,2,8,189,217,0.084,0.871
"19967","Santa Cruz","Santa Cruz de La Sierra","Naciones Unidas",117,0,0,2,33,19,19,4,0,194,3,1,198,229,0.17,0.865
"19968","Santa Cruz","Santa Cruz de La Sierra","Naciones Unidas",130,0,0,0,21,20,12,0,0,183,2,6,191,223,0.115,0.857
"19969","Santa Cruz","Santa Cruz de La Sierra","Naciones Unidas",141,0,0,4,31,18,3,0,0,197,0,3,200,228,0.157,0.877
"19970","Santa Cruz","Santa Cruz de La Sierra","Naciones Unidas",95,0,0,2,31,15,18,0,0,161,0,1,162,188,0.193,0.862
"19971","Santa Cruz","Santa Cruz de La Sierra","Modulo Educativo German Busch",162,0,2,0,21,17,11,0,0,213,1,6,220,236,0.099,0.932
"19972","Santa Cruz","Santa Cruz de La Sierra","Modulo Educativo German Busch",154,2,0,0,31,26,9,0,0,222,0,2,224,236,0.14,0.949
"19973","Santa Cruz","Santa Cruz de La Sierra","Modulo Educativo German Busch",132,0,0,0,16,13,8,0,0,169,1,2,172,193,0.095,0.891
"19974","Santa Cruz","Santa Cruz de La Sierra","Col. 7 de Septiembre",135,0,0,1,19,11,14,0,0,180,0,4,184,211,0.106,0.872
"19975","Santa Cruz","Santa Cruz de La Sierra","Col. 7 de Septiembre",123,0,0,0,14,13,14,2,0,166,0,6,172,213,0.084,0.808
"19976","Santa Cruz","Santa Cruz de La Sierra","Col. 7 de Septiembre",140,0,0,0,21,10,17,0,0,188,0,3,191,223,0.112,0.857
"19977","Santa Cruz","Santa Cruz de La Sierra","Col. 7 de Septiembre",106,0,0,3,31,12,17,2,0,171,2,1,174,206,0.181,0.845
"19978","Santa Cruz","Santa Cruz de La Sierra","Col. 7 de Septiembre",121,0,1,0,16,12,12,0,0,162,1,5,168,198,0.099,0.848
"19979","Santa Cruz","Santa Cruz de La Sierra","Col. 7 de Septiembre",128,0,0,0,20,14,12,0,0,174,1,2,177,212,0.115,0.835
"19980","Santa Cruz","Santa Cruz de La Sierra","Col. 7 de Septiembre",144,0,1,2,20,10,10,0,0,187,1,3,191,213,0.107,0.897
"19981","Santa Cruz","Santa Cruz de La Sierra","Col. 7 de Septiembre",102,0,0,2,32,10,16,3,0,165,1,12,178,205,0.194,0.868
"19982","Santa Cruz","Santa Cruz de La Sierra","Col. 7 de Septiembre",122,0,0,3,19,13,12,1,0,170,2,6,178,215,0.112,0.828
"19983","Santa Cruz","Santa Cruz de La Sierra","Col. 7 de Septiembre",119,1,1,0,36,13,14,0,0,184,1,5,190,218,0.196,0.872
"19984","Santa Cruz","Santa Cruz de La Sierra","Col. 7 de Septiembre",130,3,0,0,24,16,4,1,1,179,1,5,185,212,0.134,0.873
"19985","Santa Cruz","Santa Cruz de La Sierra","Col. 7 de Septiembre",126,0,0,1,30,13,10,0,1,181,0,4,185,217,0.166,0.853
"19986","Santa Cruz","Santa Cruz de La Sierra","Col. 7 de Septiembre",123,0,0,0,20,11,8,1,0,163,3,3,169,219,0.123,0.772
"19987","Santa Cruz","Santa Cruz de La Sierra","Col. 7 de Septiembre",116,0,1,1,24,22,12,3,1,180,1,3,184,215,0.133,0.856
"19988","Santa Cruz","Santa Cruz de La Sierra","Col. 7 de Septiembre",123,0,0,0,37,18,9,0,0,187,0,2,189,223,0.198,0.848
"19989","Santa Cruz","Santa Cruz de La Sierra","Esc. Real America (Esc. F. Florida)",130,0,0,1,27,21,6,2,3,190,1,5,196,228,0.142,0.86
"19990","Santa Cruz","Santa Cruz de La Sierra","Esc. Real America (Esc. F. Florida)",139,0,1,0,31,15,8,1,1,196,1,5,202,226,0.158,0.894
"19991","Santa Cruz","Santa Cruz de La Sierra","Esc. Real America (Esc. F. Florida)",127,1,0,2,30,16,11,2,0,189,1,8,198,221,0.159,0.896
"19992","Santa Cruz","Santa Cruz de La Sierra","Esc. Real America (Esc. F. Florida)",136,0,0,0,28,17,10,1,0,192,1,2,195,227,0.146,0.859
"19993","Santa Cruz","Santa Cruz de La Sierra","Esc. Real America (Esc. F. Florida)",136,0,0,0,30,17,16,1,1,201,1,1,203,228,0.149,0.89
"19994","Santa Cruz","Santa Cruz de La Sierra","Esc. Real America (Esc. F. Florida)",125,1,2,2,35,19,10,2,0,196,2,6,204,224,0.179,0.911
"19995","Santa Cruz","Santa Cruz de La Sierra","Esc. Real America (Esc. F. Florida)",151,1,0,2,26,11,8,2,1,202,1,7,210,230,0.129,0.913
"19996","Santa Cruz","Santa Cruz de La Sierra","Esc. Real America (Esc. F. Florida)",153,0,0,0,29,11,6,0,0,199,1,4,204,225,0.146,0.907
"19997","Santa Cruz","Santa Cruz de La Sierra","Esc. Real America (Esc. F. Florida)",140,0,0,0,29,30,8,3,0,210,2,4,216,231,0.138,0.935
"19998","Santa Cruz","Santa Cruz de La Sierra","U.E. 18 de Noviembre",157,0,0,0,32,16,19,0,0,224,2,4,230,238,0.143,0.966
"19999","Santa Cruz","Santa Cruz de La Sierra","U.E. 18 de Noviembre",123,0,0,2,28,16,21,0,1,191,2,3,196,201,0.147,0.975
"20000","Santa Cruz","Santa Cruz de La Sierra","Esc. Claracuta",155,1,0,0,21,13,9,0,0,199,1,8,208,232,0.106,0.897
"20001","Santa Cruz","Santa Cruz de La Sierra","Esc. Claracuta",155,0,0,0,19,18,9,0,0,201,0,6,207,228,0.095,0.908
"20002","Santa Cruz","Santa Cruz de La Sierra","Esc. Claracuta",120,0,0,0,37,18,14,2,3,194,2,8,204,225,0.191,0.907
"20003","Santa Cruz","Santa Cruz de La Sierra","Esc. Claracuta",159,0,0,0,20,17,5,1,0,202,0,7,209,231,0.099,0.905
"20004","Santa Cruz","Santa Cruz de La Sierra","Esc. Claracuta",154,0,1,1,36,10,3,1,0,206,2,3,211,230,0.175,0.917
"20005","Santa Cruz","Santa Cruz de La Sierra","Esc. Claracuta",140,0,0,1,29,16,9,0,0,195,3,7,205,228,0.149,0.899
"20006","Santa Cruz","Santa Cruz de La Sierra","Esc. Claracuta",144,0,0,2,40,15,6,1,0,208,1,6,215,229,0.192,0.939
"20007","Santa Cruz","Santa Cruz de La Sierra","Esc. Claracuta",146,0,0,0,27,15,10,0,0,198,2,5,205,229,0.136,0.895
"20008","Santa Cruz","Santa Cruz de La Sierra","Esc. Claracuta",153,1,0,1,24,15,5,2,0,201,1,11,213,231,0.119,0.922
"20009","Santa Cruz","Santa Cruz de La Sierra","Esc. Claracuta",142,0,2,2,26,14,5,0,0,191,3,7,201,226,0.136,0.889
"20010","Santa Cruz","Santa Cruz de La Sierra","Esc. Claracuta",159,0,1,1,21,14,3,0,1,200,0,6,206,229,0.105,0.9
"20011","Santa Cruz","Santa Cruz de La Sierra","Esc. Claracuta",153,2,0,0,32,15,1,1,0,204,0,10,214,230,0.157,0.93
"20012","Santa Cruz","Santa Cruz de La Sierra","Col. Luz Y Saber II",135,0,0,1,30,11,8,0,1,186,0,8,194,227,0.161,0.855
"20013","Santa Cruz","Santa Cruz de La Sierra","Col. Luz Y Saber II",114,0,1,0,39,18,3,2,0,177,2,6,185,220,0.22,0.841
"20014","Santa Cruz","Santa Cruz de La Sierra","Col. Luz Y Saber II",145,0,0,0,31,16,6,0,2,200,1,5,206,233,0.155,0.884
"20015","Santa Cruz","Santa Cruz de La Sierra","Col. Luz Y Saber II",122,0,0,4,41,16,9,0,1,193,3,9,205,231,0.212,0.887
"20016","Santa Cruz","Santa Cruz de La Sierra","Col. Luz Y Saber II",147,0,0,0,35,9,12,1,3,207,1,7,215,232,0.169,0.927
"20017","Santa Cruz","Santa Cruz de La Sierra","Col. Luz Y Saber II",123,0,0,0,27,26,7,0,1,184,0,7,191,226,0.147,0.845
"20018","Santa Cruz","Santa Cruz de La Sierra","Col. Luz Y Saber II",115,0,1,2,46,16,8,2,0,190,1,18,209,231,0.242,0.905
"20019","Santa Cruz","Santa Cruz de La Sierra","Col. Luz Y Saber II",141,1,0,1,41,15,12,0,2,213,1,0,214,227,0.192,0.943
"20020","Santa Cruz","Santa Cruz de La Sierra","Col. Luz Y Saber II",151,0,0,2,19,16,7,1,1,197,0,5,202,225,0.096,0.898
"20021","Santa Cruz","Santa Cruz de La Sierra","Col. Luz Y Saber II",120,0,0,1,43,16,12,0,6,198,0,9,207,225,0.217,0.92
"20022","Santa Cruz","Santa Cruz de La Sierra","Col. Luz Y Saber II",140,0,0,1,28,12,8,1,1,191,0,3,194,219,0.147,0.886
"20023","Santa Cruz","Santa Cruz de La Sierra","Col. Luz Y Saber II",128,1,0,0,33,15,12,0,0,189,2,11,202,230,0.175,0.878
"20024","Santa Cruz","Santa Cruz de La Sierra","Col. Luz Y Saber II",130,0,0,0,29,25,9,0,0,193,2,8,203,229,0.15,0.886
"20025","Santa Cruz","Santa Cruz de La Sierra","Col. Luz Y Saber II",130,0,0,1,34,10,11,0,2,188,0,9,197,227,0.181,0.868
"20026","Santa Cruz","Santa Cruz de La Sierra","Col. Luz Y Saber II",150,0,1,0,20,19,8,0,0,198,0,6,204,229,0.101,0.891
"20027","Santa Cruz","Santa Cruz de La Sierra","Col. Luz Y Saber II",161,1,0,1,16,16,5,0,0,200,1,4,205,225,0.08,0.911
"20028","Santa Cruz","Santa Cruz de La Sierra","Col. Luz Y Saber II",127,0,0,3,25,17,9,2,0,183,1,7,191,227,0.137,0.841
"20029","Santa Cruz","Santa Cruz de La Sierra","Col. Luz Y Saber II",133,0,0,0,38,16,12,0,0,199,0,3,202,227,0.191,0.89
"20030","Santa Cruz","Santa Cruz de La Sierra","Col. Luz Y Saber II",127,1,0,2,33,13,6,0,2,184,1,11,196,230,0.179,0.852
"20031","Santa Cruz","Santa Cruz de La Sierra","Col. Arturo Medeiros",116,1,1,0,40,27,16,1,0,202,3,7,212,231,0.198,0.918
"20032","Santa Cruz","Santa Cruz de La Sierra","Col. Arturo Medeiros",116,0,0,2,56,26,8,0,1,209,4,7,220,233,0.268,0.944
"20033","Santa Cruz","Santa Cruz de La Sierra","Col. Arturo Medeiros",133,0,0,0,45,17,12,4,0,211,3,2,216,232,0.213,0.931
"20034","Santa Cruz","Santa Cruz de La Sierra","Col. Arturo Medeiros",118,0,0,0,52,23,11,0,0,204,0,4,208,232,0.255,0.897
"20035","Santa Cruz","Santa Cruz de La Sierra","Col. Arturo Medeiros",109,2,0,0,52,21,17,1,0,202,5,7,214,230,0.257,0.93
"20036","Santa Cruz","Santa Cruz de La Sierra","Col. Arturo Medeiros",127,1,0,0,32,30,17,3,0,210,1,7,218,236,0.152,0.924
"20037","Santa Cruz","Santa Cruz de La Sierra","Col. Arturo Medeiros",124,0,0,0,26,30,15,1,0,196,3,7,206,232,0.133,0.888
"20038","Santa Cruz","Santa Cruz de La Sierra","Col. Arturo Medeiros",125,0,0,0,44,26,7,1,0,203,3,4,210,228,0.217,0.921
"20039","Santa Cruz","Santa Cruz de La Sierra","Esc. Jose Mariano Serrano",168,0,0,3,14,14,0,1,0,200,0,1,201,228,0.07,0.882
"20040","Santa Cruz","Santa Cruz de La Sierra","Esc. Jose Mariano Serrano",169,0,0,1,15,10,4,0,0,199,1,1,201,231,0.075,0.87
"20041","Santa Cruz","Santa Cruz de La Sierra","Esc. Jose Mariano Serrano",147,0,0,5,20,19,6,0,1,198,2,4,204,228,0.101,0.895
"20042","Santa Cruz","Santa Cruz de La Sierra","Esc. Jose Mariano Serrano",163,1,0,2,9,11,7,0,0,193,1,3,197,219,0.047,0.9
"20043","Santa Cruz","Santa Cruz de La Sierra","Esc. Jose Mariano Serrano",151,0,0,3,18,22,3,0,0,197,0,4,201,225,0.091,0.893
"20044","Santa Cruz","Santa Cruz de La Sierra","Esc. Jose Mariano Serrano",156,0,0,6,7,21,3,1,0,194,0,4,198,227,0.036,0.872
"20045","Santa Cruz","Santa Cruz de La Sierra","Esc. Jose Mariano Serrano",154,0,0,2,25,9,2,0,0,192,1,4,197,226,0.13,0.872
"20046","Santa Cruz","Santa Cruz de La Sierra","Esc. Jose Mariano Serrano",163,2,1,0,18,11,6,0,0,201,1,3,205,225,0.09,0.911
"20047","Santa Cruz","Santa Cruz de La Sierra","Esc. Jose Mariano Serrano",128,0,0,1,14,19,1,1,0,164,0,3,167,190,0.085,0.879
"20048","Santa Cruz","Santa Cruz de La Sierra","Col. Juan La Borde Morel",158,0,1,1,25,13,10,1,0,209,0,5,214,229,0.12,0.934
"20049","Santa Cruz","Santa Cruz de La Sierra","Col. Juan La Borde Morel",147,1,0,0,26,10,5,0,0,189,0,8,197,222,0.138,0.887
"20050","Santa Cruz","Santa Cruz de La Sierra","Col. Juan La Borde Morel",149,0,0,0,35,23,2,1,0,210,0,2,212,232,0.167,0.914
"20051","Santa Cruz","Santa Cruz de La Sierra","Col. Juan La Borde Morel",152,0,0,1,33,16,8,0,0,210,0,6,216,235,0.157,0.919
"20052","Santa Cruz","Santa Cruz de La Sierra","Col. Juan La Borde Morel",152,0,1,0,27,17,15,1,0,213,0,2,215,230,0.127,0.935
"20053","Santa Cruz","Santa Cruz de La Sierra","Col. Juan La Borde Morel",146,1,0,1,24,18,8,0,1,199,1,5,205,230,0.121,0.891
"20054","Santa Cruz","Santa Cruz de La Sierra","Col. Juan La Borde Morel",153,0,4,0,28,15,4,0,1,205,0,3,208,229,0.137,0.908
"20055","Santa Cruz","Santa Cruz de La Sierra","Col. Juan La Borde Morel",162,0,0,0,24,14,5,0,0,205,0,7,212,233,0.117,0.91
"20056","Santa Cruz","Santa Cruz de La Sierra","Col. Juan La Borde Morel",160,0,0,0,23,17,8,1,0,209,0,4,213,232,0.11,0.918
"20057","Santa Cruz","Santa Cruz de La Sierra","Col. Juan La Borde Morel",144,0,0,0,33,11,7,0,0,195,0,3,198,229,0.169,0.865
"20058","Santa Cruz","Santa Cruz de La Sierra","Col. Juan La Borde Morel",161,0,1,2,23,13,7,1,0,208,2,8,218,234,0.111,0.932
"20059","Santa Cruz","Santa Cruz de La Sierra","Col. Juan La Borde Morel",145,0,0,0,26,20,8,1,0,200,1,6,207,225,0.13,0.92
"20060","Santa Cruz","Santa Cruz de La Sierra","Col. Juan La Borde Morel",137,1,0,1,35,19,6,0,1,200,1,9,210,231,0.175,0.909
"20061","Santa Cruz","Santa Cruz de La Sierra","Col. San Martin Norte",112,0,0,3,46,19,9,2,0,191,1,16,208,229,0.241,0.908
"20062","Santa Cruz","Santa Cruz de La Sierra","Col. San Martin Norte",132,0,0,1,35,16,17,0,2,203,1,4,208,229,0.172,0.908
"20063","Santa Cruz","Santa Cruz de La Sierra","Col. San Martin Norte",125,0,0,1,42,12,14,1,0,195,2,13,210,233,0.215,0.901
"20064","Santa Cruz","Santa Cruz de La Sierra","Col. San Martin Norte",105,0,0,2,52,21,18,2,0,200,0,7,207,226,0.26,0.916
"20065","Santa Cruz","Santa Cruz de La Sierra","Col. San Martin Norte",113,0,1,0,50,15,16,0,0,195,3,13,211,229,0.256,0.921
"20066","Santa Cruz","Santa Cruz de La Sierra","Col. San Martin Norte",128,0,0,1,46,16,13,0,2,206,1,4,211,234,0.223,0.902
"20067","Santa Cruz","Santa Cruz de La Sierra","Col. San Martin Norte",116,0,0,2,62,13,15,2,1,211,0,6,217,235,0.294,0.923
"20068","Santa Cruz","Santa Cruz de La Sierra","Col. San Martin Norte",134,1,0,2,34,19,8,1,1,200,0,9,209,228,0.17,0.917
"20069","Santa Cruz","Santa Cruz de La Sierra","Col. San Martin Norte",126,0,0,0,50,10,9,0,0,195,0,6,201,234,0.256,0.859
"20070","Santa Cruz","Santa Cruz de La Sierra","Col. San Martin Norte",120,0,0,3,34,21,4,4,0,186,1,12,199,225,0.183,0.884
"20071","Santa Cruz","Santa Cruz de La Sierra","Col. San Martin Norte",95,0,0,2,75,20,15,0,0,207,0,3,210,233,0.362,0.901
"20072","Santa Cruz","Santa Cruz de La Sierra","Col. San Martin Norte",126,0,0,1,42,8,13,1,1,192,0,39,231,231,0.219,1
"20073","Santa Cruz","Santa Cruz de La Sierra","Col. San Martin Norte",113,1,0,2,47,17,12,0,0,192,2,7,201,229,0.245,0.878
"20074","Santa Cruz","Santa Cruz de La Sierra","Col. San Martin Norte",115,0,0,1,47,21,20,2,0,206,4,3,213,231,0.228,0.922
"20075","Santa Cruz","Santa Cruz de La Sierra","Col. San Martin Norte",129,0,0,0,37,20,3,2,2,193,0,39,232,232,0.192,1
"20076","Santa Cruz","Santa Cruz de La Sierra","Col. San Martin Norte",122,0,0,1,44,13,20,1,0,201,1,9,211,231,0.219,0.913
"20077","Santa Cruz","Santa Cruz de La Sierra","Col. San Martin Norte",140,1,0,0,24,12,10,0,0,187,0,19,206,228,0.128,0.904
"20078","Santa Cruz","Santa Cruz de La Sierra","Col. San Martin Norte",135,0,0,2,34,15,7,0,2,195,0,10,205,231,0.174,0.887
"20079","Santa Cruz","Santa Cruz de La Sierra","Col. San Martin Norte",138,1,0,1,37,20,8,0,0,205,3,3,211,231,0.18,0.913
"20080","Santa Cruz","Santa Cruz de La Sierra","Col. San Martin Norte",130,1,0,1,41,12,6,3,0,194,1,9,204,233,0.211,0.876
"20081","Santa Cruz","Santa Cruz de La Sierra","Col. San Martin Norte",120,0,0,0,43,19,9,2,2,195,1,10,206,226,0.221,0.912
"20082","Santa Cruz","Santa Cruz de La Sierra","Col. San Martin Norte",125,0,1,0,45,12,12,1,0,196,2,2,200,220,0.23,0.909
"20083","Santa Cruz","Santa Cruz de La Sierra","Unidad Educativa San Juan",114,1,0,1,47,18,15,1,0,197,0,6,203,227,0.239,0.894
"20084","Santa Cruz","Santa Cruz de La Sierra","Unidad Educativa San Juan",135,0,0,0,26,24,7,0,0,192,0,5,197,221,0.135,0.891
"20085","Santa Cruz","Santa Cruz de La Sierra","Unidad Educativa San Juan",129,0,0,0,31,19,4,3,0,186,3,7,196,223,0.167,0.879
"20086","Santa Cruz","Santa Cruz de La Sierra","Escuela 23 de Marzo",120,2,0,0,45,17,6,1,0,191,0,10,201,226,0.236,0.889
"20087","Santa Cruz","Santa Cruz de La Sierra","Escuela 23 de Marzo",131,0,0,0,34,24,9,0,0,198,2,8,208,232,0.172,0.897
"20088","Santa Cruz","Santa Cruz de La Sierra","Escuela 23 de Marzo",119,0,1,0,35,13,16,1,0,185,2,8,195,226,0.189,0.863
"20089","Santa Cruz","Santa Cruz de La Sierra","Escuela 23 de Marzo",98,0,0,1,60,18,17,0,1,195,2,11,208,230,0.308,0.904
"20090","Santa Cruz","Santa Cruz de La Sierra","Escuela 23 de Marzo",84,0,3,0,65,19,26,0,1,198,1,10,209,233,0.328,0.897
"20091","Santa Cruz","Santa Cruz de La Sierra","Escuela 23 de Marzo",129,0,0,1,36,21,15,1,0,203,2,4,209,235,0.177,0.889
"20092","Santa Cruz","Santa Cruz de La Sierra","Escuela 23 de Marzo",116,0,0,2,46,25,8,2,0,199,5,4,208,226,0.231,0.92
"20093","Santa Cruz","Santa Cruz de La Sierra","Escuela 23 de Marzo",113,0,0,0,49,17,17,0,0,196,1,10,207,234,0.25,0.885
"20094","Santa Cruz","Santa Cruz de La Sierra","Escuela 23 de Marzo",107,0,0,1,46,22,13,1,0,190,2,10,202,232,0.242,0.871
"20095","Santa Cruz","Santa Cruz de La Sierra","Escuela 23 de Marzo",94,0,0,0,71,17,9,1,0,192,1,4,197,231,0.37,0.853
"20096","Santa Cruz","Santa Cruz de La Sierra","Escuela 23 de Marzo",126,0,0,0,32,11,11,0,0,180,2,26,208,228,0.178,0.912
"20097","Santa Cruz","Santa Cruz de La Sierra","Escuela 23 de Marzo",124,0,0,1,38,13,12,0,0,188,2,12,202,224,0.202,0.902
"20098","Santa Cruz","Santa Cruz de La Sierra","Escuela 23 de Marzo",117,0,1,0,45,12,19,0,1,195,2,8,205,228,0.231,0.899
"20099","Santa Cruz","Santa Cruz de La Sierra","Escuela 23 de Marzo",93,0,0,1,74,13,17,3,0,201,1,7,209,235,0.368,0.889
"20100","Santa Cruz","Santa Cruz de La Sierra","Escuela 23 de Marzo",115,2,0,0,33,18,11,1,1,181,7,10,198,233,0.182,0.85
"20101","Santa Cruz","Santa Cruz de La Sierra","Escuela 23 de Marzo",129,0,1,0,29,17,12,2,0,190,0,9,199,225,0.153,0.884
"20102","Santa Cruz","Santa Cruz de La Sierra","Escuela 23 de Marzo",132,1,0,1,47,18,6,0,0,205,1,1,207,228,0.229,0.908
"20103","Santa Cruz","Santa Cruz de La Sierra","Escuela 23 de Marzo",118,2,0,0,46,20,6,2,0,194,3,8,205,226,0.237,0.907
"20104","Santa Cruz","Santa Cruz de La Sierra","Escuela 23 de Marzo",64,1,1,6,34,54,8,9,0,177,27,5,209,232,0.192,0.901
"20105","Santa Cruz","Santa Cruz de La Sierra","Escuela San Joaquin",120,0,1,1,40,15,12,3,2,194,1,2,197,223,0.206,0.883
"20106","Santa Cruz","Santa Cruz de La Sierra","Escuela San Joaquin",96,0,1,2,52,26,14,0,1,192,0,6,198,227,0.271,0.872
"20107","Santa Cruz","Santa Cruz de La Sierra","Escuela San Joaquin",92,2,2,0,60,23,9,4,2,194,1,10,205,227,0.309,0.903
"20108","Santa Cruz","Santa Cruz de La Sierra","Escuela San Joaquin",90,1,0,0,58,29,14,0,0,192,2,6,200,233,0.302,0.858
"20109","Santa Cruz","Santa Cruz de La Sierra","Escuela San Joaquin",88,1,0,0,75,20,14,0,1,199,4,5,208,231,0.377,0.9
"20110","Santa Cruz","Santa Cruz de La Sierra","Escuela San Joaquin",93,0,0,1,63,26,10,1,1,195,2,7,204,227,0.323,0.899
"20111","Santa Cruz","Santa Cruz de La Sierra","Escuela San Joaquin",90,0,0,1,69,19,19,1,0,199,0,1,200,227,0.347,0.881
"20112","Santa Cruz","Santa Cruz de La Sierra","Escuela San Joaquin",104,0,0,1,46,29,20,2,0,202,3,3,208,225,0.228,0.924
"20113","Santa Cruz","Santa Cruz de La Sierra","Escuela San Joaquin",108,0,1,0,59,24,18,2,2,214,1,2,217,234,0.276,0.927
"20114","Santa Cruz","Santa Cruz de La Sierra","Escuela San Joaquin",96,0,1,1,49,24,12,0,0,183,3,8,194,225,0.268,0.862
"20115","Santa Cruz","Santa Cruz de La Sierra","Escuela San Joaquin",117,0,0,0,28,32,8,1,0,186,1,9,196,228,0.151,0.86
"20116","Santa Cruz","Santa Cruz de La Sierra","Escuela San Joaquin",110,0,0,1,45,24,9,0,2,191,1,0,192,231,0.236,0.831
"20117","Santa Cruz","Santa Cruz de La Sierra","U.E. Santa Cruz de la Sierra",162,0,0,1,16,9,6,1,0,195,0,3,198,224,0.082,0.884
"20118","Santa Cruz","Santa Cruz de La Sierra","U.E. Santa Cruz de la Sierra",161,0,0,0,20,13,5,2,0,201,0,6,207,233,0.1,0.888
"20119","Santa Cruz","Santa Cruz de La Sierra","U.E. Santa Cruz de la Sierra",159,1,0,1,20,7,7,1,0,196,0,2,198,226,0.102,0.876
"20120","Santa Cruz","Santa Cruz de La Sierra","U.E. Santa Cruz de la Sierra",161,0,1,0,16,10,6,0,1,195,1,2,198,222,0.082,0.892
"20121","Santa Cruz","Santa Cruz de La Sierra","U.E. Santa Cruz de la Sierra",152,1,0,2,18,12,8,3,0,196,0,4,200,229,0.092,0.873
"20122","Santa Cruz","Santa Cruz de La Sierra","U.E. Santa Cruz de la Sierra",160,1,0,1,24,12,7,1,1,207,0,3,210,230,0.116,0.913
"20123","Santa Cruz","Santa Cruz de La Sierra","U.E. Santa Cruz de la Sierra",151,0,1,0,19,5,12,2,0,190,1,3,194,222,0.1,0.874
"20124","Santa Cruz","Santa Cruz de La Sierra","U.E. Santa Cruz de la Sierra",163,0,1,0,21,7,3,0,0,195,0,6,201,227,0.108,0.885
"20125","Santa Cruz","Santa Cruz de La Sierra","U.E. Santa Cruz de la Sierra",157,0,0,0,21,15,6,0,0,199,0,4,203,222,0.106,0.914
"20126","Santa Cruz","Santa Cruz de La Sierra","U.E. Santa Cruz de la Sierra",152,1,0,0,19,15,6,0,0,193,2,6,201,226,0.098,0.889
"20127","Santa Cruz","Santa Cruz de La Sierra","U.E. Santa Cruz de la Sierra",144,0,0,2,27,14,6,3,0,196,0,6,202,223,0.138,0.906
"20128","Santa Cruz","Santa Cruz de La Sierra","U.E. Santa Cruz de la Sierra",157,0,0,0,31,9,10,1,1,209,0,4,213,226,0.148,0.942
"20129","Santa Cruz","Santa Cruz de La Sierra","U.E. Santa Cruz de la Sierra",175,0,0,4,15,11,5,2,0,212,1,3,216,235,0.071,0.919
"20130","Santa Cruz","Santa Cruz de La Sierra","U.E. Santa Cruz de la Sierra",154,0,0,0,17,16,5,3,0,195,0,1,196,222,0.087,0.883
"20131","Santa Cruz","Santa Cruz de La Sierra","U.E. Santa Cruz de la Sierra",161,1,0,2,19,4,7,4,0,198,1,6,205,230,0.096,0.891
"20132","Santa Cruz","Santa Cruz de La Sierra","U.E. Santa Cruz de la Sierra",155,0,0,0,19,12,6,1,0,193,0,8,201,228,0.098,0.882
"20133","Santa Cruz","Santa Cruz de La Sierra","U.E. Santa Cruz de la Sierra",152,0,0,0,25,13,14,0,0,204,0,4,208,228,0.123,0.912
"20134","Santa Cruz","Santa Cruz de La Sierra","U.E. Santa Cruz de la Sierra",168,0,0,1,13,19,5,2,1,209,1,2,212,235,0.062,0.902
"20135","Santa Cruz","Santa Cruz de La Sierra","U.E. Santa Cruz de la Sierra",171,0,0,0,12,8,10,1,0,202,0,1,203,228,0.059,0.89
"20136","Santa Cruz","Santa Cruz de La Sierra","U.E. Santa Cruz de la Sierra",156,0,0,0,29,10,6,1,0,202,0,3,205,226,0.144,0.907
"20137","Santa Cruz","Santa Cruz de La Sierra","U.E. Santa Cruz de la Sierra",151,0,0,0,18,16,10,3,0,198,0,2,200,231,0.091,0.866
"20138","Santa Cruz","Santa Cruz de La Sierra","U.E. Santa Cruz de la Sierra",176,2,0,0,15,16,2,3,0,214,1,3,218,236,0.07,0.924
"20139","Santa Cruz","Santa Cruz de La Sierra","U.E. Santa Cruz de la Sierra",153,0,0,1,22,15,5,0,1,197,0,4,201,224,0.112,0.897
"20140","Santa Cruz","Santa Cruz de La Sierra","Escuela Km 9",134,0,0,1,42,16,6,1,0,200,0,6,206,227,0.21,0.907
"20141","Santa Cruz","Santa Cruz de La Sierra","Escuela Km 9",134,0,0,0,36,19,9,0,0,198,1,3,202,232,0.182,0.871
"20142","Santa Cruz","Santa Cruz de La Sierra","Escuela Km 9",142,0,0,2,28,15,14,0,0,201,0,8,209,227,0.139,0.921
"20143","Santa Cruz","Santa Cruz de La Sierra","Escuela Km 9",161,1,0,0,21,11,9,2,0,205,0,5,210,229,0.102,0.917
"20144","Santa Cruz","Santa Cruz de La Sierra","Escuela Km 9",103,1,0,0,64,22,10,2,0,202,0,8,210,233,0.317,0.901
"20145","Santa Cruz","Santa Cruz de La Sierra","Escuela Km 9",107,0,0,1,54,14,20,1,0,197,1,8,206,233,0.274,0.884
"20146","Santa Cruz","Santa Cruz de La Sierra","Escuela Km 9",118,0,0,2,43,20,12,1,0,196,1,6,203,228,0.219,0.89
"20147","Santa Cruz","Santa Cruz de La Sierra","Escuela Km 9",128,0,0,1,54,12,5,1,0,201,0,6,207,231,0.269,0.896
"20148","Santa Cruz","Santa Cruz de La Sierra","Escuela Km 9",137,0,0,1,36,14,12,1,0,201,0,2,203,224,0.179,0.906
"20149","Santa Cruz","Santa Cruz de La Sierra","Escuela Km 9",131,0,1,1,38,13,20,0,1,205,0,6,211,235,0.185,0.898
"20150","Santa Cruz","Santa Cruz de La Sierra","Escuela Km 9",136,0,0,3,30,13,15,1,0,198,0,5,203,227,0.152,0.894
"20151","Santa Cruz","Santa Cruz de La Sierra","Escuela Km 9",123,0,0,1,55,14,17,1,0,211,4,1,216,235,0.261,0.919
"20152","Santa Cruz","Santa Cruz de La Sierra","Escuela Km 9",127,0,1,2,38,17,12,1,0,198,1,0,199,227,0.192,0.877
"20153","Santa Cruz","Santa Cruz de La Sierra","Escuela Km 9",141,0,0,0,33,26,1,2,0,203,2,1,206,229,0.163,0.9
"20154","Santa Cruz","Santa Cruz de La Sierra","Escuela Km 9",126,2,0,1,34,14,18,1,1,197,1,1,199,226,0.173,0.881
"20155","Santa Cruz","Santa Cruz de La Sierra","Escuela Km 9",146,1,0,2,34,13,5,1,0,202,1,2,205,226,0.168,0.907
"20156","Santa Cruz","Santa Cruz de La Sierra","Escuela Km 9",110,0,1,0,47,22,10,1,0,191,1,13,205,233,0.246,0.88
"20157","Santa Cruz","Santa Cruz de La Sierra","Escuela Km 9",144,2,0,0,28,22,6,2,0,204,0,7,211,233,0.137,0.906
"20158","Santa Cruz","Santa Cruz de La Sierra","Escuela Km 9",131,0,0,0,37,22,13,1,1,205,1,3,209,229,0.18,0.913
"20159","Santa Cruz","Santa Cruz de La Sierra","Escuela Km 9",127,1,1,2,35,13,15,1,0,195,2,6,203,228,0.179,0.89
"20160","Santa Cruz","Santa Cruz de La Sierra","Escuela Km 9",144,2,1,0,27,18,11,0,0,203,1,3,207,230,0.133,0.9
"20161","Santa Cruz","Santa Cruz de La Sierra","Escuela Km 9",142,0,0,1,36,18,9,1,0,207,0,4,211,232,0.174,0.909
"20162","Santa Cruz","Santa Cruz de La Sierra","Escuela Km 9",136,0,0,2,31,14,15,0,0,198,1,1,200,231,0.157,0.866
"20163","Santa Cruz","Santa Cruz de La Sierra","Escuela Primavera",130,1,0,1,33,12,16,1,1,195,2,5,202,229,0.169,0.882
"20164","Santa Cruz","Santa Cruz de La Sierra","Escuela Primavera",113,0,1,0,38,18,18,0,0,188,1,4,193,230,0.202,0.839
"20165","Santa Cruz","Santa Cruz de La Sierra","Escuela Primavera",132,2,2,0,47,15,12,0,2,212,1,4,217,235,0.222,0.923
"20166","Santa Cruz","Santa Cruz de La Sierra","Escuela Primavera",139,0,0,1,33,18,9,1,1,202,4,4,210,235,0.163,0.894
"20167","Santa Cruz","Santa Cruz de La Sierra","Escuela Primavera",135,2,0,5,25,20,8,1,0,196,1,4,201,234,0.128,0.859
"20168","Santa Cruz","Santa Cruz de La Sierra","Escuela Primavera",115,1,1,0,18,14,13,1,0,163,2,3,168,184,0.11,0.913
"20169","Santa Cruz","Santa Cruz de La Sierra","Esc. Mamerto Cuellar Costa",132,0,1,0,39,12,18,5,0,207,5,2,214,234,0.188,0.915
"20170","Santa Cruz","Santa Cruz de La Sierra","Esc. Mamerto Cuellar Costa",142,0,0,3,24,24,7,1,0,201,1,3,205,231,0.119,0.887
"20171","Santa Cruz","Santa Cruz de La Sierra","Esc. Mamerto Cuellar Costa",142,0,0,0,32,16,14,3,0,207,1,3,211,231,0.155,0.913
"20172","Santa Cruz","Santa Cruz de La Sierra","Esc. Mamerto Cuellar Costa",137,1,0,3,26,21,11,5,0,204,6,4,214,235,0.127,0.911
"20173","Santa Cruz","Santa Cruz de La Sierra","Esc. Mamerto Cuellar Costa",133,0,2,2,47,13,13,0,1,211,0,4,215,231,0.223,0.931
"20174","Santa Cruz","Santa Cruz de La Sierra","Esc. Mamerto Cuellar Costa",143,0,0,1,20,20,16,1,0,201,0,4,205,230,0.1,0.891
"20175","Santa Cruz","Santa Cruz de La Sierra","Esc. Mamerto Cuellar Costa",154,0,0,1,26,22,7,1,0,211,3,1,215,236,0.123,0.911
"20176","Santa Cruz","Santa Cruz de La Sierra","Esc. Mamerto Cuellar Costa",126,0,0,2,38,19,10,3,0,198,1,5,204,227,0.192,0.899
"20177","Santa Cruz","Santa Cruz de La Sierra","Esc. Mamerto Cuellar Costa",150,0,0,1,29,20,10,1,0,211,1,4,216,228,0.137,0.947
"20178","Santa Cruz","Santa Cruz de La Sierra","Esc. Mamerto Cuellar Costa",166,0,0,2,26,11,2,1,3,211,1,4,216,240,0.123,0.9
"20179","Santa Cruz","Santa Cruz de La Sierra","Col. Gabriel Rene Moreno",125,0,0,1,17,20,7,1,2,173,0,8,181,214,0.098,0.846
"20180","Santa Cruz","Santa Cruz de La Sierra","Col. Gabriel Rene Moreno",128,0,1,0,28,8,6,1,1,173,0,6,179,215,0.162,0.833
"20181","Santa Cruz","Santa Cruz de La Sierra","Col. Gabriel Rene Moreno",124,0,0,1,20,18,6,0,1,170,0,3,173,209,0.118,0.828
"20182","Santa Cruz","Santa Cruz de La Sierra","Col. Gabriel Rene Moreno",129,0,0,1,20,14,8,0,0,172,0,4,176,218,0.116,0.807
"20183","Santa Cruz","Santa Cruz de La Sierra","Col. Gabriel Rene Moreno",138,0,0,0,20,17,9,1,0,185,1,3,189,221,0.108,0.855
"20184","Santa Cruz","Santa Cruz de La Sierra","Col. Gabriel Rene Moreno",132,0,0,1,24,18,4,1,2,182,1,1,184,214,0.132,0.86
"20185","Santa Cruz","Santa Cruz de La Sierra","Col. Gabriel Rene Moreno",129,0,0,1,24,11,7,2,1,175,0,7,182,212,0.137,0.858
"20186","Santa Cruz","Santa Cruz de La Sierra","Col. Gabriel Rene Moreno",140,0,0,0,26,20,2,0,1,189,0,5,194,223,0.138,0.87
"20187","Santa Cruz","Santa Cruz de La Sierra","Col. Gabriel Rene Moreno",132,0,0,0,13,13,7,1,0,166,0,2,168,199,0.078,0.844
"20188","Santa Cruz","Santa Cruz de La Sierra","Kinder Luisa Saucedo",143,0,1,4,21,7,8,3,1,188,3,3,194,225,0.112,0.862
"20189","Santa Cruz","Santa Cruz de La Sierra","Kinder Luisa Saucedo",127,0,0,4,14,11,2,6,4,168,0,3,171,207,0.083,0.826
"20190","Santa Cruz","Santa Cruz de La Sierra","Kinder Luisa Saucedo",152,0,0,1,14,13,4,0,2,186,2,3,191,216,0.075,0.884
"20191","Santa Cruz","Santa Cruz de La Sierra","Kinder Luisa Saucedo",160,0,0,2,13,16,4,0,1,196,0,2,198,224,0.066,0.884
"20192","Santa Cruz","Santa Cruz de La Sierra","Esc. Normal Enriquet  Finot",131,0,0,0,10,18,4,1,0,164,0,0,164,209,0.061,0.785
"20193","Santa Cruz","Santa Cruz de La Sierra","Esc. Normal Enriquet  Finot",152,0,0,2,5,20,0,1,0,180,1,2,183,228,0.028,0.803
"20194","Santa Cruz","Santa Cruz de La Sierra","Esc. Normal Enriquet  Finot",160,0,0,1,9,16,4,0,0,190,0,0,190,226,0.047,0.841
"20195","Santa Cruz","Santa Cruz de La Sierra","Esc. Normal Enriquet  Finot",151,0,0,5,14,13,0,0,0,183,0,1,184,219,0.077,0.84
"20196","Santa Cruz","Santa Cruz de La Sierra","Esc. Normal Enriquet  Finot",146,0,0,2,20,16,5,0,0,189,1,2,192,227,0.106,0.846
"20197","Santa Cruz","Santa Cruz de La Sierra","Esc. Normal Enriquet  Finot",136,0,0,1,14,21,2,1,0,175,0,2,177,216,0.08,0.819
"20198","Santa Cruz","Santa Cruz de La Sierra","Esc. Normal Enriquet  Finot",137,0,0,1,9,13,4,1,0,165,0,3,168,220,0.055,0.764
"20199","Santa Cruz","Santa Cruz de La Sierra","Esc. Normal Enriquet  Finot",149,0,0,4,13,16,5,2,0,189,0,0,189,228,0.069,0.829
"20200","Santa Cruz","Santa Cruz de La Sierra","Esc. Normal Enriquet  Finot",143,0,0,2,23,17,3,0,0,188,0,2,190,223,0.122,0.852
"20201","Santa Cruz","Santa Cruz de La Sierra","Esc. Normal Enriquet  Finot",160,0,0,1,10,20,2,0,0,193,0,0,193,227,0.052,0.85
"20202","Santa Cruz","Santa Cruz de La Sierra","Esc. Normal Enriquet  Finot",144,0,0,1,9,7,4,1,0,166,0,2,168,213,0.054,0.789
"20203","Santa Cruz","Santa Cruz de La Sierra","Esc. Normal Enriquet  Finot",143,0,0,1,15,18,3,0,0,180,0,6,186,219,0.083,0.849
"20204","Santa Cruz","Santa Cruz de La Sierra","Esc. Normal Enriquet  Finot",140,0,0,1,13,10,6,0,0,170,0,4,174,214,0.076,0.813
"20205","Santa Cruz","Santa Cruz de La Sierra","Esc. Normal Enriquet  Finot",164,0,0,1,7,12,2,1,0,187,1,3,191,225,0.037,0.849
"20206","Santa Cruz","Santa Cruz de La Sierra","Esc. Normal Enriquet  Finot",146,0,0,1,6,16,5,1,0,175,0,1,176,217,0.034,0.811
"20207","Santa Cruz","Santa Cruz de La Sierra","Esc. Normal Enriquet  Finot",136,0,1,1,13,13,3,1,0,168,0,2,170,218,0.077,0.78
"20208","Santa Cruz","Santa Cruz de La Sierra","Esc. Normal Enriquet  Finot",139,0,0,2,11,18,3,2,0,175,1,3,179,224,0.063,0.799
"20209","Santa Cruz","Santa Cruz de La Sierra","Esc. Normal Enriquet  Finot",137,0,0,0,9,23,4,2,0,175,0,1,176,220,0.051,0.8
"20210","Santa Cruz","Santa Cruz de La Sierra","Esc. Normal Enriquet  Finot",152,0,0,0,8,20,1,0,0,181,0,2,183,220,0.044,0.832
"20211","Santa Cruz","Santa Cruz de La Sierra","Esc. Normal Enriquet  Finot",154,2,0,1,11,26,3,1,0,198,1,1,200,228,0.056,0.877
"20212","Santa Cruz","Santa Cruz de La Sierra","Esc. Normal Enriquet  Finot",145,1,0,2,16,4,3,0,0,171,0,1,172,218,0.094,0.789
"20213","Santa Cruz","Santa Cruz de La Sierra","Esc. Los Sauces I",116,2,0,0,32,11,15,2,0,178,1,14,193,224,0.18,0.862
"20214","Santa Cruz","Santa Cruz de La Sierra","Esc. Los Sauces I",126,0,1,1,42,16,10,1,0,197,0,5,202,231,0.213,0.874
"20215","Santa Cruz","Santa Cruz de La Sierra","Esc. Los Sauces I",105,1,1,0,50,18,16,2,0,193,1,7,201,231,0.259,0.87
"20216","Santa Cruz","Santa Cruz de La Sierra","Esc. Los Sauces I",132,0,0,1,20,20,16,1,1,191,0,4,195,223,0.105,0.874
"20217","Santa Cruz","Santa Cruz de La Sierra","Esc. Los Sauces I",135,0,0,0,29,18,12,2,0,196,2,3,201,228,0.148,0.882
"20218","Santa Cruz","Santa Cruz de La Sierra","Esc. Los Sauces I",153,0,0,0,19,17,9,0,1,199,0,6,205,229,0.095,0.895
"20219","Santa Cruz","Santa Cruz de La Sierra","Esc. Los Sauces I",127,0,0,2,35,23,20,0,0,207,4,4,215,234,0.169,0.919
"20220","Santa Cruz","Santa Cruz de La Sierra","Esc. Los Sauces I",142,2,0,4,22,13,13,3,0,199,2,3,204,231,0.111,0.883
"20221","Santa Cruz","Santa Cruz de La Sierra","Esc. Los Sauces I",138,0,0,3,25,16,15,1,0,198,4,4,206,226,0.126,0.912
"20222","Santa Cruz","Santa Cruz de La Sierra","Esc. Los Sauces I",111,0,1,0,45,20,18,0,1,196,2,7,205,227,0.23,0.903
"20223","Santa Cruz","Santa Cruz de La Sierra","Esc. Los Sauces I",124,0,0,0,31,25,14,2,0,196,1,5,202,223,0.158,0.906
"20224","Santa Cruz","Santa Cruz de La Sierra","Esc. Los Sauces I",128,0,0,1,38,22,13,1,0,203,3,6,212,232,0.187,0.914
"20225","Santa Cruz","Santa Cruz de La Sierra","Esc. Los Sauces I",119,1,0,1,45,18,17,0,1,202,1,8,211,239,0.223,0.883
"20226","Santa Cruz","Santa Cruz de La Sierra","Escuela 1ro. de Mayo",128,1,0,0,23,15,10,1,0,178,0,4,182,224,0.129,0.812
"20227","Santa Cruz","Santa Cruz de La Sierra","Escuela 1ro. de Mayo",112,0,0,3,43,15,9,1,0,183,1,7,191,227,0.235,0.841
"20228","Santa Cruz","Santa Cruz de La Sierra","Escuela 1ro. de Mayo",133,0,0,0,25,16,7,1,0,182,0,7,189,224,0.137,0.844
"20229","Santa Cruz","Santa Cruz de La Sierra","Escuela 1ro. de Mayo",126,0,0,1,27,19,8,0,0,181,2,8,191,226,0.149,0.845
"20230","Santa Cruz","Santa Cruz de La Sierra","Escuela 1ro. de Mayo",135,0,0,0,17,22,6,2,0,182,2,4,188,222,0.093,0.847
"20231","Santa Cruz","Santa Cruz de La Sierra","Escuela 1ro. de Mayo",138,1,0,0,20,10,6,3,1,179,0,6,185,220,0.112,0.841
"20232","Santa Cruz","Santa Cruz de La Sierra","Col. Ovidio Santistevan",145,0,0,0,27,8,9,1,0,190,0,8,198,225,0.142,0.88
"20233","Santa Cruz","Santa Cruz de La Sierra","Col. Ovidio Santistevan",157,0,0,0,24,8,11,0,1,201,0,4,205,230,0.119,0.891
"20234","Santa Cruz","Santa Cruz de La Sierra","Col. Ovidio Santistevan",153,0,0,0,25,24,6,1,0,209,0,2,211,233,0.12,0.906
"20235","Santa Cruz","Santa Cruz de La Sierra","Col. Ovidio Santistevan",142,1,1,2,29,15,6,0,2,198,0,1,199,228,0.146,0.873
"20236","Santa Cruz","Santa Cruz de La Sierra","Col. Ovidio Santistevan",121,0,0,1,29,16,7,1,0,175,1,10,186,222,0.166,0.838
"20237","Santa Cruz","Santa Cruz de La Sierra","Col. Ovidio Santistevan",136,1,0,0,38,14,13,0,1,203,0,4,207,226,0.187,0.916
"20238","Santa Cruz","Santa Cruz de La Sierra","Col. Ovidio Santistevan",117,1,1,0,28,21,10,2,0,180,2,5,187,223,0.156,0.839
"20239","Santa Cruz","Santa Cruz de La Sierra","Col. Ovidio Santistevan",117,0,0,1,34,23,8,0,0,183,1,6,190,222,0.186,0.856
"20240","Santa Cruz","Santa Cruz de La Sierra","Col. Ovidio Santistevan",134,0,0,0,28,18,11,2,0,193,1,6,200,222,0.145,0.901
"20241","Santa Cruz","Santa Cruz de La Sierra","Col. Ovidio Santistevan",124,0,0,1,33,12,7,1,0,178,3,6,187,222,0.185,0.842
"20242","Santa Cruz","Santa Cruz de La Sierra","Col. Ovidio Santistevan",148,0,0,1,10,16,3,0,0,178,3,12,193,225,0.056,0.858
"20243","Santa Cruz","Santa Cruz de La Sierra","Col. Ovidio Santistevan",128,1,0,1,38,10,13,3,0,194,1,4,199,228,0.196,0.873
"20244","Santa Cruz","Santa Cruz de La Sierra","Col. Ovidio Santistevan",135,0,1,0,21,28,4,0,1,190,0,10,200,219,0.111,0.913
"20245","Santa Cruz","Santa Cruz de La Sierra","Col. Ovidio Santistevan",146,1,0,2,24,7,8,4,0,192,1,5,198,226,0.125,0.876
"20246","Santa Cruz","Santa Cruz de La Sierra","Col. Ovidio Santistevan",133,0,0,1,29,17,3,1,0,184,1,7,192,230,0.158,0.835
"20247","Santa Cruz","Santa Cruz de La Sierra","Col. Ovidio Santistevan",148,0,0,0,24,13,6,3,0,194,0,4,198,231,0.124,0.857
"20248","Santa Cruz","Santa Cruz de La Sierra","Col. Ovidio Santistevan",126,0,0,1,41,8,13,0,2,191,2,8,201,228,0.215,0.882
"20249","Santa Cruz","Santa Cruz de La Sierra","Col. Ovidio Santistevan",139,1,0,0,12,27,6,2,1,188,1,6,195,230,0.064,0.848
"20250","Santa Cruz","Santa Cruz de La Sierra","Col. Ovidio Santistevan",164,0,0,0,14,12,7,3,0,200,2,23,225,225,0.07,1
"20251","Santa Cruz","Santa Cruz de La Sierra","Col. Ovidio Santistevan",151,1,0,0,18,16,6,0,0,192,1,6,199,223,0.094,0.892
"20252","Santa Cruz","Santa Cruz de La Sierra","Col. Ovidio Santistevan",142,0,0,1,24,21,5,3,1,197,0,2,199,219,0.122,0.909
"20253","Santa Cruz","Santa Cruz de La Sierra","Col. Ovidio Santistevan",140,0,1,4,34,11,9,0,0,199,3,7,209,232,0.171,0.901
"20254","Santa Cruz","Santa Cruz de La Sierra","Col. Ovidio Santistevan",133,0,0,0,38,18,6,0,1,196,1,8,205,230,0.194,0.891
"20255","Santa Cruz","Santa Cruz de La Sierra","Col. Ovidio Santistevan",111,0,0,0,16,12,12,1,0,152,0,3,155,177,0.105,0.876
"20256","Santa Cruz","Santa Cruz de La Sierra","Col. Villa Bolivia",126,0,1,2,32,19,11,2,0,193,2,6,201,229,0.166,0.878
"20257","Santa Cruz","Santa Cruz de La Sierra","Col. Villa Bolivia",140,0,0,0,25,23,7,4,0,199,1,0,200,228,0.126,0.877
"20258","Santa Cruz","Santa Cruz de La Sierra","Col. Villa Bolivia",130,0,0,0,37,17,7,2,1,194,1,5,200,224,0.191,0.893
"20259","Santa Cruz","Santa Cruz de La Sierra","Col. Villa Bolivia",131,1,2,0,35,12,5,0,0,186,0,5,191,225,0.188,0.849
"20260","Santa Cruz","Santa Cruz de La Sierra","Col. Villa Bolivia",122,0,0,0,45,20,9,1,0,197,1,5,203,226,0.228,0.898
"20261","Santa Cruz","Santa Cruz de La Sierra","Col. Villa Bolivia",129,0,0,1,27,24,7,1,0,189,0,8,197,230,0.143,0.857
"20262","Santa Cruz","Santa Cruz de La Sierra","Col. Villa Bolivia",110,0,0,1,47,13,16,2,0,189,2,9,200,230,0.249,0.87
"20263","Santa Cruz","Santa Cruz de La Sierra","Col. Villa Bolivia",130,0,1,1,38,19,7,0,1,197,0,6,203,223,0.193,0.91
"20264","Santa Cruz","Santa Cruz de La Sierra","Col. Villa Bolivia",149,0,0,2,25,13,6,2,0,197,0,5,202,229,0.127,0.882
"20265","Santa Cruz","Santa Cruz de La Sierra","Col. Villa Bolivia",150,0,0,0,12,25,8,0,0,195,0,1,196,226,0.062,0.867
"20266","Santa Cruz","Santa Cruz de La Sierra","Col. Villa Bolivia",109,0,0,0,60,19,14,1,0,203,1,5,209,231,0.296,0.905
"20267","Santa Cruz","Santa Cruz de La Sierra","Col. Villa Bolivia",145,0,0,0,29,15,7,0,0,196,1,5,202,229,0.148,0.882
"20268","Santa Cruz","Santa Cruz de La Sierra","Col. Villa Bolivia",131,0,0,0,20,29,3,0,0,183,1,12,196,224,0.109,0.875
"20269","Santa Cruz","Santa Cruz de La Sierra","Col. Villa Bolivia",124,0,0,2,30,22,13,0,0,191,1,5,197,231,0.157,0.853
"20270","Santa Cruz","Santa Cruz de La Sierra","Col. Villa Bolivia",141,0,1,0,18,24,13,0,0,197,0,7,204,231,0.091,0.883
"20271","Santa Cruz","Santa Cruz de La Sierra","Col. Villa Bolivia",145,0,1,0,24,20,3,3,0,196,3,3,202,230,0.122,0.878
"20272","Santa Cruz","Santa Cruz de La Sierra","Col. Villa Bolivia",149,0,1,0,13,22,8,0,0,193,0,2,195,221,0.067,0.882
"20273","Santa Cruz","Santa Cruz de La Sierra","Col. Villa Bolivia",134,0,0,2,24,24,4,6,0,194,2,7,203,232,0.124,0.875
"20274","Santa Cruz","Santa Cruz de La Sierra","Col. Villa Bolivia",130,0,1,0,24,27,3,0,0,185,1,9,195,232,0.13,0.841
"20275","Santa Cruz","Santa Cruz de La Sierra","Col. Villa Bolivia",137,0,1,0,33,10,5,3,0,189,2,4,195,228,0.175,0.855
"20276","Santa Cruz","Santa Cruz de La Sierra","Col. Villa Bolivia",143,0,0,0,24,13,8,0,0,188,2,5,195,225,0.128,0.867
"20277","Santa Cruz","Santa Cruz de La Sierra","U.E. Isuto",122,0,0,2,31,24,11,3,0,193,2,9,204,229,0.161,0.891
"20278","Santa Cruz","Santa Cruz de La Sierra","U.E. Isuto",138,1,0,2,31,27,8,1,0,208,1,9,218,236,0.149,0.924
"20279","Santa Cruz","Santa Cruz de La Sierra","U.E. Isuto",151,0,0,2,26,15,10,2,0,206,2,7,215,232,0.126,0.927
"20280","Santa Cruz","Santa Cruz de La Sierra","U.E. Isuto",113,0,0,1,25,20,8,1,0,168,1,5,174,199,0.149,0.874
"20281","Santa Cruz","Santa Cruz de La Sierra","Kinder Guarderia El Carmen",141,0,0,1,21,7,19,1,1,191,0,5,196,225,0.11,0.871
"20282","Santa Cruz","Santa Cruz de La Sierra","Kinder Guarderia El Carmen",139,1,0,0,29,11,21,1,0,202,0,2,204,226,0.144,0.903
"20283","Santa Cruz","Santa Cruz de La Sierra","Facultad de Ciencias Agricolas U.A.G.R.M.",185,0,0,1,19,9,6,0,0,220,0,6,226,235,0.086,0.962
"20284","Santa Cruz","Santa Cruz de La Sierra","Facultad de Ciencias Agricolas U.A.G.R.M.",169,2,0,0,29,14,7,0,0,221,2,2,225,234,0.131,0.962
"20285","Santa Cruz","Santa Cruz de La Sierra","Facultad de Ciencias Agricolas U.A.G.R.M.",162,0,0,1,34,13,8,1,0,219,1,2,222,238,0.155,0.933
"20286","Santa Cruz","Santa Cruz de La Sierra","Facultad de Ciencias Agricolas U.A.G.R.M.",160,1,0,0,28,15,10,0,2,216,0,3,219,234,0.13,0.936
"20287","Santa Cruz","Santa Cruz de La Sierra","Facultad de Ciencias Agricolas U.A.G.R.M.",173,0,0,0,25,14,7,0,0,219,1,2,222,234,0.114,0.949
"20288","Santa Cruz","Santa Cruz de La Sierra","Facultad de Ciencias Agricolas U.A.G.R.M.",168,0,0,1,21,15,5,1,0,211,0,2,213,236,0.1,0.903
"20289","Santa Cruz","Santa Cruz de La Sierra","Col. Seferino Namucara Don Bosco",148,0,0,1,14,8,9,2,0,182,0,5,187,219,0.077,0.854
"20290","Santa Cruz","Santa Cruz de La Sierra","Col. Seferino Namucara Don Bosco",153,0,0,0,18,12,8,1,0,192,1,6,199,219,0.094,0.909
"20291","Santa Cruz","Santa Cruz de La Sierra","Col. Seferino Namucara Don Bosco",150,0,0,1,16,9,5,0,0,181,1,0,182,215,0.088,0.847
"20292","Santa Cruz","Santa Cruz de La Sierra","Col. Inst. Domingo Savio",134,0,0,0,19,14,7,1,0,175,1,9,185,216,0.109,0.856
"20293","Santa Cruz","Santa Cruz de La Sierra","Col. Inst. Domingo Savio",114,0,0,0,22,20,8,0,1,165,1,2,168,204,0.133,0.824
"20294","Santa Cruz","Santa Cruz de La Sierra","Col. Inst. Domingo Savio",158,0,0,0,17,15,4,1,0,195,0,3,198,224,0.087,0.884
"20295","Santa Cruz","Santa Cruz de La Sierra","Col. Inst. Domingo Savio",137,1,0,2,11,20,6,1,0,178,0,4,182,214,0.062,0.85
"20296","Santa Cruz","Santa Cruz de La Sierra","Colegio Marista",147,0,0,2,14,17,5,0,0,185,0,2,187,217,0.076,0.862
"20297","Santa Cruz","Santa Cruz de La Sierra","Colegio Marista",134,0,0,1,12,28,2,2,0,179,1,2,182,217,0.067,0.839
"20298","Santa Cruz","Santa Cruz de La Sierra","Colegio Marista",150,0,0,1,9,15,3,3,0,181,0,4,185,212,0.05,0.873
"20299","Santa Cruz","Santa Cruz de La Sierra","Colegio Marista",151,1,0,2,12,17,4,2,0,189,0,1,190,215,0.063,0.884
"20300","Santa Cruz","Santa Cruz de La Sierra","Colegio Marista",147,0,0,0,7,28,3,0,0,185,0,4,189,211,0.038,0.896
"20301","Santa Cruz","Santa Cruz de La Sierra","Colegio Marista",142,0,0,0,6,34,7,0,0,189,0,1,190,213,0.032,0.892
"20302","Santa Cruz","Santa Cruz de La Sierra","Colegio Marista",162,0,0,2,11,17,1,1,0,194,1,3,198,223,0.057,0.888
"20303","Santa Cruz","Santa Cruz de La Sierra","Colegio Marista",148,0,0,0,8,24,2,0,0,182,1,3,186,214,0.044,0.869
"20304","Santa Cruz","Santa Cruz de La Sierra","Colegio Marista",155,0,0,2,14,21,4,0,0,196,0,2,198,227,0.071,0.872
"20305","Santa Cruz","Santa Cruz de La Sierra","Col. Republica del Uruguay",148,0,0,1,14,13,7,2,0,185,0,2,187,219,0.076,0.854
"20306","Santa Cruz","Santa Cruz de La Sierra","Col. Republica del Uruguay",163,0,1,0,13,12,4,2,1,196,1,1,198,221,0.066,0.896
"20307","Santa Cruz","Santa Cruz de La Sierra","Col. Republica del Uruguay",141,0,0,1,23,17,6,1,0,189,0,3,192,213,0.122,0.901
"20308","Santa Cruz","Santa Cruz de La Sierra","Col. Republica del Uruguay",146,0,0,1,15,16,8,3,0,189,1,4,194,224,0.079,0.866
"20309","Santa Cruz","Santa Cruz de La Sierra","Col. Republica del Uruguay",136,0,0,1,23,20,6,1,0,187,1,0,188,228,0.123,0.825
"20310","Santa Cruz","Santa Cruz de La Sierra","Col. Republica del Uruguay",146,0,0,1,22,14,7,0,0,190,0,6,196,225,0.116,0.871
"20311","Santa Cruz","Santa Cruz de La Sierra","Col. Republica del Uruguay",139,0,0,0,22,12,6,0,0,179,0,1,180,208,0.123,0.865
"20312","Santa Cruz","Santa Cruz de La Sierra","Col. Republica del Uruguay",139,0,0,4,11,19,3,0,0,176,0,2,178,214,0.062,0.832
"20313","Santa Cruz","Santa Cruz de La Sierra","Col. Republica del Uruguay",129,0,0,1,21,16,4,1,1,173,1,0,174,215,0.121,0.809
"20314","Santa Cruz","Santa Cruz de La Sierra","Col. Republica del Uruguay",147,1,0,0,26,14,1,0,0,189,1,8,198,221,0.138,0.896
"20315","Santa Cruz","Santa Cruz de La Sierra","Col. Republica del Uruguay",144,0,0,1,14,15,8,0,0,182,4,5,191,219,0.077,0.872
"20316","Santa Cruz","Santa Cruz de La Sierra","Col. Republica del Uruguay",146,2,0,0,13,14,6,0,1,182,0,6,188,219,0.071,0.858
"20317","Santa Cruz","Santa Cruz de La Sierra","Col. Republica del Uruguay",145,0,0,1,12,16,7,0,1,182,0,5,187,219,0.066,0.854
"20318","Santa Cruz","Santa Cruz de La Sierra","Col. Republica del Uruguay",143,0,1,0,29,6,9,2,0,190,36,5,231,231,0.153,1
"20319","Santa Cruz","Santa Cruz de La Sierra","Col. Boston College",154,0,0,2,17,14,6,0,1,194,0,3,197,220,0.088,0.895
"20320","Santa Cruz","Santa Cruz de La Sierra","Col. Boston College",151,1,0,0,11,19,7,0,0,189,0,2,191,226,0.058,0.845
"20321","Santa Cruz","Santa Cruz de La Sierra","Col. Boston College",147,2,0,2,19,10,9,0,0,189,1,3,193,221,0.101,0.873
"20322","Santa Cruz","Santa Cruz de La Sierra","Col. Boston College",167,0,0,2,10,9,5,1,1,195,1,5,201,221,0.051,0.91
"20323","Santa Cruz","Santa Cruz de La Sierra","Col. Boston College",170,0,0,1,12,19,4,0,0,206,0,1,207,231,0.058,0.896
"20324","Santa Cruz","Santa Cruz de La Sierra","Col. Boston College",160,0,0,2,16,13,5,2,0,198,0,2,200,222,0.081,0.901
"20325","Santa Cruz","Santa Cruz de La Sierra","Col. Boston College",150,0,0,0,10,20,6,1,0,187,1,4,192,225,0.053,0.853
"20326","Santa Cruz","Santa Cruz de La Sierra","Col. Gaston Guillaux",134,0,0,0,26,18,7,4,0,189,1,2,192,225,0.138,0.853
"20327","Santa Cruz","Santa Cruz de La Sierra","Col. Gaston Guillaux",141,0,1,1,27,13,3,1,2,189,0,8,197,225,0.143,0.876
"20328","Santa Cruz","Santa Cruz de La Sierra","Col. Gaston Guillaux",128,0,0,1,27,9,9,2,0,176,0,6,182,219,0.153,0.831
"20329","Santa Cruz","Santa Cruz de La Sierra","Col. Gaston Guillaux",122,0,1,0,37,8,10,0,1,179,1,7,187,230,0.207,0.813
"20330","Santa Cruz","Santa Cruz de La Sierra","Col. Gaston Guillaux",148,0,0,0,34,9,7,1,1,200,0,5,205,229,0.17,0.895
"20331","Santa Cruz","Santa Cruz de La Sierra","Col. Gaston Guillaux",125,0,1,2,25,11,10,2,0,176,2,2,180,220,0.142,0.818
"20332","Santa Cruz","Santa Cruz de La Sierra","Col. Gaston Guillaux",131,0,0,0,23,9,13,0,1,177,1,5,183,216,0.13,0.847
"20333","Santa Cruz","Santa Cruz de La Sierra","Col. Gaston Guillaux",128,0,1,1,21,15,6,0,1,173,0,1,174,213,0.121,0.817
"20334","Santa Cruz","Santa Cruz de La Sierra","Col. Gaston Guillaux",111,0,1,2,51,11,4,0,1,181,3,5,189,229,0.282,0.825
"20335","Santa Cruz","Santa Cruz de La Sierra","Col. Gaston Guillaux",138,0,0,1,22,13,10,1,0,185,0,4,189,217,0.119,0.871
"20336","Santa Cruz","Santa Cruz de La Sierra","Col. Gaston Guillaux",140,0,1,0,28,13,8,1,1,192,0,2,194,225,0.146,0.862
"20337","Santa Cruz","Santa Cruz de La Sierra","Col. Gaston Guillaux",122,0,0,0,27,19,10,1,0,179,1,3,183,221,0.151,0.828
"20338","Santa Cruz","Santa Cruz de La Sierra","Col. Gaston Guillaux",129,0,0,0,32,14,6,2,0,183,0,3,186,229,0.175,0.812
"20339","Santa Cruz","Santa Cruz de La Sierra","Col. Gaston Guillaux",142,0,0,0,21,21,10,0,0,194,0,1,195,223,0.108,0.874
"20340","Santa Cruz","Santa Cruz de La Sierra","Col. Gaston Guillaux",143,0,0,0,20,13,5,1,0,182,1,1,184,217,0.11,0.848
"20341","Santa Cruz","Santa Cruz de La Sierra","Col. Gaston Guillaux",142,0,0,0,29,8,6,2,0,187,2,6,195,225,0.155,0.867
"20342","Santa Cruz","Santa Cruz de La Sierra","Col. Gaston Guillaux",122,0,1,1,37,13,9,3,1,187,2,3,192,226,0.198,0.85
"20343","Santa Cruz","Santa Cruz de La Sierra","Col. Gaston Guillaux",120,0,0,0,40,9,11,2,1,183,1,4,188,228,0.219,0.825
"20344","Santa Cruz","Santa Cruz de La Sierra","Col. Instituto Americano Juan Wesley",150,0,0,2,27,14,5,1,0,199,3,2,204,223,0.136,0.915
"20345","Santa Cruz","Santa Cruz de La Sierra","Col. Instituto Americano Juan Wesley",161,0,0,0,8,18,7,1,0,195,1,3,199,223,0.041,0.892
"20346","Santa Cruz","Santa Cruz de La Sierra","Col. Instituto Americano Juan Wesley",143,0,1,3,18,17,4,2,2,190,2,7,199,222,0.095,0.896
"20347","Santa Cruz","Santa Cruz de La Sierra","Col. Instituto Americano Juan Wesley",147,0,0,0,25,16,8,1,0,197,0,3,200,226,0.127,0.885
"20348","Santa Cruz","Santa Cruz de La Sierra","Col. Instituto Americano Juan Wesley",167,0,0,1,17,11,4,3,0,203,1,1,205,226,0.084,0.907
"20349","Santa Cruz","Santa Cruz de La Sierra","Col. Instituto Americano Juan Wesley",157,0,1,1,17,15,8,2,0,201,2,4,207,228,0.085,0.908
"20350","Santa Cruz","Santa Cruz de La Sierra","Col. Instituto Americano Juan Wesley",145,0,0,3,14,16,5,0,1,184,0,6,190,221,0.076,0.86
"20351","Santa Cruz","Santa Cruz de La Sierra","Col. Instituto Americano Juan Wesley",170,0,1,1,17,8,6,0,0,203,0,0,203,225,0.084,0.902
"20352","Santa Cruz","Santa Cruz de La Sierra","Col. Instituto Americano Juan Wesley",164,0,0,1,16,14,3,0,0,198,2,4,204,227,0.081,0.899
"20353","Santa Cruz","Santa Cruz de La Sierra","Col. Instituto Americano Juan Wesley",152,0,0,1,27,14,2,0,0,196,0,5,201,227,0.138,0.885
"20354","Santa Cruz","Santa Cruz de La Sierra","Col. Instituto Americano Juan Wesley",145,2,1,1,18,14,4,4,0,189,0,6,195,222,0.095,0.878
"20355","Santa Cruz","Santa Cruz de La Sierra","Col. Instituto Americano Juan Wesley",150,0,0,1,22,6,5,0,0,184,2,7,193,223,0.12,0.865
"20356","Santa Cruz","Santa Cruz de La Sierra","Col. Instituto Americano Juan Wesley",137,0,0,1,19,16,6,2,0,181,1,6,188,225,0.105,0.836
"20357","Santa Cruz","Santa Cruz de La Sierra","Col. Instituto Americano Juan Wesley",165,1,0,3,17,13,6,0,0,205,0,4,209,234,0.083,0.893
"20358","Santa Cruz","Santa Cruz de La Sierra","Col. Dios es Amor",155,0,1,1,19,12,4,1,0,193,3,5,201,221,0.098,0.91
"20359","Santa Cruz","Santa Cruz de La Sierra","Col. Dios es Amor",141,0,0,1,22,20,7,2,0,193,0,4,197,222,0.114,0.887
"20360","Santa Cruz","Santa Cruz de La Sierra","Col. Dios es Amor",144,0,0,0,15,14,5,2,1,181,1,5,187,215,0.083,0.87
"20361","Santa Cruz","Santa Cruz de La Sierra","Col. Dios es Amor",139,0,0,1,28,13,2,1,0,184,3,2,189,216,0.152,0.875
"20362","Santa Cruz","Santa Cruz de La Sierra","Col. Dios es Amor",150,0,0,1,18,12,5,3,1,190,0,8,198,227,0.095,0.872
"20363","Santa Cruz","Santa Cruz de La Sierra","Col. Dios es Amor",134,0,0,2,24,14,9,3,0,186,1,5,192,225,0.129,0.853
"20364","Santa Cruz","Santa Cruz de La Sierra","Col. Dios es Amor",145,0,0,0,9,12,3,2,0,171,1,4,176,195,0.053,0.903
"20365","Santa Cruz","Santa Cruz de La Sierra","Col. Nacional Salesiano",144,0,1,1,20,13,5,1,0,185,0,2,187,222,0.108,0.842
"20366","Santa Cruz","Santa Cruz de La Sierra","Col. Nacional Salesiano",133,0,0,2,27,16,3,0,0,181,2,6,189,218,0.149,0.867
"20367","Santa Cruz","Santa Cruz de La Sierra","Col. Nacional Salesiano",139,0,0,3,31,10,5,4,0,192,1,4,197,217,0.161,0.908
"20368","Santa Cruz","Santa Cruz de La Sierra","Col. Nacional Salesiano",157,0,1,2,23,7,7,2,0,199,0,6,205,227,0.116,0.903
"20369","Santa Cruz","Santa Cruz de La Sierra","Col. Nacional Salesiano",128,0,1,2,35,12,1,1,0,180,1,5,186,224,0.194,0.83
"20370","Santa Cruz","Santa Cruz de La Sierra","Col. Nacional Salesiano",145,0,0,1,23,16,8,0,1,194,1,3,198,220,0.119,0.9
"20371","Santa Cruz","Santa Cruz de La Sierra","Col. Nacional Salesiano",136,0,0,0,25,11,10,1,0,183,0,8,191,221,0.137,0.864
"20372","Santa Cruz","Santa Cruz de La Sierra","Col. Nacional Salesiano",144,0,0,1,24,16,6,1,0,192,1,3,196,226,0.125,0.867
"20373","Santa Cruz","Santa Cruz de La Sierra","Col. Nacional Salesiano",122,1,1,3,23,11,2,0,0,163,0,1,164,180,0.141,0.911
"20374","Santa Cruz","Santa Cruz de La Sierra","Col. Club De Leones",161,0,0,0,15,15,5,4,2,202,1,4,207,226,0.074,0.916
"20375","Santa Cruz","Santa Cruz de La Sierra","Col. Club De Leones",147,1,0,0,21,14,5,0,0,188,1,8,197,222,0.112,0.887
"20376","Santa Cruz","Santa Cruz de La Sierra","Col. Club De Leones",140,0,0,2,23,20,9,1,0,195,1,3,199,226,0.118,0.881
"20377","Santa Cruz","Santa Cruz de La Sierra","Col. Club De Leones",141,0,0,1,25,12,6,3,0,188,0,7,195,220,0.133,0.886
"20378","Santa Cruz","Santa Cruz de La Sierra","Col. Club De Leones",140,0,1,0,28,13,5,2,0,189,1,4,194,217,0.148,0.894
"20379","Santa Cruz","Santa Cruz de La Sierra","Col. Club De Leones",144,0,0,0,23,20,7,0,0,194,2,0,196,219,0.119,0.895
"20380","Santa Cruz","Santa Cruz de La Sierra","Col. Club De Leones",137,0,0,2,24,9,8,2,0,182,2,6,190,219,0.132,0.868
"20381","Santa Cruz","Santa Cruz de La Sierra","Col. Club De Leones",152,0,0,3,20,13,2,2,0,192,0,5,197,221,0.104,0.891
"20382","Santa Cruz","Santa Cruz de La Sierra","Col. Club De Leones",124,1,0,0,41,14,5,1,0,186,1,3,190,210,0.22,0.905
"20383","Santa Cruz","Santa Cruz de La Sierra","Col. Josefina Goytia",147,0,0,1,21,14,4,0,0,187,0,4,191,220,0.112,0.868
"20384","Santa Cruz","Santa Cruz de La Sierra","Col. Josefina Goytia",153,0,2,0,12,24,3,1,0,195,1,5,201,217,0.062,0.926
"20385","Santa Cruz","Santa Cruz de La Sierra","Col. Josefina Goytia",151,0,0,0,22,11,2,0,0,186,1,10,197,220,0.118,0.895
"20386","Santa Cruz","Santa Cruz de La Sierra","Col. Josefina Goytia",149,0,0,0,17,17,1,0,0,184,0,9,193,216,0.092,0.894
"20387","Santa Cruz","Santa Cruz de La Sierra","Col. Josefina Goytia",149,0,1,0,7,18,3,0,0,178,0,6,184,215,0.039,0.856
"20388","Santa Cruz","Santa Cruz de La Sierra","Colegio Don Bosco",146,0,0,1,15,14,2,1,0,179,0,4,183,218,0.084,0.839
"20389","Santa Cruz","Santa Cruz de La Sierra","Colegio Don Bosco",140,0,0,1,20,11,8,0,0,180,1,2,183,218,0.111,0.839
"20390","Santa Cruz","Santa Cruz de La Sierra","Colegio Don Bosco",136,0,0,1,16,22,5,2,3,185,0,4,189,223,0.086,0.848
"20391","Santa Cruz","Santa Cruz de La Sierra","Colegio Don Bosco",153,0,0,1,14,21,1,2,0,192,0,4,196,227,0.073,0.863
"20392","Santa Cruz","Santa Cruz de La Sierra","Colegio Don Bosco",132,0,0,2,19,19,3,0,0,175,1,5,181,216,0.109,0.838
"20393","Santa Cruz","Santa Cruz de La Sierra","Colegio Don Bosco",133,0,1,2,19,21,5,1,1,183,0,4,187,219,0.104,0.854
"20394","Santa Cruz","Santa Cruz de La Sierra","Colegio Don Bosco",143,0,1,0,14,19,6,1,1,185,0,2,187,222,0.076,0.842
"20395","Santa Cruz","Santa Cruz de La Sierra","Colegio Don Bosco",147,0,0,3,22,17,3,1,0,193,0,3,196,224,0.114,0.875
"20396","Santa Cruz","Santa Cruz de La Sierra","Colegio Don Bosco",133,0,0,1,18,11,7,2,0,172,0,3,175,221,0.105,0.792
"20397","Santa Cruz","Santa Cruz de La Sierra","Colegio Don Bosco",141,0,0,0,13,21,3,0,0,178,1,6,185,222,0.073,0.833
"20398","Santa Cruz","Santa Cruz de La Sierra","Colegio Don Bosco",136,0,0,1,20,25,4,2,0,188,0,5,193,225,0.106,0.858
"20399","Santa Cruz","Santa Cruz de La Sierra","Colegio Don Bosco",142,0,1,1,24,19,6,1,1,195,0,3,198,229,0.123,0.865
"20400","Santa Cruz","Santa Cruz de La Sierra","Col. La Santa Cruz",155,0,0,1,12,18,5,1,0,192,0,8,200,225,0.062,0.889
"20401","Santa Cruz","Santa Cruz de La Sierra","Col. La Santa Cruz",167,0,0,0,8,14,4,0,0,193,1,6,200,227,0.041,0.881
"20402","Santa Cruz","Santa Cruz de La Sierra","Col. La Santa Cruz",149,0,0,2,10,14,5,0,1,181,1,8,190,218,0.055,0.872
"20403","Santa Cruz","Santa Cruz de La Sierra","Col. La Santa Cruz",150,0,0,1,13,17,2,1,0,184,0,1,185,221,0.071,0.837
"20404","Santa Cruz","Santa Cruz de La Sierra","Col. La Santa Cruz",159,0,0,1,12,16,5,3,0,196,0,2,198,215,0.061,0.921
"20405","Santa Cruz","Santa Cruz de La Sierra","Col. La Santa Cruz",135,0,0,1,16,19,4,1,1,177,0,1,178,210,0.09,0.848
"20406","Santa Cruz","Santa Cruz de La Sierra","Col. La Santa Cruz",153,0,0,0,11,21,0,1,0,186,1,3,190,219,0.059,0.868
"20407","Santa Cruz","Santa Cruz de La Sierra","Col. La Santa Cruz",165,0,0,2,6,11,2,1,2,189,0,2,191,222,0.032,0.86
"20408","Santa Cruz","Santa Cruz de La Sierra","Col. La Santa Cruz",150,0,0,2,13,11,6,0,1,183,0,1,184,215,0.071,0.856
"20409","Santa Cruz","Santa Cruz de La Sierra","Col. La Santa Cruz",145,0,0,0,11,22,3,1,1,183,0,6,189,217,0.06,0.871
"20410","Santa Cruz","Santa Cruz de La Sierra","Col. La Santa Cruz",153,0,0,0,12,16,4,0,0,185,1,1,187,211,0.065,0.886
"20411","Santa Cruz","Santa Cruz de La Sierra","Col. Britanico",167,0,0,2,12,14,2,0,0,197,0,3,200,230,0.061,0.87
"20412","Santa Cruz","Santa Cruz de La Sierra","Col. Britanico",164,0,0,0,7,16,1,0,0,188,0,11,199,228,0.037,0.873
"20413","Santa Cruz","Santa Cruz de La Sierra","Col. Britanico",169,0,0,0,10,11,10,1,0,201,0,3,204,228,0.05,0.895
"20414","Santa Cruz","Santa Cruz de La Sierra","Col. Britanico",159,0,0,0,11,19,3,0,0,192,1,3,196,228,0.057,0.86
"20415","Santa Cruz","Santa Cruz de La Sierra","Col. Britanico",156,0,0,0,8,21,2,1,0,188,0,4,192,226,0.043,0.85
"20416","Santa Cruz","Santa Cruz de La Sierra","Col. Britanico",164,0,0,2,8,20,1,0,0,195,0,3,198,226,0.041,0.876
"20417","Santa Cruz","Santa Cruz de La Sierra","Col. Britanico",163,0,0,0,5,20,4,1,1,194,0,2,196,222,0.026,0.883
"20418","Santa Cruz","Santa Cruz de La Sierra","Col. Britanico",159,0,0,1,10,14,1,0,0,185,0,5,190,222,0.054,0.856
"20419","Santa Cruz","Santa Cruz de La Sierra","Col. Britanico",163,0,0,1,5,17,1,1,0,188,0,6,194,219,0.027,0.886
"20420","Santa Cruz","Santa Cruz de La Sierra","Col. Britanico",151,0,0,0,12,23,2,1,0,189,0,4,193,219,0.063,0.881
"20421","Santa Cruz","Santa Cruz de La Sierra","Col. Britanico",169,0,0,1,13,14,1,0,0,198,0,2,200,229,0.066,0.873
"20422","Santa Cruz","Santa Cruz de La Sierra","Col. Britanico",160,0,0,0,8,19,7,0,0,194,0,2,196,219,0.041,0.895
"20423","Santa Cruz","Santa Cruz de La Sierra","Col. Britanico",166,0,0,1,10,16,2,0,0,195,1,3,199,228,0.051,0.873
"20424","Santa Cruz","Santa Cruz de La Sierra","Col. Britanico",167,0,0,0,9,14,6,2,0,198,0,2,200,225,0.045,0.889
"20425","Santa Cruz","Santa Cruz de La Sierra","Col. Liceo Maria Vacadiez",137,0,0,2,17,18,3,0,0,177,1,8,186,212,0.096,0.877
"20426","Santa Cruz","Santa Cruz de La Sierra","Col. Liceo Maria Vacadiez",147,0,0,1,24,17,7,1,0,197,1,8,206,229,0.122,0.9
"20427","Santa Cruz","Santa Cruz de La Sierra","Col. Liceo Maria Vacadiez",142,0,0,0,20,18,6,1,0,187,0,5,192,230,0.107,0.835
"20428","Santa Cruz","Santa Cruz de La Sierra","Col. Liceo Maria Vacadiez",127,0,0,1,30,22,7,4,2,193,0,5,198,226,0.155,0.876
"20429","Santa Cruz","Santa Cruz de La Sierra","Col. Liceo Maria Vacadiez",146,0,0,0,19,23,4,1,0,193,0,3,196,221,0.098,0.887
"20430","Santa Cruz","Santa Cruz de La Sierra","Col. Liceo Maria Vacadiez",153,0,0,0,6,24,5,0,0,188,1,3,192,221,0.032,0.869
"20431","Santa Cruz","Santa Cruz de La Sierra","Col. Liceo Maria Vacadiez",152,1,0,0,10,19,6,2,0,190,0,5,195,226,0.053,0.863
"20432","Santa Cruz","Santa Cruz de La Sierra","Col. Liceo Maria Vacadiez",153,0,0,1,13,15,3,0,0,185,1,2,188,223,0.07,0.843
"20433","Santa Cruz","Santa Cruz de La Sierra","Col. Pablo Sexto",144,0,0,0,28,19,8,0,0,199,1,5,205,227,0.141,0.903
"20434","Santa Cruz","Santa Cruz de La Sierra","Col. Pablo Sexto",137,1,0,0,28,7,9,1,0,183,3,4,190,221,0.153,0.86
"20435","Santa Cruz","Santa Cruz de La Sierra","Col. Pablo Sexto",140,0,1,0,32,17,6,2,0,198,0,1,199,225,0.162,0.884
"20436","Santa Cruz","Santa Cruz de La Sierra","Col. Pablo Sexto",133,0,0,2,35,15,8,1,1,195,0,5,200,224,0.179,0.893
"20437","Santa Cruz","Santa Cruz de La Sierra","Col. Pablo Sexto",136,0,0,3,33,12,6,2,0,192,0,6,198,222,0.172,0.892
"20438","Santa Cruz","Santa Cruz de La Sierra","Col. Pablo Sexto",147,0,0,1,32,8,10,0,0,198,0,4,202,228,0.162,0.886
"20439","Santa Cruz","Santa Cruz de La Sierra","Col. Pablo Sexto",124,0,0,1,39,15,15,2,0,196,0,2,198,225,0.199,0.88
"20440","Santa Cruz","Santa Cruz de La Sierra","Col. Pablo Sexto",133,0,0,4,30,17,12,2,1,199,1,7,207,229,0.151,0.904
"20441","Santa Cruz","Santa Cruz de La Sierra","Col. Pablo Sexto",156,0,0,2,13,11,8,5,0,195,0,2,197,221,0.067,0.891
"20442","Santa Cruz","Santa Cruz de La Sierra","Col. Pablo Sexto",137,0,0,1,36,14,12,2,1,203,0,2,205,226,0.177,0.907
"20443","Santa Cruz","Santa Cruz de La Sierra","Col. Domingo Leigue (Boliviano Canadiense)",153,0,0,1,17,18,5,4,0,198,1,0,199,223,0.086,0.892
"20444","Santa Cruz","Santa Cruz de La Sierra","Col. Domingo Leigue (Boliviano Canadiense)",146,0,0,4,21,12,2,3,0,188,0,4,192,213,0.112,0.901
"20445","Santa Cruz","Santa Cruz de La Sierra","Col. Domingo Leigue (Boliviano Canadiense)",141,0,0,1,28,10,5,0,0,185,0,6,191,217,0.151,0.88
"20446","Santa Cruz","Santa Cruz de La Sierra","Col. Domingo Leigue (Boliviano Canadiense)",143,0,0,1,24,18,5,1,0,192,0,5,197,224,0.125,0.879
"20447","Santa Cruz","Santa Cruz de La Sierra","Col. Domingo Leigue (Boliviano Canadiense)",153,0,0,0,24,15,5,3,0,200,0,2,202,226,0.12,0.894
"20448","Santa Cruz","Santa Cruz de La Sierra","Col. Domingo Leigue (Boliviano Canadiense)",146,0,1,2,26,11,4,0,1,191,0,5,196,219,0.136,0.895
"20449","Santa Cruz","Santa Cruz de La Sierra","Col. Domingo Leigue (Boliviano Canadiense)",168,0,0,0,12,15,4,2,0,201,2,5,208,229,0.06,0.908
"20450","Santa Cruz","Santa Cruz de La Sierra","Col. Domingo Leigue (Boliviano Canadiense)",171,0,0,0,9,9,8,1,0,198,0,3,201,224,0.045,0.897
"20451","Santa Cruz","Santa Cruz de La Sierra","Col. Domingo Leigue (Boliviano Canadiense)",148,0,0,1,21,18,6,0,0,194,0,4,198,224,0.108,0.884
"20452","Santa Cruz","Santa Cruz de La Sierra","Col. Domingo Leigue (Boliviano Canadiense)",165,1,0,1,12,16,10,1,0,206,0,5,211,228,0.058,0.925
"20453","Santa Cruz","Santa Cruz de La Sierra","Col. Venancio Aquino Villegas",157,0,0,0,21,9,9,1,0,197,0,3,200,226,0.107,0.885
"20454","Santa Cruz","Santa Cruz de La Sierra","Col. Venancio Aquino Villegas",147,0,0,0,22,10,7,0,0,186,1,12,199,229,0.118,0.869
"20455","Santa Cruz","Santa Cruz de La Sierra","Col. Venancio Aquino Villegas",172,0,0,0,13,13,1,0,0,199,0,4,203,226,0.065,0.898
"20456","Santa Cruz","Santa Cruz de La Sierra","Col. Venancio Aquino Villegas",154,0,1,1,20,15,2,1,0,194,0,3,197,219,0.103,0.9
"20457","Santa Cruz","Santa Cruz de La Sierra","Col. Venancio Aquino Villegas",150,0,1,0,18,17,5,1,0,192,0,5,197,217,0.094,0.908
"20458","Santa Cruz","Santa Cruz de La Sierra","Col. Venancio Aquino Villegas",159,0,0,4,17,18,6,1,0,205,0,2,207,226,0.083,0.916
"20459","Santa Cruz","Santa Cruz de La Sierra","Col. Venancio Aquino Villegas",135,0,0,2,13,9,6,2,0,167,2,7,176,199,0.078,0.884
"20460","Santa Cruz","Santa Cruz de La Sierra","Col. Gualberto Villarroel",144,0,0,2,24,16,7,2,0,195,1,4,200,227,0.123,0.881
"20461","Santa Cruz","Santa Cruz de La Sierra","Col. Gualberto Villarroel",158,0,0,1,9,11,6,0,0,185,0,5,190,216,0.049,0.88
"20462","Santa Cruz","Santa Cruz de La Sierra","Col. Gualberto Villarroel",160,0,0,0,16,8,6,1,0,191,1,5,197,221,0.084,0.891
"20463","Santa Cruz","Santa Cruz de La Sierra","Col. Gualberto Villarroel",141,0,0,2,25,18,11,0,0,197,1,3,201,224,0.127,0.897
"20464","Santa Cruz","Santa Cruz de La Sierra","Col. Gualberto Villarroel",131,0,0,1,23,21,10,2,0,188,0,2,190,221,0.122,0.86
"20465","Santa Cruz","Santa Cruz de La Sierra","Col. Gualberto Villarroel",150,0,0,1,18,11,11,0,0,191,0,7,198,228,0.094,0.868
"20466","Santa Cruz","Santa Cruz de La Sierra","Col. Gualberto Villarroel",149,0,0,0,25,9,8,0,0,191,0,2,193,221,0.131,0.873
"20467","Santa Cruz","Santa Cruz de La Sierra","Col. Gualberto Villarroel",143,0,0,1,24,14,11,4,0,197,1,2,200,230,0.122,0.87
"20468","Santa Cruz","Santa Cruz de La Sierra","Col. Gualberto Villarroel",156,0,0,3,15,9,11,1,0,195,0,4,199,228,0.077,0.873
"20469","Santa Cruz","Santa Cruz de La Sierra","Col. Gualberto Villarroel",157,1,0,2,23,18,5,0,0,206,0,4,210,232,0.112,0.905
"20470","Santa Cruz","Santa Cruz de La Sierra","Col. Gualberto Villarroel",146,0,0,0,15,22,11,1,0,195,0,5,200,228,0.077,0.877
"20471","Santa Cruz","Santa Cruz de La Sierra","Col. Gualberto Villarroel",145,0,0,1,13,20,14,0,0,193,2,2,197,226,0.067,0.872
"20472","Santa Cruz","Santa Cruz de La Sierra","Col. Gualberto Villarroel",144,0,1,2,27,14,14,1,0,203,0,7,210,232,0.133,0.905
"20473","Santa Cruz","Santa Cruz de La Sierra","Col. Gualberto Villarroel",145,0,0,0,25,15,8,1,0,194,0,3,197,222,0.129,0.887
"20474","Santa Cruz","Santa Cruz de La Sierra","Col. Club De Leones #10 (Máximo Diescher)",138,0,0,1,15,23,6,4,0,187,0,4,191,221,0.08,0.864
"20475","Santa Cruz","Santa Cruz de La Sierra","Col. Club De Leones #10 (Máximo Diescher)",135,0,1,0,29,7,9,4,0,185,1,1,187,218,0.157,0.858
"20476","Santa Cruz","Santa Cruz de La Sierra","Col. Club De Leones #10 (Máximo Diescher)",140,0,0,1,22,24,4,0,0,191,0,4,195,218,0.115,0.894
"20477","Santa Cruz","Santa Cruz de La Sierra","Col. Club De Leones #10 (Máximo Diescher)",137,0,0,4,23,16,5,3,1,189,1,6,196,222,0.122,0.883
"20478","Santa Cruz","Santa Cruz de La Sierra","Col. Club De Leones #10 (Máximo Diescher)",140,0,0,0,14,16,6,2,0,178,0,7,185,210,0.079,0.881
"20479","Santa Cruz","Santa Cruz de La Sierra","Col. Club De Leones #10 (Máximo Diescher)",146,0,1,1,27,24,2,2,0,203,1,5,209,227,0.133,0.921
"20480","Santa Cruz","Santa Cruz de La Sierra","Col. Tristan Roca",122,0,1,0,32,16,14,1,0,186,0,5,191,216,0.172,0.884
"20481","Santa Cruz","Santa Cruz de La Sierra","Col. Tristan Roca",132,0,0,1,35,18,5,1,1,193,1,4,198,227,0.181,0.872
"20482","Santa Cruz","Santa Cruz de La Sierra","Col. Tristan Roca",120,0,0,1,39,14,11,1,0,186,0,7,193,218,0.21,0.885
"20483","Santa Cruz","Santa Cruz de La Sierra","Col. Tristan Roca",130,0,0,3,26,20,14,3,0,196,2,2,200,219,0.133,0.913
"20484","Santa Cruz","Santa Cruz de La Sierra","Col. Tristan Roca",132,0,0,0,21,16,10,1,0,180,0,5,185,218,0.117,0.849
"20485","Santa Cruz","Santa Cruz de La Sierra","Col. Tristan Roca",134,0,2,0,30,16,6,0,0,188,1,7,196,220,0.16,0.891
"20486","Santa Cruz","Santa Cruz de La Sierra","Col. Tristan Roca",142,0,0,0,21,16,10,0,0,189,2,5,196,223,0.111,0.879
"20487","Santa Cruz","Santa Cruz de La Sierra","Col. Tristan Roca",143,1,0,0,19,24,2,1,0,190,0,9,199,225,0.1,0.884
"20488","Santa Cruz","Santa Cruz de La Sierra","Col. Tristan Roca",131,0,0,5,26,17,8,2,1,190,2,3,195,223,0.137,0.874
"20489","Santa Cruz","Santa Cruz de La Sierra","Col. Tristan Roca",132,0,0,0,21,21,6,2,2,184,2,5,191,219,0.114,0.872
"20490","Santa Cruz","Santa Cruz de La Sierra","Col. Tristan Roca",134,0,0,1,25,10,13,2,0,185,0,6,191,217,0.135,0.88
"20491","Santa Cruz","Santa Cruz de La Sierra","Col. Tristan Roca",130,0,0,0,24,22,13,0,0,189,0,4,193,220,0.127,0.877
"20492","Santa Cruz","Santa Cruz de La Sierra","Colegio Justo Leigue",169,0,1,1,11,15,2,0,0,199,0,4,203,228,0.055,0.89
"20493","Santa Cruz","Santa Cruz de La Sierra","Colegio Justo Leigue",155,0,1,0,20,18,5,0,0,199,1,1,201,223,0.101,0.901
"20494","Santa Cruz","Santa Cruz de La Sierra","Colegio Justo Leigue",158,0,0,0,28,10,6,1,0,203,0,4,207,223,0.138,0.928
"20495","Santa Cruz","Santa Cruz de La Sierra","Colegio Justo Leigue",150,0,1,0,22,11,6,0,3,193,1,2,196,218,0.114,0.899
"20496","Santa Cruz","Santa Cruz de La Sierra","Colegio Justo Leigue",161,0,0,2,20,7,2,1,1,194,0,7,201,222,0.103,0.905
"20497","Santa Cruz","Santa Cruz de La Sierra","Colegio Justo Leigue",167,0,0,0,17,15,4,2,0,205,1,0,206,223,0.083,0.924
"20498","Santa Cruz","Santa Cruz de La Sierra","Colegio Justo Leigue",149,0,0,0,17,20,4,1,0,191,0,4,195,219,0.089,0.89
"20499","Santa Cruz","Santa Cruz de La Sierra","Col. Carmen Ortiz De Peredo",164,0,0,1,8,16,7,1,0,197,1,5,203,227,0.041,0.894
"20500","Santa Cruz","Santa Cruz de La Sierra","Col. Carmen Ortiz De Peredo",151,1,0,1,19,13,6,2,0,193,0,2,195,223,0.098,0.874
"20501","Santa Cruz","Santa Cruz de La Sierra","Col. Carmen Ortiz De Peredo",155,0,0,0,8,22,7,1,0,193,0,5,198,224,0.041,0.884
"20502","Santa Cruz","Santa Cruz de La Sierra","Col. Carmen Ortiz De Peredo",158,0,0,1,11,13,4,0,0,187,1,3,191,223,0.059,0.857
"20503","Santa Cruz","Santa Cruz de La Sierra","Col. Carmen Ortiz De Peredo",161,0,0,0,17,11,7,0,0,196,0,3,199,220,0.087,0.905
"20504","Santa Cruz","Santa Cruz de La Sierra","Col. Carmen Ortiz De Peredo",156,0,0,0,9,21,9,1,0,196,0,1,197,223,0.046,0.883
"20505","Santa Cruz","Santa Cruz de La Sierra","Col. Carmen Ortiz De Peredo",151,0,0,0,15,14,5,0,0,185,1,2,188,220,0.081,0.855
"20506","Santa Cruz","Santa Cruz de La Sierra","Col. Carmen Ortiz De Peredo",148,0,0,0,16,20,7,0,1,192,1,3,196,224,0.083,0.875
"20507","Santa Cruz","Santa Cruz de La Sierra","Col. Carmen Ortiz De Peredo",173,0,0,1,10,11,3,0,0,198,1,2,201,229,0.051,0.878
"20508","Santa Cruz","Santa Cruz de La Sierra","Col. Carmen Ortiz De Peredo",139,0,0,0,18,17,8,0,0,182,1,5,188,226,0.099,0.832
"20509","Santa Cruz","Santa Cruz de La Sierra","Col. Carmen Ortiz De Peredo",158,0,0,1,7,19,3,0,0,188,0,5,193,222,0.037,0.869
"20510","Santa Cruz","Santa Cruz de La Sierra","Col. Carmen Ortiz De Peredo",147,0,1,2,15,26,9,0,0,200,2,2,204,228,0.075,0.895
"20511","Santa Cruz","Santa Cruz de La Sierra","Col. Carmen Ortiz De Peredo",154,0,0,3,12,14,1,0,0,184,0,10,194,223,0.065,0.87
"20512","Santa Cruz","Santa Cruz de La Sierra","Col. Pedro Gutierrez",158,0,0,2,7,20,10,0,0,197,0,4,201,225,0.036,0.893
"20513","Santa Cruz","Santa Cruz de La Sierra","Col. Pedro Gutierrez",166,0,0,0,14,14,3,0,0,197,1,3,201,226,0.071,0.889
"20514","Santa Cruz","Santa Cruz de La Sierra","Col. Pedro Gutierrez",164,1,1,2,15,7,10,2,0,202,1,10,213,227,0.074,0.938
"20515","Santa Cruz","Santa Cruz de La Sierra","Col. Pedro Gutierrez",145,0,0,1,20,12,7,0,1,186,0,6,192,222,0.108,0.865
"20516","Santa Cruz","Santa Cruz de La Sierra","Col. Pedro Gutierrez",146,1,0,0,10,25,9,1,0,192,0,2,194,218,0.052,0.89
"20517","Santa Cruz","Santa Cruz de La Sierra","Col. Pedro Gutierrez",164,0,0,0,11,12,6,0,0,193,1,5,199,221,0.057,0.9
"20518","Santa Cruz","Santa Cruz de La Sierra","Col. Pedro Gutierrez",159,0,0,3,5,20,2,2,2,193,0,1,194,225,0.026,0.862
"20519","Santa Cruz","Santa Cruz de La Sierra","Col. Pedro Gutierrez",145,0,0,0,16,15,11,2,2,191,0,9,200,222,0.084,0.901
"20520","Santa Cruz","Santa Cruz de La Sierra","Col. Pedro Gutierrez",160,0,0,1,14,18,0,1,1,195,0,2,197,223,0.072,0.883
"20521","Santa Cruz","Santa Cruz de La Sierra","Col. Pedro Gutierrez",143,0,0,0,17,15,6,0,0,181,0,6,187,223,0.094,0.839
"20522","Santa Cruz","Santa Cruz de La Sierra","Col. Pedro Gutierrez",146,0,1,2,15,12,11,0,5,192,1,2,195,225,0.078,0.867
"20523","Santa Cruz","Santa Cruz de La Sierra","Col. Pedro Gutierrez",162,0,0,2,11,21,4,0,0,200,1,5,206,226,0.055,0.912
"20524","Santa Cruz","Santa Cruz de La Sierra","Col. Pedro Gutierrez",158,0,0,1,17,16,5,0,1,198,0,4,202,219,0.086,0.922
"20525","Santa Cruz","Santa Cruz de La Sierra","Col. Pedro Gutierrez",163,0,0,0,17,20,3,1,1,205,0,1,206,226,0.083,0.912
"20526","Santa Cruz","Santa Cruz de La Sierra","Col. Pedro Gutierrez",163,0,0,0,11,17,2,3,1,197,1,6,204,227,0.056,0.899
"20527","Santa Cruz","Santa Cruz de La Sierra","Col. Pedro Gutierrez",136,0,0,0,15,7,6,1,0,165,0,3,168,187,0.091,0.898
"20528","Santa Cruz","Santa Cruz de La Sierra","Colegio  6 de Junio",146,0,0,1,14,10,6,0,1,178,2,9,189,221,0.079,0.855
"20529","Santa Cruz","Santa Cruz de La Sierra","Colegio  6 de Junio",125,0,0,2,29,10,7,2,0,175,1,11,187,216,0.166,0.866
"20530","Santa Cruz","Santa Cruz de La Sierra","Colegio  6 de Junio",153,0,0,0,21,14,7,4,1,200,1,3,204,227,0.105,0.899
"20531","Santa Cruz","Santa Cruz de La Sierra","Colegio  6 de Junio",124,0,0,1,37,18,9,0,0,189,2,6,197,228,0.196,0.864
"20532","Santa Cruz","Santa Cruz de La Sierra","Colegio  6 de Junio",144,0,0,1,28,13,6,0,0,192,0,3,195,229,0.146,0.852
"20533","Santa Cruz","Santa Cruz de La Sierra","Colegio  6 de Junio",146,0,1,2,23,16,6,2,0,196,1,7,204,228,0.117,0.895
"20534","Santa Cruz","Santa Cruz de La Sierra","Colegio  6 de Junio",145,0,0,1,26,14,5,0,0,191,0,4,195,216,0.136,0.903
"20535","Santa Cruz","Santa Cruz de La Sierra","Colegio  6 de Junio",136,0,0,3,31,19,11,2,0,202,2,0,204,230,0.153,0.887
"20536","Santa Cruz","Santa Cruz de La Sierra","Colegio  6 de Junio",157,0,0,1,17,18,1,0,0,194,1,9,204,222,0.088,0.919
"20537","Santa Cruz","Santa Cruz de La Sierra","Colegio  6 de Junio",127,0,1,1,27,12,6,1,2,177,1,11,189,225,0.153,0.84
"20538","Santa Cruz","Santa Cruz de La Sierra","Colegio  6 de Junio",136,0,0,2,23,12,5,1,0,179,1,11,191,220,0.128,0.868
"20539","Santa Cruz","Santa Cruz de La Sierra","Colegio  6 de Junio",133,0,0,3,30,16,7,0,0,189,0,6,195,220,0.159,0.886
"20540","Santa Cruz","Santa Cruz de La Sierra","Colegio  6 de Junio",136,0,0,2,30,13,9,3,0,193,2,3,198,227,0.155,0.872
"20541","Santa Cruz","Santa Cruz de La Sierra","Col. Bailon Mercado Ortiz",157,1,1,1,21,15,6,1,0,203,0,3,206,228,0.103,0.904
"20542","Santa Cruz","Santa Cruz de La Sierra","Col. Bailon Mercado Ortiz",149,0,0,1,24,11,11,1,0,197,1,21,219,226,0.122,0.969
"20543","Santa Cruz","Santa Cruz de La Sierra","Col. Bailon Mercado Ortiz",144,0,1,2,32,7,9,1,0,196,2,7,205,227,0.163,0.903
"20544","Santa Cruz","Santa Cruz de La Sierra","Col. Bailon Mercado Ortiz",129,0,0,1,40,13,13,2,0,198,3,3,204,231,0.202,0.883
"20545","Santa Cruz","Santa Cruz de La Sierra","Col. Bailon Mercado Ortiz",131,0,0,2,28,18,8,3,0,190,1,4,195,225,0.147,0.867
"20546","Santa Cruz","Santa Cruz de La Sierra","Col. Bailon Mercado Ortiz",149,0,0,0,25,8,12,1,1,196,0,9,205,229,0.128,0.895
"20547","Santa Cruz","Santa Cruz de La Sierra","Col. Bailon Mercado Ortiz",151,0,0,2,18,11,9,0,0,191,0,3,194,219,0.094,0.886
"20548","Santa Cruz","Santa Cruz de La Sierra","Col. Bailon Mercado Ortiz",134,0,1,1,31,12,8,3,0,190,3,4,197,230,0.163,0.857
"20549","Santa Cruz","Santa Cruz de La Sierra","Col. Bailon Mercado Ortiz",137,1,1,0,28,12,8,1,0,188,1,5,194,221,0.149,0.878
"20550","Santa Cruz","Santa Cruz de La Sierra","Col. Bailon Mercado Ortiz",150,0,1,0,16,17,5,1,0,190,0,3,193,222,0.084,0.869
"20551","Santa Cruz","Santa Cruz de La Sierra","Col. Bailon Mercado Ortiz",142,0,1,0,34,13,9,0,0,199,0,8,207,231,0.171,0.896
"20552","Santa Cruz","Santa Cruz de La Sierra","Col. Bailon Mercado Ortiz",150,0,0,0,26,13,4,0,0,193,1,8,202,221,0.135,0.914
"20553","Santa Cruz","Santa Cruz de La Sierra","Col. Bailon Mercado Ortiz",138,0,0,0,35,16,8,1,0,198,0,4,202,228,0.177,0.886
"20554","Santa Cruz","Santa Cruz de La Sierra","Col. Bailon Mercado Ortiz",146,1,0,0,26,17,10,0,1,201,0,6,207,226,0.129,0.916
"20555","Santa Cruz","Santa Cruz de La Sierra","Col. Kinder Fanny Antelo",126,3,1,0,32,22,10,2,0,196,0,7,203,223,0.163,0.91
"20556","Santa Cruz","Santa Cruz de La Sierra","Col. Kinder Fanny Antelo",139,0,0,3,34,12,13,1,0,202,0,0,202,224,0.168,0.902
"20557","Santa Cruz","Santa Cruz de La Sierra","Col. Kinder Fanny Antelo",145,0,0,2,26,9,2,2,0,186,1,8,195,222,0.14,0.878
"20558","Santa Cruz","Santa Cruz de La Sierra","Col. Kinder Fanny Antelo",140,0,0,7,33,11,10,4,0,205,1,7,213,234,0.161,0.91
"20559","Santa Cruz","Santa Cruz de La Sierra","Col. 24 de Septiembre",146,0,2,0,27,15,13,1,0,204,1,2,207,227,0.132,0.912
"20560","Santa Cruz","Santa Cruz de La Sierra","Col. 24 de Septiembre",144,1,1,0,19,16,8,0,0,189,0,5,194,218,0.101,0.89
"20561","Santa Cruz","Santa Cruz de La Sierra","Col. 24 de Septiembre",150,0,0,0,17,12,8,1,0,188,1,2,191,222,0.09,0.86
"20562","Santa Cruz","Santa Cruz de La Sierra","Col. 24 de Septiembre",141,0,0,3,24,11,0,1,0,180,1,6,187,229,0.133,0.817
"20563","Santa Cruz","Santa Cruz de La Sierra","Col. 24 de Septiembre",142,0,0,2,22,14,11,0,0,191,0,7,198,226,0.115,0.876
"20564","Santa Cruz","Santa Cruz de La Sierra","Col. 24 de Septiembre",147,0,1,0,25,17,3,0,0,193,0,5,198,224,0.13,0.884
"20565","Santa Cruz","Santa Cruz de La Sierra","Col. 24 de Septiembre",151,2,0,0,19,15,4,3,0,194,1,1,196,224,0.098,0.875
"20566","Santa Cruz","Santa Cruz de La Sierra","Col. 24 de Septiembre",149,0,0,3,15,21,4,0,0,192,2,4,198,225,0.078,0.88
"20567","Santa Cruz","Santa Cruz de La Sierra","Col. 24 de Septiembre",158,0,1,1,22,18,6,0,0,206,0,3,209,225,0.107,0.929
"20568","Santa Cruz","Santa Cruz de La Sierra","Col. 24 de Septiembre",150,1,0,0,26,10,5,1,0,193,0,4,197,217,0.135,0.908
"20569","Santa Cruz","Santa Cruz de La Sierra","Col. 24 de Septiembre",156,0,0,1,17,12,6,0,1,193,0,9,202,226,0.088,0.894
"20570","Santa Cruz","Santa Cruz de La Sierra","Col. 24 de Septiembre",160,0,0,0,22,13,8,1,0,204,0,6,210,226,0.108,0.929
"20571","Santa Cruz","Santa Cruz de La Sierra","Col. Escuela Magisterio",154,0,0,0,19,17,4,0,0,194,0,4,198,222,0.098,0.892
"20572","Santa Cruz","Santa Cruz de La Sierra","Col. Escuela Magisterio",139,1,0,1,24,15,11,1,0,192,4,4,200,225,0.125,0.889
"20573","Santa Cruz","Santa Cruz de La Sierra","Col. Escuela Magisterio",149,0,0,1,27,14,5,3,0,199,0,4,203,221,0.136,0.919
"20574","Santa Cruz","Santa Cruz de La Sierra","Col. Escuela Magisterio",150,0,0,1,12,13,8,3,0,187,1,3,191,219,0.064,0.872
"20575","Santa Cruz","Santa Cruz de La Sierra","Col. Escuela Magisterio",145,0,0,1,38,12,1,0,0,197,1,3,201,226,0.193,0.889
"20576","Santa Cruz","Santa Cruz de La Sierra","Col. Escuela Magisterio",131,0,0,0,35,24,6,2,0,198,0,6,204,226,0.177,0.903
"20577","Santa Cruz","Santa Cruz de La Sierra","Col. Escuela Magisterio",161,1,0,0,14,17,6,1,0,200,0,23,223,223,0.07,1
"20578","Santa Cruz","Santa Cruz de La Sierra","Col. Escuela Magisterio",161,0,0,0,14,12,5,1,0,193,0,3,196,218,0.073,0.899
"20579","Santa Cruz","Santa Cruz de La Sierra","Col. Escuela Magisterio",128,1,0,1,35,16,12,2,0,195,1,4,200,226,0.179,0.885
"20580","Santa Cruz","Santa Cruz de La Sierra","Col. Escuela Magisterio",150,0,0,0,19,16,7,0,0,192,2,6,200,224,0.099,0.893
"20581","Santa Cruz","Santa Cruz de La Sierra","Col. Escuela Magisterio",149,0,0,1,22,12,9,0,1,194,1,2,197,223,0.113,0.883
"20582","Santa Cruz","Santa Cruz de La Sierra","Col. Escuela Magisterio",144,0,0,0,21,13,7,5,1,191,0,4,195,225,0.11,0.867
"20583","Santa Cruz","Santa Cruz de La Sierra","Col. Escuela Magisterio",146,0,0,0,27,13,8,0,2,196,1,5,202,231,0.138,0.874
"20584","Santa Cruz","Santa Cruz de La Sierra","Col. Escuela Magisterio",150,0,0,0,19,23,8,2,0,202,0,4,206,230,0.094,0.896
"20585","Santa Cruz","Santa Cruz de La Sierra","Col. Escuela Magisterio",164,0,0,2,15,13,9,1,0,204,1,3,208,223,0.074,0.933
"20586","Santa Cruz","Santa Cruz de La Sierra","Col. Escuela Magisterio",158,1,0,0,23,11,9,1,2,205,0,4,209,228,0.112,0.917
"20587","Santa Cruz","Santa Cruz de La Sierra","Col. Escuela Magisterio",128,0,0,0,24,15,6,1,0,174,1,12,187,206,0.138,0.908
"20588","Santa Cruz","Santa Cruz de La Sierra","Col. Wenseslao Montero",150,0,1,1,15,13,3,1,0,184,0,4,188,220,0.082,0.855
"20589","Santa Cruz","Santa Cruz de La Sierra","Col. Wenseslao Montero",155,1,0,1,19,16,5,0,0,197,2,5,204,228,0.096,0.895
"20590","Santa Cruz","Santa Cruz de La Sierra","Col. Wenseslao Montero",158,1,0,1,17,13,6,1,0,197,0,10,207,226,0.086,0.916
"20591","Santa Cruz","Santa Cruz de La Sierra","Col. Wenseslao Montero",151,0,0,1,25,22,2,1,0,202,0,3,205,225,0.124,0.911
"20592","Santa Cruz","Santa Cruz de La Sierra","Col. Wenseslao Montero",147,0,0,0,25,19,8,0,2,201,0,4,205,227,0.124,0.903
"20593","Santa Cruz","Santa Cruz de La Sierra","Col. Wenseslao Montero",142,1,0,1,17,11,14,1,0,187,1,5,193,225,0.091,0.858
"20594","Santa Cruz","Santa Cruz de La Sierra","Col. Wenseslao Montero",160,0,0,1,21,5,4,1,0,192,1,6,199,227,0.109,0.877
"20595","Santa Cruz","Santa Cruz de La Sierra","Col. Wenseslao Montero",153,0,0,0,20,16,3,0,0,192,1,5,198,221,0.104,0.896
"20596","Santa Cruz","Santa Cruz de La Sierra","Col. Wenseslao Montero",164,0,0,0,11,22,7,2,0,206,1,2,209,228,0.053,0.917
"20597","Santa Cruz","Santa Cruz de La Sierra","Col. Wenseslao Montero",147,0,1,0,28,12,8,1,1,198,1,1,200,225,0.141,0.889
"20598","Santa Cruz","Santa Cruz de La Sierra","Col. Wenseslao Montero",148,0,0,2,25,17,9,0,0,201,0,0,201,228,0.124,0.882
"20599","Santa Cruz","Santa Cruz de La Sierra","Col. Wenseslao Montero",159,0,0,0,17,15,8,0,0,199,0,4,203,229,0.085,0.886
"20600","Santa Cruz","Santa Cruz de La Sierra","Col. Wenseslao Montero",158,0,0,1,14,18,4,1,1,197,0,10,207,225,0.071,0.92
"20601","Santa Cruz","Santa Cruz de La Sierra","Col. Wenseslao Montero",150,1,0,1,20,11,9,2,0,194,0,5,199,226,0.103,0.881
"20602","Santa Cruz","Santa Cruz de La Sierra","U.E. Domingo Faustino",157,0,0,0,20,13,9,3,1,203,0,5,208,221,0.099,0.941
"20603","Santa Cruz","Santa Cruz de La Sierra","U.E. Domingo Faustino",131,0,0,0,30,18,7,0,1,187,1,2,190,215,0.16,0.884
"20604","Santa Cruz","Santa Cruz de La Sierra","U.E. Domingo Faustino",134,1,0,1,23,17,6,1,0,183,0,1,184,216,0.126,0.852
"20605","Santa Cruz","Santa Cruz de La Sierra","U.E. Domingo Faustino",145,0,0,1,24,18,6,0,0,194,0,0,194,227,0.124,0.855
"20606","Santa Cruz","Santa Cruz de La Sierra","U.E. Domingo Faustino",129,0,1,0,20,13,12,2,0,177,0,1,178,216,0.113,0.824
"20607","Santa Cruz","Santa Cruz de La Sierra","U.E. Domingo Faustino",134,0,2,0,24,18,7,1,0,186,1,4,191,222,0.129,0.86
"20608","Santa Cruz","Santa Cruz de La Sierra","Col. Fe y Alegria - Aniceto Arze",145,0,0,0,28,19,8,4,0,204,2,2,208,229,0.137,0.908
"20609","Santa Cruz","Santa Cruz de La Sierra","Col. Fe y Alegria - Aniceto Arze",135,0,0,0,30,12,8,3,0,188,0,4,192,220,0.16,0.873
"20610","Santa Cruz","Santa Cruz de La Sierra","Col. Fe y Alegria - Aniceto Arze",142,0,0,1,15,17,12,2,0,189,1,6,196,221,0.079,0.887
"20611","Santa Cruz","Santa Cruz de La Sierra","Col. Fe y Alegria - Aniceto Arze",137,0,0,2,42,10,6,1,0,198,2,2,202,223,0.212,0.906
"20612","Santa Cruz","Santa Cruz de La Sierra","Col. Fe y Alegria - Aniceto Arze",151,0,0,0,28,14,8,1,0,202,0,7,209,229,0.139,0.913
"20613","Santa Cruz","Santa Cruz de La Sierra","Col. Fe y Alegria - Aniceto Arze",122,0,1,2,35,16,13,1,2,192,1,7,200,227,0.182,0.881
"20614","Santa Cruz","Santa Cruz de La Sierra","Col. Fe y Alegria - Aniceto Arze",140,0,0,0,25,14,15,0,0,194,1,3,198,228,0.129,0.868
"20615","Santa Cruz","Santa Cruz de La Sierra","Col. Fe y Alegria - Aniceto Arze",142,0,0,2,26,20,2,2,1,195,0,2,197,224,0.133,0.879
"20616","Santa Cruz","Santa Cruz de La Sierra","Col. Fe y Alegria - Aniceto Arze",144,0,0,1,24,16,7,3,0,195,1,4,200,227,0.123,0.881
"20617","Santa Cruz","Santa Cruz de La Sierra","Col. Fe y Alegria - Aniceto Arze",147,1,0,0,23,15,9,2,1,198,3,1,202,225,0.116,0.898
"20618","Santa Cruz","Santa Cruz de La Sierra","Col. Fe y Alegria - Aniceto Arze",147,0,0,1,24,16,3,0,1,192,0,5,197,222,0.125,0.887
"20619","Santa Cruz","Santa Cruz de La Sierra","Col. Fe y Alegria - Aniceto Arze",139,0,0,1,22,23,7,2,0,194,1,3,198,223,0.113,0.888
"20620","Santa Cruz","Santa Cruz de La Sierra","Col. Fe y Alegria - Aniceto Arze",150,1,1,1,20,13,7,2,0,195,1,2,198,214,0.103,0.925
"20621","Santa Cruz","Santa Cruz de La Sierra","Col. Fe y Alegria - Aniceto Arze",137,0,0,3,27,11,9,3,0,190,3,5,198,224,0.142,0.884
"20622","Santa Cruz","Santa Cruz de La Sierra","Col. Fe y Alegria - Aniceto Arze",142,2,0,2,27,16,9,1,1,200,0,4,204,233,0.135,0.876
"20623","Santa Cruz","Santa Cruz de La Sierra","Col. Fe y Alegria - Aniceto Arze",155,0,0,3,22,9,6,0,0,195,2,2,199,227,0.113,0.877
"20624","Santa Cruz","Santa Cruz de La Sierra","Col. Fe y Alegria - Aniceto Arze",135,0,0,0,37,8,5,1,1,187,1,1,189,226,0.198,0.836
"20625","Santa Cruz","Santa Cruz de La Sierra","Col. Fe y Alegria - Aniceto Arze",158,0,0,0,27,16,3,3,2,209,1,4,214,234,0.129,0.915
"20626","Santa Cruz","Santa Cruz de La Sierra","Col. Fe y Alegria - Aniceto Arze",144,0,0,1,25,8,8,2,1,189,1,3,193,222,0.132,0.869
"20627","Santa Cruz","Santa Cruz de La Sierra","Col. Fe y Alegria - Aniceto Arze",140,1,1,1,27,14,6,1,0,191,0,8,199,226,0.141,0.881
"20628","Santa Cruz","Santa Cruz de La Sierra","Col. Fe y Alegria - Aniceto Arze",145,0,0,0,28,17,9,1,4,204,0,4,208,227,0.137,0.916
"20629","Santa Cruz","Santa Cruz de La Sierra","Col. Fe y Alegria - Aniceto Arze",148,0,0,4,25,15,2,4,0,198,0,6,204,230,0.126,0.887
"20630","Santa Cruz","Santa Cruz de La Sierra","Col. Fe y Alegria - Aniceto Arze",149,0,0,0,17,16,3,1,0,186,2,0,188,221,0.091,0.851
"20631","Santa Cruz","Santa Cruz de La Sierra","Col. Fe y Alegria - Aniceto Arze",156,0,0,2,16,14,5,0,0,193,3,2,198,227,0.083,0.872
"20632","Santa Cruz","Santa Cruz de La Sierra","Col. Fe y Alegria - Aniceto Arze",155,0,0,0,22,13,10,2,0,202,0,0,202,221,0.109,0.914
"20633","Santa Cruz","Santa Cruz de La Sierra","Col. Fe y Alegria - Aniceto Arze",159,0,0,0,25,10,7,0,0,201,1,5,207,225,0.124,0.92
"20634","Santa Cruz","Santa Cruz de La Sierra","Col. Fe y Alegria - Aniceto Arze",142,0,0,1,24,14,17,0,0,198,0,5,203,226,0.121,0.898
"20635","Santa Cruz","Santa Cruz de La Sierra","Colegio Raquel Sossa",152,1,0,2,15,15,3,1,0,189,0,6,195,218,0.079,0.894
"20636","Santa Cruz","Santa Cruz de La Sierra","Colegio Raquel Sossa",137,0,0,4,14,22,5,4,0,186,0,2,188,217,0.075,0.866
"20637","Santa Cruz","Santa Cruz de La Sierra","Colegio Raquel Sossa",145,0,0,1,23,16,8,0,0,193,1,4,198,217,0.119,0.912
"20638","Santa Cruz","Santa Cruz de La Sierra","Colegio Raquel Sossa",162,0,0,2,12,15,4,1,1,197,0,1,198,225,0.061,0.88
"20639","Santa Cruz","Santa Cruz de La Sierra","Col. El Pajonal",136,0,0,0,34,19,7,1,1,198,1,4,203,230,0.172,0.883
"20640","Santa Cruz","Santa Cruz de La Sierra","Col. El Pajonal",124,0,0,0,45,12,13,0,0,194,0,4,198,231,0.232,0.857
"20641","Santa Cruz","Santa Cruz de La Sierra","Col. El Pajonal",133,0,0,1,45,16,4,1,0,200,0,5,205,227,0.225,0.903
"20642","Santa Cruz","Santa Cruz de La Sierra","Col. El Pajonal",137,0,0,0,27,20,7,0,0,191,0,3,194,222,0.141,0.874
"20643","Santa Cruz","Santa Cruz de La Sierra","Col. El Pajonal",133,0,0,1,26,18,11,2,0,191,1,8,200,227,0.136,0.881
"20644","Santa Cruz","Santa Cruz de La Sierra","Col. El Pajonal",139,0,1,1,26,14,13,0,1,195,1,5,201,225,0.133,0.893
"20645","Santa Cruz","Santa Cruz de La Sierra","Col. El Pajonal",130,1,0,2,39,16,8,2,0,198,0,4,202,225,0.197,0.898
"20646","Santa Cruz","Santa Cruz de La Sierra","Col. El Pajonal",148,0,0,1,20,22,8,1,0,200,0,3,203,223,0.1,0.91
"20647","Santa Cruz","Santa Cruz de La Sierra","Col. El Pajonal",131,0,0,1,31,29,9,1,1,203,3,4,210,223,0.153,0.942
"20648","Santa Cruz","Santa Cruz de La Sierra","Colegio Nestor Suarez",125,0,1,2,45,10,9,0,1,193,0,1,194,219,0.233,0.886
"20649","Santa Cruz","Santa Cruz de La Sierra","Colegio Nestor Suarez",145,0,1,1,35,14,13,0,1,210,2,4,216,232,0.167,0.931
"20650","Santa Cruz","Santa Cruz de La Sierra","Colegio Nestor Suarez",137,0,1,0,30,15,8,1,1,193,1,4,198,223,0.155,0.888
"20651","Santa Cruz","Santa Cruz de La Sierra","Colegio Nestor Suarez",127,0,1,2,32,20,13,0,1,196,1,5,202,225,0.163,0.898
"20652","Santa Cruz","Santa Cruz de La Sierra","Colegio Nestor Suarez",128,1,0,1,41,13,11,0,0,195,0,9,204,225,0.21,0.907
"20653","Santa Cruz","Santa Cruz de La Sierra","Colegio Nestor Suarez",113,0,0,0,48,15,7,4,2,189,1,5,195,224,0.254,0.871
"20654","Santa Cruz","Santa Cruz de La Sierra","Colegio Nestor Suarez",117,0,2,1,52,15,6,1,0,194,1,3,198,224,0.268,0.884
"20655","Santa Cruz","Santa Cruz de La Sierra","Colegio Nestor Suarez",132,1,0,2,40,13,7,1,1,197,1,4,202,221,0.203,0.914
"20656","Santa Cruz","Santa Cruz de La Sierra","Colegio Nestor Suarez",152,0,0,0,29,14,7,2,0,204,1,2,207,230,0.142,0.9
"20657","Santa Cruz","Santa Cruz de La Sierra","Colegio Nestor Suarez",101,0,1,0,74,7,11,2,1,197,0,1,198,226,0.376,0.876
"20658","Santa Cruz","Santa Cruz de La Sierra","Colegio Nestor Suarez",122,1,0,0,42,18,7,0,0,190,4,7,201,224,0.221,0.897
"20659","Santa Cruz","Santa Cruz de La Sierra","Colegio Nestor Suarez",143,0,2,2,30,17,8,0,0,202,3,6,211,224,0.149,0.942
"20660","Santa Cruz","Santa Cruz de La Sierra","Colegio Nestor Suarez",124,1,0,0,36,21,9,1,3,195,0,6,201,224,0.185,0.897
"20661","Santa Cruz","Santa Cruz de La Sierra","Colegio Nestor Suarez",131,0,0,1,44,13,7,0,2,198,0,4,202,234,0.222,0.863
"20662","Santa Cruz","Santa Cruz de La Sierra","Colegio Nestor Suarez",137,0,0,1,37,25,7,1,0,208,0,5,213,227,0.178,0.938
"20663","Santa Cruz","Santa Cruz de La Sierra","Colegio Nestor Suarez",128,1,1,1,36,15,10,1,0,193,0,5,198,227,0.187,0.872
"20664","Santa Cruz","Santa Cruz de La Sierra","Colegio Nestor Suarez",129,1,0,0,34,20,6,1,0,191,3,2,196,221,0.178,0.887
"20665","Santa Cruz","Santa Cruz de La Sierra","Colegio Nestor Suarez",129,1,0,0,32,25,7,0,1,195,0,9,204,226,0.164,0.903
"20666","Santa Cruz","Santa Cruz de La Sierra","Colegio Nestor Suarez",119,0,0,1,49,15,10,1,1,196,3,7,206,227,0.25,0.907
"20667","Santa Cruz","Santa Cruz de La Sierra","Col. Sagrado Corazon",123,0,0,0,46,20,11,2,0,202,0,3,205,230,0.228,0.891
"20668","Santa Cruz","Santa Cruz de La Sierra","Col. Sagrado Corazon",122,0,1,1,39,12,18,1,0,194,2,7,203,234,0.201,0.868
"20669","Santa Cruz","Santa Cruz de La Sierra","Col. Sagrado Corazon",130,0,0,0,31,15,8,0,1,185,2,6,193,224,0.168,0.862
"20670","Santa Cruz","Santa Cruz de La Sierra","Col. Sagrado Corazon",135,1,1,0,29,15,15,1,0,197,4,7,208,229,0.147,0.908
"20671","Santa Cruz","Santa Cruz de La Sierra","Col. Sagrado Corazon",135,0,0,2,36,16,12,2,0,203,0,7,210,230,0.177,0.913
"20672","Santa Cruz","Santa Cruz de La Sierra","Col. Magdalena Postel",144,0,1,0,33,11,9,1,2,201,0,4,205,227,0.164,0.903
"20673","Santa Cruz","Santa Cruz de La Sierra","Col. Magdalena Postel",130,0,0,0,31,13,0,0,2,176,2,6,184,222,0.176,0.829
"20674","Santa Cruz","Santa Cruz de La Sierra","Col. Magdalena Postel",135,0,0,0,21,12,11,1,1,181,0,11,192,225,0.116,0.853
"20675","Santa Cruz","Santa Cruz de La Sierra","Col. Magdalena Postel",127,0,0,0,35,19,7,5,0,193,3,4,200,220,0.181,0.909
"20676","Santa Cruz","Santa Cruz de La Sierra","Col. Magdalena Postel",135,0,0,1,30,14,21,1,4,206,1,2,209,229,0.146,0.913
"20677","Santa Cruz","Santa Cruz de La Sierra","Col. Magdalena Postel",135,0,0,2,26,14,8,0,3,188,3,6,197,222,0.138,0.887
"20678","Santa Cruz","Santa Cruz de La Sierra","Col. Magdalena Postel",141,0,1,0,30,18,5,0,1,196,0,5,201,231,0.153,0.87
"20679","Santa Cruz","Santa Cruz de La Sierra","Col. Magdalena Postel",134,0,1,2,25,10,10,0,1,183,0,5,188,217,0.137,0.866
"20680","Santa Cruz","Santa Cruz de La Sierra","Col. Magdalena Postel",139,0,1,0,24,11,4,1,1,181,0,10,191,224,0.133,0.853
"20681","Santa Cruz","Santa Cruz de La Sierra","Col. Magdalena Postel",125,0,0,1,35,14,12,3,6,196,4,5,205,228,0.179,0.899
"20682","Santa Cruz","Santa Cruz de La Sierra","Col. Magdalena Postel",148,0,0,0,26,16,8,0,1,199,1,6,206,226,0.131,0.912
"20683","Santa Cruz","Santa Cruz de La Sierra","Col. Magdalena Postel",141,0,0,2,32,13,6,0,0,194,1,6,201,227,0.165,0.885
"20684","Santa Cruz","Santa Cruz de La Sierra","Col. Magdalena Postel",136,1,1,2,28,22,8,0,2,200,1,8,209,231,0.14,0.905
"20685","Santa Cruz","Santa Cruz de La Sierra","Col. Magdalena Postel",140,0,0,2,42,7,8,0,2,201,2,4,207,231,0.209,0.896
"20686","Santa Cruz","Santa Cruz de La Sierra","Col. Magdalena Postel",140,0,0,1,24,13,9,0,0,187,1,4,192,221,0.128,0.869
"20687","Santa Cruz","Santa Cruz de La Sierra","Col. Magdalena Postel",146,1,1,3,31,20,3,1,3,209,1,4,214,231,0.148,0.926
"20688","Santa Cruz","Santa Cruz de La Sierra","Col. Magdalena Postel",151,0,1,0,24,17,13,0,0,206,0,4,210,226,0.117,0.929
"20689","Santa Cruz","Santa Cruz de La Sierra","Col. Magdalena Postel",143,0,0,1,43,9,7,2,2,207,1,1,209,228,0.208,0.917
"20690","Santa Cruz","Santa Cruz de La Sierra","Col. Magdalena Postel",130,1,1,2,34,15,9,0,3,195,1,5,201,227,0.174,0.885
"20691","Santa Cruz","Santa Cruz de La Sierra","Col. Magdalena Postel",126,2,0,1,43,11,9,0,1,193,1,6,200,220,0.223,0.909
"20692","Santa Cruz","Santa Cruz de La Sierra","Col. U.E. La Resureccion - Esc. Convif",159,0,0,0,15,21,2,0,0,197,0,5,202,225,0.076,0.898
"20693","Santa Cruz","Santa Cruz de La Sierra","Col. U.E. La Resureccion - Esc. Convif",178,0,0,1,14,11,3,0,1,208,0,2,210,228,0.067,0.921
"20694","Santa Cruz","Santa Cruz de La Sierra","Col. U.E. La Resureccion - Esc. Convif",171,0,0,2,13,13,2,1,0,202,1,2,205,231,0.064,0.887
"20695","Santa Cruz","Santa Cruz de La Sierra","Col. U.E. La Resureccion - Esc. Convif",170,0,0,1,6,19,2,1,0,199,0,3,202,227,0.03,0.89
"20696","Santa Cruz","Santa Cruz de La Sierra","Col. U.E. La Resureccion - Esc. Convif",164,1,0,1,13,15,2,0,0,196,0,3,199,218,0.066,0.913
"20697","Santa Cruz","Santa Cruz de La Sierra","Col. U.E. La Resureccion - Esc. Convif",165,0,0,0,6,15,4,1,0,191,0,2,193,221,0.031,0.873
"20698","Santa Cruz","Santa Cruz de La Sierra","Col. U.E. La Resureccion - Esc. Convif",178,0,0,0,16,10,1,2,0,207,0,1,208,226,0.077,0.92
"20699","Santa Cruz","Santa Cruz de La Sierra","Col. U.E. La Resureccion - Esc. Convif",172,1,0,0,12,14,3,0,0,202,1,2,205,226,0.059,0.907
"20700","Santa Cruz","Santa Cruz de La Sierra","Col. Escuela 2 De Agosto",144,0,0,0,21,23,7,1,2,198,1,4,203,226,0.106,0.898
"20701","Santa Cruz","Santa Cruz de La Sierra","Col. Escuela 2 De Agosto",148,0,0,4,21,8,6,0,0,187,0,6,193,219,0.112,0.881
"20702","Santa Cruz","Santa Cruz de La Sierra","Col. Escuela 2 De Agosto",135,0,0,0,30,13,8,2,0,188,2,2,192,220,0.16,0.873
"20703","Santa Cruz","Santa Cruz de La Sierra","Col. Escuela 2 De Agosto",148,0,0,0,30,16,7,0,0,201,0,4,205,221,0.149,0.928
"20704","Santa Cruz","Santa Cruz de La Sierra","Col. Escuela 2 De Agosto",140,0,0,2,28,17,2,0,0,189,0,3,192,222,0.148,0.865
"20705","Santa Cruz","Santa Cruz de La Sierra","Col. Escuela 2 De Agosto",153,0,0,1,20,16,7,2,0,199,1,2,202,227,0.101,0.89
"20706","Santa Cruz","Santa Cruz de La Sierra","Col. Escuela 2 De Agosto",146,0,0,1,26,11,5,3,2,194,2,2,198,228,0.134,0.868
"20707","Santa Cruz","Santa Cruz de La Sierra","Col. Escuela 2 De Agosto",152,0,1,2,24,14,4,1,1,199,1,3,203,223,0.121,0.91
"20708","Santa Cruz","Santa Cruz de La Sierra","Col. Escuela 2 De Agosto",142,0,0,1,19,13,3,3,0,181,2,4,187,223,0.105,0.839
"20709","Santa Cruz","Santa Cruz de La Sierra","Col. Escuela 2 De Agosto",151,0,0,1,21,22,6,0,0,201,0,4,205,225,0.104,0.911
"20710","Santa Cruz","Santa Cruz de La Sierra","Col. Escuela 2 De Agosto",129,0,0,2,31,19,5,0,0,186,1,8,195,224,0.167,0.871
"20711","Santa Cruz","Santa Cruz de La Sierra","Col. Escuela 2 De Agosto",118,0,0,0,22,9,6,1,0,156,0,4,160,190,0.141,0.842
"20712","Santa Cruz","Santa Cruz de La Sierra","U. E. Escuela Ñuflo De Chavez",160,0,0,1,18,14,6,0,0,199,0,27,226,226,0.09,1
"20713","Santa Cruz","Santa Cruz de La Sierra","U. E. Escuela Ñuflo De Chavez",180,0,0,0,14,13,2,0,0,209,1,1,211,227,0.067,0.93
"20714","Santa Cruz","Santa Cruz de La Sierra","U. E. Escuela Ñuflo De Chavez",146,1,0,1,20,14,8,0,0,190,0,5,195,224,0.105,0.871
"20715","Santa Cruz","Santa Cruz de La Sierra","U. E. Escuela Ñuflo De Chavez",156,0,0,1,16,8,13,2,1,197,1,3,201,228,0.081,0.882
"20716","Santa Cruz","Santa Cruz de La Sierra","U. E. Escuela Ñuflo De Chavez",152,0,0,0,17,14,12,0,4,199,0,3,202,227,0.085,0.89
"20717","Santa Cruz","Santa Cruz de La Sierra","U. E. Escuela Ñuflo De Chavez",155,0,0,1,18,15,2,0,0,191,2,4,197,225,0.094,0.876
"20718","Santa Cruz","Santa Cruz de La Sierra","U. E. Escuela Ñuflo De Chavez",151,0,0,1,21,17,10,8,0,208,0,5,213,230,0.101,0.926
"20719","Santa Cruz","Santa Cruz de La Sierra","U. E. Escuela Ñuflo De Chavez",158,0,0,1,11,20,6,1,1,198,1,6,205,224,0.056,0.915
"20720","Santa Cruz","Santa Cruz de La Sierra","U. E. Escuela Ñuflo De Chavez",145,0,1,0,18,14,9,0,2,189,0,7,196,225,0.095,0.871
"20721","Santa Cruz","Santa Cruz de La Sierra","U. E. Escuela Ñuflo De Chavez",161,2,0,0,18,12,3,0,1,197,0,7,204,226,0.091,0.903
"20722","Santa Cruz","Santa Cruz de La Sierra","U. E. Escuela Ñuflo De Chavez",152,0,0,0,22,9,10,2,3,198,2,5,205,229,0.111,0.895
"20723","Santa Cruz","Santa Cruz de La Sierra","Col. Adventista Santa Cruz",153,0,1,0,21,14,5,0,0,194,0,6,200,223,0.108,0.897
"20724","Santa Cruz","Santa Cruz de La Sierra","Col. Adventista Santa Cruz",164,0,0,0,26,12,2,1,0,205,0,4,209,230,0.127,0.909
"20725","Santa Cruz","Santa Cruz de La Sierra","Col. Adventista Santa Cruz",155,0,0,0,12,9,8,1,0,185,2,13,200,227,0.065,0.881
"20726","Santa Cruz","Santa Cruz de La Sierra","Col. Adventista Santa Cruz",146,0,0,1,18,11,12,1,0,189,0,7,196,226,0.095,0.867
"20727","Santa Cruz","Santa Cruz de La Sierra","Col. Adventista Santa Cruz",154,0,0,1,18,9,6,3,0,191,1,7,199,221,0.094,0.9
"20728","Santa Cruz","Santa Cruz de La Sierra","Col. Adventista Santa Cruz",152,0,1,1,26,10,5,0,0,195,1,4,200,222,0.133,0.901
"20729","Santa Cruz","Santa Cruz de La Sierra","Col. Adventista Santa Cruz",161,0,2,0,23,6,5,1,0,198,1,6,205,223,0.116,0.919
"20730","Santa Cruz","Santa Cruz de La Sierra","Col. Adventista Santa Cruz",159,1,0,0,17,13,2,1,0,193,0,4,197,224,0.088,0.879
"20731","Santa Cruz","Santa Cruz de La Sierra","Col. Adventista Santa Cruz",142,0,0,0,20,20,6,1,0,189,2,11,202,223,0.106,0.906
"20732","Santa Cruz","Santa Cruz de La Sierra","Col. Adventista Santa Cruz",155,0,0,0,26,14,6,1,0,202,2,2,206,228,0.129,0.904
"20733","Santa Cruz","Santa Cruz de La Sierra","Col. Adventista Santa Cruz",146,1,0,0,14,28,1,0,0,190,0,3,193,217,0.074,0.889
"20734","Santa Cruz","Santa Cruz de La Sierra","Col. Adventista Santa Cruz",158,0,0,1,18,16,4,1,0,198,2,7,207,227,0.091,0.912
"20735","Santa Cruz","Santa Cruz de La Sierra","Col. Adventista Santa Cruz",160,0,0,0,14,15,1,1,0,191,0,7,198,223,0.073,0.888
"20736","Santa Cruz","Santa Cruz de La Sierra","Col. Adventista Santa Cruz",144,0,0,0,23,18,8,1,0,194,0,6,200,225,0.119,0.889
"20737","Santa Cruz","Santa Cruz de La Sierra","Col. Adventista Santa Cruz",153,0,0,0,23,12,7,2,0,197,0,3,200,222,0.117,0.901
"20738","Santa Cruz","Santa Cruz de La Sierra","Col. Adventista Santa Cruz",152,0,0,1,16,15,7,1,0,192,0,5,197,226,0.083,0.872
"20739","Santa Cruz","Santa Cruz de La Sierra","Col. Adventista Santa Cruz",164,0,0,0,14,25,2,1,0,206,0,5,211,226,0.068,0.934
"20740","Santa Cruz","Santa Cruz de La Sierra","Col. Adventista Santa Cruz",151,0,0,0,18,10,12,0,2,193,2,2,197,223,0.093,0.883
"20741","Santa Cruz","Santa Cruz de La Sierra","Col. Adventista Santa Cruz",142,0,0,0,27,12,8,0,0,189,0,8,197,230,0.143,0.857
"20742","Santa Cruz","Santa Cruz de La Sierra","Colegio Josefina Balsamo( Los Tusequis)",155,0,0,1,30,10,4,0,1,201,0,5,206,226,0.149,0.912
"20743","Santa Cruz","Santa Cruz de La Sierra","Colegio Josefina Balsamo( Los Tusequis)",148,0,0,0,23,13,11,3,0,198,0,4,202,231,0.116,0.874
"20744","Santa Cruz","Santa Cruz de La Sierra","Colegio Josefina Balsamo( Los Tusequis)",140,1,1,1,33,13,5,0,0,194,1,3,198,228,0.17,0.868
"20745","Santa Cruz","Santa Cruz de La Sierra","Colegio Josefina Balsamo( Los Tusequis)",147,0,0,0,26,25,7,1,1,207,1,5,213,229,0.126,0.93
"20746","Santa Cruz","Santa Cruz de La Sierra","Colegio Josefina Balsamo( Los Tusequis)",131,0,0,0,29,20,11,0,2,193,0,6,199,229,0.15,0.869
"20747","Santa Cruz","Santa Cruz de La Sierra","Colegio Josefina Balsamo( Los Tusequis)",159,0,0,0,14,19,8,0,0,200,0,4,204,225,0.07,0.907
"20748","Santa Cruz","Santa Cruz de La Sierra","Colegio Josefina Balsamo( Los Tusequis)",141,1,0,2,28,20,6,1,1,200,1,1,202,230,0.14,0.878
"20749","Santa Cruz","Santa Cruz de La Sierra","Colegio Josefina Balsamo( Los Tusequis)",151,0,0,0,28,18,5,1,0,203,0,3,206,231,0.138,0.892
"20750","Santa Cruz","Santa Cruz de La Sierra","Colegio Josefina Balsamo( Los Tusequis)",143,1,0,0,25,19,6,0,0,194,0,2,196,229,0.129,0.856
"20751","Santa Cruz","Santa Cruz de La Sierra","Colegio Josefina Balsamo( Los Tusequis)",124,0,0,1,32,17,9,2,0,185,0,4,189,224,0.173,0.844
"20752","Santa Cruz","Santa Cruz de La Sierra","Colegio Josefina Balsamo( Los Tusequis)",145,0,0,2,20,14,7,0,0,188,5,7,200,229,0.106,0.873
"20753","Santa Cruz","Santa Cruz de La Sierra","Colegio Josefina Balsamo( Los Tusequis)",155,0,0,2,27,16,5,0,0,205,2,2,209,228,0.132,0.917
"20754","Santa Cruz","Santa Cruz de La Sierra","Colegio Josefina Balsamo( Los Tusequis)",150,1,0,0,20,19,4,1,0,195,1,5,201,226,0.103,0.889
"20755","Santa Cruz","Santa Cruz de La Sierra","Colegio Josefina Balsamo( Los Tusequis)",145,1,0,3,32,10,5,0,0,196,2,4,202,231,0.163,0.874
"20756","Santa Cruz","Santa Cruz de La Sierra","Colegio Josefina Balsamo( Los Tusequis)",136,0,0,1,20,10,9,0,1,177,1,6,184,227,0.113,0.811
"20757","Santa Cruz","Santa Cruz de La Sierra","Colegio Josefina Balsamo( Los Tusequis)",157,0,0,0,23,13,8,0,1,202,1,5,208,229,0.114,0.908
"20758","Santa Cruz","Santa Cruz de La Sierra","Colegio Josefina Balsamo( Los Tusequis)",152,0,0,0,17,15,11,0,0,195,2,4,201,229,0.087,0.878
"20759","Santa Cruz","Santa Cruz de La Sierra","Colegio Josefina Balsamo( Los Tusequis)",138,0,0,1,22,16,4,3,0,184,0,11,195,225,0.12,0.867
"20760","Santa Cruz","Santa Cruz de La Sierra","Colegio Josefina Balsamo( Los Tusequis)",140,0,1,0,22,13,10,0,0,186,1,3,190,222,0.118,0.856
"20761","Santa Cruz","Santa Cruz de La Sierra","Col. Nueva Esperanza",148,0,0,0,31,13,6,1,0,199,0,2,201,226,0.156,0.889
"20762","Santa Cruz","Santa Cruz de La Sierra","Col. Nueva Esperanza",116,0,0,1,44,10,15,0,0,186,0,13,199,220,0.237,0.905
"20763","Santa Cruz","Santa Cruz de La Sierra","Col. Nueva Esperanza",140,0,0,2,30,23,6,2,0,203,1,4,208,230,0.148,0.904
"20764","Santa Cruz","Santa Cruz de La Sierra","Col. Nueva Esperanza",128,0,0,0,46,17,6,1,0,198,1,0,199,225,0.232,0.884
"20765","Santa Cruz","Santa Cruz de La Sierra","Col. Nueva Esperanza",135,0,1,0,25,20,4,2,0,187,2,3,192,226,0.134,0.85
"20766","Santa Cruz","Santa Cruz de La Sierra","Col. Nueva Esperanza",143,1,0,1,26,20,5,2,0,198,0,4,202,228,0.131,0.886
"20767","Santa Cruz","Santa Cruz de La Sierra","Col. Nueva Esperanza",133,0,0,1,30,15,12,1,0,192,0,3,195,232,0.156,0.841
"20768","Santa Cruz","Santa Cruz de La Sierra","Col. Nueva Esperanza",123,0,0,0,34,12,10,1,0,180,1,6,187,223,0.189,0.839
"20769","Santa Cruz","Santa Cruz de La Sierra","Col. Nueva Esperanza",147,0,0,2,18,13,8,2,0,190,0,3,193,222,0.095,0.869
"20770","Santa Cruz","Santa Cruz de La Sierra","Col. Nueva Esperanza",142,1,0,0,26,5,8,3,0,185,2,1,188,227,0.141,0.828
"20771","Santa Cruz","Santa Cruz de La Sierra","Colegio  23 de Abril",116,1,0,1,38,23,12,0,0,191,2,0,193,224,0.199,0.862
"20772","Santa Cruz","Santa Cruz de La Sierra","Colegio  23 de Abril",113,0,0,2,45,16,8,2,0,186,0,2,188,222,0.242,0.847
"20773","Santa Cruz","Santa Cruz de La Sierra","Colegio  23 de Abril",101,0,2,1,56,20,16,2,0,198,1,2,201,233,0.283,0.863
"20774","Santa Cruz","Santa Cruz de La Sierra","Colegio  23 de Abril",112,1,0,0,61,17,17,1,0,209,0,4,213,233,0.292,0.914
"20775","Santa Cruz","Santa Cruz de La Sierra","Colegio  23 de Abril",109,0,0,2,57,13,10,1,1,193,1,6,200,230,0.295,0.87
"20776","Santa Cruz","Santa Cruz de La Sierra","Colegio  23 de Abril",110,0,1,1,53,15,13,1,0,194,1,5,200,227,0.273,0.881
"20777","Santa Cruz","Santa Cruz de La Sierra","Colegio  23 de Abril",97,0,0,1,61,15,11,0,0,185,0,2,187,224,0.33,0.835
"20778","Santa Cruz","Santa Cruz de La Sierra","Colegio  23 de Abril",118,1,0,0,42,16,13,2,1,193,3,6,202,226,0.218,0.894
"20779","Santa Cruz","Santa Cruz de La Sierra","Colegio  23 de Abril",117,2,1,0,50,18,16,1,0,205,1,2,208,229,0.244,0.908
"20780","Santa Cruz","Santa Cruz de La Sierra","Colegio  23 de Abril",105,0,0,2,56,13,13,3,2,194,2,5,201,228,0.289,0.882
"20781","Santa Cruz","Santa Cruz de La Sierra","Colegio  23 de Abril",125,0,2,2,41,9,14,3,0,196,0,2,198,229,0.209,0.865
"20782","Santa Cruz","Santa Cruz de La Sierra","Colegio  23 de Abril",138,0,0,1,42,12,9,2,0,204,1,3,208,227,0.206,0.916
"20783","Santa Cruz","Santa Cruz de La Sierra","Colegio  23 de Abril",141,0,1,1,41,10,7,2,0,203,0,4,207,234,0.202,0.885
"20784","Santa Cruz","Santa Cruz de La Sierra","Colegio  23 de Abril",88,0,0,0,38,12,15,0,0,153,0,1,154,173,0.248,0.89
"20785","Santa Cruz","Santa Cruz de La Sierra","Col. Felix Bascope Sanandita",147,0,0,0,21,15,8,1,0,192,2,10,204,223,0.109,0.915
"20786","Santa Cruz","Santa Cruz de La Sierra","Col. Felix Bascope Sanandita",131,0,1,0,25,18,5,3,0,183,3,4,190,218,0.137,0.872
"20787","Santa Cruz","Santa Cruz de La Sierra","Col. Felix Bascope Sanandita",132,0,0,1,29,12,8,1,0,183,1,12,196,226,0.158,0.867
"20788","Santa Cruz","Santa Cruz de La Sierra","Col. Felix Bascope Sanandita",152,0,0,0,24,9,8,1,0,194,0,4,198,221,0.124,0.896
"20789","Santa Cruz","Santa Cruz de La Sierra","Col. Felix Bascope Sanandita",151,0,0,1,22,14,3,1,0,192,0,7,199,226,0.115,0.881
"20790","Santa Cruz","Santa Cruz de La Sierra","Col. Felix Bascope Sanandita",145,0,1,0,22,18,7,2,0,195,0,12,207,228,0.113,0.908
"20791","Santa Cruz","Santa Cruz de La Sierra","Col. Felix Bascope Sanandita",157,0,0,0,21,10,9,3,0,200,0,2,202,221,0.105,0.914
"20792","Santa Cruz","Santa Cruz de La Sierra","Col. Felix Bascope Sanandita",159,0,0,2,20,14,2,3,0,200,0,2,202,226,0.1,0.894
"20793","Santa Cruz","Santa Cruz de La Sierra","Col. Felix Bascope Sanandita",151,0,0,0,24,13,6,0,0,194,0,3,197,220,0.124,0.895
"20794","Santa Cruz","Santa Cruz de La Sierra","Col. Felix Bascope Sanandita",151,0,0,0,16,16,3,0,0,186,1,5,192,216,0.086,0.889
"20795","Santa Cruz","Santa Cruz de La Sierra","Col. Felix Bascope Sanandita",154,1,1,1,22,19,6,5,0,209,0,0,209,228,0.105,0.917
"20796","Santa Cruz","Santa Cruz de La Sierra","Col. San Carlos",153,0,0,0,30,7,6,1,0,197,1,5,203,226,0.152,0.898
"20797","Santa Cruz","Santa Cruz de La Sierra","Col. San Carlos",145,0,0,0,26,15,6,2,1,195,0,7,202,224,0.133,0.902
"20798","Santa Cruz","Santa Cruz de La Sierra","Col. San Carlos",147,0,0,2,34,18,6,1,0,208,1,4,213,231,0.163,0.922
"20799","Santa Cruz","Santa Cruz de La Sierra","Col. San Carlos",149,0,0,3,27,9,10,0,0,198,1,6,205,230,0.136,0.891
"20800","Santa Cruz","Santa Cruz de La Sierra","Col. San Carlos",161,0,0,1,24,9,8,2,1,206,2,2,210,230,0.117,0.913
"20801","Santa Cruz","Santa Cruz de La Sierra","Col. San Carlos",146,0,0,0,32,6,6,4,1,195,1,9,205,230,0.164,0.891
"20802","Santa Cruz","Santa Cruz de La Sierra","Col. San Carlos",156,0,0,0,20,6,7,2,1,192,1,3,196,224,0.104,0.875
"20803","Santa Cruz","Santa Cruz de La Sierra","Col. San Carlos",153,0,0,1,30,15,9,1,0,209,0,4,213,230,0.144,0.926
"20804","Santa Cruz","Santa Cruz de La Sierra","Col. San Carlos",157,0,0,1,22,12,5,1,0,198,1,9,208,234,0.111,0.889
"20805","Santa Cruz","Santa Cruz de La Sierra","Col. San Carlos",145,0,0,3,26,12,11,1,0,198,1,5,204,225,0.131,0.907
"20806","Santa Cruz","Santa Cruz de La Sierra","Col. San Carlos",117,0,0,0,16,11,9,0,0,153,0,3,156,174,0.105,0.897
"20807","Santa Cruz","Santa Cruz de La Sierra","Col. Esc. Manuel Ignacio Salvatierra",127,0,0,2,17,21,9,0,0,176,0,2,178,216,0.097,0.824
"20808","Santa Cruz","Santa Cruz de La Sierra","Col. Esc. Manuel Ignacio Salvatierra",129,0,0,1,30,22,4,3,1,190,1,1,192,217,0.158,0.885
"20809","Santa Cruz","Santa Cruz de La Sierra","Col. Esc. Manuel Ignacio Salvatierra",121,0,0,0,26,22,5,3,0,177,0,2,179,228,0.147,0.785
"20810","Santa Cruz","Santa Cruz de La Sierra","Col. Seccional Monseñor Santiestevan",119,0,0,2,34,16,6,0,1,178,1,2,181,211,0.191,0.858
"20811","Santa Cruz","Santa Cruz de La Sierra","Col. Seccional Monseñor Santiestevan",99,0,1,0,41,21,11,0,0,173,2,4,179,216,0.237,0.829
"20812","Santa Cruz","Santa Cruz de La Sierra","Col. Seccional Monseñor Santiestevan",114,0,0,1,34,10,8,1,1,169,1,4,174,204,0.201,0.853
"20813","Santa Cruz","Santa Cruz de La Sierra","Col. Seccional Monseñor Santiestevan",103,1,0,0,37,7,10,0,2,160,2,9,171,215,0.231,0.795
"20814","Santa Cruz","Santa Cruz de La Sierra","Col. Seccional Monseñor Santiestevan",105,3,0,0,41,14,15,0,2,180,1,4,185,216,0.228,0.856
"20815","Santa Cruz","Santa Cruz de La Sierra","Col. Seccional Monseñor Santiestevan",136,0,1,0,17,29,5,0,0,188,0,1,189,217,0.09,0.871
"20816","Santa Cruz","Santa Cruz de La Sierra","Col. Seccional Monseñor Santiestevan",121,0,0,2,30,12,8,0,1,174,0,8,182,222,0.172,0.82
"20817","Santa Cruz","Santa Cruz de La Sierra","Col. Seccional Monseñor Santiestevan",119,0,0,0,27,24,8,1,0,179,2,3,184,218,0.151,0.844
"20818","Santa Cruz","Santa Cruz de La Sierra","Col. Romulo Herrera",114,0,1,1,41,14,11,0,1,183,0,1,184,223,0.224,0.825
"20819","Santa Cruz","Santa Cruz de La Sierra","Col. Romulo Herrera",107,0,0,0,42,15,14,0,1,179,0,2,181,214,0.235,0.846
"20820","Santa Cruz","Santa Cruz de La Sierra","Col. Romulo Herrera",78,2,2,0,78,9,13,2,0,184,0,4,188,215,0.424,0.874
"20821","Santa Cruz","Santa Cruz de La Sierra","Col. Romulo Herrera",103,0,0,0,48,13,12,0,2,178,1,8,187,218,0.27,0.858
"20822","Santa Cruz","Santa Cruz de La Sierra","Col. Romulo Herrera",106,0,0,1,42,11,9,3,1,173,1,9,183,214,0.243,0.855
"20823","Santa Cruz","Santa Cruz de La Sierra","Col. Romulo Herrera",116,1,2,1,53,7,8,0,3,191,3,2,196,213,0.277,0.92
"20824","Santa Cruz","Santa Cruz de La Sierra","Col. Romulo Herrera",112,0,1,2,43,18,8,1,0,185,0,5,190,223,0.232,0.852
"20825","Santa Cruz","Santa Cruz de La Sierra","Col. Romulo Herrera",111,0,0,1,52,13,4,0,1,182,0,4,186,215,0.286,0.865
"20826","Santa Cruz","Santa Cruz de La Sierra","Col. Romulo Herrera",115,0,0,1,39,9,7,1,1,173,1,3,177,212,0.225,0.835
"20827","Santa Cruz","Santa Cruz de La Sierra","Col. Romulo Herrera",102,0,0,0,32,20,6,3,0,163,1,4,168,216,0.196,0.778
"20828","Santa Cruz","Santa Cruz de La Sierra","Col. Romulo Herrera",119,1,0,0,38,14,5,1,0,178,1,5,184,221,0.213,0.833
"20829","Santa Cruz","Santa Cruz de La Sierra","Col. Romulo Herrera",97,0,2,0,54,11,13,1,0,178,2,5,185,216,0.303,0.856
"20830","Santa Cruz","Santa Cruz de La Sierra","Col. Basilio De Cuellar",147,0,0,2,12,23,1,1,1,187,0,3,190,221,0.064,0.86
"20831","Santa Cruz","Santa Cruz de La Sierra","Col. Basilio De Cuellar",133,0,0,4,10,25,5,1,0,178,1,3,182,211,0.056,0.863
"20832","Santa Cruz","Santa Cruz de La Sierra","Col. Basilio De Cuellar",135,0,0,3,18,14,9,3,0,182,0,2,184,211,0.099,0.872
"20833","Santa Cruz","Santa Cruz de La Sierra","Col. Basilio De Cuellar",149,0,0,1,7,22,3,4,0,186,0,3,189,223,0.038,0.848
"20834","Santa Cruz","Santa Cruz de La Sierra","Col. Obispo Santistevan",143,0,0,2,14,23,6,0,1,189,1,3,193,219,0.074,0.881
"20835","Santa Cruz","Santa Cruz de La Sierra","Col. Obispo Santistevan",149,0,0,3,14,21,3,0,0,190,0,4,194,221,0.074,0.878
"20836","Santa Cruz","Santa Cruz de La Sierra","Col. Obispo Santistevan",156,0,0,0,11,18,4,0,0,189,1,2,192,223,0.058,0.861
"20837","Santa Cruz","Santa Cruz de La Sierra","Col. Obispo Santistevan",129,1,0,1,10,26,2,1,1,171,0,3,174,201,0.058,0.866
"20838","Santa Cruz","Santa Cruz de La Sierra","Col. Nacional Florida",144,0,1,3,14,17,3,0,0,182,1,2,185,217,0.077,0.853
"20839","Santa Cruz","Santa Cruz de La Sierra","Col. Nacional Florida",147,0,0,0,21,15,5,1,1,190,1,4,195,223,0.111,0.874
"20840","Santa Cruz","Santa Cruz de La Sierra","Col. Nacional Florida",126,0,0,1,16,22,6,4,1,176,0,6,182,219,0.091,0.831
"20841","Santa Cruz","Santa Cruz de La Sierra","Col. Nacional Florida",141,0,0,1,20,23,9,0,0,194,0,6,200,219,0.103,0.913
"20842","Santa Cruz","Santa Cruz de La Sierra","Col. Nacional Florida",148,0,0,1,13,20,5,0,0,187,1,3,191,222,0.07,0.86
"20843","Santa Cruz","Santa Cruz de La Sierra","Col. Nacional Florida",155,0,0,1,19,15,2,1,1,194,0,2,196,220,0.098,0.891
"20844","Santa Cruz","Santa Cruz de La Sierra","Col. Nacional Florida",136,0,0,2,14,12,7,0,0,171,0,4,175,219,0.082,0.799
"20845","Santa Cruz","Santa Cruz de La Sierra","Col. Centro Aprondy",161,0,1,0,15,20,8,0,0,205,0,3,208,229,0.073,0.908
"20846","Santa Cruz","Santa Cruz de La Sierra","Col. Centro Aprondy",153,0,0,1,20,18,2,0,1,195,1,2,198,227,0.103,0.872
"20847","Santa Cruz","Santa Cruz de La Sierra","Col. Centro Aprondy",148,0,0,2,17,13,8,0,1,189,0,4,193,219,0.09,0.881
"20848","Santa Cruz","Santa Cruz de La Sierra","Col. Centro Aprondy",142,0,0,1,21,10,7,0,0,181,1,15,197,224,0.116,0.879
"20849","Santa Cruz","Santa Cruz de La Sierra","Col. Centro Aprondy",146,0,0,1,16,14,7,1,0,185,0,9,194,218,0.086,0.89
"20850","Santa Cruz","Santa Cruz de La Sierra","Col. Centro Aprondy",149,0,0,1,18,16,4,2,0,190,2,2,194,220,0.095,0.882
"20851","Santa Cruz","Santa Cruz de La Sierra","Col. Centro Aprondy",147,0,1,2,23,10,6,3,0,192,0,4,196,219,0.12,0.895
"20852","Santa Cruz","Santa Cruz de La Sierra","Col. Centro Aprondy",154,0,0,0,11,19,11,0,1,196,1,8,205,224,0.056,0.915
"20853","Santa Cruz","Santa Cruz de La Sierra","Col. Centro Aprondy",147,1,0,0,16,14,3,2,0,183,1,9,193,221,0.087,0.873
"20854","Santa Cruz","Santa Cruz de La Sierra","Col. Centro Aprondy",146,0,0,0,17,15,5,0,0,183,1,11,195,222,0.093,0.878
"20855","Santa Cruz","Santa Cruz de La Sierra","Col. Centro Aprondy",124,0,0,0,20,14,3,1,0,162,0,7,169,198,0.123,0.854
"20856","Santa Cruz","Santa Cruz de La Sierra","Col. Tecnologico Santa Cruz",149,0,1,1,24,11,4,3,0,193,1,6,200,229,0.124,0.873
"20857","Santa Cruz","Santa Cruz de La Sierra","Col. Tecnologico Santa Cruz",141,0,0,1,19,14,4,1,1,181,1,1,183,214,0.105,0.855
"20858","Santa Cruz","Santa Cruz de La Sierra","Col. Tecnologico Santa Cruz",147,0,1,1,19,9,9,1,0,187,1,4,192,222,0.102,0.865
"20859","Santa Cruz","Santa Cruz de La Sierra","Col. Tecnologico Santa Cruz",136,0,0,1,12,13,11,0,0,173,3,5,181,222,0.069,0.815
"20860","Santa Cruz","Santa Cruz de La Sierra","Col. Tecnologico Santa Cruz",153,0,0,1,15,13,6,0,0,188,0,1,189,225,0.08,0.84
"20861","Santa Cruz","Santa Cruz de La Sierra","Col. Tecnologico Santa Cruz",138,1,0,1,23,9,13,1,2,188,2,1,191,221,0.122,0.864
"20862","Santa Cruz","Santa Cruz de La Sierra","Col. Tecnologico Santa Cruz",134,0,1,0,25,16,6,1,0,183,1,0,184,220,0.137,0.836
"20863","Santa Cruz","Santa Cruz de La Sierra","Col. Tecnologico Santa Cruz",128,1,0,3,30,18,8,1,0,189,0,2,191,221,0.159,0.864
"20864","Santa Cruz","Santa Cruz de La Sierra","Col. Tecnologico Santa Cruz",149,0,0,1,17,12,8,0,1,188,0,2,190,225,0.09,0.844
"20865","Santa Cruz","Santa Cruz de La Sierra","Col. Tecnologico Santa Cruz",131,0,0,2,34,15,6,0,0,188,1,5,194,223,0.181,0.87
"20866","Santa Cruz","Santa Cruz de La Sierra","Col. Tecnologico Santa Cruz",138,0,0,1,26,11,6,1,1,184,1,4,189,229,0.141,0.825
"20867","Santa Cruz","Santa Cruz de La Sierra","Col. Tecnologico Santa Cruz",148,0,0,2,17,13,5,0,0,185,0,9,194,223,0.092,0.87
"20868","Santa Cruz","Santa Cruz de La Sierra","Col. Tecnologico Santa Cruz",143,0,0,0,19,14,9,2,0,187,0,3,190,222,0.102,0.856
"20869","Santa Cruz","Santa Cruz de La Sierra","Col. Tecnologico Santa Cruz",146,1,0,1,17,20,8,1,0,194,0,6,200,226,0.088,0.885
"20870","Santa Cruz","Santa Cruz de La Sierra","Col. Tecnologico Santa Cruz",147,0,1,0,22,5,0,2,0,177,3,5,185,217,0.124,0.853
"20871","Santa Cruz","Santa Cruz de La Sierra","Col. Mariscal Sucre",149,0,0,1,25,23,4,1,0,203,1,7,211,231,0.123,0.913
"20872","Santa Cruz","Santa Cruz de La Sierra","Col. Mariscal Sucre",161,1,0,1,15,10,5,2,0,195,0,3,198,228,0.077,0.868
"20873","Santa Cruz","Santa Cruz de La Sierra","Col. Mariscal Sucre",154,1,1,1,27,12,6,0,0,202,1,4,207,228,0.134,0.908
"20874","Santa Cruz","Santa Cruz de La Sierra","Col. Mariscal Sucre",153,1,0,0,22,17,6,1,0,200,1,7,208,227,0.11,0.916
"20875","Santa Cruz","Santa Cruz de La Sierra","Col. Mariscal Sucre",159,0,0,1,25,13,3,1,3,205,1,1,207,233,0.122,0.888
"20876","Santa Cruz","Santa Cruz de La Sierra","Col. Mariscal Sucre",153,0,0,0,25,11,9,0,0,198,1,3,202,229,0.126,0.882
"20877","Santa Cruz","Santa Cruz de La Sierra","Col. Mariscal Sucre",136,0,0,2,16,18,14,1,1,188,0,4,192,217,0.085,0.885
"20878","Santa Cruz","Santa Cruz de La Sierra","Col. Mariscal Sucre",150,0,0,0,19,16,11,0,2,198,0,1,199,224,0.096,0.888
"20879","Santa Cruz","Santa Cruz de La Sierra","Col. Mariscal Sucre",154,0,0,1,16,13,6,1,0,191,1,3,195,223,0.084,0.874
"20880","Santa Cruz","Santa Cruz de La Sierra","Col. Mariscal Sucre",150,0,0,0,26,16,4,1,0,197,1,5,203,224,0.132,0.906
"20881","Santa Cruz","Santa Cruz de La Sierra","Col. Mariscal Sucre",165,0,0,1,19,12,6,1,0,204,2,3,209,227,0.093,0.921
"20882","Santa Cruz","Santa Cruz de La Sierra","Col. Mariscal Sucre",147,2,0,0,23,8,10,0,0,190,0,2,192,216,0.121,0.889
"20883","Santa Cruz","Santa Cruz de La Sierra","Col. Mariscal Sucre",166,0,1,1,20,14,4,0,0,206,2,1,209,229,0.097,0.913
"20884","Santa Cruz","Santa Cruz de La Sierra","Col. Mariscal Sucre",160,0,1,0,18,11,8,0,0,198,0,2,200,229,0.091,0.873
"20885","Santa Cruz","Santa Cruz de La Sierra","Col. Ramon Dario Gutierrez",143,1,1,0,21,24,5,1,1,197,0,2,199,228,0.107,0.873
"20886","Santa Cruz","Santa Cruz de La Sierra","Col. Ramon Dario Gutierrez",154,0,0,0,20,14,7,1,0,196,1,1,198,227,0.102,0.872
"20887","Santa Cruz","Santa Cruz de La Sierra","Col. Ramon Dario Gutierrez",156,0,0,0,25,6,3,4,1,195,0,5,200,227,0.128,0.881
"20888","Santa Cruz","Santa Cruz de La Sierra","Col. Ramon Dario Gutierrez",155,0,0,1,22,15,2,1,0,196,0,5,201,229,0.112,0.878
"20889","Santa Cruz","Santa Cruz de La Sierra","Col. Ramon Dario Gutierrez",150,0,2,1,10,22,8,1,0,194,0,4,198,233,0.052,0.85
"20890","Santa Cruz","Santa Cruz de La Sierra","Col. Ramon Dario Gutierrez",153,1,0,1,22,18,6,0,0,201,0,3,204,228,0.109,0.895
"20891","Santa Cruz","Santa Cruz de La Sierra","Col. Ramon Dario Gutierrez",162,0,0,3,9,15,4,3,1,197,1,5,203,220,0.046,0.923
"20892","Santa Cruz","Santa Cruz de La Sierra","Col. Ramon Dario Gutierrez",163,1,0,1,22,11,4,1,0,203,1,2,206,230,0.108,0.896
"20893","Santa Cruz","Santa Cruz de La Sierra","Col. Juan Pablo II",148,0,1,2,17,14,9,0,0,191,1,6,198,224,0.089,0.884
"20894","Santa Cruz","Santa Cruz de La Sierra","Col. Juan Pablo II",139,0,0,1,14,28,1,1,0,184,0,1,185,213,0.076,0.869
"20895","Santa Cruz","Santa Cruz de La Sierra","Col. Juan Pablo II",155,0,0,0,20,13,3,1,0,192,0,2,194,226,0.104,0.858
"20896","Santa Cruz","Santa Cruz de La Sierra","Col. Juan Pablo II",157,0,0,2,17,18,6,0,1,201,2,1,204,228,0.085,0.895
"20897","Santa Cruz","Santa Cruz de La Sierra","Col. Juan Pablo II",163,0,0,1,13,19,3,4,0,203,0,4,207,226,0.064,0.916
"20898","Santa Cruz","Santa Cruz de La Sierra","Col. Juan Pablo II",154,0,0,1,16,19,6,1,0,197,0,5,202,226,0.081,0.894
"20899","Santa Cruz","Santa Cruz de La Sierra","Col. Juan Pablo II",169,0,0,3,10,17,4,0,0,203,1,2,206,225,0.049,0.916
"20900","Santa Cruz","Santa Cruz de La Sierra","Col. Juan Pablo II",161,0,0,1,15,23,4,3,0,207,0,5,212,226,0.072,0.938
"20901","Santa Cruz","Santa Cruz de La Sierra","Col. Juan Pablo II",151,0,0,1,11,19,6,2,0,190,1,4,195,218,0.058,0.894
"20902","Santa Cruz","Santa Cruz de La Sierra","Col. Juan Pablo II",144,0,1,2,17,12,3,0,0,179,0,6,185,215,0.095,0.86
"20903","Santa Cruz","Santa Cruz de La Sierra","Col. Juan Pablo II",165,0,0,1,12,17,3,0,0,198,0,1,199,224,0.061,0.888
"20904","Santa Cruz","Santa Cruz de La Sierra","Col. Juan Pablo II",158,0,0,1,8,15,6,2,1,191,1,3,195,224,0.042,0.871
"20905","Santa Cruz","Santa Cruz de La Sierra","Col. Juan Pablo II",170,0,0,0,16,11,5,2,2,206,1,19,226,226,0.078,1
"20906","Santa Cruz","Santa Cruz de La Sierra","Col. Juan Pablo II",161,0,0,0,13,21,3,1,0,199,0,5,204,227,0.065,0.899
"20907","Santa Cruz","Santa Cruz de La Sierra","Col. Juan Pablo II",157,0,0,0,10,9,3,1,0,180,2,2,184,219,0.056,0.84
"20908","Santa Cruz","Santa Cruz de La Sierra","Col. Juan Pablo II",167,0,0,0,9,11,3,0,1,191,2,0,193,223,0.047,0.865
"20909","Santa Cruz","Santa Cruz de La Sierra","Col. Juan Pablo II",161,0,0,2,15,14,3,2,1,198,0,4,202,226,0.076,0.894
"20910","Santa Cruz","Santa Cruz de La Sierra","Col. Juan Pablo II",136,0,0,0,13,12,4,0,0,165,2,5,172,192,0.079,0.896
"20911","Santa Cruz","Santa Cruz de La Sierra","Col.  Elfi Rivera De Barbery",78,0,0,2,53,30,10,3,0,176,0,5,181,217,0.301,0.834
"20912","Santa Cruz","Santa Cruz de La Sierra","Col.  Elfi Rivera De Barbery",95,0,0,1,47,29,10,0,1,183,0,10,193,226,0.257,0.854
"20913","Santa Cruz","Santa Cruz de La Sierra","Col.  Elfi Rivera De Barbery",93,0,1,0,45,31,12,1,1,184,2,9,195,223,0.245,0.874
"20914","Santa Cruz","Santa Cruz de La Sierra","Col.  Elfi Rivera De Barbery",92,1,1,0,49,31,7,0,0,181,2,8,191,222,0.271,0.86
"20915","Santa Cruz","Santa Cruz de La Sierra","Col.  Elfi Rivera De Barbery",104,1,0,1,45,24,8,0,2,185,1,7,193,222,0.243,0.869
"20916","Santa Cruz","Santa Cruz de La Sierra","Col.  Elfi Rivera De Barbery",96,0,0,1,67,15,12,2,0,193,1,13,207,227,0.347,0.912
"20917","Santa Cruz","Santa Cruz de La Sierra","Col.  Elfi Rivera De Barbery",107,0,0,0,42,28,12,2,0,191,1,3,195,222,0.22,0.878
"20918","Santa Cruz","Santa Cruz de La Sierra","Col.  Elfi Rivera De Barbery",103,1,0,1,38,20,8,0,0,171,0,9,180,214,0.222,0.841
"20919","Santa Cruz","Santa Cruz de La Sierra","Col.  Elfi Rivera De Barbery",73,2,0,2,83,20,17,0,0,197,1,8,206,231,0.421,0.892
"20920","Santa Cruz","Santa Cruz de La Sierra","Col.  Elfi Rivera De Barbery",78,0,0,0,80,15,14,2,0,189,1,10,200,233,0.423,0.858
"20921","Santa Cruz","Santa Cruz de La Sierra","Col.  Elfi Rivera De Barbery",124,0,1,0,34,15,5,0,0,179,2,10,191,223,0.19,0.857
"20922","Santa Cruz","Santa Cruz de La Sierra","Col.  Elfi Rivera De Barbery",104,0,2,0,43,22,10,2,1,184,0,3,187,213,0.234,0.878
"20923","Santa Cruz","Santa Cruz de La Sierra","Col.  Elfi Rivera De Barbery",79,0,0,1,69,24,7,3,1,184,1,12,197,229,0.375,0.86
"20924","Santa Cruz","Santa Cruz de La Sierra","Col.  Elfi Rivera De Barbery",103,2,0,0,60,17,7,1,0,190,0,9,199,225,0.316,0.884
"20925","Santa Cruz","Santa Cruz de La Sierra","Col.  Elfi Rivera De Barbery",78,0,0,0,56,30,6,1,0,171,2,11,184,227,0.327,0.811
"20926","Santa Cruz","Santa Cruz de La Sierra","Col.  Elfi Rivera De Barbery",91,1,0,1,54,32,6,1,1,187,0,10,197,224,0.289,0.879
"20927","Santa Cruz","Santa Cruz de La Sierra","Col.  Elfi Rivera De Barbery",105,0,0,0,38,23,13,2,1,182,0,10,192,223,0.209,0.861
"20928","Santa Cruz","Santa Cruz de La Sierra","Col.  Elfi Rivera De Barbery",103,0,1,0,46,25,14,1,2,192,1,4,197,225,0.24,0.876
"20929","Santa Cruz","Santa Cruz de La Sierra","Col.  Elfi Rivera De Barbery",105,0,0,0,55,18,10,0,0,188,0,11,199,232,0.293,0.858
"20930","Santa Cruz","Santa Cruz de La Sierra","Col.  Elfi Rivera De Barbery",75,0,2,0,88,21,7,2,1,196,1,9,206,228,0.449,0.904
"20931","Santa Cruz","Santa Cruz de La Sierra","Col.  Elfi Rivera De Barbery",93,0,0,1,32,24,10,0,1,161,2,15,178,219,0.199,0.813
"20932","Santa Cruz","Santa Cruz de La Sierra","Col.  Elfi Rivera De Barbery",98,1,0,0,47,22,12,1,2,183,1,13,197,221,0.257,0.891
"20933","Santa Cruz","Santa Cruz de La Sierra","Col.  Elfi Rivera De Barbery",109,0,0,0,34,27,10,0,0,180,2,6,188,220,0.189,0.855
"20934","Santa Cruz","Santa Cruz de La Sierra","Col.  Elfi Rivera De Barbery",86,0,0,3,63,28,12,0,1,193,2,4,199,220,0.326,0.905
"20935","Santa Cruz","Santa Cruz de La Sierra","Col.  Elfi Rivera De Barbery",93,0,0,0,45,22,10,1,0,171,5,12,188,219,0.263,0.858
"20936","Santa Cruz","Santa Cruz de La Sierra","Col.  Elfi Rivera De Barbery",111,1,0,0,41,31,10,0,0,194,0,8,202,231,0.211,0.874
"20937","Santa Cruz","Santa Cruz de La Sierra","Col.  Elfi Rivera De Barbery",100,0,0,0,59,23,16,0,0,198,2,6,206,226,0.298,0.912
"20938","Santa Cruz","Santa Cruz de La Sierra","Col.  Elfi Rivera De Barbery",102,0,0,1,54,24,8,2,1,192,1,12,205,224,0.281,0.915
"20939","Santa Cruz","Santa Cruz de La Sierra","Col.  Elfi Rivera De Barbery",108,0,0,2,30,30,6,1,1,178,2,16,196,226,0.169,0.867
"20940","Santa Cruz","Santa Cruz de La Sierra","Col.  Elfi Rivera De Barbery",85,0,0,0,45,27,16,1,1,175,1,7,183,213,0.257,0.859
"20941","Santa Cruz","Santa Cruz de La Sierra","Col.  Elfi Rivera De Barbery",118,2,0,2,37,23,10,2,1,195,0,3,198,227,0.19,0.872
"20942","Santa Cruz","Santa Cruz de La Sierra","Col.  Elfi Rivera De Barbery",124,1,0,0,35,21,6,1,0,188,1,10,199,229,0.186,0.869
"20943","Santa Cruz","Santa Cruz de La Sierra","Col.  Elfi Rivera De Barbery",95,1,1,2,33,28,7,2,1,170,2,17,189,220,0.194,0.859
"20944","Santa Cruz","Santa Cruz de La Sierra","Col.  Elfi Rivera De Barbery",109,2,0,2,41,26,10,2,0,192,2,3,197,224,0.214,0.879
"20945","Santa Cruz","Santa Cruz de La Sierra","Col.  Elfi Rivera De Barbery",43,0,2,8,40,65,0,4,0,162,38,6,206,229,0.247,0.9
"20946","Santa Cruz","Santa Cruz de La Sierra","Col.  Elfi Rivera De Barbery",102,1,1,0,31,30,9,0,0,174,0,12,186,219,0.178,0.849
"20947","Santa Cruz","Santa Cruz de La Sierra","Col.  Elfi Rivera De Barbery",109,0,2,0,49,25,10,1,0,196,2,6,204,228,0.25,0.895
"20948","Santa Cruz","Santa Cruz de La Sierra","Col.  Elfi Rivera De Barbery",97,0,0,0,56,21,11,2,1,188,3,10,201,226,0.298,0.889
"20949","Santa Cruz","Santa Cruz de La Sierra","Modulo Rancho Nuevo",100,1,0,1,65,25,19,1,1,213,2,6,221,238,0.305,0.929
"20950","Santa Cruz","Santa Cruz de La Sierra","Modulo Rancho Nuevo",117,0,0,1,43,30,18,1,1,211,0,11,222,239,0.204,0.929
"20951","Santa Cruz","Santa Cruz de La Sierra","Modulo Rancho Nuevo",109,1,1,0,42,26,21,2,0,202,2,6,210,237,0.208,0.886
"20952","Santa Cruz","Santa Cruz de La Sierra","Modulo Rancho Nuevo",92,0,0,0,71,25,18,3,0,209,2,5,216,237,0.34,0.911
"20953","Santa Cruz","Santa Cruz de La Sierra","Modulo Rancho Nuevo",118,2,0,1,39,32,12,0,0,204,0,5,209,231,0.191,0.905
"20954","Santa Cruz","Santa Cruz de La Sierra","Modulo Rancho Nuevo",108,0,0,0,55,20,17,1,0,201,0,10,211,237,0.274,0.89
"20955","Santa Cruz","Santa Cruz de La Sierra","Modulo Rancho Nuevo",92,0,0,2,46,27,21,1,0,189,2,10,201,238,0.243,0.845
"20956","Santa Cruz","Santa Cruz de La Sierra","Modulo Rancho Nuevo",118,2,0,2,36,26,15,0,0,199,0,5,204,236,0.181,0.864
"20957","Santa Cruz","Santa Cruz de La Sierra","Modulo Rancho Nuevo",82,0,1,0,72,22,24,2,2,205,0,10,215,237,0.351,0.907
"20958","Santa Cruz","Santa Cruz de La Sierra","Modulo Rancho Nuevo",122,0,0,0,38,38,9,0,0,207,0,8,215,238,0.184,0.903
"20959","Santa Cruz","Santa Cruz de La Sierra","Modulo Rancho Nuevo",95,2,1,0,53,25,18,0,1,195,0,5,200,233,0.272,0.858
"20960","Santa Cruz","Santa Cruz de La Sierra","Modulo Rancho Nuevo",112,0,0,1,47,30,10,1,3,204,2,3,209,236,0.23,0.886
"20961","Santa Cruz","Santa Cruz de La Sierra","Modulo Rancho Nuevo",101,0,0,0,56,36,15,0,1,209,1,8,218,236,0.268,0.924
"20962","Santa Cruz","Santa Cruz de La Sierra","Modulo Rancho Nuevo",109,1,0,1,39,31,13,0,0,194,1,13,208,236,0.201,0.881
"20963","Santa Cruz","Santa Cruz de La Sierra","Modulo Rancho Nuevo",97,0,0,1,50,35,18,1,0,202,2,10,214,238,0.248,0.899
"20964","Santa Cruz","Santa Cruz de La Sierra","Modulo Rancho Nuevo",105,1,1,0,43,24,20,3,0,197,1,9,207,239,0.218,0.866
"20965","Santa Cruz","Santa Cruz de La Sierra","Modulo Rancho Nuevo",106,1,2,1,46,34,10,0,0,200,1,9,210,236,0.23,0.89
"20966","Santa Cruz","Santa Cruz de La Sierra","Colegio Elvira Parada",109,0,0,0,48,19,15,1,0,192,3,3,198,227,0.25,0.872
"20967","Santa Cruz","Santa Cruz de La Sierra","Colegio Elvira Parada",117,0,0,0,51,19,10,3,0,200,1,3,204,234,0.255,0.872
"20968","Santa Cruz","Santa Cruz de La Sierra","Colegio Elvira Parada",126,0,1,0,32,28,16,1,0,204,3,7,214,233,0.157,0.918
"20969","Santa Cruz","Santa Cruz de La Sierra","Colegio Elvira Parada",117,0,1,1,35,23,13,0,0,190,1,11,202,231,0.184,0.874
"20970","Santa Cruz","Santa Cruz de La Sierra","Colegio Elvira Parada",83,0,0,1,71,20,12,0,1,188,1,3,192,226,0.378,0.85
"20971","Santa Cruz","Santa Cruz de La Sierra","Colegio Elvira Parada",104,0,0,0,43,29,12,0,0,188,3,7,198,233,0.229,0.85
"20972","Santa Cruz","Santa Cruz de La Sierra","Colegio Elvira Parada",95,0,0,0,61,18,14,1,0,189,3,8,200,236,0.323,0.847
"20973","Santa Cruz","Santa Cruz de La Sierra","Colegio Elvira Parada",98,1,1,0,60,21,15,1,1,198,3,5,206,231,0.303,0.892
"20974","Santa Cruz","Santa Cruz de La Sierra","Colegio Elvira Parada",99,1,0,0,43,33,13,3,0,192,0,4,196,228,0.224,0.86
"20975","Santa Cruz","Santa Cruz de La Sierra","Colegio Elvira Parada",99,0,0,0,71,22,12,1,0,205,2,5,212,231,0.346,0.918
"20976","Santa Cruz","Santa Cruz de La Sierra","Colegio Elvira Parada",126,0,0,2,31,27,7,0,0,193,0,6,199,225,0.161,0.884
"20977","Santa Cruz","Santa Cruz de La Sierra","Colegio Elvira Parada",104,0,0,0,40,20,15,2,0,181,3,7,191,228,0.221,0.838
"20978","Santa Cruz","Santa Cruz de La Sierra","Colegio Elvira Parada",107,0,0,0,40,23,8,1,0,179,2,15,196,229,0.223,0.856
"20979","Santa Cruz","Santa Cruz de La Sierra","Colegio Elvira Parada",102,1,0,0,55,24,21,0,0,203,1,3,207,229,0.271,0.904
"20980","Santa Cruz","Santa Cruz de La Sierra","Colegio Elvira Parada",116,0,0,0,34,33,9,1,0,193,1,7,201,229,0.176,0.878
"20981","Santa Cruz","Santa Cruz de La Sierra","Colegio Elvira Parada",128,0,0,1,33,29,7,0,0,198,2,9,209,228,0.167,0.917
"20982","Santa Cruz","Santa Cruz de La Sierra","Colegio Elvira Parada",102,1,0,0,38,34,6,1,0,182,1,6,189,228,0.209,0.829
"20983","Santa Cruz","Santa Cruz de La Sierra","Colegio Elvira Parada",102,0,0,0,48,23,7,2,1,183,1,9,193,229,0.262,0.843
"20984","Santa Cruz","Santa Cruz de La Sierra","Colegio Elvira Parada",114,1,0,0,44,20,12,1,0,192,0,4,196,226,0.229,0.867
"20985","Santa Cruz","Santa Cruz de La Sierra","16 de Julio",84,0,2,2,58,36,16,2,1,201,3,7,211,235,0.289,0.898
"20986","Santa Cruz","Santa Cruz de La Sierra","16 de Julio",65,0,0,0,70,37,19,1,0,192,3,12,207,231,0.365,0.896
"20987","Santa Cruz","Santa Cruz de La Sierra","16 de Julio",97,1,1,0,59,23,17,2,2,202,3,8,213,232,0.292,0.918
"20988","Santa Cruz","Santa Cruz de La Sierra","16 de Julio",104,0,2,0,52,32,14,1,1,206,2,6,214,236,0.252,0.907
"20989","Santa Cruz","Santa Cruz de La Sierra","16 de Julio",93,0,0,1,53,36,13,1,1,198,5,7,210,234,0.268,0.897
"20990","Santa Cruz","Santa Cruz de La Sierra","16 de Julio",90,1,0,0,47,26,12,4,4,184,4,6,194,216,0.255,0.898
"20991","Santa Cruz","Santa Cruz de La Sierra","U.E. Villa Alba",127,1,1,0,42,23,14,1,0,209,4,6,219,235,0.201,0.932
"20992","Santa Cruz","Santa Cruz de La Sierra","U.E. 23 de Diciembre J. Carlos Truji",106,0,0,1,50,13,12,0,0,182,1,5,188,214,0.275,0.879
"20993","Santa Cruz","Santa Cruz de La Sierra","U.E. 23 de Diciembre J. Carlos Truji",119,0,0,0,31,20,9,1,1,181,4,7,192,225,0.171,0.853
"20994","Santa Cruz","Santa Cruz de La Sierra","U.E. 23 de Diciembre J. Carlos Truji",119,0,1,1,36,15,9,1,1,183,1,8,192,220,0.197,0.873
"20995","Santa Cruz","Santa Cruz de La Sierra","U.E. 23 de Diciembre J. Carlos Truji",118,0,0,0,47,17,4,1,0,187,1,5,193,223,0.251,0.865
"20996","Santa Cruz","Santa Cruz de La Sierra","U.E. 23 de Diciembre J. Carlos Truji",97,1,0,1,46,13,14,1,0,173,2,5,180,222,0.266,0.811
"20997","Santa Cruz","Santa Cruz de La Sierra","U.E. 23 de Diciembre J. Carlos Truji",118,0,0,1,23,18,10,0,0,170,1,5,176,221,0.135,0.796
"20998","Santa Cruz","Santa Cruz de La Sierra","U.E. 23 de Diciembre J. Carlos Truji",109,0,1,2,49,22,7,0,0,190,0,2,192,227,0.258,0.846
"20999","Santa Cruz","Santa Cruz de La Sierra","U.E. 23 de Diciembre J. Carlos Truji",91,0,0,0,49,24,6,2,0,172,1,12,185,220,0.285,0.841
"21000","Santa Cruz","Santa Cruz de La Sierra","U.E. 23 de Diciembre J. Carlos Truji",115,1,1,1,31,24,6,2,0,181,0,6,187,215,0.171,0.87
"21001","Santa Cruz","Santa Cruz de La Sierra","U.E. 23 de Diciembre J. Carlos Truji",96,0,1,1,50,17,19,1,0,185,2,6,193,225,0.27,0.858
"21002","Santa Cruz","Santa Cruz de La Sierra","U.E. 23 de Diciembre J. Carlos Truji",122,0,0,2,34,24,5,2,0,189,1,7,197,228,0.18,0.864
"21003","Santa Cruz","Santa Cruz de La Sierra","U.E. 23 de Diciembre J. Carlos Truji",116,0,0,0,34,24,10,2,1,187,0,9,196,223,0.182,0.879
"21004","Santa Cruz","Santa Cruz de La Sierra","U.E. 23 de Diciembre J. Carlos Truji",107,0,0,1,41,19,7,0,0,175,1,6,182,216,0.234,0.843
"21005","Santa Cruz","Santa Cruz de La Sierra","U.E. 23 de Diciembre J. Carlos Truji",105,1,0,2,38,25,8,0,0,179,0,10,189,228,0.212,0.829
"21006","Santa Cruz","Santa Cruz de La Sierra","U.E. 23 de Diciembre J. Carlos Truji",110,0,0,1,46,18,12,1,0,188,1,5,194,222,0.245,0.874
"21007","Santa Cruz","Santa Cruz de La Sierra","U.E. 23 de Diciembre J. Carlos Truji",128,0,1,0,29,21,4,2,2,187,0,8,195,224,0.155,0.871
"21008","Santa Cruz","Santa Cruz de La Sierra","U.E. 23 de Diciembre J. Carlos Truji",131,0,0,0,31,20,4,1,0,187,2,4,193,219,0.166,0.881
"21009","Santa Cruz","Santa Cruz de La Sierra","U.E. 23 de Diciembre J. Carlos Truji",120,1,0,0,26,31,8,0,0,186,2,6,194,222,0.14,0.874
"21010","Santa Cruz","Santa Cruz de La Sierra","U.E. 23 de Diciembre J. Carlos Truji",107,0,0,0,44,29,7,3,0,190,1,4,195,222,0.232,0.878
"21011","Santa Cruz","Santa Cruz de La Sierra","U.E. 23 de Diciembre J. Carlos Truji",117,0,0,1,31,26,8,1,1,185,1,9,195,224,0.168,0.871
"21012","Santa Cruz","Santa Cruz de La Sierra","U.E. 23 de Diciembre J. Carlos Truji",97,0,0,0,67,26,9,3,0,202,2,4,208,227,0.332,0.916
"21013","Santa Cruz","Santa Cruz de La Sierra","Col. Unidad Educativa España",87,0,0,0,74,22,18,0,0,201,2,7,210,230,0.368,0.913
"21014","Santa Cruz","Santa Cruz de La Sierra","Col. Unidad Educativa España",119,0,0,0,39,31,9,4,0,202,2,4,208,227,0.193,0.916
"21015","Santa Cruz","Santa Cruz de La Sierra","Col. Unidad Educativa España",92,0,0,1,59,19,18,1,2,192,4,10,206,231,0.307,0.892
"21016","Santa Cruz","Santa Cruz de La Sierra","Col. Unidad Educativa España",84,1,1,2,77,13,19,0,1,198,3,5,206,228,0.389,0.904
"21017","Santa Cruz","Santa Cruz de La Sierra","Col. Unidad Educativa España",97,0,0,2,70,21,7,2,0,199,0,8,207,230,0.352,0.9
"21018","Santa Cruz","Santa Cruz de La Sierra","Col. Unidad Educativa España",96,0,0,2,51,31,11,1,1,193,1,8,202,225,0.264,0.898
"21019","Santa Cruz","Santa Cruz de La Sierra","Col. Unidad Educativa España",102,0,0,1,60,25,9,1,1,199,1,5,205,227,0.302,0.903
"21020","Santa Cruz","Santa Cruz de La Sierra","Col. Unidad Educativa España",114,1,0,0,52,22,22,2,1,214,1,4,219,233,0.243,0.94
"21021","Santa Cruz","Santa Cruz de La Sierra","Col. Unidad Educativa España",98,0,0,2,47,18,20,0,1,186,1,8,195,225,0.253,0.867
"21022","Santa Cruz","Santa Cruz de La Sierra","Col. Unidad Educativa España",98,1,0,1,55,31,7,1,1,195,1,6,202,230,0.282,0.878
"21023","Santa Cruz","Santa Cruz de La Sierra","Col. Unidad Educativa España",116,0,2,2,40,24,14,4,1,203,0,14,217,233,0.197,0.931
"21024","Santa Cruz","Santa Cruz de La Sierra","Col. Unidad Educativa España",77,1,1,0,77,18,15,3,1,193,0,6,199,224,0.399,0.888
"21025","Santa Cruz","Santa Cruz de La Sierra","Col. Unidad Educativa España",96,0,1,0,35,29,18,1,1,181,1,7,189,217,0.193,0.871
"21026","Santa Cruz","Santa Cruz de La Sierra","Col. Unidad Educativa España",99,0,0,0,62,23,12,2,0,198,0,6,204,223,0.313,0.915
"21027","Santa Cruz","Santa Cruz de La Sierra","Col. Unidad Educativa España",103,0,0,0,49,26,8,3,2,191,0,10,201,230,0.257,0.874
"21028","Santa Cruz","Santa Cruz de La Sierra","Col. Unidad Educativa España",92,1,1,1,50,31,15,2,1,194,2,13,209,225,0.258,0.929
"21029","Santa Cruz","Santa Cruz de La Sierra","Luz Del Mundo C",113,0,0,0,52,24,13,0,0,202,1,14,217,237,0.257,0.916
"21030","Santa Cruz","Santa Cruz de La Sierra","Luz Del Mundo C",126,0,2,0,38,30,19,0,1,216,0,2,218,239,0.176,0.912
"21031","Santa Cruz","Santa Cruz de La Sierra","Luz Del Mundo C",134,0,1,1,39,21,15,0,0,211,0,8,219,237,0.185,0.924
"21032","Santa Cruz","Santa Cruz de La Sierra","Luz Del Mundo C",145,0,0,0,32,16,7,1,1,202,0,9,211,237,0.158,0.89
"21033","Santa Cruz","Santa Cruz de La Sierra","U.E. Cielito Lindo",117,0,0,0,52,29,6,5,2,211,3,5,219,237,0.246,0.924
"21034","Santa Cruz","Santa Cruz de La Sierra","U.E. Cielito Lindo",92,0,0,1,53,34,11,2,0,193,1,10,204,230,0.275,0.887
"21035","Santa Cruz","Santa Cruz de La Sierra","U.E. Cielito Lindo",94,0,0,0,60,27,13,1,0,195,1,11,207,233,0.308,0.888
"21036","Santa Cruz","Santa Cruz de La Sierra","U.E. Cielito Lindo",109,0,1,1,54,22,12,0,0,199,2,7,208,229,0.271,0.908
"21037","Santa Cruz","Santa Cruz de La Sierra","U.E. Cielito Lindo",99,0,1,1,53,37,15,3,0,209,0,4,213,229,0.254,0.93
"21038","Santa Cruz","Santa Cruz de La Sierra","U.E. Cielito Lindo",112,2,1,0,51,32,7,4,1,210,0,6,216,237,0.243,0.911
"21039","Santa Cruz","Santa Cruz de La Sierra","U.E. Cielito Lindo",116,0,0,0,48,40,10,2,0,216,0,5,221,236,0.222,0.936
"21040","Santa Cruz","Santa Cruz de La Sierra","U.E. Cielito Lindo",67,0,1,1,52,25,6,0,0,152,1,8,161,178,0.342,0.904
"21041","Santa Cruz","Santa Cruz de La Sierra","U.E. Señor de los Milagros",100,0,1,1,56,36,14,2,1,211,0,6,217,236,0.265,0.919
"21042","Santa Cruz","Santa Cruz de La Sierra","U.E. Señor de los Milagros",103,1,1,1,61,28,17,0,0,212,3,5,220,238,0.288,0.924
"21043","Santa Cruz","Santa Cruz de La Sierra","U.E. Señor de los Milagros",123,0,0,0,52,27,15,2,0,219,0,2,221,237,0.237,0.932
"21044","Santa Cruz","Santa Cruz de La Sierra","Col. Esc. Gral. Ismael Montes Gamboa",97,0,1,1,58,33,13,2,0,205,3,8,216,234,0.283,0.923
"21045","Santa Cruz","Santa Cruz de La Sierra","Col. Esc. Gral. Ismael Montes Gamboa",82,1,0,1,81,22,13,0,1,201,2,3,206,229,0.403,0.9
"21046","Santa Cruz","Santa Cruz de La Sierra","Col. Esc. Gral. Ismael Montes Gamboa",100,1,0,0,60,24,17,2,1,205,0,3,208,227,0.293,0.916
"21047","Santa Cruz","Santa Cruz de La Sierra","Col. Esc. Gral. Ismael Montes Gamboa",87,0,0,0,99,13,8,0,0,207,0,6,213,229,0.478,0.93
"21048","Santa Cruz","Santa Cruz de La Sierra","Col. Esc. Gral. Ismael Montes Gamboa",73,1,1,2,90,21,13,0,2,203,0,5,208,233,0.443,0.893
"21049","Santa Cruz","Santa Cruz de La Sierra","Col. Esc. Gral. Ismael Montes Gamboa",68,0,1,0,103,18,18,1,0,209,1,7,217,233,0.493,0.931
"21050","Santa Cruz","Santa Cruz de La Sierra","Col. Esc. Gral. Ismael Montes Gamboa",57,1,1,2,97,17,15,1,0,191,6,9,206,225,0.508,0.916
"21051","Santa Cruz","Santa Cruz de La Sierra","Col. Esc. Gral. Ismael Montes Gamboa",117,0,0,1,41,28,15,1,0,203,4,7,214,236,0.202,0.907
"21052","Santa Cruz","Santa Cruz de La Sierra","Col. Esc. Gral. Ismael Montes Gamboa",74,0,0,0,71,24,26,1,1,197,6,7,210,232,0.36,0.905
"21053","Santa Cruz","Santa Cruz de La Sierra","Col. Esc. Gral. Ismael Montes Gamboa",81,0,0,0,81,23,16,0,1,202,1,7,210,234,0.401,0.897
"21054","Santa Cruz","Santa Cruz de La Sierra","Col. Esc. Gral. Ismael Montes Gamboa",74,1,1,0,64,34,23,0,0,197,2,6,205,232,0.325,0.884
"21055","Santa Cruz","Santa Cruz de La Sierra","Col. Esc. Gral. Ismael Montes Gamboa",67,0,0,2,81,26,12,1,1,190,0,7,197,228,0.426,0.864
"21056","Santa Cruz","Santa Cruz de La Sierra","Col. Esc. Gral. Ismael Montes Gamboa",94,0,0,1,58,28,11,0,0,192,1,7,200,227,0.302,0.881
"21057","Santa Cruz","Santa Cruz de La Sierra","Col. Esc. Gral. Ismael Montes Gamboa",46,0,1,0,108,17,12,0,3,187,0,10,197,229,0.578,0.86
"21058","Santa Cruz","Santa Cruz de La Sierra","Col. Esc. Gral. Ismael Montes Gamboa",70,0,0,0,91,19,12,0,0,192,2,8,202,230,0.474,0.878
"21059","Santa Cruz","Santa Cruz de La Sierra","Col. Esc. Gral. Ismael Montes Gamboa",99,0,2,0,36,27,19,0,2,185,0,10,195,221,0.195,0.882
"21060","Santa Cruz","Santa Cruz de La Sierra","Col. Esc. Gral. Ismael Montes Gamboa",103,1,0,1,39,33,12,0,0,189,2,10,201,225,0.206,0.893
"21061","Santa Cruz","Santa Cruz de La Sierra","Col. Esc. Gral. Ismael Montes Gamboa",82,1,0,4,77,21,12,0,2,199,0,3,202,226,0.387,0.894
"21062","Santa Cruz","Santa Cruz de La Sierra","Col. Esc. Gral. Ismael Montes Gamboa",96,0,1,1,52,27,18,0,2,197,2,10,209,230,0.264,0.909
"21063","Santa Cruz","Santa Cruz de La Sierra","Col. Esc. Gral. Ismael Montes Gamboa",98,0,2,1,57,23,14,0,1,196,1,6,203,228,0.291,0.89
"21064","Santa Cruz","Santa Cruz de La Sierra","Col. Esc. Gral. Ismael Montes Gamboa",71,0,1,1,94,18,13,0,1,199,1,7,207,227,0.472,0.912
"21065","Santa Cruz","Santa Cruz de La Sierra","Col. Esc. Gral. Ismael Montes Gamboa",104,0,1,2,60,17,10,2,0,196,0,2,198,225,0.306,0.88
"21066","Santa Cruz","Santa Cruz de La Sierra","Col. Esc. Gral. Ismael Montes Gamboa",85,0,0,1,65,30,9,1,1,192,2,3,197,227,0.339,0.868
"21067","Santa Cruz","Santa Cruz de La Sierra","Col. Esc. Gral. Ismael Montes Gamboa",108,0,1,0,56,17,17,1,1,201,3,7,211,225,0.279,0.938
"21068","Santa Cruz","Santa Cruz de La Sierra","Col. Esc. Gral. Ismael Montes Gamboa",96,0,0,1,58,35,8,2,0,200,2,1,203,228,0.29,0.89
"21069","Santa Cruz","Santa Cruz de La Sierra","Col. Esc. Gral. Ismael Montes Gamboa",74,0,1,0,99,19,13,0,1,207,2,7,216,232,0.478,0.931
"21070","Santa Cruz","Santa Cruz de La Sierra","Col. Esc. Gral. Ismael Montes Gamboa",102,0,0,0,37,30,17,1,0,187,4,5,196,223,0.198,0.879
"21071","Santa Cruz","Santa Cruz de La Sierra","Col. Esc. Gral. Ismael Montes Gamboa",72,0,1,0,87,18,12,1,0,191,2,10,203,227,0.455,0.894
"21072","Santa Cruz","Santa Cruz de La Sierra","Urkupiña",71,1,0,0,69,26,23,2,1,193,1,4,198,230,0.358,0.861
"21073","Santa Cruz","Santa Cruz de La Sierra","Urkupiña",74,1,0,1,67,32,16,1,1,193,1,6,200,232,0.347,0.862
"21074","Santa Cruz","Santa Cruz de La Sierra","Urkupiña",59,1,1,1,70,33,11,1,1,178,1,16,195,236,0.393,0.826
"21075","Santa Cruz","Santa Cruz de La Sierra","Col. San Francisco De Sales Don Bosco",136,0,0,0,29,10,6,0,1,182,1,2,185,216,0.159,0.856
"21076","Santa Cruz","Santa Cruz de La Sierra","Col. San Francisco De Sales Don Bosco",136,0,1,3,32,15,4,2,0,193,1,8,202,230,0.166,0.878
"21077","Santa Cruz","Santa Cruz de La Sierra","Col. San Francisco De Sales Don Bosco",127,0,0,0,35,19,7,1,0,189,2,4,195,223,0.185,0.874
"21078","Santa Cruz","Santa Cruz de La Sierra","Col. San Francisco De Sales Don Bosco",143,0,0,1,19,13,6,2,0,184,0,4,188,216,0.103,0.87
"21079","Santa Cruz","Santa Cruz de La Sierra","Col. San Francisco De Sales Don Bosco",144,0,1,1,28,11,10,0,0,195,1,5,201,225,0.144,0.893
"21080","Santa Cruz","Santa Cruz de La Sierra","Col. San Francisco De Sales Don Bosco",130,0,0,0,39,15,11,2,1,198,2,3,203,228,0.197,0.89
"21081","Santa Cruz","Santa Cruz de La Sierra","Col. San Francisco De Sales Don Bosco",120,1,0,2,34,22,10,2,0,191,0,5,196,226,0.178,0.867
"21082","Santa Cruz","Santa Cruz de La Sierra","Col. San Francisco De Sales Don Bosco",124,1,0,2,44,14,4,2,0,191,3,5,199,228,0.23,0.873
"21083","Santa Cruz","Santa Cruz de La Sierra","Col. San Francisco De Sales Don Bosco",112,0,1,2,50,14,12,1,0,192,1,4,197,226,0.26,0.872
"21084","Santa Cruz","Santa Cruz de La Sierra","Col. San Francisco De Sales Don Bosco",144,0,0,3,22,10,7,4,0,190,0,8,198,216,0.116,0.917
"21085","Santa Cruz","Santa Cruz de La Sierra","Col. San Francisco De Sales Don Bosco",139,0,0,1,25,19,6,0,0,190,1,8,199,227,0.132,0.877
"21086","Santa Cruz","Santa Cruz de La Sierra","Col. San Francisco De Sales Don Bosco",135,0,0,0,29,16,9,0,0,189,0,6,195,232,0.153,0.841
"21087","Santa Cruz","Santa Cruz de La Sierra","Col. San Francisco De Sales Don Bosco",115,0,0,0,34,24,7,1,1,182,0,7,189,225,0.187,0.84
"21088","Santa Cruz","Santa Cruz de La Sierra","Col. San Francisco De Sales Don Bosco",119,0,0,2,40,30,11,1,0,203,3,1,207,227,0.197,0.912
"21089","Santa Cruz","Santa Cruz de La Sierra","Col. San Francisco De Sales Don Bosco",131,0,0,3,23,26,7,0,0,190,1,3,194,228,0.121,0.851
"21090","Santa Cruz","Santa Cruz de La Sierra","Col. San Francisco De Sales Don Bosco",139,0,0,1,24,21,6,1,0,192,2,4,198,225,0.125,0.88
"21091","Santa Cruz","Santa Cruz de La Sierra","Col. San Francisco De Sales Don Bosco",137,0,1,1,22,19,6,1,1,188,2,1,191,221,0.117,0.864
"21092","Santa Cruz","Santa Cruz de La Sierra","Col. San Francisco De Sales Don Bosco",111,0,0,0,38,19,12,1,0,181,0,8,189,221,0.21,0.855
"21093","Santa Cruz","Santa Cruz de La Sierra","Col. San Francisco De Sales Don Bosco",137,0,2,1,35,15,9,0,1,200,0,5,205,227,0.175,0.903
"21094","Santa Cruz","Santa Cruz de La Sierra","Col. San Francisco De Sales Don Bosco",151,0,0,1,17,15,8,3,0,195,0,4,199,230,0.087,0.865
"21095","Santa Cruz","Santa Cruz de La Sierra","Col. San Francisco De Sales Don Bosco",137,1,1,1,24,18,12,0,1,195,1,3,199,229,0.123,0.869
"21096","Santa Cruz","Santa Cruz de La Sierra","Col. San Francisco De Sales Don Bosco",140,0,1,1,32,11,6,2,0,193,0,5,198,227,0.166,0.872
"21097","Santa Cruz","Santa Cruz de La Sierra","Col. San Francisco De Sales Don Bosco",134,0,0,0,33,23,13,1,0,204,0,6,210,225,0.162,0.933
"21098","Santa Cruz","Santa Cruz de La Sierra","Col. San Francisco De Sales Don Bosco",125,0,0,0,33,16,9,1,1,185,2,4,191,226,0.178,0.845
"21099","Santa Cruz","Santa Cruz de La Sierra","Col. San Francisco De Sales Don Bosco",149,0,1,0,23,16,9,0,0,198,2,2,202,231,0.116,0.874
"21100","Santa Cruz","Santa Cruz de La Sierra","Col. San Francisco De Sales Don Bosco",119,0,0,0,35,14,11,3,1,183,1,6,190,230,0.191,0.826
"21101","Santa Cruz","Santa Cruz de La Sierra","Col. San Francisco De Sales Don Bosco",138,0,0,2,35,8,7,0,0,190,0,3,193,222,0.184,0.869
"21102","Santa Cruz","Santa Cruz de La Sierra","Col. San Francisco De Sales Don Bosco",136,0,1,0,28,12,10,1,0,188,4,5,197,226,0.149,0.872
"21103","Santa Cruz","Santa Cruz de La Sierra","Col. San Francisco De Sales Don Bosco",128,0,0,2,38,17,6,0,1,192,1,3,196,229,0.198,0.856
"21104","Santa Cruz","Santa Cruz de La Sierra","Col. San Francisco De Sales Don Bosco",137,0,0,0,26,23,10,0,0,196,2,2,200,225,0.133,0.889
"21105","Santa Cruz","Santa Cruz de La Sierra","Col. San Francisco De Sales Don Bosco",135,0,0,4,31,14,10,0,0,194,1,8,203,226,0.16,0.898
"21106","Santa Cruz","Santa Cruz de La Sierra","Col. San Francisco De Sales Don Bosco",144,0,1,0,20,13,7,1,0,186,0,3,189,229,0.108,0.825
"21107","Santa Cruz","Santa Cruz de La Sierra","Col. San Francisco De Sales Don Bosco",150,0,0,0,36,10,8,0,0,204,0,7,211,234,0.176,0.902
"21108","Santa Cruz","Santa Cruz de La Sierra","Col. San Francisco De Sales Don Bosco",137,0,1,3,28,26,5,0,1,201,0,5,206,231,0.139,0.892
"21109","Santa Cruz","Santa Cruz de La Sierra","Col. San Francisco De Sales Don Bosco",147,0,0,0,38,10,14,1,0,210,1,4,215,229,0.181,0.939
"21110","Santa Cruz","Santa Cruz de La Sierra","Col. San Francisco De Sales Don Bosco",140,0,0,0,34,8,14,1,1,198,0,6,204,228,0.172,0.895
"21111","Santa Cruz","Santa Cruz de La Sierra","U.E. Arca De Noe",97,1,0,0,57,27,8,0,2,192,0,9,201,226,0.297,0.889
"21112","Santa Cruz","Santa Cruz de La Sierra","U.E. Arca De Noe",106,1,0,1,58,27,10,1,0,204,2,6,212,233,0.284,0.91
"21113","Santa Cruz","Santa Cruz de La Sierra","U.E. Arca De Noe",106,0,2,0,60,33,6,0,0,207,2,6,215,236,0.29,0.911
"21114","Santa Cruz","Santa Cruz de La Sierra","U.E. Arca De Noe",88,1,0,0,62,32,11,2,0,196,2,1,199,235,0.316,0.847
"21115","Santa Cruz","Santa Cruz de La Sierra","16 de Febrero",99,1,1,0,70,21,11,3,0,206,1,3,210,235,0.34,0.894
"21116","Santa Cruz","Santa Cruz de La Sierra","16 de Febrero",107,0,0,2,61,28,15,0,1,214,1,4,219,237,0.285,0.924
"21117","Santa Cruz","Santa Cruz de La Sierra","16 de Febrero",81,0,1,1,44,28,14,0,1,170,2,4,176,193,0.259,0.912
"21118","Santa Cruz","Santa Cruz de La Sierra","U.E. 18 de Julio",82,0,1,1,72,26,14,5,0,201,0,14,215,230,0.358,0.935
"21119","Santa Cruz","Santa Cruz de La Sierra","U.E. 18 de Julio",72,3,0,1,92,19,14,2,1,204,4,5,213,236,0.451,0.903
"21120","Santa Cruz","Santa Cruz de La Sierra","U.E. 18 de Julio",77,1,0,0,92,17,23,2,1,213,1,8,222,233,0.432,0.953
"21121","Santa Cruz","Santa Cruz de La Sierra","U.E. 18 de Julio",101,1,0,0,77,15,14,0,0,208,0,6,214,237,0.37,0.903
"21122","Santa Cruz","Santa Cruz de La Sierra","U.E. 18 de Julio",100,0,2,0,75,16,13,0,2,208,1,6,215,236,0.361,0.911
"21123","Santa Cruz","Santa Cruz de La Sierra","U.E. 18 de Julio",92,0,1,0,72,22,16,1,1,205,1,10,216,236,0.351,0.915
"21124","Santa Cruz","Santa Cruz de La Sierra","U.E. 18 de Julio",77,0,1,1,86,23,14,2,0,204,3,4,211,235,0.422,0.898
"21125","Santa Cruz","Santa Cruz de La Sierra","U.E. 18 de Julio",101,2,1,0,65,22,19,1,2,213,0,5,218,235,0.305,0.928
"21126","Santa Cruz","Santa Cruz de La Sierra","U.E. 18 de Julio",83,0,0,0,100,15,14,1,1,214,2,4,220,238,0.467,0.924
"21127","Santa Cruz","Santa Cruz de La Sierra","U.E. 18 de Julio",83,0,0,2,78,28,11,2,2,206,2,7,215,232,0.379,0.927
"21128","Santa Cruz","Santa Cruz de La Sierra","U.E. 18 de Julio",88,0,0,0,81,25,15,0,1,210,1,9,220,237,0.386,0.928
"21129","Santa Cruz","Santa Cruz de La Sierra","U.E. 18 de Julio",78,1,2,0,60,15,14,0,0,170,1,3,174,186,0.353,0.935
"21130","Santa Cruz","Santa Cruz de La Sierra","U.E. El Dorado Norte",78,0,0,1,73,25,20,1,0,198,1,6,205,231,0.369,0.887
"21131","Santa Cruz","Santa Cruz de La Sierra","U.E. El Dorado Norte",79,2,1,3,71,25,9,1,0,191,0,4,195,221,0.372,0.882
"21132","Santa Cruz","Santa Cruz de La Sierra","U.E. El Dorado Norte",97,0,0,1,42,24,14,0,0,178,3,10,191,224,0.236,0.853
"21133","Santa Cruz","Santa Cruz de La Sierra","U.E. El Dorado Norte",78,0,0,1,71,23,15,1,0,189,0,38,227,228,0.376,0.996
"21134","Santa Cruz","Santa Cruz de La Sierra","U.E. El Dorado Norte",63,0,0,0,94,19,17,2,2,197,1,5,203,229,0.477,0.886
"21135","Santa Cruz","Santa Cruz de La Sierra","U.E. El Dorado Norte",72,1,1,0,77,20,17,0,1,189,1,8,198,229,0.407,0.865
"21136","Santa Cruz","Santa Cruz de La Sierra","U.E. El Dorado Norte",83,0,1,1,63,25,14,2,0,189,1,41,231,231,0.333,1
"21137","Santa Cruz","Santa Cruz de La Sierra","U.E. El Dorado Norte",44,0,2,1,109,12,16,1,0,185,1,7,193,226,0.589,0.854
"21138","Santa Cruz","Santa Cruz de La Sierra","U.E. El Dorado Norte",45,0,1,2,114,13,22,0,2,199,0,4,203,222,0.573,0.914
"21139","Santa Cruz","Santa Cruz de La Sierra","U.E. El Dorado Norte",81,0,1,0,61,27,17,2,0,189,0,8,197,234,0.323,0.842
"21140","Santa Cruz","Santa Cruz de La Sierra","U.E. El Dorado Norte",75,1,0,2,62,27,6,1,1,175,2,11,188,231,0.354,0.814
"21141","Santa Cruz","Santa Cruz de La Sierra","U.E. El Dorado Norte",65,0,0,2,83,19,17,1,0,187,2,5,194,222,0.444,0.874
"21142","Santa Cruz","Santa Cruz de La Sierra","U.E. El Dorado Norte",75,0,0,1,71,22,18,1,1,189,3,9,201,228,0.376,0.882
"21143","Santa Cruz","Santa Cruz de La Sierra","U.E. El Dorado Norte",81,0,0,1,76,15,17,1,0,191,0,6,197,228,0.398,0.864
"21144","Santa Cruz","Santa Cruz de La Sierra","U.E. El Dorado Norte",96,0,1,0,69,23,12,0,2,203,0,2,205,234,0.34,0.876
"21145","Santa Cruz","Santa Cruz de La Sierra","U.E. El Dorado Norte",81,1,0,2,74,14,15,2,0,189,2,10,201,228,0.392,0.882
"21146","Santa Cruz","Santa Cruz de La Sierra","U.E. El Dorado Norte",96,0,0,0,55,20,16,1,0,188,2,2,192,225,0.293,0.853
"21147","Santa Cruz","Santa Cruz de La Sierra","U.E. El Dorado Norte",73,0,1,0,79,24,12,0,0,189,2,10,201,230,0.418,0.874
"21148","Santa Cruz","Santa Cruz de La Sierra","U.E. El Dorado Norte",29,0,3,2,112,18,23,1,2,190,2,7,199,225,0.589,0.884
"21149","Santa Cruz","Santa Cruz de La Sierra","U.E. El Dorado Norte",59,0,0,2,98,14,13,0,1,187,3,4,194,226,0.524,0.858
"21150","Santa Cruz","Santa Cruz de La Sierra","U.E. El Dorado Norte",103,2,1,0,38,30,5,1,0,180,1,12,193,228,0.211,0.846
"21151","Santa Cruz","Santa Cruz de La Sierra","U.E. El Dorado Norte",76,0,1,1,68,27,17,0,1,191,4,4,199,227,0.356,0.877
"21152","Santa Cruz","Santa Cruz de La Sierra","U.E. El Dorado Norte",87,0,0,3,57,28,17,3,1,196,1,4,201,224,0.291,0.897
"21153","Santa Cruz","Santa Cruz de La Sierra","U.E. El Dorado Norte",79,0,2,0,72,16,16,1,1,187,3,6,196,228,0.385,0.86
"21154","Santa Cruz","Santa Cruz de La Sierra","U.E. El Dorado Norte",87,0,0,0,56,28,16,0,0,187,1,12,200,226,0.299,0.885
"21155","Santa Cruz","Santa Cruz de La Sierra","U.E. El Dorado Norte",93,0,0,0,55,33,15,1,0,197,1,3,201,231,0.279,0.87
"21156","Santa Cruz","Santa Cruz de La Sierra","U.E. El Dorado Norte",69,1,1,1,72,21,17,0,0,182,1,7,190,224,0.396,0.848
"21157","Santa Cruz","Santa Cruz de La Sierra","U.E. El Dorado Norte",46,1,1,0,117,9,15,0,0,189,0,12,201,234,0.619,0.859
"21158","Santa Cruz","Santa Cruz de La Sierra","U.E. El Dorado Norte",91,0,0,0,49,27,8,3,0,178,3,8,189,229,0.275,0.825
"21159","Santa Cruz","Santa Cruz de La Sierra","U.E. El Dorado Norte",78,0,0,0,66,16,16,2,0,178,2,9,189,225,0.371,0.84
"21160","Santa Cruz","Santa Cruz de La Sierra","U.E. El Dorado Norte",65,0,0,0,68,38,17,3,0,191,1,6,198,223,0.356,0.888
"21161","Santa Cruz","Santa Cruz de La Sierra","U.E. El Dorado Norte",101,1,1,1,68,24,14,1,1,212,0,3,215,233,0.321,0.923
"21162","Santa Cruz","Santa Cruz de La Sierra","U.E. El Dorado Norte",92,1,0,1,67,26,8,2,1,198,1,5,204,229,0.338,0.891
"21163","Santa Cruz","Santa Cruz de La Sierra","U.E. El Dorado Norte",98,0,1,0,53,34,13,0,1,200,0,7,207,234,0.265,0.885
"21164","Santa Cruz","Santa Cruz de La Sierra","U.E. El Dorado Norte",49,0,1,6,84,18,19,0,1,178,2,2,182,227,0.472,0.802
"21165","Santa Cruz","Santa Cruz de La Sierra","U.E. El Dorado Norte",97,0,0,1,49,25,13,0,0,185,1,8,194,224,0.265,0.866
"21166","Santa Cruz","Santa Cruz de La Sierra","U.E. El Dorado Norte",81,0,1,1,76,19,13,2,0,193,2,3,198,233,0.394,0.85
"21167","Santa Cruz","Santa Cruz de La Sierra","U.E. El Dorado Norte",66,1,2,0,89,13,11,1,1,184,1,8,193,230,0.484,0.839
"21168","Santa Cruz","Santa Cruz de La Sierra","U.E. El Dorado Norte",68,0,0,0,72,34,12,2,2,190,3,5,198,219,0.379,0.904
"21169","Santa Cruz","Santa Cruz de La Sierra","U.E. 24 de Marzo",83,0,0,1,82,26,12,1,1,206,2,4,212,237,0.398,0.895
"21170","Santa Cruz","Santa Cruz de La Sierra","U.E. 24 de Marzo",63,0,2,1,103,21,23,0,0,213,4,4,221,234,0.484,0.944
"21171","Santa Cruz","Santa Cruz de La Sierra","U.E. 24 de Marzo",84,1,0,1,91,21,19,3,4,224,1,7,232,239,0.406,0.971
"21172","Santa Cruz","Santa Cruz de La Sierra","U.E. 24 de Marzo",83,1,0,2,81,27,18,4,0,216,2,4,222,239,0.375,0.929
"21173","Santa Cruz","Santa Cruz de La Sierra","U.E. 24 de Marzo",74,1,0,2,97,22,18,0,2,216,2,5,223,239,0.449,0.933
"21174","Santa Cruz","Santa Cruz de La Sierra","U.E. 24 de Marzo",81,2,3,0,75,19,21,1,1,203,2,12,217,235,0.369,0.923
"21175","Santa Cruz","Santa Cruz de La Sierra","U.E. Nuevo Horizonte",70,1,0,2,83,28,20,1,0,205,2,6,213,236,0.405,0.903
"21176","Santa Cruz","Santa Cruz de La Sierra","U.E. Nuevo Horizonte",79,1,0,0,79,32,14,1,0,206,0,6,212,232,0.383,0.914
"21177","Santa Cruz","Santa Cruz de La Sierra","U.E. Nuevo Horizonte",96,1,0,0,68,26,19,2,0,212,2,4,218,235,0.321,0.928
"21178","Santa Cruz","Santa Cruz de La Sierra","U.E. Nuevo Horizonte",98,0,0,0,68,23,7,0,0,196,1,2,199,229,0.347,0.869
"21179","Santa Cruz","Santa Cruz de La Sierra","U.E. Nuevo Horizonte",55,0,1,2,113,16,18,1,1,207,2,5,214,230,0.546,0.93
"21180","Santa Cruz","Santa Cruz de La Sierra","U.E. Nuevo Horizonte",76,1,1,3,73,23,20,4,2,203,0,5,208,235,0.36,0.885
"21181","Santa Cruz","Santa Cruz de La Sierra","U.E. Nuevo Horizonte",66,2,0,0,104,21,13,0,1,207,1,8,216,237,0.502,0.911
"21182","Santa Cruz","Santa Cruz de La Sierra","U.E. Nuevo Horizonte",73,1,0,1,78,29,24,1,0,207,0,2,209,233,0.377,0.897
"21183","Santa Cruz","Santa Cruz de La Sierra","U.E. Nuevo Horizonte",88,1,0,1,59,28,20,1,1,199,2,7,208,233,0.296,0.893
"21184","Santa Cruz","Santa Cruz de La Sierra","U.E. Nuevo Horizonte",47,1,0,3,116,17,13,0,1,198,2,2,202,230,0.586,0.878
"21185","Santa Cruz","Santa Cruz de La Sierra","U.E. Nuevo Horizonte",97,0,0,0,54,31,13,3,0,198,0,1,199,226,0.273,0.881
"21186","Santa Cruz","Santa Cruz de La Sierra","U.E. Nuevo Horizonte",84,0,0,2,73,24,16,1,1,201,6,5,212,233,0.363,0.91
"21187","Santa Cruz","Santa Cruz de La Sierra","U.E. Nuevo Horizonte",84,0,1,0,63,34,21,2,1,206,2,6,214,233,0.306,0.918
"21188","Santa Cruz","Santa Cruz de La Sierra","U.E. Nuevo Horizonte",65,0,1,1,87,20,17,0,3,194,4,6,204,228,0.448,0.895
"21189","Santa Cruz","Santa Cruz de La Sierra","U.E. Nuevo Horizonte",84,0,1,1,70,21,18,5,2,202,1,5,208,235,0.347,0.885
"21190","Santa Cruz","Santa Cruz de La Sierra","U.E. Nuevo Horizonte",70,0,0,0,84,31,12,0,0,197,1,8,206,227,0.426,0.907
"21191","Santa Cruz","Santa Cruz de La Sierra","U.E. Nuevo Horizonte",88,0,0,1,70,26,10,0,0,195,3,5,203,227,0.359,0.894
"21192","Santa Cruz","Santa Cruz de La Sierra","U.E. Nuevo Horizonte",88,1,1,2,77,31,8,4,1,213,0,8,221,235,0.362,0.94
"21193","Santa Cruz","Santa Cruz de La Sierra","U.E. Nuevo Horizonte",82,0,0,0,96,11,12,0,2,203,1,2,206,228,0.473,0.904
"21194","Santa Cruz","Santa Cruz de La Sierra","U.E. Bibosi",53,0,0,0,110,26,16,0,1,206,1,5,212,237,0.534,0.895
"21195","Santa Cruz","Santa Cruz de La Sierra","U.E. Bibosi",70,0,0,0,93,22,15,2,0,202,2,5,209,239,0.46,0.874
"21196","Santa Cruz","Santa Cruz de La Sierra","U.E. Bibosi",58,0,1,0,99,29,15,1,0,203,0,7,210,238,0.488,0.882
"21197","Santa Cruz","Santa Cruz de La Sierra","U.E. 26 De Septiembre",62,0,1,0,94,20,13,2,0,192,1,6,199,229,0.49,0.869
"21198","Santa Cruz","Santa Cruz de La Sierra","U.E. 26 De Septiembre",68,0,0,1,76,35,16,0,0,196,0,2,198,224,0.388,0.884
"21199","Santa Cruz","Santa Cruz de La Sierra","U.E. 26 De Septiembre",65,0,0,0,98,21,11,0,1,196,1,2,199,231,0.5,0.861
"21200","Santa Cruz","Santa Cruz de La Sierra","U.E. 26 De Septiembre",74,0,0,0,87,23,11,0,0,195,0,10,205,229,0.446,0.895
"21201","Santa Cruz","Santa Cruz de La Sierra","U.E. 26 De Septiembre",54,0,0,0,102,23,19,1,0,199,0,2,201,231,0.513,0.87
"21202","Santa Cruz","Santa Cruz de La Sierra","U.E. 26 De Septiembre",70,0,0,2,81,35,16,0,0,204,1,6,211,236,0.397,0.894
"21203","Santa Cruz","Santa Cruz de La Sierra","U.E. 26 De Septiembre",60,0,0,1,98,28,10,1,1,199,1,2,202,225,0.492,0.898
"21204","Santa Cruz","Santa Cruz de La Sierra","U.E. 26 De Septiembre",36,0,1,1,120,23,19,1,1,202,1,1,204,226,0.594,0.903
"21205","Santa Cruz","Santa Cruz de La Sierra","U.E. 26 De Septiembre",72,0,0,0,63,39,9,2,0,185,2,5,192,232,0.341,0.828
"21206","Santa Cruz","Santa Cruz de La Sierra","U.E. 26 De Septiembre",62,1,0,2,86,17,25,1,3,197,1,10,208,231,0.437,0.9
"21207","Santa Cruz","Santa Cruz de La Sierra","U.E. 26 De Septiembre",46,1,0,0,94,33,14,0,0,188,3,3,194,233,0.5,0.833
"21208","Santa Cruz","Santa Cruz de La Sierra","U.E. 26 De Septiembre",73,0,0,1,84,27,9,2,0,196,2,4,202,229,0.429,0.882
"21209","Santa Cruz","Santa Cruz de La Sierra","U.E. 26 De Septiembre",71,1,0,1,83,25,13,1,0,195,2,10,207,234,0.426,0.885
"21210","Santa Cruz","Santa Cruz de La Sierra","U.E. 26 De Septiembre",85,0,0,1,66,27,15,1,1,196,0,3,199,222,0.337,0.896
"21211","Santa Cruz","Santa Cruz de La Sierra","U.E. 26 De Septiembre",64,0,2,0,103,14,16,0,0,199,2,7,208,230,0.518,0.904
"21212","Santa Cruz","Santa Cruz de La Sierra","U.E. 26 De Septiembre",41,0,0,0,125,11,14,1,2,194,3,7,204,228,0.644,0.895
"21213","Santa Cruz","Santa Cruz de La Sierra","U.E. 26 De Septiembre",74,1,0,1,55,41,19,0,0,191,0,6,197,233,0.288,0.845
"21214","Santa Cruz","Santa Cruz de La Sierra","U.E. 26 De Septiembre",60,0,1,1,76,44,15,0,2,199,1,6,206,230,0.382,0.896
"21215","Santa Cruz","Santa Cruz de La Sierra","U.E. 26 De Septiembre",57,2,0,1,90,40,13,1,0,204,2,8,214,235,0.441,0.911
"21216","Santa Cruz","Santa Cruz de La Sierra","U.E. 26 De Septiembre",69,0,0,3,82,22,10,1,2,189,1,7,197,229,0.434,0.86
"21217","Santa Cruz","Santa Cruz de La Sierra","U.E. 26 De Septiembre",91,0,1,0,59,30,9,3,0,193,2,7,202,229,0.306,0.882
"21218","Santa Cruz","Santa Cruz de La Sierra","U.E. 26 De Septiembre",45,0,1,2,83,31,22,1,2,187,1,6,194,228,0.444,0.851
"21219","Santa Cruz","Santa Cruz de La Sierra","U.E. 26 De Septiembre",53,1,1,1,103,21,8,0,0,188,1,2,191,226,0.548,0.845
"21220","Santa Cruz","Santa Cruz de La Sierra","U.E. 26 De Septiembre",72,0,0,0,73,38,14,1,0,198,2,6,206,225,0.369,0.916
"21221","Santa Cruz","Santa Cruz de La Sierra","U.E. 26 De Septiembre",71,0,0,0,68,31,15,2,1,188,2,8,198,228,0.362,0.868
"21222","Santa Cruz","Santa Cruz de La Sierra","U.E. 26 De Septiembre",75,0,1,0,76,27,14,2,1,196,1,7,204,232,0.388,0.879
"21223","Santa Cruz","Santa Cruz de La Sierra","U.E. 26 De Septiembre",68,2,2,1,72,34,11,1,0,191,1,6,198,229,0.377,0.865
"21224","Santa Cruz","Santa Cruz de La Sierra","U.E. 26 De Septiembre",63,1,2,0,87,25,18,1,1,198,0,8,206,232,0.439,0.888
"21225","Santa Cruz","Santa Cruz de La Sierra","U.E. 26 De Septiembre",82,0,0,0,76,28,8,0,0,194,0,5,199,230,0.392,0.865
"21226","Santa Cruz","Santa Cruz de La Sierra","U.E. 26 De Septiembre",71,0,1,0,92,15,16,0,0,195,3,3,201,228,0.472,0.882
"21227","Santa Cruz","Santa Cruz de La Sierra","U.E. 26 De Septiembre",63,1,0,0,78,26,20,3,0,191,0,7,198,230,0.408,0.861
"21228","Santa Cruz","Santa Cruz de La Sierra","Progreso",119,0,0,2,40,18,11,1,3,194,0,7,201,255,0.206,0.788
"21229","Santa Cruz","Santa Cruz de La Sierra","Virgen De Guadalupe",112,1,0,1,63,23,7,3,0,210,1,7,218,232,0.3,0.94
"21230","Santa Cruz","Santa Cruz de La Sierra","Virgen De Guadalupe",90,0,1,2,66,32,20,0,0,211,3,7,221,237,0.313,0.932
"21231","Santa Cruz","Santa Cruz de La Sierra","Virgen De Guadalupe",90,1,0,1,77,19,15,1,0,204,3,13,220,237,0.377,0.928
"21232","Santa Cruz","Santa Cruz de La Sierra","Virgen De Guadalupe",113,0,0,0,56,25,11,5,0,210,3,3,216,236,0.267,0.915
"21233","Santa Cruz","Santa Cruz de La Sierra","Virgen De Guadalupe",108,0,0,1,68,24,15,0,0,216,1,7,224,235,0.315,0.953
"21234","Santa Cruz","Santa Cruz de La Sierra","Virgen De Guadalupe",102,0,0,1,71,22,10,0,0,206,0,8,214,235,0.345,0.911
"21235","Santa Cruz","Santa Cruz de La Sierra","Virgen De Guadalupe",93,0,0,0,72,26,13,2,1,207,1,13,221,234,0.348,0.944
"21236","Santa Cruz","Santa Cruz de La Sierra","Virgen De Guadalupe",112,0,1,1,44,29,15,3,0,205,2,7,214,236,0.215,0.907
"21237","Santa Cruz","Santa Cruz de La Sierra","Virgen De Guadalupe",75,0,1,0,91,23,19,2,2,213,1,9,223,236,0.427,0.945
"21238","Santa Cruz","Santa Cruz de La Sierra","Virgen De Guadalupe",106,1,0,1,49,42,9,0,2,210,1,8,219,231,0.233,0.948
"21239","Santa Cruz","Santa Cruz de La Sierra","Virgen De Guadalupe",109,1,0,1,57,33,12,3,0,216,0,3,219,235,0.264,0.932
"21240","Santa Cruz","Santa Cruz de La Sierra","Virgen De Guadalupe",123,0,0,1,40,28,11,5,0,208,0,5,213,232,0.192,0.918
"21241","Santa Cruz","Santa Cruz de La Sierra","Virgen De Guadalupe",105,0,1,0,64,29,14,2,0,215,3,5,223,237,0.298,0.941
"21242","Santa Cruz","Santa Cruz de La Sierra","Virgen De Guadalupe",108,0,0,0,47,31,13,0,0,199,2,8,209,236,0.236,0.886
"21243","Santa Cruz","Santa Cruz de La Sierra","Virgen De Guadalupe",126,0,0,1,49,29,5,3,0,213,1,4,218,231,0.23,0.944
"21244","Santa Cruz","Santa Cruz de La Sierra","Virgen De Guadalupe",111,0,1,0,38,34,13,3,1,201,2,9,212,235,0.189,0.902
"21245","Santa Cruz","Santa Cruz de La Sierra","Virgen De Guadalupe",133,0,0,1,41,21,7,1,1,205,1,5,211,234,0.2,0.902
"21246","Santa Cruz","Santa Cruz de La Sierra","Virgen De Guadalupe",81,0,0,0,65,28,12,0,0,186,2,7,195,214,0.349,0.911
"21247","Santa Cruz","Santa Cruz de La Sierra","U.E. San Cayetano",87,0,0,0,58,40,15,2,2,204,1,7,212,232,0.284,0.914
"21248","Santa Cruz","Santa Cruz de La Sierra","U.E. San Cayetano",75,1,1,1,89,21,15,2,1,206,2,11,219,236,0.432,0.928
"21249","Santa Cruz","Santa Cruz de La Sierra","U.E. San Cayetano",69,0,1,2,87,31,13,2,3,208,1,4,213,237,0.418,0.899
"21250","Santa Cruz","Santa Cruz de La Sierra","U.E. San Cayetano",78,2,0,2,71,46,9,0,0,208,1,7,216,238,0.341,0.908
"21251","Santa Cruz","Santa Cruz de La Sierra","U.E. San Cayetano",58,0,0,1,66,34,22,0,0,181,1,31,213,237,0.365,0.899
"21252","Santa Cruz","Santa Cruz de La Sierra","U.E. San Cayetano",95,0,0,3,62,37,17,0,1,215,0,7,222,233,0.288,0.953
"21253","Santa Cruz","Santa Cruz de La Sierra","U.E. San Cayetano",92,0,2,1,55,41,12,3,0,206,2,4,212,236,0.267,0.898
"21254","Santa Cruz","Santa Cruz de La Sierra","U.E. San Cayetano",87,1,0,0,89,19,12,4,1,213,2,5,220,234,0.418,0.94
"21255","Santa Cruz","Santa Cruz de La Sierra","U.E. San Cayetano",89,0,0,1,53,40,9,2,1,195,6,7,208,235,0.272,0.885
"21256","Santa Cruz","Santa Cruz de La Sierra","U.E. San Cayetano",93,1,0,1,54,38,11,3,4,205,1,6,212,230,0.263,0.922
"21257","Santa Cruz","Santa Cruz de La Sierra","U.E. San Cayetano",87,0,0,1,64,44,20,2,0,218,1,6,225,235,0.294,0.957
"21258","Santa Cruz","Santa Cruz de La Sierra","U.E. Zaragoza",72,0,1,2,80,45,14,1,3,218,1,9,228,236,0.367,0.966
"21259","Santa Cruz","Santa Cruz de La Sierra","U.E. Zaragoza",73,0,1,0,66,35,26,1,3,205,2,12,219,238,0.322,0.92
"21260","Santa Cruz","Santa Cruz de La Sierra","U.E. Zaragoza",69,0,1,1,75,39,17,0,1,203,2,9,214,233,0.369,0.918
"21261","Santa Cruz","Santa Cruz de La Sierra","U.E. Zaragoza",86,0,0,0,69,45,15,1,2,218,2,9,229,234,0.317,0.979
"21262","Santa Cruz","Santa Cruz de La Sierra","U.E. Zaragoza",58,0,0,0,103,31,16,3,0,211,3,7,221,232,0.488,0.953
"21263","Santa Cruz","Santa Cruz de La Sierra","U.E. Zaragoza",81,1,0,2,71,40,10,4,1,210,1,8,219,239,0.338,0.916
"21264","Santa Cruz","Santa Cruz de La Sierra","U.E. Zaragoza",69,0,1,0,93,35,12,2,1,213,3,11,227,233,0.437,0.974
"21265","Santa Cruz","Santa Cruz de La Sierra","U.E. Zaragoza",97,1,0,1,57,37,8,1,0,202,7,6,215,230,0.282,0.935
"21266","Santa Cruz","Santa Cruz de La Sierra","U.E. Zaragoza",87,2,0,1,73,31,12,3,1,210,1,6,217,232,0.348,0.935
"21267","Santa Cruz","Santa Cruz de La Sierra","U. E. El Retoño",84,0,0,0,60,32,7,2,0,185,1,6,192,231,0.324,0.831
"21268","Santa Cruz","Santa Cruz de La Sierra","U. E. El Retoño",95,1,0,0,44,34,8,3,0,185,2,4,191,224,0.238,0.853
"21269","Santa Cruz","Santa Cruz de La Sierra","U. E. El Retoño",89,0,0,0,61,30,15,3,0,198,1,5,204,231,0.308,0.883
"21270","Santa Cruz","Santa Cruz de La Sierra","U. E. El Retoño",73,1,0,2,79,30,6,2,2,195,0,7,202,235,0.405,0.86
"21271","Santa Cruz","Santa Cruz de La Sierra","U. E. El Retoño",86,1,0,3,55,30,13,0,2,190,2,9,201,233,0.289,0.863
"21272","Santa Cruz","Santa Cruz de La Sierra","U. E. El Retoño",76,0,0,0,73,26,17,0,0,192,0,4,196,232,0.38,0.845
"21273","Santa Cruz","Santa Cruz de La Sierra","U. E. El Retoño",87,2,0,1,60,29,9,3,1,192,1,5,198,227,0.312,0.872
"21274","Santa Cruz","Santa Cruz de La Sierra","U. E. El Retoño",83,1,0,0,59,32,13,1,1,190,0,11,201,230,0.311,0.874
"21275","Santa Cruz","Santa Cruz de La Sierra","U. E. El Retoño",83,0,1,1,62,30,12,0,0,189,1,4,194,234,0.328,0.829
"21276","Santa Cruz","Santa Cruz de La Sierra","U. E. El Retoño",75,1,0,2,66,42,11,2,1,200,0,7,207,228,0.33,0.908
"21277","Santa Cruz","Santa Cruz de La Sierra","U. E. El Retoño",78,0,0,2,47,43,12,3,0,185,0,6,191,226,0.254,0.845
"21278","Santa Cruz","Santa Cruz de La Sierra","U. E. El Retoño",82,0,0,0,54,40,12,1,1,190,2,6,198,235,0.284,0.843
"21279","Santa Cruz","Santa Cruz de La Sierra","U. E. El Retoño",66,0,1,2,68,32,17,1,2,189,1,3,193,228,0.36,0.846
"21280","Santa Cruz","Santa Cruz de La Sierra","U. E. El Retoño",100,0,0,2,43,30,10,1,2,188,2,4,194,227,0.229,0.855
"21281","Santa Cruz","Santa Cruz de La Sierra","U. E. El Retoño",96,0,1,2,27,35,6,0,2,169,1,11,181,229,0.16,0.79
"21282","Santa Cruz","Santa Cruz de La Sierra","U. E. El Retoño",84,0,0,1,59,33,10,3,0,190,5,4,199,227,0.311,0.877
"21283","Santa Cruz","Santa Cruz de La Sierra","U. E. El Retoño",108,2,0,1,47,29,9,0,0,196,1,7,204,228,0.24,0.895
"21284","Santa Cruz","Santa Cruz de La Sierra","U. E. El Retoño",94,0,0,4,53,25,8,4,2,190,3,3,196,222,0.279,0.883
"21285","Santa Cruz","Santa Cruz de La Sierra","U. E. El Retoño",75,0,0,0,65,31,12,0,0,183,4,6,193,226,0.355,0.854
"21286","Santa Cruz","Santa Cruz de La Sierra","U. E. El Retoño",94,2,0,0,53,25,6,1,1,182,4,4,190,218,0.291,0.872
"21287","Santa Cruz","Santa Cruz de La Sierra","U. E. El Retoño",103,0,0,0,42,37,5,4,1,192,1,8,201,226,0.219,0.889
"21288","Santa Cruz","Santa Cruz de La Sierra","U. E. El Retoño",95,0,0,0,39,35,9,0,0,178,1,4,183,223,0.219,0.821
"21289","Santa Cruz","Santa Cruz de La Sierra","U. E. El Retoño",93,1,0,2,44,27,14,0,0,181,0,13,194,225,0.243,0.862
"21290","Santa Cruz","Santa Cruz de La Sierra","U. E. El Retoño",82,0,0,0,53,39,18,3,1,196,3,6,205,223,0.27,0.919
"21291","Santa Cruz","Santa Cruz de La Sierra","U. E. El Retoño",102,0,0,1,49,35,13,1,1,202,0,9,211,234,0.243,0.902
"21292","Santa Cruz","Santa Cruz de La Sierra","U. E. El Retoño",86,0,0,0,67,27,9,1,0,190,2,4,196,228,0.353,0.86
"21293","Santa Cruz","Santa Cruz de La Sierra","U. E. El Retoño",84,1,1,0,57,32,16,1,1,193,1,3,197,227,0.295,0.868
"21294","Santa Cruz","Santa Cruz de La Sierra","U.E. Los Cusis",88,1,0,0,55,42,19,1,1,207,1,9,217,235,0.266,0.923
"21295","Santa Cruz","Santa Cruz de La Sierra","U.E. Los Cusis",87,1,2,0,65,41,12,0,2,210,0,10,220,239,0.31,0.921
"21296","Santa Cruz","Santa Cruz de La Sierra","U.E. Los Cusis",77,2,0,0,82,39,8,0,1,209,2,11,222,235,0.392,0.945
"21297","Santa Cruz","Santa Cruz de La Sierra","U.E. Los Cusis",98,0,2,1,63,35,7,0,1,207,3,7,217,232,0.304,0.935
"21298","Santa Cruz","Santa Cruz de La Sierra","U.E. Los Cusis",89,0,0,2,57,40,22,1,2,213,4,6,223,234,0.268,0.953
"21299","Santa Cruz","Santa Cruz de La Sierra","U.E. Los Cusis",81,0,0,0,62,48,14,1,3,209,0,7,216,237,0.297,0.911
"21300","Santa Cruz","Santa Cruz de La Sierra","U.E. Los Cusis",96,0,0,0,60,48,6,0,0,210,4,2,216,236,0.286,0.915
"21301","Santa Cruz","Santa Cruz de La Sierra","U.E. Los Cusis",90,0,1,1,59,48,7,3,0,209,1,4,214,233,0.282,0.918
"21302","Santa Cruz","Santa Cruz de La Sierra","U.E. Los Cusis",101,0,0,1,55,42,8,1,0,208,0,12,220,237,0.264,0.928
"21303","Santa Cruz","Santa Cruz de La Sierra","U.E. Los Cusis",92,1,1,0,62,35,13,3,1,208,4,2,214,232,0.298,0.922
"21304","Santa Cruz","Santa Cruz de La Sierra","U.E. Los Cusis",84,0,1,0,66,49,12,1,1,214,1,12,227,247,0.308,0.919
"21305","Santa Cruz","Santa Cruz de La Sierra","Fred Nuñez Gonzales",86,1,1,0,85,37,11,0,0,221,0,3,224,237,0.385,0.945
"21306","Santa Cruz","Santa Cruz de La Sierra","Fred Nuñez Gonzales",66,0,0,0,107,22,16,2,0,213,5,7,225,235,0.502,0.957
"21307","Santa Cruz","Santa Cruz de La Sierra","Fred Nuñez Gonzales",66,0,0,0,100,27,19,2,0,214,0,12,226,238,0.467,0.95
"21308","Santa Cruz","Santa Cruz de La Sierra","Fred Nuñez Gonzales",68,0,0,0,103,28,17,1,2,219,2,3,224,238,0.47,0.941
"21309","Santa Cruz","Santa Cruz de La Sierra","Fred Nuñez Gonzales",70,0,0,0,90,30,22,2,0,214,3,5,222,238,0.421,0.933
"21310","Santa Cruz","Santa Cruz de La Sierra","Fred Nuñez Gonzales",74,2,1,0,81,25,19,0,0,202,5,9,216,237,0.401,0.911
"21311","Santa Cruz","Santa Cruz de La Sierra","Fred Nuñez Gonzales",67,0,2,2,89,23,18,4,0,205,4,11,220,234,0.434,0.94
"21312","Santa Cruz","Santa Cruz de La Sierra","Fred Nuñez Gonzales",71,1,0,2,91,32,7,2,3,209,1,9,219,238,0.435,0.92
"21313","Santa Cruz","Santa Cruz de La Sierra","Fred Nuñez Gonzales",77,1,2,0,75,36,9,1,3,204,2,6,212,228,0.368,0.93
"21314","Santa Cruz","Santa Cruz de La Sierra","Unidad Educativa Pompeya Santisimo Redentor",106,0,0,0,55,20,7,2,1,191,2,5,198,226,0.288,0.876
"21315","Santa Cruz","Santa Cruz de La Sierra","Unidad Educativa Pompeya Santisimo Redentor",105,0,0,2,62,16,13,3,0,201,0,6,207,232,0.308,0.892
"21316","Santa Cruz","Santa Cruz de La Sierra","Unidad Educativa Pompeya Santisimo Redentor",96,0,0,1,58,21,10,4,0,190,0,6,196,222,0.305,0.883
"21317","Santa Cruz","Santa Cruz de La Sierra","Unidad Educativa Pompeya Santisimo Redentor",91,0,0,1,56,17,17,0,0,182,1,9,192,226,0.308,0.85
"21318","Santa Cruz","Santa Cruz de La Sierra","Unidad Educativa Pompeya Santisimo Redentor",89,0,0,3,51,18,20,1,0,182,0,42,224,228,0.28,0.982
"21319","Santa Cruz","Santa Cruz de La Sierra","Unidad Educativa Pompeya Santisimo Redentor",69,0,1,0,82,18,19,1,1,191,1,3,195,229,0.429,0.852
"21320","Santa Cruz","Santa Cruz de La Sierra","Unidad Educativa Pompeya Santisimo Redentor",95,0,0,0,54,23,12,1,0,185,2,6,193,222,0.292,0.869
"21321","Santa Cruz","Santa Cruz de La Sierra","Unidad Educativa Pompeya Santisimo Redentor",88,2,0,0,59,20,12,2,0,183,0,5,188,224,0.322,0.839
"21322","Santa Cruz","Santa Cruz de La Sierra","Unidad Educativa Pompeya Santisimo Redentor",84,0,0,2,61,19,16,1,1,184,1,9,194,229,0.332,0.847
"21323","Santa Cruz","Santa Cruz de La Sierra","Unidad Educativa Pompeya Santisimo Redentor",113,1,0,3,33,16,11,1,1,179,4,6,189,221,0.184,0.855
"21324","Santa Cruz","Santa Cruz de La Sierra","Unidad Educativa Pompeya Santisimo Redentor",74,1,1,2,70,16,14,1,0,179,2,9,190,219,0.391,0.868
"21325","Santa Cruz","Santa Cruz de La Sierra","Unidad Educativa Pompeya Santisimo Redentor",114,0,0,0,38,23,12,1,1,189,1,5,195,228,0.201,0.855
"21326","Santa Cruz","Santa Cruz de La Sierra","Unidad Educativa Pompeya Santisimo Redentor",64,0,0,0,107,10,13,4,1,199,2,3,204,229,0.538,0.891
"21327","Santa Cruz","Santa Cruz de La Sierra","Unidad Educativa Pompeya Santisimo Redentor",88,1,0,0,52,20,20,2,2,185,2,4,191,224,0.281,0.853
"21328","Santa Cruz","Santa Cruz de La Sierra","Unidad Educativa Pompeya Santisimo Redentor",100,0,0,0,42,21,12,0,1,176,4,5,185,223,0.239,0.83
"21329","Santa Cruz","Santa Cruz de La Sierra","Unidad Educativa Pompeya Santisimo Redentor",101,1,1,0,46,24,7,1,3,184,5,5,194,223,0.25,0.87
"21330","Santa Cruz","Santa Cruz de La Sierra","Unidad Educativa Pompeya Santisimo Redentor",88,0,0,1,59,16,18,1,1,184,3,8,195,225,0.321,0.867
"21331","Santa Cruz","Santa Cruz de La Sierra","Unidad Educativa Pompeya Santisimo Redentor",120,1,0,1,31,19,8,0,3,183,2,5,190,224,0.169,0.848
"21332","Santa Cruz","Santa Cruz de La Sierra","Unidad Educativa Pompeya Santisimo Redentor",61,0,0,3,88,16,18,0,2,188,1,4,193,224,0.468,0.862
"21333","Santa Cruz","Santa Cruz de La Sierra","Unidad Educativa Pompeya Santisimo Redentor",109,0,1,0,36,20,13,3,0,182,0,7,189,221,0.198,0.855
"21334","Santa Cruz","Santa Cruz de La Sierra","Unidad Educativa Pompeya Santisimo Redentor",89,1,0,2,55,26,10,0,1,184,0,10,194,227,0.299,0.855
"21335","Santa Cruz","Santa Cruz de La Sierra","Unidad Educativa Pompeya Santisimo Redentor",100,1,0,2,36,26,20,0,0,185,1,5,191,225,0.195,0.849
"21336","Santa Cruz","Santa Cruz de La Sierra","Unidad Educativa Pompeya Santisimo Redentor",105,0,0,2,41,27,9,1,1,186,2,8,196,218,0.22,0.899
"21337","Santa Cruz","Santa Cruz de La Sierra","Unidad Educativa Pompeya Santisimo Redentor",114,1,0,1,34,25,11,0,0,186,1,12,199,224,0.183,0.888
"21338","Santa Cruz","Santa Cruz de La Sierra","Unidad Educativa Pompeya Santisimo Redentor",105,0,0,1,52,12,14,2,1,187,4,7,198,226,0.278,0.876
"21339","Santa Cruz","Santa Cruz de La Sierra","Unidad Educativa Pompeya Santisimo Redentor",107,0,1,0,42,29,8,3,0,190,0,7,197,235,0.221,0.838
"21340","Santa Cruz","Santa Cruz de La Sierra","Unidad Educativa Pompeya Santisimo Redentor",88,0,0,1,58,20,17,2,1,187,1,4,192,225,0.31,0.853
"21341","Santa Cruz","Santa Cruz de La Sierra","U.E. Josefina Balsamo Los Pinos",121,1,0,1,56,11,19,2,0,211,1,8,220,238,0.265,0.924
"21342","Santa Cruz","Santa Cruz de La Sierra","U.E. Josefina Balsamo Los Pinos",121,0,0,0,60,15,24,3,0,223,0,3,226,240,0.269,0.942
"21343","Santa Cruz","Santa Cruz de La Sierra","U.E. Josefina Balsamo Los Pinos",135,1,0,3,39,21,19,1,1,220,2,2,224,239,0.177,0.937
"21344","Santa Cruz","Santa Cruz de La Sierra","U.E. Josefina Balsamo Los Pinos",87,0,0,0,39,26,17,1,1,171,1,2,174,186,0.228,0.935
"21345","Santa Cruz","Santa Cruz de La Sierra","U.E. 26 de Noviembre",109,2,0,1,31,18,18,0,0,179,1,8,188,207,0.173,0.908
"21346","Santa Cruz","Santa Cruz de La Sierra","U.E. Santa Cecilia",106,0,0,1,64,26,21,0,0,218,1,5,224,238,0.294,0.941
"21347","Santa Cruz","Santa Cruz de La Sierra","Col. Pampa De La Isla",120,0,0,0,35,22,10,1,1,189,0,6,195,231,0.185,0.844
"21348","Santa Cruz","Santa Cruz de La Sierra","Col. Pampa De La Isla",99,0,0,1,38,37,14,0,0,189,2,4,195,232,0.201,0.841
"21349","Santa Cruz","Santa Cruz de La Sierra","Col. Pampa De La Isla",79,2,0,1,61,20,20,5,3,191,1,10,202,232,0.319,0.871
"21350","Santa Cruz","Santa Cruz de La Sierra","Col. Pampa De La Isla",111,0,0,1,51,28,6,2,0,199,0,3,202,233,0.256,0.867
"21351","Santa Cruz","Santa Cruz de La Sierra","Col. Pampa De La Isla",93,0,0,1,44,33,5,2,0,178,3,8,189,229,0.247,0.825
"21352","Santa Cruz","Santa Cruz de La Sierra","Col. Pampa De La Isla",113,0,1,0,41,18,17,1,0,191,1,6,198,227,0.215,0.872
"21353","Santa Cruz","Santa Cruz de La Sierra","Col. Pampa De La Isla",123,0,0,0,32,29,9,2,0,195,2,3,200,229,0.164,0.873
"21354","Santa Cruz","Santa Cruz de La Sierra","Col. Pampa De La Isla",118,0,0,1,32,23,9,0,0,183,3,7,193,222,0.175,0.869
"21355","Santa Cruz","Santa Cruz de La Sierra","Col. Pampa De La Isla",108,1,0,0,49,21,12,3,1,195,0,4,199,232,0.251,0.858
"21356","Santa Cruz","Santa Cruz de La Sierra","Col. Pampa De La Isla",122,1,0,1,37,27,8,0,1,197,1,8,206,234,0.188,0.88
"21357","Santa Cruz","Santa Cruz de La Sierra","Col. Pampa De La Isla",114,0,0,2,41,29,6,0,2,194,4,2,200,229,0.211,0.873
"21358","Santa Cruz","Santa Cruz de La Sierra","Col. Pampa De La Isla",116,1,0,1,35,25,11,0,0,189,3,8,200,227,0.185,0.881
"21359","Santa Cruz","Santa Cruz de La Sierra","Colegio San Felipe",72,1,0,0,79,22,19,1,2,196,0,5,201,230,0.403,0.874
"21360","Santa Cruz","Santa Cruz de La Sierra","Colegio San Felipe",96,2,1,0,58,16,10,0,0,183,0,10,193,225,0.317,0.858
"21361","Santa Cruz","Santa Cruz de La Sierra","Colegio San Felipe",82,1,1,0,70,20,16,2,0,192,1,7,200,231,0.365,0.866
"21362","Santa Cruz","Santa Cruz de La Sierra","Colegio San Felipe",86,0,0,0,71,18,16,0,1,192,2,7,201,230,0.37,0.874
"21363","Santa Cruz","Santa Cruz de La Sierra","Colegio San Felipe",77,1,0,0,68,30,21,2,1,200,0,8,208,231,0.34,0.9
"21364","Santa Cruz","Santa Cruz de La Sierra","Colegio San Felipe",99,0,0,0,55,25,13,1,1,194,2,5,201,229,0.284,0.878
"21365","Santa Cruz","Santa Cruz de La Sierra","Colegio San Felipe",100,0,0,0,56,32,13,0,0,201,1,2,204,229,0.279,0.891
"21366","Santa Cruz","Santa Cruz de La Sierra","Colegio San Felipe",62,0,2,0,93,15,15,1,1,189,1,7,197,225,0.492,0.876
"21367","Santa Cruz","Santa Cruz de La Sierra","Colegio San Felipe",62,0,0,2,85,14,11,2,0,176,0,20,196,230,0.483,0.852
"21368","Santa Cruz","Santa Cruz de La Sierra","Colegio San Felipe",105,0,1,1,53,16,11,1,3,191,1,4,196,224,0.277,0.875
"21369","Santa Cruz","Santa Cruz de La Sierra","Colegio San Felipe",102,0,0,0,59,18,9,1,0,189,1,6,196,227,0.312,0.863
"21370","Santa Cruz","Santa Cruz de La Sierra","Colegio San Felipe",78,0,0,0,81,20,8,2,2,191,1,7,199,225,0.424,0.884
"21371","Santa Cruz","Santa Cruz de La Sierra","Colegio San Felipe",77,1,0,1,77,19,12,0,1,188,3,9,200,224,0.41,0.893
"21372","Santa Cruz","Santa Cruz de La Sierra","Colegio San Felipe",104,0,1,0,52,23,13,0,0,193,0,1,194,222,0.269,0.874
"21373","Santa Cruz","Santa Cruz de La Sierra","Colegio San Felipe",86,0,1,0,70,17,18,0,0,192,4,6,202,224,0.365,0.902
"21374","Santa Cruz","Santa Cruz de La Sierra","Colegio San Felipe",96,0,1,1,65,20,8,2,0,193,2,9,204,231,0.337,0.883
"21375","Santa Cruz","Santa Cruz de La Sierra","Colegio San Felipe",83,2,0,0,81,14,13,0,0,193,1,15,209,232,0.42,0.901
"21376","Santa Cruz","Santa Cruz de La Sierra","Colegio San Felipe",68,0,5,0,92,13,22,0,1,201,1,4,206,228,0.458,0.904
"21377","Santa Cruz","Santa Cruz de La Sierra","Colegio San Felipe",73,0,0,2,87,16,23,1,0,202,0,6,208,229,0.431,0.908
"21378","Santa Cruz","Santa Cruz de La Sierra","Colegio San Felipe",112,1,0,0,53,20,12,2,0,200,3,8,211,231,0.265,0.913
"21379","Santa Cruz","Santa Cruz de La Sierra","Colegio San Felipe",107,0,1,3,56,16,13,0,2,198,2,2,202,232,0.283,0.871
"21380","Santa Cruz","Santa Cruz de La Sierra","Colegio San Felipe",104,0,0,0,49,19,13,0,2,187,4,6,197,222,0.262,0.887
"21381","Santa Cruz","Santa Cruz de La Sierra","Colegio San Felipe",91,0,0,0,78,20,9,1,0,199,1,5,205,224,0.392,0.915
"21382","Santa Cruz","Santa Cruz de La Sierra","Colegio San Felipe",114,0,0,1,54,27,9,0,1,206,1,4,211,230,0.262,0.917
"21383","Santa Cruz","Santa Cruz de La Sierra","Colegio San Felipe",101,0,0,2,60,23,13,0,1,200,1,2,203,227,0.3,0.894
"21384","Santa Cruz","Santa Cruz de La Sierra","Colegio San Felipe",107,0,1,1,47,25,10,2,0,193,1,5,199,224,0.244,0.888
"21385","Santa Cruz","Santa Cruz de La Sierra","Colegio San Felipe",92,0,0,2,71,10,19,2,3,199,1,6,206,228,0.357,0.904
"21386","Santa Cruz","Santa Cruz de La Sierra","Colegio San Felipe",110,0,1,1,50,26,13,0,0,201,2,1,204,234,0.249,0.872
"21387","Santa Cruz","Santa Cruz de La Sierra","Colegio San Felipe",101,0,1,1,63,27,16,2,1,212,0,2,214,231,0.297,0.926
"21388","Santa Cruz","Santa Cruz de La Sierra","Colegio San Felipe",102,0,1,0,61,27,9,1,1,202,22,2,226,226,0.302,1
"21389","Santa Cruz","Santa Cruz de La Sierra","Colegio San Felipe",85,0,1,2,72,15,15,1,0,191,3,4,198,226,0.377,0.876
"21390","Santa Cruz","Santa Cruz de La Sierra","Colegio San Felipe",95,0,0,0,56,18,12,1,0,182,1,7,190,230,0.308,0.826
"21391","Santa Cruz","Santa Cruz de La Sierra","Colegio San Felipe",90,1,0,0,52,30,14,3,2,192,2,3,197,227,0.271,0.868
"21392","Santa Cruz","Santa Cruz de La Sierra","Colegio San Felipe",87,0,0,0,65,26,8,2,1,189,1,6,196,226,0.344,0.867
"21393","Santa Cruz","Santa Cruz de La Sierra","Colegio San Felipe",103,0,0,2,47,22,12,1,0,187,2,10,199,230,0.251,0.865
"21394","Santa Cruz","Santa Cruz de La Sierra","Colegio San Felipe",99,1,0,0,70,16,10,1,0,197,1,4,202,232,0.355,0.871
"21395","Santa Cruz","Santa Cruz de La Sierra","Colegio San Felipe",86,0,0,0,75,25,13,0,0,199,2,1,202,231,0.377,0.874
"21396","Santa Cruz","Santa Cruz de La Sierra","Col.  Pedro Añez",118,0,0,0,48,26,5,1,1,199,0,5,204,225,0.241,0.907
"21397","Santa Cruz","Santa Cruz de La Sierra","Col.  Pedro Añez",114,0,1,0,47,26,9,1,0,198,3,7,208,229,0.237,0.908
"21398","Santa Cruz","Santa Cruz de La Sierra","Col.  Pedro Añez",121,0,1,0,40,22,12,0,1,197,1,3,201,230,0.203,0.874
"21399","Santa Cruz","Santa Cruz de La Sierra","Col.  Pedro Añez",114,0,0,1,40,24,15,0,1,195,1,4,200,222,0.205,0.901
"21400","Santa Cruz","Santa Cruz de La Sierra","Col.  Pedro Añez",107,0,0,0,43,23,13,0,1,187,0,15,202,231,0.23,0.874
"21401","Santa Cruz","Santa Cruz de La Sierra","Col.  Pedro Añez",85,0,0,2,67,24,15,1,3,197,1,5,203,230,0.34,0.883
"21402","Santa Cruz","Santa Cruz de La Sierra","Col.  Pedro Añez",103,1,0,0,57,25,17,4,1,208,3,4,215,234,0.274,0.919
"21403","Santa Cruz","Santa Cruz de La Sierra","Col.  Pedro Añez",102,0,1,1,64,24,15,2,0,209,1,3,213,233,0.306,0.914
"21404","Santa Cruz","Santa Cruz de La Sierra","Col.  Pedro Añez",96,0,0,1,63,19,6,0,0,185,4,9,198,229,0.341,0.865
"21405","Santa Cruz","Santa Cruz de La Sierra","Col.  Pedro Añez",106,0,1,1,44,32,8,0,0,192,3,6,201,226,0.229,0.889
"21406","Santa Cruz","Santa Cruz de La Sierra","Col.  Pedro Añez",113,0,0,1,43,19,5,0,0,181,1,6,188,224,0.238,0.839
"21407","Santa Cruz","Santa Cruz de La Sierra","Col.  Pedro Añez",103,0,2,1,49,22,14,3,0,194,0,5,199,226,0.253,0.881
"21408","Santa Cruz","Santa Cruz de La Sierra","Col.  Pedro Añez",77,0,0,0,79,14,18,0,0,188,1,5,194,227,0.42,0.855
"21409","Santa Cruz","Santa Cruz de La Sierra","Col.  Pedro Añez",126,1,0,0,34,19,7,0,0,187,0,4,191,230,0.182,0.83
"21410","Santa Cruz","Santa Cruz de La Sierra","Col.  Pedro Añez",97,1,2,0,41,27,17,0,1,186,1,5,192,223,0.22,0.861
"21411","Santa Cruz","Santa Cruz de La Sierra","Col.  Pedro Añez",115,0,0,1,38,25,7,0,2,188,0,9,197,224,0.202,0.879
"21412","Santa Cruz","Santa Cruz de La Sierra","Col.  Pedro Añez",112,0,1,0,35,26,12,0,0,186,1,10,197,223,0.188,0.883
"21413","Santa Cruz","Santa Cruz de La Sierra","Col.  Pedro Añez",80,1,1,0,69,18,16,1,0,186,1,14,201,232,0.371,0.866
"21414","Santa Cruz","Santa Cruz de La Sierra","Col.  Pedro Añez",117,0,1,0,52,26,13,1,0,210,1,3,214,231,0.248,0.926
"21415","Santa Cruz","Santa Cruz de La Sierra","Col.  Pedro Añez",91,0,1,3,56,28,9,1,1,190,2,10,202,223,0.295,0.906
"21416","Santa Cruz","Santa Cruz de La Sierra","Col.  Pedro Añez",100,0,0,0,40,32,8,2,0,182,1,12,195,226,0.22,0.863
"21417","Santa Cruz","Santa Cruz de La Sierra","Col.  Pedro Añez",102,0,0,2,52,33,11,0,1,201,1,6,208,228,0.259,0.912
"21418","Santa Cruz","Santa Cruz de La Sierra","Col.  Pedro Añez",119,0,0,1,40,26,13,1,1,201,1,9,211,230,0.199,0.917
"21419","Santa Cruz","Santa Cruz de La Sierra","Col.  Pedro Añez",126,0,0,0,38,23,8,2,0,197,1,7,205,229,0.193,0.895
"21420","Santa Cruz","Santa Cruz de La Sierra","Col.  Pedro Añez",100,1,0,0,64,22,12,1,1,201,2,5,208,233,0.318,0.893
"21421","Santa Cruz","Santa Cruz de La Sierra","U.E. El Arenal C",104,0,1,0,74,19,13,0,2,213,0,7,220,237,0.347,0.928
"21422","Santa Cruz","Santa Cruz de La Sierra","Col. Educativo Cotoca",100,1,0,1,55,30,10,2,0,199,1,3,203,233,0.276,0.871
"21423","Santa Cruz","Santa Cruz de La Sierra","Col. Educativo Cotoca",84,0,0,1,64,24,11,1,0,185,1,9,195,234,0.346,0.833
"21424","Santa Cruz","Santa Cruz de La Sierra","Col. Educativo Cotoca",90,0,0,0,70,28,18,0,1,207,0,7,214,234,0.338,0.915
"21425","Santa Cruz","Santa Cruz de La Sierra","Col. Educativo Cotoca",62,1,1,0,87,17,22,2,1,193,0,8,201,229,0.451,0.878
"21426","Santa Cruz","Santa Cruz de La Sierra","Col. Educativo Cotoca",92,0,0,0,58,30,6,1,2,189,1,13,203,227,0.307,0.894
"21427","Santa Cruz","Santa Cruz de La Sierra","Col. Educativo Cotoca",98,0,0,0,62,19,23,1,2,205,0,7,212,230,0.302,0.922
"21428","Santa Cruz","Santa Cruz de La Sierra","Col. Educativo Cotoca",104,1,1,1,66,17,9,1,1,201,2,10,213,232,0.328,0.918
"21429","Santa Cruz","Santa Cruz de La Sierra","Col. Educativo Cotoca",88,1,0,1,64,23,14,0,0,191,1,2,194,231,0.335,0.84
"21430","Santa Cruz","Santa Cruz de La Sierra","Col. Educativo Cotoca",79,0,1,0,85,12,21,0,2,200,1,5,206,228,0.425,0.904
"21431","Santa Cruz","Santa Cruz de La Sierra","Col. Educativo Cotoca",92,0,2,0,60,30,15,1,1,201,0,6,207,229,0.299,0.904
"21432","Santa Cruz","Santa Cruz de La Sierra","Col. Educativo Cotoca",101,0,2,0,49,23,13,1,0,189,1,7,197,221,0.259,0.891
"21433","Santa Cruz","Santa Cruz de La Sierra","Col. Educativo Cotoca",108,0,1,2,44,19,12,0,1,187,2,7,196,232,0.235,0.845
"21434","Santa Cruz","Santa Cruz de La Sierra","Col. Educativo Cotoca",70,0,1,0,91,22,14,1,0,199,0,6,205,230,0.457,0.891
"21435","Santa Cruz","Santa Cruz de La Sierra","Col. Educativo Cotoca",107,0,0,0,39,26,12,2,0,186,0,6,192,230,0.21,0.835
"21436","Santa Cruz","Santa Cruz de La Sierra","Col. Educativo Cotoca",115,0,0,0,48,21,4,2,1,191,1,3,195,230,0.251,0.848
"21437","Santa Cruz","Santa Cruz de La Sierra","Col. Educativo Cotoca",89,1,1,0,64,22,20,1,0,198,4,7,209,224,0.323,0.933
"21438","Santa Cruz","Santa Cruz de La Sierra","Col. Educativo Cotoca",101,0,0,0,49,33,7,0,1,191,1,11,203,229,0.257,0.886
"21439","Santa Cruz","Santa Cruz de La Sierra","Col. Educativo Cotoca",76,1,0,0,80,20,21,0,0,198,1,8,207,227,0.404,0.912
"21440","Santa Cruz","Santa Cruz de La Sierra","U.E. Alfredo Barbery Chavez",84,0,1,0,64,22,20,0,1,192,0,5,197,227,0.333,0.868
"21441","Santa Cruz","Santa Cruz de La Sierra","U.E. Alfredo Barbery Chavez",106,1,0,0,43,31,23,0,0,204,0,7,211,229,0.211,0.921
"21442","Santa Cruz","Santa Cruz de La Sierra","U.E. Alfredo Barbery Chavez",100,0,0,0,53,21,14,0,0,188,0,6,194,229,0.282,0.847
"21443","Santa Cruz","Santa Cruz de La Sierra","U.E. Alfredo Barbery Chavez",97,0,0,2,62,19,11,3,1,195,1,4,200,228,0.318,0.877
"21444","Santa Cruz","Santa Cruz de La Sierra","U.E. Alfredo Barbery Chavez",91,0,0,0,57,19,19,1,0,187,0,9,196,223,0.305,0.879
"21445","Santa Cruz","Santa Cruz de La Sierra","U.E. Alfredo Barbery Chavez",84,0,0,0,56,26,17,2,1,186,3,6,195,224,0.301,0.871
"21446","Santa Cruz","Santa Cruz de La Sierra","U.E. Alfredo Barbery Chavez",84,0,0,0,67,25,23,1,1,201,2,4,207,230,0.333,0.9
"21447","Santa Cruz","Santa Cruz de La Sierra","U.E. Alfredo Barbery Chavez",65,0,0,0,79,20,21,1,3,189,2,13,204,227,0.418,0.899
"21448","Santa Cruz","Santa Cruz de La Sierra","U.E. Alfredo Barbery Chavez",102,1,0,0,39,27,13,2,0,184,2,4,190,222,0.212,0.856
"21449","Santa Cruz","Santa Cruz de La Sierra","U.E. Alfredo Barbery Chavez",97,0,0,0,58,27,14,0,0,196,1,6,203,228,0.296,0.89
"21450","Santa Cruz","Santa Cruz de La Sierra","U.E. Alfredo Barbery Chavez",81,2,1,0,58,24,16,0,1,183,1,6,190,225,0.317,0.844
"21451","Santa Cruz","Santa Cruz de La Sierra","U.E. Alfredo Barbery Chavez",95,0,1,0,58,27,9,1,0,191,3,8,202,234,0.304,0.863
"21452","Santa Cruz","Santa Cruz de La Sierra","U.E. Alfredo Barbery Chavez",84,1,0,0,75,23,12,0,2,197,1,8,206,226,0.381,0.912
"21453","Santa Cruz","Santa Cruz de La Sierra","U.E. Alfredo Barbery Chavez",89,0,0,0,70,26,10,2,1,198,0,4,202,221,0.354,0.914
"21454","Santa Cruz","Santa Cruz de La Sierra","U.E. Alfredo Barbery Chavez",109,0,0,0,47,27,9,6,1,199,1,3,203,229,0.236,0.886
"21455","Santa Cruz","Santa Cruz de La Sierra","U.E. Alfredo Barbery Chavez",89,0,1,0,70,19,11,1,0,191,4,8,203,230,0.366,0.883
"21456","Santa Cruz","Santa Cruz de La Sierra","U.E. Alfredo Barbery Chavez",61,1,1,0,93,16,27,1,0,200,0,5,205,230,0.465,0.891
"21457","Santa Cruz","Santa Cruz de La Sierra","U.E. Alfredo Barbery Chavez",100,0,0,0,48,26,12,0,0,186,3,8,197,224,0.258,0.879
"21458","Santa Cruz","Santa Cruz de La Sierra","U.E. Alfredo Barbery Chavez",103,1,0,0,54,30,10,0,0,198,1,6,205,228,0.273,0.899
"21459","Santa Cruz","Santa Cruz de La Sierra","U.E. Alfredo Barbery Chavez",100,0,1,2,54,28,10,0,1,196,2,9,207,228,0.276,0.908
"21460","Santa Cruz","Santa Cruz de La Sierra","U.E. Alfredo Barbery Chavez",99,0,0,0,58,23,15,0,0,195,2,3,200,235,0.297,0.851
"21461","Santa Cruz","Santa Cruz de La Sierra","U.E. Alfredo Barbery Chavez",113,0,0,0,42,34,4,4,0,197,1,6,204,225,0.213,0.907
"21462","Santa Cruz","Santa Cruz de La Sierra","U.E. Alfredo Barbery Chavez",104,1,0,1,63,16,11,1,0,197,0,6,203,227,0.32,0.894
"21463","Santa Cruz","Santa Cruz de La Sierra","U.E. Alfredo Barbery Chavez",84,0,1,1,88,12,16,4,0,206,1,3,210,228,0.427,0.921
"21464","Santa Cruz","Santa Cruz de La Sierra","U.E. Alfredo Barbery Chavez",116,0,0,0,41,32,6,0,0,195,2,11,208,229,0.21,0.908
"21465","Santa Cruz","Santa Cruz de La Sierra","U.E. Alfredo Barbery Chavez",93,1,0,0,61,18,10,3,0,186,3,8,197,225,0.328,0.876
"21466","Santa Cruz","Santa Cruz de La Sierra","U.E. Alfredo Barbery Chavez",118,2,0,0,40,22,12,1,0,195,1,11,207,232,0.205,0.892
"21467","Santa Cruz","Santa Cruz de La Sierra","U.E. Alfredo Barbery Chavez",94,0,0,0,66,22,9,0,1,192,1,8,201,224,0.344,0.897
"21468","Santa Cruz","Santa Cruz de La Sierra","U.E. Alfredo Barbery Chavez",111,0,1,1,33,36,10,0,1,193,1,3,197,220,0.171,0.895
"21469","Santa Cruz","Santa Cruz de La Sierra","U.E. Alfredo Barbery Chavez",111,1,1,0,43,23,13,3,1,196,1,8,205,228,0.219,0.899
"21470","Santa Cruz","Santa Cruz de La Sierra","U.E. Alfredo Barbery Chavez",110,0,0,1,40,30,12,1,0,194,0,8,202,227,0.206,0.89
"21471","Santa Cruz","Santa Cruz de La Sierra","U.E. Alfredo Barbery Chavez",86,0,0,1,64,31,13,0,0,195,1,9,205,231,0.328,0.887
"21472","Santa Cruz","Santa Cruz de La Sierra","U.E. Alfredo Barbery Chavez",91,1,1,0,63,29,16,2,0,203,0,6,209,232,0.31,0.901
"21473","Santa Cruz","Santa Cruz de La Sierra","Motacusal",29,0,0,0,164,12,6,1,0,212,9,1,222,238,0.774,0.933
"21474","Santa Cruz","Santa Cruz de La Sierra","U.E. Libertad",75,0,1,2,97,24,20,0,2,221,1,6,228,240,0.439,0.95
"21475","Santa Cruz","Santa Cruz de La Sierra","U.E. Libertad",92,0,0,0,82,33,9,0,1,217,2,8,227,237,0.378,0.958
"21476","Santa Cruz","Santa Cruz de La Sierra","Col. Felix Bascope",145,0,0,3,27,13,12,1,0,201,0,7,208,226,0.134,0.92
"21477","Santa Cruz","Santa Cruz de La Sierra","Col. Felix Bascope",166,2,0,0,20,16,8,0,0,212,0,2,214,231,0.094,0.926
"21478","Santa Cruz","Santa Cruz de La Sierra","Col. Felix Bascope",153,1,0,2,37,10,5,1,0,209,2,0,211,236,0.177,0.894
"21479","Santa Cruz","Santa Cruz de La Sierra","Col. Felix Bascope",134,0,0,2,44,11,12,1,1,205,0,6,211,234,0.215,0.902
"21480","Santa Cruz","Santa Cruz de La Sierra","Col. Felix Bascope",139,0,0,0,40,10,13,2,1,205,0,6,211,230,0.195,0.917
"21481","Santa Cruz","Santa Cruz de La Sierra","Col. Felix Bascope",161,0,0,1,15,18,12,0,0,207,1,5,213,229,0.072,0.93
"21482","Santa Cruz","Santa Cruz de La Sierra","Col. Felix Bascope",140,0,0,0,36,21,7,0,1,205,0,4,209,227,0.176,0.921
"21483","Santa Cruz","Santa Cruz de La Sierra","Col. Felix Bascope",150,0,1,0,35,17,11,0,0,214,2,4,220,234,0.164,0.94
"21484","Santa Cruz","Santa Cruz de La Sierra","Col. Felix Bascope",159,0,1,0,18,16,5,0,0,199,0,14,213,223,0.09,0.955
"21485","Santa Cruz","Santa Cruz de La Sierra","Col. Felix Bascope",153,0,0,0,26,12,13,1,0,205,1,5,211,227,0.127,0.93
"21486","Santa Cruz","Santa Cruz de La Sierra","Col. Felix Bascope",145,0,0,0,20,16,9,2,2,194,0,4,198,226,0.103,0.876
"21487","Santa Cruz","Santa Cruz de La Sierra","Col. Felix Bascope",148,0,2,1,23,17,2,1,0,194,1,8,203,221,0.119,0.919
"21488","Santa Cruz","Santa Cruz de La Sierra","Col. Felix Bascope",131,1,1,0,46,15,7,3,0,204,1,6,211,227,0.225,0.93
"21489","Santa Cruz","Santa Cruz de La Sierra","Col. Felix Bascope",153,0,0,0,18,14,12,1,0,198,1,4,203,221,0.091,0.919
"21490","Santa Cruz","Santa Cruz de La Sierra","Col. Felix Bascope",160,0,0,0,25,11,3,1,0,200,1,5,206,231,0.125,0.892
"21491","Santa Cruz","Santa Cruz de La Sierra","Col. Felix Bascope",168,1,0,0,24,14,4,4,0,215,0,3,218,234,0.112,0.932
"21492","Santa Cruz","Santa Cruz de La Sierra","Col. Felix Bascope",154,1,0,0,27,8,9,1,0,200,0,5,205,228,0.135,0.899
"21493","Santa Cruz","Santa Cruz de La Sierra","Col. Felix Bascope",139,0,0,1,26,15,6,5,0,192,1,8,201,225,0.135,0.893
"21494","Santa Cruz","Santa Cruz de La Sierra","Col. Madre Clara Ricci (Jesus Roman Vaca",135,0,0,0,35,13,14,2,1,200,0,4,204,228,0.175,0.895
"21495","Santa Cruz","Santa Cruz de La Sierra","Col. Madre Clara Ricci (Jesus Roman Vaca",112,0,0,0,60,17,10,0,1,200,2,3,205,229,0.3,0.895
"21496","Santa Cruz","Santa Cruz de La Sierra","Col. Madre Clara Ricci (Jesus Roman Vaca",108,0,0,1,63,18,10,4,2,206,0,6,212,234,0.306,0.906
"21497","Santa Cruz","Santa Cruz de La Sierra","Col. Madre Clara Ricci (Jesus Roman Vaca",124,0,0,0,44,17,15,3,0,203,3,2,208,228,0.217,0.912
"21498","Santa Cruz","Santa Cruz de La Sierra","Col. Madre Clara Ricci (Jesus Roman Vaca",122,0,0,0,45,20,12,5,0,204,1,8,213,233,0.221,0.914
"21499","Santa Cruz","Santa Cruz de La Sierra","Col. Madre Clara Ricci (Jesus Roman Vaca",140,0,0,0,23,19,17,2,1,202,0,4,206,228,0.114,0.904
"21500","Santa Cruz","Santa Cruz de La Sierra","Col. Madre Clara Ricci (Jesus Roman Vaca",110,0,1,0,56,14,20,4,1,206,3,6,215,230,0.272,0.935
"21501","Santa Cruz","Santa Cruz de La Sierra","Col. Madre Clara Ricci (Jesus Roman Vaca",142,0,1,0,35,9,10,3,2,202,1,7,210,229,0.173,0.917
"21502","Santa Cruz","Santa Cruz de La Sierra","Col. Madre Clara Ricci (Jesus Roman Vaca",131,0,1,0,44,18,10,1,0,205,2,3,210,234,0.215,0.897
"21503","Santa Cruz","Santa Cruz de La Sierra","Col. Bertha Cuellar",102,0,0,1,45,17,12,0,0,177,1,10,188,227,0.254,0.828
"21504","Santa Cruz","Santa Cruz de La Sierra","Col. Bertha Cuellar",125,0,1,0,37,13,11,0,0,187,2,6,195,229,0.198,0.852
"21505","Santa Cruz","Santa Cruz de La Sierra","Col. Bertha Cuellar",134,0,0,1,34,15,6,2,0,192,1,8,201,227,0.177,0.885
"21506","Santa Cruz","Santa Cruz de La Sierra","Col. Bertha Cuellar",138,1,0,0,41,13,5,1,0,199,1,5,205,237,0.206,0.865
"21507","Santa Cruz","Santa Cruz de La Sierra","Col. Bertha Cuellar",104,0,2,2,48,18,10,1,3,188,1,5,194,226,0.255,0.858
"21508","Santa Cruz","Santa Cruz de La Sierra","Col. Bertha Cuellar",108,0,1,0,44,19,9,1,1,183,1,8,192,227,0.24,0.846
"21509","Santa Cruz","Santa Cruz de La Sierra","Col. Bertha Cuellar",88,0,0,1,69,19,13,0,3,193,1,2,196,231,0.358,0.848
"21510","Santa Cruz","Santa Cruz de La Sierra","Col. Bertha Cuellar",121,0,0,1,35,15,9,3,1,185,0,12,197,230,0.189,0.857
"21511","Santa Cruz","Santa Cruz de La Sierra","Col. Bertha Cuellar",109,0,0,0,50,20,10,1,0,190,0,7,197,225,0.263,0.876
"21512","Santa Cruz","Santa Cruz de La Sierra","Col. Bertha Cuellar",114,0,0,0,50,10,8,3,1,186,3,5,194,226,0.269,0.858
"21513","Santa Cruz","Santa Cruz de La Sierra","Col. Bertha Cuellar",132,0,0,0,35,13,8,3,1,192,0,7,199,230,0.182,0.865
"21514","Santa Cruz","Santa Cruz de La Sierra","Col. Bertha Cuellar",109,0,0,0,53,15,13,1,1,192,1,5,198,222,0.276,0.892
"21515","Santa Cruz","Santa Cruz de La Sierra","Col. Bertha Cuellar",116,0,0,1,44,17,8,3,1,190,1,2,193,226,0.232,0.854
"21516","Santa Cruz","Santa Cruz de La Sierra","Col. Bertha Cuellar",93,2,0,1,49,16,27,3,0,191,0,5,196,226,0.257,0.867
"21517","Santa Cruz","Santa Cruz de La Sierra","Col. Bertha Cuellar",121,0,0,0,30,22,9,0,1,183,1,7,191,231,0.164,0.827
"21518","Santa Cruz","Santa Cruz de La Sierra","Col. Bertha Cuellar",128,0,0,1,33,24,10,4,1,201,1,4,206,229,0.164,0.9
"21519","Santa Cruz","Santa Cruz de La Sierra","Col. Bertha Cuellar",111,0,1,0,47,12,14,4,0,189,4,11,204,228,0.249,0.895
"21520","Santa Cruz","Santa Cruz de La Sierra","Col. Bertha Cuellar",111,1,0,0,44,23,6,3,1,189,1,10,200,227,0.233,0.881
"21521","Santa Cruz","Santa Cruz de La Sierra","Col. Bertha Cuellar",106,1,1,0,38,17,14,3,1,181,2,10,193,226,0.21,0.854
"21522","Santa Cruz","Santa Cruz de La Sierra","Col. Bertha Cuellar",119,0,0,0,47,12,16,2,4,200,1,5,206,228,0.235,0.904
"21523","Santa Cruz","Santa Cruz de La Sierra","Col. Bertha Cuellar",125,1,0,0,37,22,14,0,1,200,1,8,209,227,0.185,0.921
"21524","Santa Cruz","Santa Cruz de La Sierra","Col. Bertha Cuellar",99,0,0,0,48,23,9,2,3,184,2,4,190,222,0.261,0.856
"21525","Santa Cruz","Santa Cruz de La Sierra","Col. Bertha Cuellar",130,0,0,1,27,22,12,0,1,193,0,4,197,225,0.14,0.876
"21526","Santa Cruz","Santa Cruz de La Sierra","Col. Bertha Cuellar",118,1,1,1,23,21,8,2,2,177,1,6,184,227,0.13,0.811
"21527","Santa Cruz","Santa Cruz de La Sierra","Col. Bertha Cuellar",107,2,0,0,56,14,5,1,2,187,0,7,194,224,0.299,0.866
"21528","Santa Cruz","Santa Cruz de La Sierra","Col. Bertha Cuellar",115,1,0,0,43,26,7,3,0,195,1,3,199,227,0.221,0.877
"21529","Santa Cruz","Santa Cruz de La Sierra","Col. Bertha Cuellar",119,0,0,2,50,9,12,1,0,193,1,6,200,223,0.259,0.897
"21530","Santa Cruz","Santa Cruz de La Sierra","Col. Pampa De La Cruz",104,0,0,2,43,20,25,3,0,197,1,4,202,224,0.218,0.902
"21531","Santa Cruz","Santa Cruz de La Sierra","Col. Pampa De La Cruz",125,0,0,0,32,19,10,0,1,187,2,7,196,226,0.171,0.867
"21532","Santa Cruz","Santa Cruz de La Sierra","Col. Pampa De La Cruz",120,0,1,1,37,23,12,3,0,197,1,2,200,227,0.188,0.881
"21533","Santa Cruz","Santa Cruz de La Sierra","Col. Pampa De La Cruz",101,0,0,1,52,22,12,2,1,191,1,5,197,226,0.272,0.872
"21534","Santa Cruz","Santa Cruz de La Sierra","Col. Pampa De La Cruz",113,1,0,2,32,18,11,7,0,184,3,8,195,229,0.174,0.852
"21535","Santa Cruz","Santa Cruz de La Sierra","Col. Pampa De La Cruz",100,1,0,2,39,23,12,3,1,181,2,9,192,218,0.215,0.881
"21536","Santa Cruz","Santa Cruz de La Sierra","Col. Pampa De La Cruz",117,0,0,1,34,21,3,2,0,178,0,13,191,224,0.191,0.853
"21537","Santa Cruz","Santa Cruz de La Sierra","Col. Pampa De La Cruz",111,0,0,1,50,22,16,1,0,201,2,4,207,229,0.249,0.904
"21538","Santa Cruz","Santa Cruz de La Sierra","Col. Pampa De La Cruz",131,0,1,1,27,25,13,1,0,199,1,5,205,222,0.136,0.923
"21539","Santa Cruz","Santa Cruz de La Sierra","Col. Pampa De La Cruz",126,0,0,0,28,21,10,1,0,186,1,6,193,224,0.151,0.862
"21540","Santa Cruz","Santa Cruz de La Sierra","Col. Pampa De La Cruz",115,0,0,1,48,25,7,6,0,202,2,6,210,228,0.238,0.921
"21541","Santa Cruz","Santa Cruz de La Sierra","Col. Pampa De La Cruz",119,1,0,0,29,22,7,7,1,186,2,5,193,221,0.156,0.873
"21542","Santa Cruz","Santa Cruz de La Sierra","Col. Pampa De La Cruz",121,1,1,1,37,31,8,5,1,206,0,4,210,229,0.18,0.917
"21543","Santa Cruz","Santa Cruz de La Sierra","Col. Pampa De La Cruz",106,1,0,0,36,16,13,6,0,178,1,9,188,223,0.202,0.843
"21544","Santa Cruz","Santa Cruz de La Sierra","U.E. Hacia La Cumbre",127,0,0,1,40,23,10,2,0,203,2,4,209,236,0.197,0.886
"21545","Santa Cruz","Santa Cruz de La Sierra","U.E. Hacia La Cumbre",136,0,1,0,29,17,15,2,2,202,0,7,209,235,0.144,0.889
"21546","Santa Cruz","Santa Cruz de La Sierra","Col. 18 de Marzo",112,0,0,1,49,20,9,2,1,194,1,12,207,232,0.253,0.892
"21547","Santa Cruz","Santa Cruz de La Sierra","Col. 18 de Marzo",131,0,1,0,50,10,16,2,0,210,0,2,212,228,0.238,0.93
"21548","Santa Cruz","Santa Cruz de La Sierra","Col. 18 de Marzo",115,0,0,0,44,24,12,2,1,198,3,1,202,225,0.222,0.898
"21549","Santa Cruz","Santa Cruz de La Sierra","Col. 18 de Marzo",122,0,0,1,43,17,5,4,1,193,0,6,199,227,0.223,0.877
"21550","Santa Cruz","Santa Cruz de La Sierra","Col. 18 de Marzo",105,0,0,1,58,10,18,2,1,195,0,3,198,225,0.297,0.88
"21551","Santa Cruz","Santa Cruz de La Sierra","Col. 18 de Marzo",108,0,2,2,42,23,16,1,1,195,0,6,201,228,0.215,0.882
"21552","Santa Cruz","Santa Cruz de La Sierra","Col. 18 de Marzo",82,0,0,2,80,16,22,0,1,203,2,2,207,232,0.394,0.892
"21553","Santa Cruz","Santa Cruz de La Sierra","Col. 18 de Marzo",117,0,1,0,52,14,11,1,0,196,1,5,202,232,0.265,0.871
"21554","Santa Cruz","Santa Cruz de La Sierra","Col. 18 de Marzo",131,0,0,0,36,17,11,0,0,195,1,7,203,229,0.185,0.886
"21555","Santa Cruz","Santa Cruz de La Sierra","Col. 18 de Marzo",113,0,0,0,49,29,6,0,1,198,1,2,201,227,0.247,0.885
"21556","Santa Cruz","Santa Cruz de La Sierra","Col. 18 de Marzo",104,0,0,0,46,24,20,0,1,195,0,5,200,229,0.236,0.873
"21557","Santa Cruz","Santa Cruz de La Sierra","Col. 18 de Marzo",116,0,0,1,43,15,11,7,0,193,0,6,199,227,0.223,0.877
"21558","Santa Cruz","Santa Cruz de La Sierra","Col. 18 de Marzo",109,1,0,0,62,14,9,1,0,196,2,2,200,231,0.316,0.866
"21559","Santa Cruz","Santa Cruz de La Sierra","Col. 18 de Marzo",129,0,0,0,38,27,12,2,0,208,1,4,213,233,0.183,0.914
"21560","Santa Cruz","Santa Cruz de La Sierra","Col. 18 de Marzo",111,0,2,0,66,15,11,2,0,207,2,6,215,234,0.319,0.919
"21561","Santa Cruz","Santa Cruz de La Sierra","Col. 18 de Marzo",94,0,0,0,85,19,13,0,1,212,20,1,233,234,0.401,0.996
"21562","Santa Cruz","Santa Cruz de La Sierra","Col. 18 de Marzo",121,0,0,1,31,31,8,3,0,195,0,8,203,233,0.159,0.871
"21563","Santa Cruz","Santa Cruz de La Sierra","Col. 18 de Marzo",100,1,0,0,61,14,14,0,0,190,7,3,200,230,0.321,0.87
"21564","Santa Cruz","Santa Cruz de La Sierra","Col. 18 de Marzo",119,0,0,0,47,26,16,0,0,208,1,0,209,230,0.226,0.909
"21565","Santa Cruz","Santa Cruz de La Sierra","Col. 18 de Marzo",108,0,2,0,45,22,14,2,0,193,0,5,198,230,0.233,0.861
"21566","Santa Cruz","Santa Cruz de La Sierra","Col. 18 de Marzo",131,0,0,0,37,30,6,0,0,204,3,5,212,236,0.181,0.898
"21567","Santa Cruz","Santa Cruz de La Sierra","Col. 18 de Marzo",128,0,0,1,33,21,10,4,0,197,1,3,201,230,0.168,0.874
"21568","Santa Cruz","Santa Cruz de La Sierra","Col. 18 de Marzo",95,0,1,0,50,19,15,2,2,184,1,9,194,226,0.272,0.858
"21569","Santa Cruz","Santa Cruz de La Sierra","Col. 18 de Marzo",135,0,1,1,29,30,14,1,0,211,1,5,217,230,0.137,0.943
"21570","Santa Cruz","Santa Cruz de La Sierra","Col. 18 de Marzo",102,1,1,0,46,17,13,1,2,183,2,9,194,229,0.251,0.847
"21571","Santa Cruz","Santa Cruz de La Sierra","Col. 18 de Marzo",104,0,0,0,56,21,10,1,3,195,1,4,200,228,0.287,0.877
"21572","Santa Cruz","Santa Cruz de La Sierra","Col. 18 de Marzo",107,0,0,1,44,27,13,1,1,194,0,7,201,233,0.227,0.863
"21573","Santa Cruz","Santa Cruz de La Sierra","Col. 18 de Marzo",125,1,0,1,42,19,12,0,1,201,1,8,210,232,0.209,0.905
"21574","Santa Cruz","Santa Cruz de La Sierra","Col. 18 de Marzo",94,0,0,1,55,15,26,3,0,194,1,2,197,224,0.284,0.879
"21575","Santa Cruz","Santa Cruz de La Sierra","Col. 18 de Marzo",120,1,0,0,42,20,6,3,1,193,1,9,203,230,0.218,0.883
"21576","Santa Cruz","Santa Cruz de La Sierra","Col. 18 de Marzo",113,0,0,1,59,8,10,2,2,195,1,5,201,233,0.303,0.863
"21577","Santa Cruz","Santa Cruz de La Sierra","Col. 18 de Marzo",100,0,0,1,41,16,4,1,2,165,0,5,170,188,0.248,0.904
"21578","Santa Cruz","Santa Cruz de La Sierra","Col. Fausto Medrano",97,1,0,2,58,16,15,3,1,193,0,5,198,226,0.301,0.876
"21579","Santa Cruz","Santa Cruz de La Sierra","Col. Fausto Medrano",121,0,0,0,30,20,16,1,0,188,1,6,195,222,0.16,0.878
"21580","Santa Cruz","Santa Cruz de La Sierra","Col. Fausto Medrano",104,0,0,0,64,22,10,1,0,201,1,3,205,229,0.318,0.895
"21581","Santa Cruz","Santa Cruz de La Sierra","Col. Fausto Medrano",84,0,1,0,84,8,13,4,2,196,4,9,209,233,0.429,0.897
"21582","Santa Cruz","Santa Cruz de La Sierra","Col. Fausto Medrano",108,0,0,1,50,21,10,1,2,193,0,2,195,227,0.259,0.859
"21583","Santa Cruz","Santa Cruz de La Sierra","Col. Fausto Medrano",89,0,0,0,75,21,13,3,0,201,0,7,208,234,0.373,0.889
"21584","Santa Cruz","Santa Cruz de La Sierra","Col. Fausto Medrano",114,1,0,1,40,25,12,0,0,193,2,4,199,227,0.207,0.877
"21585","Santa Cruz","Santa Cruz de La Sierra","Col. Fausto Medrano",87,0,2,1,80,14,14,2,2,202,0,6,208,230,0.396,0.904
"21586","Santa Cruz","Santa Cruz de La Sierra","Col. Fausto Medrano",102,1,0,0,69,12,16,1,0,201,1,3,205,229,0.343,0.895
"21587","Santa Cruz","Santa Cruz de La Sierra","Col. Fausto Medrano",93,0,0,0,54,20,14,1,0,182,1,6,189,224,0.297,0.844
"21588","Santa Cruz","Santa Cruz de La Sierra","Col. Fausto Medrano",96,2,0,1,57,24,18,1,0,199,1,4,204,219,0.286,0.932
"21589","Santa Cruz","Santa Cruz de La Sierra","Col. Fausto Medrano",98,0,0,1,47,20,21,2,0,189,2,5,196,225,0.249,0.871
"21590","Santa Cruz","Santa Cruz de La Sierra","Col. Fausto Medrano",102,0,0,0,57,28,5,1,1,194,0,1,195,227,0.294,0.859
"21591","Santa Cruz","Santa Cruz de La Sierra","Col. Fausto Medrano",98,0,0,2,36,23,12,5,3,179,1,13,193,223,0.201,0.865
"21592","Santa Cruz","Santa Cruz de La Sierra","Col. Fausto Medrano",101,0,0,1,50,23,9,4,0,188,4,5,197,228,0.266,0.864
"21593","Santa Cruz","Santa Cruz de La Sierra","U.E. Maria De Las Candelarias",102,0,2,0,68,20,20,3,1,216,0,7,223,238,0.315,0.937
"21594","Santa Cruz","Santa Cruz de La Sierra","U.E. Maria De Las Candelarias",94,0,1,0,40,26,13,1,1,176,0,8,184,190,0.227,0.968
"21595","Santa Cruz","Santa Cruz de La Sierra","Col. Fe y Alegria",137,1,1,0,40,17,11,1,0,208,0,2,210,232,0.192,0.905
"21596","Santa Cruz","Santa Cruz de La Sierra","Col. Fe y Alegria",102,0,0,1,43,20,17,1,1,185,1,9,195,228,0.232,0.855
"21597","Santa Cruz","Santa Cruz de La Sierra","Col. Fe y Alegria",126,0,0,0,49,18,11,0,2,206,0,3,209,232,0.238,0.901
"21598","Santa Cruz","Santa Cruz de La Sierra","Col. Fe y Alegria",100,0,1,1,70,14,14,1,0,201,3,6,210,232,0.348,0.905
"21599","Santa Cruz","Santa Cruz de La Sierra","Col. Fe y Alegria",104,1,4,0,57,14,16,0,0,196,2,5,203,229,0.291,0.886
"21600","Santa Cruz","Santa Cruz de La Sierra","Col. Fe y Alegria",91,0,0,0,67,18,20,3,2,201,0,3,204,236,0.333,0.864
"21601","Santa Cruz","Santa Cruz de La Sierra","Col. Fe y Alegria",124,0,0,0,46,11,13,0,2,196,1,4,201,235,0.235,0.855
"21602","Santa Cruz","Santa Cruz de La Sierra","Col. Fe y Alegria",120,1,1,1,40,18,16,2,0,199,1,3,203,223,0.201,0.91
"21603","Santa Cruz","Santa Cruz de La Sierra","Col. Fe y Alegria",105,0,0,1,61,13,12,3,1,196,0,5,201,230,0.311,0.874
"21604","Santa Cruz","Santa Cruz de La Sierra","Col. Fe y Alegria",126,0,0,1,39,20,14,3,0,203,1,3,207,231,0.192,0.896
"21605","Santa Cruz","Santa Cruz de La Sierra","Col. Fe y Alegria",122,0,0,1,41,15,19,3,0,201,2,3,206,233,0.204,0.884
"21606","Santa Cruz","Santa Cruz de La Sierra","Col. Fe y Alegria",96,1,0,1,66,16,18,1,1,200,1,4,205,232,0.33,0.884
"21607","Santa Cruz","Santa Cruz de La Sierra","Col. Fe y Alegria",125,0,1,0,38,26,8,3,1,202,2,3,207,231,0.188,0.896
"21608","Santa Cruz","Santa Cruz de La Sierra","Col. Fe y Alegria",121,0,0,2,45,27,8,1,0,204,1,2,207,228,0.221,0.908
"21609","Santa Cruz","Santa Cruz de La Sierra","Col. Fe y Alegria",135,1,0,0,35,14,10,5,0,200,0,5,205,229,0.175,0.895
"21610","Santa Cruz","Santa Cruz de La Sierra","Col. Fe y Alegria",118,0,0,0,35,19,16,1,0,189,2,7,198,230,0.185,0.861
"21611","Santa Cruz","Santa Cruz de La Sierra","Col. Fe y Alegria",128,0,0,0,38,23,8,1,0,198,0,6,204,232,0.192,0.879
"21612","Santa Cruz","Santa Cruz de La Sierra","Col. Fe y Alegria",99,0,0,0,56,19,14,3,1,192,0,7,199,225,0.292,0.884
"21613","Santa Cruz","Santa Cruz de La Sierra","Col. Fe y Alegria",121,1,1,0,37,16,17,1,0,194,3,6,203,232,0.191,0.875
"21614","Santa Cruz","Santa Cruz de La Sierra","Col. Fe y Alegria",138,0,1,1,33,18,9,1,0,201,0,4,205,227,0.164,0.903
"21615","Santa Cruz","Santa Cruz de La Sierra","Col. Fe y Alegria",127,0,0,0,37,10,8,1,2,185,2,9,196,227,0.2,0.863
"21616","Santa Cruz","Santa Cruz de La Sierra","Col. Fe y Alegria",123,0,0,0,38,20,14,1,1,197,2,4,203,225,0.193,0.902
"21617","Santa Cruz","Santa Cruz de La Sierra","Col. Fe y Alegria",119,0,0,0,42,26,12,1,2,202,1,3,206,230,0.208,0.896
"21618","Santa Cruz","Santa Cruz de La Sierra","Col. Fe y Alegria",112,0,0,0,48,10,17,2,1,190,1,2,193,226,0.253,0.854
"21619","Santa Cruz","Santa Cruz de La Sierra","Col. Fe y Alegria",78,0,0,0,49,14,12,2,2,157,0,2,159,182,0.312,0.874
"21620","Santa Cruz","Santa Cruz de La Sierra","Col. Hispano Americano",99,0,0,0,63,12,10,1,2,187,4,7,198,224,0.337,0.884
"21621","Santa Cruz","Santa Cruz de La Sierra","Col. Hispano Americano",86,1,0,1,74,14,11,0,1,188,2,5,195,231,0.394,0.844
"21622","Santa Cruz","Santa Cruz de La Sierra","Col. Hispano Americano",98,1,0,0,49,20,14,0,1,183,0,3,186,218,0.268,0.853
"21623","Santa Cruz","Santa Cruz de La Sierra","Col. Hispano Americano",106,0,0,0,50,21,14,1,0,192,0,11,203,226,0.26,0.898
"21624","Santa Cruz","Santa Cruz de La Sierra","Col. Hispano Americano",100,0,0,1,55,18,13,3,1,191,2,2,195,226,0.288,0.863
"21625","Santa Cruz","Santa Cruz de La Sierra","Col. Hispano Americano",96,0,0,1,60,16,15,1,1,190,1,5,196,220,0.316,0.891
"21626","Santa Cruz","Santa Cruz de La Sierra","Col. Hispano Americano",112,0,0,1,52,14,13,5,0,197,1,3,201,226,0.264,0.889
"21627","Santa Cruz","Santa Cruz de La Sierra","Col. Hispano Americano",112,0,0,0,53,13,11,0,0,189,2,7,198,227,0.28,0.872
"21628","Santa Cruz","Santa Cruz de La Sierra","U. E. San Simón",125,0,0,2,41,25,5,1,1,200,1,2,203,226,0.205,0.898
"21629","Santa Cruz","Santa Cruz de La Sierra","U. E. San Simón",122,0,1,0,39,24,6,2,1,195,2,5,202,227,0.2,0.89
"21630","Santa Cruz","Santa Cruz de La Sierra","U. E. San Simón",111,0,0,1,49,16,15,2,0,194,1,6,201,225,0.253,0.893
"21631","Santa Cruz","Santa Cruz de La Sierra","U. E. San Simón",95,2,0,0,73,17,16,0,1,204,3,2,209,226,0.358,0.925
"21632","Santa Cruz","Santa Cruz de La Sierra","U. E. San Simón",111,0,0,0,38,17,13,0,0,179,0,8,187,211,0.212,0.886
"21633","Santa Cruz","Santa Cruz de La Sierra","U. E. San Simón",111,0,0,0,50,12,12,3,0,188,1,10,199,222,0.266,0.896
"21634","Santa Cruz","Santa Cruz de La Sierra","U. E. San Simón",99,0,0,0,53,20,13,2,2,189,3,11,203,227,0.28,0.894
"21635","Santa Cruz","Santa Cruz de La Sierra","U. E. San Simón",103,0,0,1,52,22,13,1,0,192,1,3,196,228,0.271,0.86
"21636","Santa Cruz","Santa Cruz de La Sierra","U. E. San Simón",110,0,0,0,48,19,6,1,1,185,2,8,195,218,0.259,0.894
"21637","Santa Cruz","Santa Cruz de La Sierra","U. E. San Simón",115,0,1,0,42,21,10,1,1,191,0,8,199,226,0.22,0.881
"21638","Santa Cruz","Santa Cruz de La Sierra","U. E. San Simón",107,0,0,1,55,16,8,2,1,190,0,7,197,219,0.289,0.9
"21639","Santa Cruz","Santa Cruz de La Sierra","U. E. San Simón",112,0,1,0,55,16,8,1,0,193,2,2,197,224,0.285,0.879
"21640","Santa Cruz","Santa Cruz de La Sierra","U. E. San Simón",123,0,0,1,34,29,5,1,1,194,1,4,199,225,0.175,0.884
"21641","Santa Cruz","Santa Cruz de La Sierra","U. E. San Simón",106,1,0,1,47,15,9,2,0,181,3,6,190,225,0.26,0.844
"21642","Santa Cruz","Santa Cruz de La Sierra","U. E. San Simón",108,0,0,0,46,19,9,1,0,183,1,5,189,218,0.251,0.867
"21643","Santa Cruz","Santa Cruz de La Sierra","U. E. San Simón",113,0,0,0,48,16,7,2,1,187,1,7,195,223,0.257,0.874
"21644","Santa Cruz","Santa Cruz de La Sierra","Col. Batallon Tren",125,0,1,0,38,16,13,3,0,196,1,10,207,229,0.194,0.904
"21645","Santa Cruz","Santa Cruz de La Sierra","Col. Batallon Tren",96,0,1,0,44,25,12,0,0,178,1,15,194,227,0.247,0.855
"21646","Santa Cruz","Santa Cruz de La Sierra","Col. Batallon Tren",120,0,0,0,41,23,9,4,0,197,1,2,200,228,0.208,0.877
"21647","Santa Cruz","Santa Cruz de La Sierra","Col. Batallon Tren",125,1,0,1,36,14,14,4,0,195,2,13,210,232,0.185,0.905
"21648","Santa Cruz","Santa Cruz de La Sierra","Col. Batallon Tren",110,1,0,1,41,31,13,1,0,198,0,11,209,228,0.207,0.917
"21649","Santa Cruz","Santa Cruz de La Sierra","Col. Batallon Tren",126,0,0,0,35,23,8,1,1,194,1,4,199,230,0.18,0.865
"21650","Santa Cruz","Santa Cruz de La Sierra","Col. Batallon Tren",119,0,1,2,30,18,12,2,1,185,2,9,196,221,0.162,0.887
"21651","Santa Cruz","Santa Cruz de La Sierra","Col. Batallon Tren",111,0,0,0,46,24,12,2,2,197,1,7,205,227,0.234,0.903
"21652","Santa Cruz","Santa Cruz de La Sierra","Col. Humberto Eguez",113,0,0,0,63,15,9,2,0,202,2,3,207,230,0.312,0.9
"21653","Santa Cruz","Santa Cruz de La Sierra","Col. Humberto Eguez",113,0,1,1,50,21,15,1,1,203,0,5,208,227,0.246,0.916
"21654","Santa Cruz","Santa Cruz de La Sierra","Col. Humberto Eguez",106,0,2,2,65,10,16,0,1,202,0,4,206,231,0.322,0.892
"21655","Santa Cruz","Santa Cruz de La Sierra","Col. Humberto Eguez",101,0,1,0,60,13,13,2,0,190,0,11,201,228,0.316,0.882
"21656","Santa Cruz","Santa Cruz de La Sierra","Col. Humberto Eguez",85,0,0,1,65,25,16,1,0,193,29,6,228,228,0.337,1
"21657","Santa Cruz","Santa Cruz de La Sierra","Col. Humberto Eguez",77,0,0,0,74,19,23,2,0,195,3,5,203,228,0.379,0.89
"21658","Santa Cruz","Santa Cruz de La Sierra","Col. Humberto Eguez",90,2,0,1,76,19,12,1,1,202,2,4,208,227,0.376,0.916
"21659","Santa Cruz","Santa Cruz de La Sierra","Col. Humberto Eguez",110,1,1,0,64,23,9,2,0,210,2,2,214,233,0.305,0.918
"21660","Santa Cruz","Santa Cruz de La Sierra","Col. Humberto Eguez",91,1,1,0,73,15,20,5,1,207,0,4,211,226,0.353,0.934
"21661","Santa Cruz","Santa Cruz de La Sierra","Col. Humberto Eguez",105,1,0,0,55,16,17,2,0,196,0,9,205,230,0.281,0.891
"21662","Santa Cruz","Santa Cruz de La Sierra","Col. Humberto Eguez",111,3,1,0,50,18,16,4,1,204,1,5,210,232,0.245,0.905
"21663","Santa Cruz","Santa Cruz de La Sierra","Col. Humberto Eguez",92,0,1,0,56,25,15,1,0,190,1,8,199,231,0.295,0.861
"21664","Santa Cruz","Santa Cruz de La Sierra","Col. Humberto Eguez",93,0,2,3,58,14,17,2,0,189,3,9,201,229,0.307,0.878
"21665","Santa Cruz","Santa Cruz de La Sierra","Col. Humberto Eguez",96,0,0,0,54,23,14,1,0,188,1,11,200,231,0.287,0.866
"21666","Santa Cruz","Santa Cruz de La Sierra","Col. Humberto Eguez",112,0,0,1,40,23,16,2,0,194,0,7,201,227,0.206,0.885
"21667","Santa Cruz","Santa Cruz de La Sierra","Col. Humberto Eguez",121,0,1,0,47,14,9,5,1,198,3,5,206,232,0.237,0.888
"21668","Santa Cruz","Santa Cruz de La Sierra","Col. Humberto Eguez",100,1,1,0,59,15,13,1,1,191,0,10,201,234,0.309,0.859
"21669","Santa Cruz","Santa Cruz de La Sierra","Col. Humberto Eguez",110,0,0,0,44,18,13,4,1,190,2,10,202,228,0.232,0.886
"21670","Santa Cruz","Santa Cruz de La Sierra","Col. Gilberto Menacho",101,0,0,1,61,22,8,2,0,195,2,3,200,229,0.313,0.873
"21671","Santa Cruz","Santa Cruz de La Sierra","Col. Gilberto Menacho",104,0,0,0,43,21,12,1,1,182,0,9,191,217,0.236,0.88
"21672","Santa Cruz","Santa Cruz de La Sierra","Col. Gilberto Menacho",106,0,0,0,52,32,14,2,0,206,0,2,208,230,0.252,0.904
"21673","Santa Cruz","Santa Cruz de La Sierra","Col. Gilberto Menacho",92,0,0,1,56,20,13,1,1,184,3,6,193,226,0.304,0.854
"21674","Santa Cruz","Santa Cruz de La Sierra","Col. Gilberto Menacho",105,0,0,1,40,23,13,5,0,187,0,5,192,229,0.214,0.838
"21675","Santa Cruz","Santa Cruz de La Sierra","Col. Gilberto Menacho",89,0,0,0,63,19,11,3,2,187,0,8,195,227,0.337,0.859
"21676","Santa Cruz","Santa Cruz de La Sierra","Col. Gilberto Menacho",89,0,2,0,74,18,12,2,0,197,0,4,201,222,0.376,0.905
"21677","Santa Cruz","Santa Cruz de La Sierra","Col. Gilberto Menacho",84,0,0,1,59,12,19,2,0,177,1,10,188,219,0.333,0.858
"21678","Santa Cruz","Santa Cruz de La Sierra","Col. Gilberto Menacho",96,0,0,1,51,22,17,1,1,189,1,6,196,226,0.27,0.867
"21679","Santa Cruz","Santa Cruz de La Sierra","Col. Gilberto Menacho",94,1,1,0,46,19,10,2,0,173,1,16,190,224,0.266,0.848
"21680","Santa Cruz","Santa Cruz de La Sierra","Col. Gilberto Menacho",98,0,0,2,51,17,6,2,0,176,3,5,184,225,0.29,0.818
"21681","Santa Cruz","Santa Cruz de La Sierra","Col. Gilberto Menacho",107,0,0,1,31,18,13,2,0,172,2,7,181,217,0.18,0.834
"21682","Santa Cruz","Santa Cruz de La Sierra","Col. Gilberto Menacho",85,0,1,0,69,17,14,2,2,190,5,11,206,230,0.363,0.896
"21683","Santa Cruz","Santa Cruz de La Sierra","Col. Gilberto Menacho",96,0,0,5,55,22,18,2,0,198,1,8,207,230,0.278,0.9
"21684","Santa Cruz","Santa Cruz de La Sierra","Col. Gilberto Menacho",114,0,1,2,30,33,9,1,1,191,2,5,198,228,0.157,0.868
"21685","Santa Cruz","Santa Cruz de La Sierra","Col. Gilberto Menacho",85,0,0,3,54,35,13,2,1,193,2,4,199,226,0.28,0.881
"21686","Santa Cruz","Santa Cruz de La Sierra","Col. Gilberto Menacho",92,1,1,0,51,29,13,1,0,188,3,10,201,226,0.271,0.889
"21687","Santa Cruz","Santa Cruz de La Sierra","Col. Gilberto Menacho",106,0,0,0,34,33,4,3,0,180,0,5,185,213,0.189,0.869
"21688","Santa Cruz","Santa Cruz de La Sierra","Col. Gilberto Menacho",85,0,0,1,76,16,16,0,1,195,1,6,202,226,0.39,0.894
"21689","Santa Cruz","Santa Cruz de La Sierra","Col. Gilberto Menacho",107,0,0,1,36,22,12,4,0,182,1,6,189,217,0.198,0.871
"21690","Santa Cruz","Santa Cruz de La Sierra","Col. Gilberto Menacho",110,1,0,1,36,33,13,1,0,195,1,5,201,227,0.185,0.885
"21691","Santa Cruz","Santa Cruz de La Sierra","Col. Gilberto Menacho",112,0,0,1,47,19,11,2,2,194,2,4,200,223,0.242,0.897
"21692","Santa Cruz","Santa Cruz de La Sierra","Col. Gilberto Menacho",103,0,0,3,46,24,9,4,1,190,1,7,198,228,0.242,0.868
"21693","Santa Cruz","Santa Cruz de La Sierra","Col. Gilberto Menacho",103,0,0,0,39,23,9,7,0,181,2,11,194,214,0.215,0.907
"21694","Santa Cruz","Santa Cruz de La Sierra","Col. Gilberto Menacho",103,2,0,0,54,15,15,3,0,192,2,4,198,227,0.281,0.872
"21695","Santa Cruz","Santa Cruz de La Sierra","Col. Gilberto Menacho",85,0,0,0,57,19,13,0,0,174,0,4,178,204,0.328,0.873
"21696","Santa Cruz","Santa Cruz de La Sierra","Kinder Libertad",98,0,0,0,63,24,20,2,0,207,1,4,212,239,0.304,0.887
"21697","Santa Cruz","Santa Cruz de La Sierra","U.E. 1ro. De Mayo",107,2,1,0,69,13,15,4,2,213,2,22,237,237,0.324,1
"21698","Santa Cruz","Santa Cruz de La Sierra","U.E. 1ro. De Mayo",114,1,0,0,50,27,20,1,5,218,2,5,225,238,0.229,0.945
"21699","Santa Cruz","Santa Cruz de La Sierra","Col. Sor Maria Cristina Perez",148,0,0,2,28,18,3,4,0,203,1,5,209,228,0.138,0.917
"21700","Santa Cruz","Santa Cruz de La Sierra","Col. Sor Maria Cristina Perez",157,1,0,0,20,17,1,1,1,198,0,4,202,222,0.101,0.91
"21701","Santa Cruz","Santa Cruz de La Sierra","Col. Sor Maria Cristina Perez",156,0,0,0,16,15,6,1,0,194,2,5,201,223,0.082,0.901
"21702","Santa Cruz","Santa Cruz de La Sierra","Col. Sor Maria Cristina Perez",156,1,0,1,17,26,11,0,0,212,1,6,219,234,0.08,0.936
"21703","Santa Cruz","Santa Cruz de La Sierra","Col. Sor Maria Cristina Perez",172,0,0,0,15,20,3,0,0,210,1,1,212,231,0.071,0.918
"21704","Santa Cruz","Santa Cruz de La Sierra","Col. Sor Maria Cristina Perez",150,0,0,0,24,8,14,3,0,199,0,4,203,231,0.121,0.879
"21705","Santa Cruz","Santa Cruz de La Sierra","Col. Sor Maria Cristina Perez",164,0,0,0,18,9,4,3,1,199,1,4,204,229,0.09,0.891
"21706","Santa Cruz","Santa Cruz de La Sierra","Col. Sor Maria Cristina Perez",155,1,0,1,13,12,12,1,0,195,1,8,204,227,0.067,0.899
"21707","Santa Cruz","Santa Cruz de La Sierra","Col. Sor Maria Cristina Perez",135,0,0,3,41,10,6,1,0,196,2,2,200,231,0.209,0.866
"21708","Santa Cruz","Santa Cruz de La Sierra","Col. Sor Maria Cristina Perez",149,0,0,3,16,23,6,3,0,200,0,7,207,228,0.08,0.908
"21709","Santa Cruz","Santa Cruz de La Sierra","Col. Sor Maria Cristina Perez",157,0,1,0,21,12,10,2,1,204,0,2,206,223,0.103,0.924
"21710","Santa Cruz","Santa Cruz de La Sierra","Col. Sor Maria Cristina Perez",153,0,0,0,30,15,11,0,0,209,1,3,213,228,0.144,0.934
"21711","Santa Cruz","Santa Cruz de La Sierra","Col. Sor Maria Cristina Perez",162,0,0,0,19,14,7,4,1,207,1,2,210,225,0.092,0.933
"21712","Santa Cruz","Santa Cruz de La Sierra","Col. Sor Maria Cristina Perez",134,1,0,0,28,16,15,3,0,197,1,6,204,224,0.142,0.911
"21713","Santa Cruz","Santa Cruz de La Sierra","Col. Sor Maria Cristina Perez",145,0,0,0,13,17,10,2,0,187,0,2,189,219,0.07,0.863
"21714","Santa Cruz","Santa Cruz de La Sierra","Col. Sor Maria Cristina Perez",136,0,0,3,31,21,9,0,0,200,1,5,206,226,0.155,0.912
"21715","Santa Cruz","Santa Cruz de La Sierra","Col. Sor Maria Cristina Perez",153,1,1,4,8,27,5,2,0,201,0,6,207,222,0.04,0.932
"21716","Santa Cruz","Santa Cruz de La Sierra","Col. Sor Maria Cristina Perez",150,0,0,1,22,23,10,1,0,207,0,8,215,232,0.106,0.927
"21717","Santa Cruz","Santa Cruz de La Sierra","Col. Sor Maria Cristina Perez",133,0,1,1,35,14,10,1,0,195,1,3,199,228,0.179,0.873
"21718","Santa Cruz","Santa Cruz de La Sierra","Col. Sor Maria Cristina Perez",155,0,0,0,18,19,7,0,0,199,0,7,206,228,0.09,0.904
"21719","Santa Cruz","Santa Cruz de La Sierra","Col. Sor Maria Cristina Perez",155,0,0,0,15,17,7,1,0,195,0,26,221,221,0.077,1
"21720","Santa Cruz","Santa Cruz de La Sierra","Col. Sor Maria Cristina Perez",165,0,0,0,15,13,5,7,0,205,1,5,211,225,0.073,0.938
"21721","Santa Cruz","Santa Cruz de La Sierra","Col. Sor Maria Cristina Perez",166,0,1,1,14,15,4,0,0,201,0,0,201,227,0.07,0.885
"21722","Santa Cruz","Santa Cruz de La Sierra","Col. Sor Maria Cristina Perez",144,1,0,0,21,20,8,0,0,194,2,9,205,230,0.108,0.891
"21723","Santa Cruz","Santa Cruz de La Sierra","Col. Sor Maria Cristina Perez",164,1,0,0,12,18,6,1,0,202,0,2,204,230,0.059,0.887
"21724","Santa Cruz","Santa Cruz de La Sierra","Col. Sor Maria Cristina Perez",141,1,0,3,19,17,16,3,0,200,0,4,204,223,0.095,0.915
"21725","Santa Cruz","Santa Cruz de La Sierra","Col. Sor Maria Cristina Perez",153,0,0,1,19,16,2,2,0,193,0,6,199,226,0.098,0.881
"21726","Santa Cruz","Santa Cruz de La Sierra","Col. Sor Maria Cristina Perez",149,0,1,0,19,19,7,1,0,196,0,3,199,222,0.097,0.896
"21727","Santa Cruz","Santa Cruz de La Sierra","Col. Sor Maria Cristina Perez",152,1,0,0,8,16,6,2,1,186,1,5,192,222,0.043,0.865
"21728","Santa Cruz","Santa Cruz de La Sierra","Col. Sor Maria Cristina Perez",151,0,0,0,10,21,4,2,1,189,1,4,194,228,0.053,0.851
"21729","Santa Cruz","Santa Cruz de La Sierra","Col. Sor Maria Cristina Perez",163,0,0,2,20,19,4,1,0,209,0,4,213,230,0.096,0.926
"21730","Santa Cruz","Santa Cruz de La Sierra","Col. Sor Maria Cristina Perez",157,1,1,0,21,17,9,2,0,208,2,3,213,230,0.101,0.926
"21731","Santa Cruz","Santa Cruz de La Sierra","Col. Sor Maria Cristina Perez",171,0,0,0,17,13,4,1,1,207,2,4,213,227,0.082,0.938
"21732","Santa Cruz","Santa Cruz de La Sierra","Col. Sor Maria Cristina Perez",144,0,0,0,10,22,4,3,0,183,0,12,195,227,0.055,0.859
"21733","Santa Cruz","Santa Cruz de La Sierra","Col. Sor Maria Cristina Perez",165,0,0,1,13,16,2,1,0,198,1,2,201,232,0.066,0.866
"21734","Santa Cruz","Santa Cruz de La Sierra","Col. Sor Maria Cristina Perez",150,0,0,1,20,18,8,0,1,198,1,2,201,227,0.101,0.885
"21735","Santa Cruz","Santa Cruz de La Sierra","Col. Sor Maria Cristina Perez",148,0,0,3,6,27,12,0,0,196,1,7,204,229,0.031,0.891
"21736","Santa Cruz","Santa Cruz de La Sierra","Col. Sor Maria Cristina Perez",159,0,0,0,13,19,10,1,0,202,1,2,205,230,0.064,0.891
"21737","Santa Cruz","Santa Cruz de La Sierra","Col. Sor Maria Cristina Perez",134,0,0,0,22,25,11,4,0,196,0,6,202,229,0.112,0.882
"21738","Santa Cruz","Santa Cruz de La Sierra","Colegio Bertha Cuellar",126,0,0,1,33,14,9,1,1,185,2,7,194,219,0.178,0.886
"21739","Santa Cruz","Santa Cruz de La Sierra","Colegio Bertha Cuellar",132,0,0,1,26,17,13,2,0,191,2,5,198,225,0.136,0.88
"21740","Santa Cruz","Santa Cruz de La Sierra","Colegio Bertha Cuellar",129,1,0,1,39,12,9,0,0,191,1,1,193,226,0.204,0.854
"21741","Santa Cruz","Santa Cruz de La Sierra","Colegio Bertha Cuellar",135,0,0,2,31,15,10,1,1,195,1,2,198,224,0.159,0.884
"21742","Santa Cruz","Santa Cruz de La Sierra","Kinder Ferroviario",141,0,0,0,13,8,7,1,0,170,0,1,171,192,0.076,0.891
"21743","Santa Cruz","Santa Cruz de La Sierra","U. E. Carlos La Torre",68,0,0,0,17,65,11,14,0,175,13,6,194,225,0.097,0.862
"21744","Santa Cruz","Santa Cruz de La Sierra","U. E. Carlos La Torre",111,0,0,0,42,20,13,2,0,188,0,10,198,224,0.223,0.884
"21745","Santa Cruz","Santa Cruz de La Sierra","U. E. Carlos La Torre",134,0,0,0,22,27,5,0,0,188,1,12,201,231,0.117,0.87
"21746","Santa Cruz","Santa Cruz de La Sierra","U. E. Carlos La Torre",105,1,0,0,39,24,12,2,0,183,2,18,203,227,0.213,0.894
"21747","Santa Cruz","Santa Cruz de La Sierra","U. E. Carlos La Torre",90,1,0,1,68,27,17,1,3,208,0,5,213,230,0.327,0.926
"21748","Santa Cruz","Santa Cruz de La Sierra","U. E. Carlos La Torre",120,0,0,0,37,31,7,5,0,200,1,9,210,230,0.185,0.913
"21749","Santa Cruz","Santa Cruz de La Sierra","U. E. Carlos La Torre",108,2,1,0,36,22,10,1,1,181,4,7,192,225,0.199,0.853
"21750","Santa Cruz","Santa Cruz de La Sierra","U. E. Carlos La Torre",117,1,1,1,43,18,7,3,0,191,4,9,204,231,0.225,0.883
"21751","Santa Cruz","Santa Cruz de La Sierra","U. E. Carlos La Torre",131,1,0,1,21,22,13,3,0,192,1,4,197,228,0.109,0.864
"21752","Santa Cruz","Santa Cruz de La Sierra","U. E. Carlos La Torre",123,1,0,0,39,20,15,0,1,199,2,8,209,230,0.196,0.909
"21753","Santa Cruz","Santa Cruz de La Sierra","U. E. Carlos La Torre",112,0,0,0,46,20,11,3,0,192,3,4,199,230,0.24,0.865
"21754","Santa Cruz","Santa Cruz de La Sierra","U. E. Carlos La Torre",123,0,1,0,28,15,14,2,0,183,1,9,193,228,0.153,0.846
"21755","Santa Cruz","Santa Cruz de La Sierra","U. E. Carlos La Torre",132,0,0,3,22,24,6,2,0,189,1,11,201,222,0.116,0.905
"21756","Santa Cruz","Santa Cruz de La Sierra","U. E. Carlos La Torre",113,0,0,1,38,20,16,2,0,190,2,6,198,230,0.2,0.861
"21757","Santa Cruz","Santa Cruz de La Sierra","U. E. Carlos La Torre",118,0,0,0,29,42,8,1,0,198,1,9,208,228,0.146,0.912
"21758","Santa Cruz","Santa Cruz de La Sierra","U. E. Carlos La Torre",138,0,0,0,22,24,4,1,0,189,0,11,200,226,0.116,0.885
"21759","Santa Cruz","Santa Cruz de La Sierra","U. E. Carlos La Torre",111,1,0,1,36,22,14,1,1,187,2,7,196,232,0.193,0.845
"21760","Santa Cruz","Santa Cruz de La Sierra","U. E. Carlos La Torre",121,1,0,0,25,24,5,3,0,179,2,9,190,222,0.14,0.856
"21761","Santa Cruz","Santa Cruz de La Sierra","U. E. Carlos La Torre",111,0,0,0,31,19,5,3,0,169,2,6,177,197,0.183,0.898
"21762","Santa Cruz","Santa Cruz de La Sierra","Col. Guapilo Junin",94,0,1,2,60,27,9,2,0,195,1,12,208,232,0.308,0.897
"21763","Santa Cruz","Santa Cruz de La Sierra","Col. Guapilo Junin",110,1,0,0,52,23,10,1,0,197,1,4,202,229,0.264,0.882
"21764","Santa Cruz","Santa Cruz de La Sierra","Col. Guapilo Junin",117,0,0,0,47,21,14,1,0,200,1,3,204,228,0.235,0.895
"21765","Santa Cruz","Santa Cruz de La Sierra","Col. Guapilo Junin",96,1,0,2,73,12,18,1,2,205,0,2,207,234,0.356,0.885
"21766","Santa Cruz","Santa Cruz de La Sierra","Col. Guapilo Junin",108,0,0,0,39,21,11,1,0,180,3,10,193,228,0.217,0.846
"21767","Santa Cruz","Santa Cruz de La Sierra","Col. Guapilo Junin",75,0,1,0,68,22,19,4,2,191,2,7,200,231,0.356,0.866
"21768","Santa Cruz","Santa Cruz de La Sierra","Col. Guapilo Junin",113,0,0,1,44,15,23,1,0,197,0,6,203,229,0.223,0.886
"21769","Santa Cruz","Santa Cruz de La Sierra","Col. Guapilo Junin",116,1,1,1,38,19,14,2,0,192,2,8,202,229,0.198,0.882
"21770","Santa Cruz","Santa Cruz de La Sierra","Col. Guapilo Junin",107,0,0,0,58,22,15,1,0,203,0,3,206,229,0.286,0.9
"21771","Santa Cruz","Santa Cruz de La Sierra","Col. Guapilo Junin",120,0,1,2,39,26,9,0,0,197,2,1,200,229,0.198,0.873
"21772","Santa Cruz","Santa Cruz de La Sierra","Col. Guapilo Junin",114,0,0,1,51,21,9,1,0,197,1,7,205,227,0.259,0.903
"21773","Santa Cruz","Santa Cruz de La Sierra","Col. Guapilo Junin",107,0,0,0,43,25,8,0,0,183,2,8,193,221,0.235,0.873
"21774","Santa Cruz","Santa Cruz de La Sierra","Col. Guapilo Junin",107,1,1,1,69,19,6,0,1,205,2,4,211,234,0.337,0.902
"21775","Santa Cruz","Santa Cruz de La Sierra","Col. Guapilo Junin",118,0,0,1,33,31,8,3,0,194,3,7,204,236,0.17,0.864
"21776","Santa Cruz","Santa Cruz de La Sierra","Col. Guapilo Junin",109,1,1,0,53,22,16,3,0,205,2,3,210,228,0.259,0.921
"21777","Santa Cruz","Santa Cruz de La Sierra","Col. Guapilo Junin",105,0,1,1,50,24,12,0,1,194,1,4,199,228,0.258,0.873
"21778","Santa Cruz","Santa Cruz de La Sierra","Col. Guapilo Junin",114,0,0,0,52,25,8,1,1,201,1,8,210,230,0.259,0.913
"21779","Santa Cruz","Santa Cruz de La Sierra","Col. Guapilo Junin",128,0,0,4,33,18,13,4,0,200,0,5,205,228,0.165,0.899
"21780","Santa Cruz","Santa Cruz de La Sierra","Col. Guapilo Junin",111,0,0,0,66,11,20,1,0,209,0,9,218,233,0.316,0.936
"21781","Santa Cruz","Santa Cruz de La Sierra","Col. Guapilo Junin",119,0,0,0,41,20,6,0,0,186,4,6,196,229,0.22,0.856
"21782","Santa Cruz","Santa Cruz de La Sierra","Col. Guapilo Junin",116,0,0,0,39,18,11,1,2,187,2,8,197,228,0.209,0.864
"21783","Santa Cruz","Santa Cruz de La Sierra","Col. Guapilo Junin",113,0,0,0,37,26,11,4,0,191,0,3,194,227,0.194,0.855
"21784","Santa Cruz","Santa Cruz de La Sierra","Col. Guapilo Junin",107,0,0,1,36,30,10,0,0,184,2,9,195,230,0.196,0.848
"21785","Santa Cruz","Santa Cruz de La Sierra","Col. Guapilo Junin",111,0,2,0,48,26,12,1,1,201,2,4,207,230,0.239,0.9
"21786","Santa Cruz","Santa Cruz de La Sierra","Col. Guapilo Junin",116,0,0,0,41,22,11,0,1,191,2,9,202,228,0.215,0.886
"21787","Santa Cruz","Santa Cruz de La Sierra","Col. Guapilo Junin",131,1,0,0,52,18,10,0,1,213,1,3,217,234,0.244,0.927
"21788","Santa Cruz","Santa Cruz de La Sierra","Col. Central Obrera Departamental",78,0,0,1,77,18,19,1,1,195,3,7,205,226,0.395,0.907
"21789","Santa Cruz","Santa Cruz de La Sierra","Col. Central Obrera Departamental",89,1,0,1,58,29,19,1,0,198,2,6,206,232,0.293,0.888
"21790","Santa Cruz","Santa Cruz de La Sierra","Col. Central Obrera Departamental",89,0,0,0,70,15,16,2,0,192,2,1,195,224,0.365,0.871
"21791","Santa Cruz","Santa Cruz de La Sierra","Col. Central Obrera Departamental",81,0,0,1,78,23,17,2,0,202,1,7,210,232,0.386,0.905
"21792","Santa Cruz","Santa Cruz de La Sierra","Col. Central Obrera Departamental",85,1,0,0,60,31,16,3,0,196,0,4,200,233,0.306,0.858
"21793","Santa Cruz","Santa Cruz de La Sierra","Col. Central Obrera Departamental",54,0,0,0,91,22,22,6,0,195,2,2,199,232,0.467,0.858
"21794","Santa Cruz","Santa Cruz de La Sierra","Col. Central Obrera Departamental",76,0,1,0,67,21,23,1,1,190,1,6,197,227,0.353,0.868
"21795","Santa Cruz","Santa Cruz de La Sierra","Col. Central Obrera Departamental",102,1,1,0,59,17,21,3,0,204,0,3,207,228,0.289,0.908
"21796","Santa Cruz","Santa Cruz de La Sierra","Col. Central Obrera Departamental",78,1,1,1,67,25,16,4,3,196,1,8,205,232,0.342,0.884
"21797","Santa Cruz","Santa Cruz de La Sierra","Col. Central Obrera Departamental",79,0,0,1,73,11,12,2,0,178,3,7,188,220,0.41,0.855
"21798","Santa Cruz","Santa Cruz de La Sierra","Col. Central Obrera Departamental",60,1,1,0,84,12,29,2,1,190,1,8,199,226,0.442,0.881
"21799","Santa Cruz","Santa Cruz de La Sierra","Col. Central Obrera Departamental",79,0,0,0,75,22,8,3,1,188,1,11,200,231,0.399,0.866
"21800","Santa Cruz","Santa Cruz de La Sierra","Col. Central Obrera Departamental",81,1,1,0,73,19,19,3,0,197,3,10,210,232,0.371,0.905
"21801","Santa Cruz","Santa Cruz de La Sierra","Col. Central Obrera Departamental",65,0,2,1,91,18,17,2,0,196,1,10,207,230,0.464,0.9
"21802","Santa Cruz","Santa Cruz de La Sierra","Col. Central Obrera Departamental",89,0,1,1,57,31,12,2,2,195,1,6,202,228,0.292,0.886
"21803","Santa Cruz","Santa Cruz de La Sierra","Col. Central Obrera Departamental",74,0,0,0,84,21,17,5,0,201,2,8,211,228,0.418,0.925
"21804","Santa Cruz","Santa Cruz de La Sierra","Col. Central Obrera Departamental",89,0,0,0,68,21,20,1,0,199,1,5,205,225,0.342,0.911
"21805","Santa Cruz","Santa Cruz de La Sierra","Col. Central Obrera Departamental",95,0,1,0,53,17,19,5,0,190,0,6,196,225,0.279,0.871
"21806","Santa Cruz","Santa Cruz de La Sierra","Col. Central Obrera Departamental",71,0,0,2,79,17,19,1,0,189,1,9,199,227,0.418,0.877
"21807","Santa Cruz","Santa Cruz de La Sierra","Col. Central Obrera Departamental",92,0,0,0,60,33,9,1,0,195,3,7,205,234,0.308,0.876
"21808","Santa Cruz","Santa Cruz de La Sierra","Col. Central Obrera Departamental",104,1,2,0,53,20,14,2,0,196,3,10,209,232,0.27,0.901
"21809","Santa Cruz","Santa Cruz de La Sierra","Col. Central Obrera Departamental",106,0,1,2,54,14,19,2,0,198,0,1,199,225,0.273,0.884
"21810","Santa Cruz","Santa Cruz de La Sierra","Col. Central Obrera Departamental",99,0,0,0,53,22,23,3,0,200,1,3,204,228,0.265,0.895
"21811","Santa Cruz","Santa Cruz de La Sierra","Col. Central Obrera Departamental",65,0,0,0,51,22,13,3,0,154,2,48,204,229,0.331,0.891
"21812","Santa Cruz","Santa Cruz de La Sierra","Col. Central Obrera Departamental",94,0,0,0,60,18,10,0,0,182,0,16,198,226,0.33,0.876
"21813","Santa Cruz","Santa Cruz de La Sierra","Col. Central Obrera Departamental",90,0,0,2,74,20,16,0,1,203,3,4,210,232,0.365,0.905
"21814","Santa Cruz","Santa Cruz de La Sierra","Col. Central Obrera Departamental",98,1,0,3,67,14,12,4,0,199,1,4,204,236,0.337,0.864
"21815","Santa Cruz","Santa Cruz de La Sierra","U.E. El Terrado",106,0,0,0,59,27,15,3,2,212,4,5,221,240,0.278,0.921
"21816","Santa Cruz","Santa Cruz de La Sierra","U.E. El Terrado",73,0,0,0,44,20,15,0,0,152,1,0,153,156,0.289,0.981
"21817","Santa Cruz","Santa Cruz de La Sierra","Col. Alan Farah",123,0,1,0,44,17,0,1,0,186,2,4,192,228,0.237,0.842
"21818","Santa Cruz","Santa Cruz de La Sierra","Col. Alan Farah",127,0,1,0,41,29,10,2,0,210,1,6,217,237,0.195,0.916
"21819","Santa Cruz","Santa Cruz de La Sierra","Col. Alan Farah",119,0,0,0,56,16,7,2,0,200,1,8,209,233,0.28,0.897
"21820","Santa Cruz","Santa Cruz de La Sierra","Col. Alan Farah",119,3,0,0,38,29,9,1,0,199,1,6,206,230,0.191,0.896
"21821","Santa Cruz","Santa Cruz de La Sierra","Col. Alan Farah",71,0,0,0,70,28,20,1,0,190,2,11,203,231,0.368,0.879
"21822","Santa Cruz","Santa Cruz de La Sierra","Col. Alan Farah",125,1,0,0,37,22,11,1,0,197,3,9,209,231,0.188,0.905
"21823","Santa Cruz","Santa Cruz de La Sierra","Col. Alan Farah",116,1,0,1,36,21,15,2,3,195,1,5,201,226,0.185,0.889
"21824","Santa Cruz","Santa Cruz de La Sierra","Col. Alan Farah",110,0,0,1,54,19,12,2,1,199,1,1,201,228,0.271,0.882
"21825","Santa Cruz","Santa Cruz de La Sierra","Col. Alan Farah",128,0,0,0,30,16,14,3,1,192,5,11,208,232,0.156,0.897
"21826","Santa Cruz","Santa Cruz de La Sierra","Col. Alan Farah",83,1,0,1,79,23,13,0,1,201,0,6,207,227,0.393,0.912
"21827","Santa Cruz","Santa Cruz de La Sierra","Col. Alan Farah",116,0,0,1,59,12,12,2,1,203,0,5,208,229,0.291,0.908
"21828","Santa Cruz","Santa Cruz de La Sierra","Col. Alan Farah",123,0,0,0,41,17,19,3,0,203,2,5,210,229,0.202,0.917
"21829","Santa Cruz","Santa Cruz de La Sierra","Col. Alan Farah",115,3,0,0,45,26,10,4,0,203,2,4,209,233,0.222,0.897
"21830","Santa Cruz","Santa Cruz de La Sierra","Col. Alan Farah",106,1,0,0,68,20,12,2,1,210,1,4,215,235,0.324,0.915
"21831","Santa Cruz","Santa Cruz de La Sierra","Col. Alan Farah",135,0,0,1,34,18,9,1,0,198,1,5,204,230,0.172,0.887
"21832","Santa Cruz","Santa Cruz de La Sierra","Col. Alan Farah",129,0,0,2,38,19,11,3,0,202,1,8,211,234,0.188,0.902
"21833","Santa Cruz","Santa Cruz de La Sierra","Col. Alan Farah",109,0,1,1,38,28,13,5,2,197,1,8,206,232,0.193,0.888
"21834","Santa Cruz","Santa Cruz de La Sierra","Col. Alan Farah",112,0,2,0,46,29,11,2,1,203,0,8,211,230,0.227,0.917
"21835","Santa Cruz","Santa Cruz de La Sierra","Col. Alan Farah",122,0,0,0,37,21,8,1,1,190,2,8,200,233,0.195,0.858
"21836","Santa Cruz","Santa Cruz de La Sierra","Col. Alan Farah",99,0,0,2,61,17,17,4,1,201,1,7,209,234,0.303,0.893
"21837","Santa Cruz","Santa Cruz de La Sierra","U.E. Arboleda De Fatima",123,1,1,1,46,23,12,0,0,207,3,10,220,235,0.222,0.936
"21838","Santa Cruz","Santa Cruz de La Sierra","U.E. Arboleda De Fatima",116,0,1,0,50,32,9,1,1,210,0,10,220,238,0.238,0.924
"21839","Santa Cruz","Santa Cruz de La Sierra","U.E. Arboleda De Fatima",98,0,0,1,60,35,17,2,1,214,1,5,220,238,0.28,0.924
"21840","Santa Cruz","Santa Cruz de La Sierra","U.E. Arboleda De Fatima",105,0,0,1,49,44,11,1,0,211,0,3,214,234,0.232,0.915
"21841","Santa Cruz","Santa Cruz de La Sierra","U.E. Arboleda De Fatima",118,0,0,0,48,31,9,2,1,209,1,4,214,238,0.23,0.899
"21842","Santa Cruz","Santa Cruz de La Sierra","U.E. Arboleda De Fatima",115,0,0,0,41,39,11,2,0,208,1,4,213,236,0.197,0.903
"21843","Santa Cruz","Santa Cruz de La Sierra","U.E. Arboleda De Fatima",119,0,0,1,33,36,15,1,0,205,0,8,213,230,0.161,0.926
"21844","Santa Cruz","Santa Cruz de La Sierra","Col. El Buen Samaritano",94,1,0,1,81,19,11,0,1,208,1,8,217,236,0.389,0.919
"21845","Santa Cruz","Santa Cruz de La Sierra","Col. El Buen Samaritano",90,0,0,2,85,24,7,0,0,208,1,10,219,237,0.409,0.924
"21846","Santa Cruz","Santa Cruz de La Sierra","Col. El Buen Samaritano",76,0,1,1,92,21,17,3,2,213,0,3,216,233,0.432,0.927
"21847","Santa Cruz","Santa Cruz de La Sierra","Col. El Buen Samaritano",88,2,0,1,78,23,12,1,1,206,4,4,214,235,0.379,0.911
"21848","Santa Cruz","Santa Cruz de La Sierra","Col. El Buen Samaritano",77,0,1,0,96,14,16,1,1,206,4,8,218,232,0.466,0.94
"21849","Santa Cruz","Santa Cruz de La Sierra","Col. El Buen Samaritano",87,1,1,0,93,17,11,1,1,212,1,9,222,234,0.439,0.949
"21850","Santa Cruz","Santa Cruz de La Sierra","Col. El Buen Samaritano",60,0,0,2,115,18,5,0,4,204,3,7,214,233,0.564,0.918
"21851","Santa Cruz","Santa Cruz de La Sierra","Col. El Buen Samaritano",84,3,1,1,82,17,14,1,1,204,2,12,218,230,0.402,0.948
"21852","Santa Cruz","Santa Cruz de La Sierra","Col. El Buen Samaritano",85,1,1,1,66,17,14,7,2,194,3,5,202,231,0.34,0.874
"21853","Santa Cruz","Santa Cruz de La Sierra","Col. El Buen Samaritano",84,0,1,1,79,18,12,1,2,198,1,11,210,232,0.399,0.905
"21854","Santa Cruz","Santa Cruz de La Sierra","Col. El Buen Samaritano",104,1,0,0,68,20,16,3,0,212,2,8,222,234,0.321,0.949
"21855","Santa Cruz","Santa Cruz de La Sierra","Col. El Buen Samaritano",80,0,0,0,91,29,10,0,0,210,2,6,218,236,0.433,0.924
"21856","Santa Cruz","Santa Cruz de La Sierra","Col. El Buen Samaritano",88,0,0,2,81,17,12,3,0,203,1,10,214,233,0.399,0.918
"21857","Santa Cruz","Santa Cruz de La Sierra","Col. Nimia Centella",103,1,0,1,69,11,14,1,1,201,1,8,210,231,0.343,0.909
"21858","Santa Cruz","Santa Cruz de La Sierra","Col. Nimia Centella",102,0,0,0,45,26,14,2,0,189,2,12,203,228,0.238,0.89
"21859","Santa Cruz","Santa Cruz de La Sierra","Col. Nimia Centella",87,0,1,0,66,22,16,0,2,194,1,3,198,223,0.34,0.888
"21860","Santa Cruz","Santa Cruz de La Sierra","Col. Nimia Centella",98,0,0,0,52,16,16,1,1,184,2,6,192,228,0.283,0.842
"21861","Santa Cruz","Santa Cruz de La Sierra","Col. Nimia Centella",81,1,1,0,89,8,17,0,2,199,0,6,205,229,0.447,0.895
"21862","Santa Cruz","Santa Cruz de La Sierra","Col. Nimia Centella",98,2,0,0,56,10,7,2,0,175,0,11,186,218,0.32,0.853
"21863","Santa Cruz","Santa Cruz de La Sierra","Col. Nimia Centella",92,2,0,1,52,25,20,2,0,194,1,7,202,226,0.268,0.894
"21864","Santa Cruz","Santa Cruz de La Sierra","Col. Nimia Centella",93,1,0,0,30,12,20,0,1,157,1,46,204,228,0.191,0.895
"21865","Santa Cruz","Santa Cruz de La Sierra","Col. Nimia Centella",108,2,0,0,46,19,16,3,2,196,4,6,206,229,0.235,0.9
"21866","Santa Cruz","Santa Cruz de La Sierra","Col. Nimia Centella",85,0,0,1,79,16,16,0,0,197,2,11,210,226,0.401,0.929
"21867","Santa Cruz","Santa Cruz de La Sierra","Col. Nimia Centella",120,0,0,0,34,16,13,2,0,185,1,5,191,220,0.184,0.868
"21868","Santa Cruz","Santa Cruz de La Sierra","Col. Nimia Centella",104,1,2,1,54,14,17,1,0,194,1,8,203,221,0.278,0.919
"21869","Santa Cruz","Santa Cruz de La Sierra","Col. Nimia Centella",112,1,0,1,50,20,13,2,0,199,1,3,203,228,0.251,0.89
"21870","Santa Cruz","Santa Cruz de La Sierra","Col. Nimia Centella",114,0,0,0,44,18,12,6,0,194,0,4,198,228,0.227,0.868
"21871","Santa Cruz","Santa Cruz de La Sierra","Col. Nimia Centella",86,1,0,0,60,23,7,4,0,181,3,11,195,226,0.331,0.863
"21872","Santa Cruz","Santa Cruz de La Sierra","Col. Nimia Centella",111,0,0,1,46,27,13,1,0,199,2,9,210,230,0.231,0.913
"21873","Santa Cruz","Santa Cruz de La Sierra","Col. Nimia Centella",93,0,0,3,58,23,16,2,1,196,1,7,204,226,0.296,0.903
"21874","Santa Cruz","Santa Cruz de La Sierra","Col. Nimia Centella",97,0,0,0,47,21,12,2,2,181,2,12,195,229,0.26,0.852
"21875","Santa Cruz","Santa Cruz de La Sierra","Col. Nimia Centella",117,1,0,1,46,19,14,3,0,201,5,4,210,229,0.229,0.917
"21876","Santa Cruz","Santa Cruz de La Sierra","Col. Nimia Centella",72,1,0,1,49,14,21,0,1,159,4,3,166,190,0.308,0.874
"21877","Santa Cruz","Santa Cruz de La Sierra","Kinder Nimia Centella",106,0,0,1,56,17,25,4,0,209,3,7,219,238,0.268,0.92
"21878","Santa Cruz","Santa Cruz de La Sierra","U.E. Pedro Rivero Mercado",117,1,0,1,58,20,19,1,2,219,1,1,221,234,0.265,0.944
"21879","Santa Cruz","Santa Cruz de La Sierra","U.E. Pedro Rivero Mercado",136,0,0,0,42,25,13,6,0,222,1,3,226,240,0.189,0.942
"21880","Santa Cruz","Santa Cruz de La Sierra","U.E. Pedro Rivero Mercado",129,0,0,1,38,16,30,8,1,223,1,1,225,239,0.17,0.941
"21881","Santa Cruz","Santa Cruz de La Sierra","Col. Heroes Del Chaco",122,0,1,0,40,14,9,0,0,186,3,3,192,221,0.215,0.869
"21882","Santa Cruz","Santa Cruz de La Sierra","Col. Heroes Del Chaco",123,0,0,4,29,24,13,1,0,194,0,1,195,221,0.149,0.882
"21883","Santa Cruz","Santa Cruz de La Sierra","Col. Heroes Del Chaco",121,0,0,3,43,13,10,1,0,191,2,1,194,226,0.225,0.858
"21884","Santa Cruz","Santa Cruz de La Sierra","Col. Heroes Del Chaco",135,0,0,0,44,11,11,2,0,203,1,22,226,226,0.217,1
"21885","Santa Cruz","Santa Cruz de La Sierra","Col. Heroes Del Chaco",117,0,0,0,52,10,14,1,1,195,1,8,204,227,0.267,0.899
"21886","Santa Cruz","Santa Cruz de La Sierra","Col. Heroes Del Chaco",126,0,1,0,51,10,13,1,1,203,1,3,207,229,0.251,0.904
"21887","Santa Cruz","Santa Cruz de La Sierra","Col. Heroes Del Chaco",130,0,0,0,55,8,6,2,1,202,2,5,209,233,0.272,0.897
"21888","Santa Cruz","Santa Cruz de La Sierra","Col. Heroes Del Chaco",116,0,0,3,43,8,21,0,0,191,2,2,195,226,0.225,0.863
"21889","Santa Cruz","Santa Cruz de La Sierra","Col. Heroes Del Chaco",137,0,1,2,42,20,8,2,0,212,1,2,215,232,0.198,0.927
"21890","Santa Cruz","Santa Cruz de La Sierra","Col. Heroes Del Chaco",106,1,0,0,53,19,11,0,0,190,1,6,197,220,0.279,0.895
"21891","Santa Cruz","Santa Cruz de La Sierra","Col. Heroes Del Chaco",105,0,1,0,52,16,15,0,0,189,0,4,193,222,0.275,0.869
"21892","Santa Cruz","Santa Cruz de La Sierra","Col. Heroes Del Chaco",139,0,0,1,20,20,9,2,0,191,0,11,202,229,0.105,0.882
"21893","Santa Cruz","Santa Cruz de La Sierra","Col. Heroes Del Chaco",117,1,0,1,45,17,8,2,2,193,2,4,199,226,0.233,0.881
"21894","Santa Cruz","Santa Cruz de La Sierra","Col. Heroes Del Chaco",101,0,1,0,59,14,14,2,1,192,0,4,196,230,0.307,0.852
"21895","Santa Cruz","Santa Cruz de La Sierra","Col. Heroes Del Chaco",133,2,0,0,30,21,9,2,0,197,0,4,201,225,0.152,0.893
"21896","Santa Cruz","Santa Cruz de La Sierra","Col. Heroes Del Chaco",139,0,0,3,40,11,2,3,0,198,2,2,202,225,0.202,0.898
"21897","Santa Cruz","Santa Cruz de La Sierra","Col. Heroes Del Chaco",138,0,0,0,35,14,6,2,0,195,0,11,206,227,0.179,0.907
"21898","Santa Cruz","Santa Cruz de La Sierra","Col. Heroes Del Chaco",135,0,1,1,39,18,8,1,0,203,2,3,208,225,0.192,0.924
"21899","Santa Cruz","Santa Cruz de La Sierra","Col. Heroes Del Chaco",132,0,0,1,47,12,11,2,0,205,0,6,211,232,0.229,0.909
"21900","Santa Cruz","Santa Cruz de La Sierra","Col. Heroes Del Chaco",149,0,0,2,23,13,9,0,1,197,1,6,204,224,0.117,0.911
"21901","Santa Cruz","Santa Cruz de La Sierra","Col. Heroes Del Chaco",132,1,0,0,35,16,9,2,0,195,0,2,197,228,0.179,0.864
"21902","Santa Cruz","Santa Cruz de La Sierra","Col. Heroes Del Chaco",135,0,0,0,37,18,7,2,0,199,0,10,209,228,0.186,0.917
"21903","Santa Cruz","Santa Cruz de La Sierra","Col. Heroes Del Chaco",128,1,0,0,31,13,9,1,2,185,2,6,193,221,0.168,0.873
"21904","Santa Cruz","Santa Cruz de La Sierra","Col. Heroes Del Chaco",130,0,0,2,33,10,13,1,2,191,1,3,195,225,0.173,0.867
"21905","Santa Cruz","Santa Cruz de La Sierra","Col. Heroes Del Chaco",118,0,0,1,40,18,9,0,0,186,2,6,194,224,0.215,0.866
"21906","Santa Cruz","Santa Cruz de La Sierra","Col. Heroes Del Chaco",114,1,0,0,40,21,9,2,0,187,1,7,195,229,0.214,0.852
"21907","Santa Cruz","Santa Cruz de La Sierra","U.E. Ramon Dario Gutierrez ""A""",149,0,0,0,22,17,7,1,0,196,0,3,199,226,0.112,0.881
"21908","Santa Cruz","Santa Cruz de La Sierra","U.E. Ramon Dario Gutierrez ""A""",162,1,0,0,14,8,8,0,0,193,1,10,204,223,0.073,0.915
"21909","Santa Cruz","Santa Cruz de La Sierra","U.E. Ramon Dario Gutierrez ""A""",153,0,1,0,39,11,7,2,1,214,0,5,219,232,0.182,0.944
"21910","Santa Cruz","Santa Cruz de La Sierra","U.E. Ramon Dario Gutierrez ""A""",154,0,1,0,33,12,10,0,0,210,1,2,213,231,0.157,0.922
"21911","Santa Cruz","Santa Cruz de La Sierra","U.E. Ramon Dario Gutierrez ""A""",143,1,0,1,30,15,7,2,0,199,1,6,206,228,0.151,0.904
"21912","Santa Cruz","Santa Cruz de La Sierra","U.E. Ramon Dario Gutierrez ""A""",156,0,0,3,28,11,4,0,0,202,0,4,206,225,0.139,0.916
"21913","Santa Cruz","Santa Cruz de La Sierra","U.E. Ramon Dario Gutierrez ""A""",162,0,1,1,17,13,6,0,0,200,0,7,207,229,0.085,0.904
"21914","Santa Cruz","Santa Cruz de La Sierra","U.E. Ramon Dario Gutierrez ""A""",147,2,0,0,17,25,10,2,0,203,0,7,210,228,0.084,0.921
"21915","Santa Cruz","Santa Cruz de La Sierra","U.E. Ramon Dario Gutierrez ""A""",136,2,1,0,37,18,7,2,1,204,2,5,211,229,0.181,0.921
"21916","Santa Cruz","Santa Cruz de La Sierra","U.E. Ramon Dario Gutierrez ""A""",162,0,1,1,12,19,3,3,2,203,2,4,209,228,0.059,0.917
"21917","Santa Cruz","Santa Cruz de La Sierra","U.E. Ramon Dario Gutierrez ""A""",148,1,0,0,19,21,9,2,1,201,0,3,204,229,0.095,0.891
"21918","Santa Cruz","Santa Cruz de La Sierra","U.E. Ramon Dario Gutierrez ""A""",160,0,0,1,27,17,4,2,1,212,1,5,218,232,0.127,0.94
"21919","Santa Cruz","Santa Cruz de La Sierra","U.E. Ramon Dario Gutierrez ""A""",149,0,0,0,31,15,8,1,0,204,1,9,214,231,0.152,0.926
"21920","Santa Cruz","Santa Cruz de La Sierra","U.E. Ramon Dario Gutierrez ""A""",149,0,0,0,30,17,8,0,0,204,1,7,212,229,0.147,0.926
"21921","Santa Cruz","Santa Cruz de La Sierra","U.E. Ramon Dario Gutierrez ""A""",156,1,0,1,27,10,12,1,0,208,0,4,212,227,0.13,0.934
"21922","Santa Cruz","Santa Cruz de La Sierra","U.E. Ramon Dario Gutierrez ""A""",155,0,1,1,15,27,9,2,0,210,0,3,213,231,0.071,0.922
"21923","Santa Cruz","Santa Cruz de La Sierra","U.E. Ramon Dario Gutierrez ""A""",147,1,0,3,32,13,12,3,0,211,0,2,213,234,0.152,0.91
"21924","Santa Cruz","Santa Cruz de La Sierra","U.E. Ramon Dario Gutierrez ""A""",105,0,0,0,25,17,9,1,0,157,2,4,163,170,0.159,0.959
"21925","Santa Cruz","Santa Cruz de La Sierra","Modulo Educativo 3 Lagunas",95,0,0,4,47,26,12,2,0,186,2,4,192,207,0.253,0.928
"21926","Santa Cruz","Santa Cruz de La Sierra","Modulo Educativo 3 Lagunas",64,1,0,0,81,15,22,1,0,184,3,3,190,224,0.44,0.848
"21927","Santa Cruz","Santa Cruz de La Sierra","Modulo Educativo 3 Lagunas",81,3,0,3,73,10,15,1,1,187,1,3,191,217,0.39,0.88
"21928","Santa Cruz","Santa Cruz de La Sierra","Modulo Educativo 3 Lagunas",96,2,1,1,63,11,16,1,0,191,1,5,197,218,0.33,0.904
"21929","Santa Cruz","Santa Cruz de La Sierra","Modulo Educativo 3 Lagunas",76,0,0,0,66,9,19,2,0,172,4,3,179,212,0.384,0.844
"21930","Santa Cruz","Santa Cruz de La Sierra","Modulo Educativo 3 Lagunas",88,0,0,0,52,16,20,1,0,177,0,5,182,209,0.294,0.871
"21931","Santa Cruz","Santa Cruz de La Sierra","Modulo Educativo 3 Lagunas",94,0,1,0,62,31,9,3,1,201,1,3,205,224,0.308,0.915
"21932","Santa Cruz","Santa Cruz de La Sierra","Modulo Educativo 3 Lagunas",104,0,0,0,55,21,10,1,0,191,1,6,198,218,0.288,0.908
"21933","Santa Cruz","Santa Cruz de La Sierra","Modulo Educativo 3 Lagunas",91,0,1,3,67,28,12,1,1,204,1,3,208,226,0.328,0.92
"21934","Santa Cruz","Santa Cruz de La Sierra","Col. 27 de Mayo",101,0,2,0,55,16,18,0,0,192,0,9,201,235,0.286,0.855
"21935","Santa Cruz","Santa Cruz de La Sierra","Col. 27 de Mayo",100,0,0,0,63,11,16,0,0,190,0,12,202,233,0.332,0.867
"21936","Santa Cruz","Santa Cruz de La Sierra","Col. 27 de Mayo",99,0,0,0,60,15,17,0,0,191,0,4,195,234,0.314,0.833
"21937","Santa Cruz","Santa Cruz de La Sierra","Col. 27 de Mayo",79,2,0,0,68,15,25,1,0,190,4,6,200,238,0.358,0.84
"21938","Santa Cruz","Santa Cruz de La Sierra","Col. 27 de Mayo",75,0,2,0,91,17,15,1,1,202,0,9,211,234,0.45,0.902
"21939","Santa Cruz","Santa Cruz de La Sierra","Col. 27 de Mayo",93,0,0,3,66,10,19,3,2,196,0,3,199,228,0.337,0.873
"21940","Santa Cruz","Santa Cruz de La Sierra","Col. 27 de Mayo",84,0,1,0,73,21,11,4,0,194,1,4,199,231,0.376,0.861
"21941","Santa Cruz","Santa Cruz de La Sierra","Col. 27 de Mayo",91,2,0,0,74,16,17,0,0,200,1,2,203,231,0.37,0.879
"21942","Santa Cruz","Santa Cruz de La Sierra","Col. 27 de Mayo",79,0,0,0,84,16,14,2,0,195,0,4,199,232,0.431,0.858
"21943","Santa Cruz","Santa Cruz de La Sierra","Col. 27 de Mayo",88,0,0,1,79,12,10,2,2,194,1,5,200,235,0.407,0.851
"21944","Santa Cruz","Santa Cruz de La Sierra","Col. 27 de Mayo",87,0,0,2,46,24,27,0,1,187,3,8,198,233,0.246,0.85
"21945","Santa Cruz","Santa Cruz de La Sierra","Col. 27 de Mayo",83,1,0,0,64,11,24,1,2,186,1,7,194,233,0.344,0.833
"21946","Santa Cruz","Santa Cruz de La Sierra","Col. 27 de Mayo",112,0,0,1,50,20,10,4,0,197,1,9,207,232,0.254,0.892
"21947","Santa Cruz","Santa Cruz de La Sierra","Col. 27 de Mayo",89,0,1,0,68,18,15,2,0,193,3,7,203,233,0.352,0.871
"21948","Santa Cruz","Santa Cruz de La Sierra","Col. 27 de Mayo",98,1,0,0,58,19,10,2,0,188,0,7,195,227,0.309,0.859
"21949","Santa Cruz","Santa Cruz de La Sierra","Col. 27 de Mayo",87,0,0,1,67,15,21,1,0,192,0,8,200,230,0.349,0.87
"21950","Santa Cruz","Santa Cruz de La Sierra","Col. 27 de Mayo",97,0,2,2,65,21,16,2,1,206,0,7,213,235,0.316,0.906
"21951","Santa Cruz","Santa Cruz de La Sierra","Col. 27 de Mayo",97,0,0,1,70,19,17,1,0,205,0,4,209,234,0.341,0.893
"21952","Santa Cruz","Santa Cruz de La Sierra","Col. Angela Pinckert",92,0,1,1,81,15,16,2,1,209,1,2,212,231,0.388,0.918
"21953","Santa Cruz","Santa Cruz de La Sierra","Col. Angela Pinckert",103,0,0,1,62,14,16,1,0,197,2,3,202,231,0.315,0.874
"21954","Santa Cruz","Santa Cruz de La Sierra","Col. Angela Pinckert",99,0,1,1,55,19,13,3,3,194,0,2,196,226,0.284,0.867
"21955","Santa Cruz","Santa Cruz de La Sierra","Col. Angela Pinckert",100,0,0,0,73,13,13,4,2,205,0,8,213,229,0.356,0.93
"21956","Santa Cruz","Santa Cruz de La Sierra","Col. Angela Pinckert",94,0,1,2,70,14,10,1,0,192,3,5,200,230,0.365,0.87
"21957","Santa Cruz","Santa Cruz de La Sierra","Col. Angela Pinckert",107,1,1,0,75,14,8,0,0,206,0,3,209,227,0.364,0.921
"21958","Santa Cruz","Santa Cruz de La Sierra","Col. Angela Pinckert",88,0,0,1,61,14,22,3,0,189,2,7,198,225,0.323,0.88
"21959","Santa Cruz","Santa Cruz de La Sierra","Col. Angela Pinckert",68,0,1,0,83,17,14,3,2,188,4,12,204,231,0.441,0.883
"21960","Santa Cruz","Santa Cruz de La Sierra","Col. Angela Pinckert",85,0,1,1,66,25,17,2,0,197,1,6,204,229,0.335,0.891
"21961","Santa Cruz","Santa Cruz de La Sierra","Col. Angela Pinckert",89,1,0,0,85,11,17,1,1,205,3,4,212,233,0.415,0.91
"21962","Santa Cruz","Santa Cruz de La Sierra","Col. Angela Pinckert",90,0,0,0,60,27,19,0,1,197,2,8,207,230,0.305,0.9
"21963","Santa Cruz","Santa Cruz de La Sierra","Col. Angela Pinckert",72,0,0,1,83,12,17,2,1,188,0,12,200,223,0.441,0.897
"21964","Santa Cruz","Santa Cruz de La Sierra","Col. Angela Pinckert",97,0,0,0,66,21,11,5,0,200,0,3,203,236,0.33,0.86
"21965","Santa Cruz","Santa Cruz de La Sierra","Col. Angela Pinckert",101,0,0,1,56,16,10,4,2,190,0,8,198,229,0.295,0.865
"21966","Santa Cruz","Santa Cruz de La Sierra","Col. Angela Pinckert",87,0,0,0,61,16,11,0,1,176,1,11,188,220,0.347,0.855
"21967","Santa Cruz","Santa Cruz de La Sierra","Col. Angela Pinckert",61,1,1,1,98,13,20,3,4,202,1,4,207,227,0.485,0.912
"21968","Santa Cruz","Santa Cruz de La Sierra","Col. Angela Pinckert",99,1,0,1,73,10,8,1,1,194,1,4,199,226,0.376,0.881
"21969","Santa Cruz","Santa Cruz de La Sierra","Col. Angela Pinckert",99,0,0,1,63,18,8,4,0,193,2,9,204,230,0.326,0.887
"21970","Santa Cruz","Santa Cruz de La Sierra","Col. Angela Pinckert",104,1,0,1,55,19,17,1,0,198,2,8,208,231,0.278,0.9
"21971","Santa Cruz","Santa Cruz de La Sierra","Col. Angela Pinckert",99,0,0,0,75,15,12,1,0,202,2,3,207,227,0.371,0.912
"21972","Santa Cruz","Santa Cruz de La Sierra","Col. Angela Pinckert",89,1,1,0,58,18,12,2,0,181,2,13,196,231,0.32,0.848
"21973","Santa Cruz","Santa Cruz de La Sierra","Col. Angela Pinckert",81,0,1,1,72,14,19,5,1,194,3,7,204,233,0.371,0.876
"21974","Santa Cruz","Santa Cruz de La Sierra","Col. Angela Pinckert",84,0,0,1,81,17,11,0,0,194,0,11,205,228,0.418,0.899
"21975","Santa Cruz","Santa Cruz de La Sierra","Col. Angela Pinckert",106,1,0,1,49,26,12,1,2,198,1,12,211,233,0.247,0.906
"21976","Santa Cruz","Santa Cruz de La Sierra","Col. Angela Pinckert",93,1,1,1,70,15,15,1,1,198,1,6,205,224,0.354,0.915
"21977","Santa Cruz","Santa Cruz de La Sierra","Col. Angela Pinckert",103,0,0,1,61,16,13,3,1,198,1,9,208,230,0.308,0.904
"21978","Santa Cruz","Santa Cruz de La Sierra","Col. Angela Pinckert",84,1,1,1,67,18,21,3,1,197,1,6,204,233,0.34,0.876
"21979","Santa Cruz","Santa Cruz de La Sierra","Col. Angela Pinckert",111,1,1,1,58,18,13,1,1,205,1,7,213,232,0.283,0.918
"21980","Santa Cruz","Santa Cruz de La Sierra","Col. Angela Pinckert",103,0,0,1,64,11,20,3,0,202,1,8,211,230,0.317,0.917
"21981","Santa Cruz","Santa Cruz de La Sierra","Col. Angela Pinckert",101,1,0,0,61,21,7,1,0,192,0,8,200,234,0.318,0.855
"21982","Santa Cruz","Santa Cruz de La Sierra","Col. Angela Pinckert",83,1,0,0,73,24,19,1,0,201,0,6,207,233,0.363,0.888
"21983","Santa Cruz","Santa Cruz de La Sierra","Col. Angela Pinckert",77,0,0,1,105,10,12,2,0,207,0,3,210,240,0.507,0.875
"21984","Santa Cruz","Santa Cruz de La Sierra","Col. Educativo San Isidro",116,0,0,2,56,10,15,1,0,200,1,6,207,231,0.28,0.896
"21985","Santa Cruz","Santa Cruz de La Sierra","Col. Educativo San Isidro",97,0,0,1,55,22,13,3,0,191,1,9,201,225,0.288,0.893
"21986","Santa Cruz","Santa Cruz de La Sierra","Col. Educativo San Isidro",114,1,0,1,52,15,10,2,1,196,2,6,204,227,0.265,0.899
"21987","Santa Cruz","Santa Cruz de La Sierra","Col. Educativo San Isidro",100,0,0,0,74,9,8,0,1,192,3,7,202,226,0.385,0.894
"21988","Santa Cruz","Santa Cruz de La Sierra","Col. Educativo San Isidro",104,0,1,4,60,19,12,0,1,201,2,5,208,228,0.299,0.912
"21989","Santa Cruz","Santa Cruz de La Sierra","Col. Educativo San Isidro",103,2,1,4,58,18,7,0,3,196,4,5,205,226,0.296,0.907
"21990","Santa Cruz","Santa Cruz de La Sierra","Col. Educativo San Isidro",87,0,1,1,87,10,17,3,1,207,0,4,211,231,0.42,0.913
"21991","Santa Cruz","Santa Cruz de La Sierra","Col. Educativo San Isidro",101,0,1,1,56,12,15,3,0,189,1,14,204,230,0.296,0.887
"21992","Santa Cruz","Santa Cruz de La Sierra","Col. Educativo San Isidro",114,0,1,1,55,20,11,3,0,205,0,5,210,227,0.268,0.925
"21993","Santa Cruz","Santa Cruz de La Sierra","Col. Educativo San Isidro",97,1,0,2,61,14,19,4,1,199,0,2,201,221,0.307,0.91
"21994","Santa Cruz","Santa Cruz de La Sierra","Col. Educativo San Isidro",107,1,0,0,56,12,23,0,1,200,1,5,206,232,0.28,0.888
"21995","Santa Cruz","Santa Cruz de La Sierra","Col. Educativo San Isidro",112,1,0,0,55,19,16,3,1,207,0,6,213,234,0.266,0.91
"21996","Santa Cruz","Santa Cruz de La Sierra","Col. Educativo San Isidro",92,0,2,1,67,17,15,0,0,194,0,3,197,229,0.345,0.86
"21997","Santa Cruz","Santa Cruz de La Sierra","Col. Educativo San Isidro",116,0,1,1,52,21,7,0,0,198,0,5,203,230,0.263,0.883
"21998","Santa Cruz","Santa Cruz de La Sierra","Col. Educativo San Isidro",82,0,0,2,81,17,19,1,1,203,0,3,206,232,0.399,0.888
"21999","Santa Cruz","Santa Cruz de La Sierra","Col. Educativo San Isidro",92,1,1,0,70,17,17,2,1,201,4,2,207,227,0.348,0.912
"22000","Santa Cruz","Santa Cruz de La Sierra","Col. Educativo San Isidro",116,1,0,2,35,18,16,3,0,191,0,9,200,226,0.183,0.885
"22001","Santa Cruz","Santa Cruz de La Sierra","Col. Educativo San Isidro",117,0,1,2,40,18,17,1,1,197,0,6,203,227,0.203,0.894
"22002","Santa Cruz","Santa Cruz de La Sierra","Col. Educativo San Isidro",114,3,1,0,49,20,12,1,1,201,1,5,207,229,0.244,0.904
"22003","Santa Cruz","Santa Cruz de La Sierra","Col. Educativo San Isidro",115,1,0,1,45,17,8,4,0,191,0,10,201,229,0.236,0.878
"22004","Santa Cruz","Santa Cruz de La Sierra","Col. Educativo San Isidro",77,0,0,1,79,14,25,1,1,198,3,4,205,231,0.399,0.887
"22005","Santa Cruz","Santa Cruz de La Sierra","Col. Educativo San Isidro",110,0,0,0,54,16,15,3,0,198,0,8,206,225,0.273,0.916
"22006","Santa Cruz","Santa Cruz de La Sierra","Col. Educativo San Isidro",104,0,0,1,57,21,14,1,2,200,0,7,207,234,0.285,0.885
"22007","Santa Cruz","Santa Cruz de La Sierra","Col. Educativo San Isidro",109,1,0,2,40,17,11,2,0,182,0,5,187,224,0.22,0.835
"22008","Santa Cruz","Santa Cruz de La Sierra","Col. Educativo San Isidro",109,0,0,0,38,27,9,2,0,185,2,9,196,230,0.205,0.852
"22009","Santa Cruz","Santa Cruz de La Sierra","Col. Educativo San Isidro",103,0,1,2,48,10,20,4,1,189,0,8,197,227,0.254,0.868
"22010","Santa Cruz","Santa Cruz de La Sierra","Col. Educativo San Isidro",108,0,0,1,62,9,15,2,1,198,1,8,207,230,0.313,0.9
"22011","Santa Cruz","Santa Cruz de La Sierra","Col. Educativo San Isidro",119,1,0,2,48,13,10,1,0,194,0,6,200,223,0.247,0.897
"22012","Santa Cruz","Santa Cruz de La Sierra","Col. Educativo San Isidro",108,0,0,1,49,23,19,3,1,204,2,4,210,233,0.24,0.901
"22013","Santa Cruz","Santa Cruz de La Sierra","Col. San Silvestre",68,0,1,0,90,17,15,3,4,198,1,4,203,233,0.455,0.871
"22014","Santa Cruz","Santa Cruz de La Sierra","Col. San Silvestre",66,0,0,0,85,12,17,5,1,186,1,11,198,224,0.457,0.884
"22015","Santa Cruz","Santa Cruz de La Sierra","Col. San Silvestre",63,1,0,1,80,30,21,0,0,196,1,6,203,226,0.408,0.898
"22016","Santa Cruz","Santa Cruz de La Sierra","Col. San Silvestre",63,0,0,1,94,20,16,0,1,195,0,9,204,233,0.482,0.876
"22017","Santa Cruz","Santa Cruz de La Sierra","Col. San Silvestre",98,1,0,1,59,12,16,2,3,192,0,16,208,228,0.307,0.912
"22018","Santa Cruz","Santa Cruz de La Sierra","Col. San Silvestre",65,1,0,0,102,14,22,4,0,208,1,6,215,233,0.49,0.923
"22019","Santa Cruz","Santa Cruz de La Sierra","Col. San Silvestre",62,1,0,1,80,21,22,3,0,190,4,9,203,230,0.421,0.883
"22020","Santa Cruz","Santa Cruz de La Sierra","Col. San Silvestre",87,0,1,1,59,23,20,3,0,194,4,7,205,226,0.304,0.907
"22021","Santa Cruz","Santa Cruz de La Sierra","Col. San Silvestre",86,0,0,0,77,10,18,1,0,192,1,10,203,232,0.401,0.875
"22022","Santa Cruz","Santa Cruz de La Sierra","Col. San Silvestre",74,1,0,1,87,7,21,1,1,193,2,10,205,228,0.451,0.899
"22023","Santa Cruz","Santa Cruz de La Sierra","Col. San Silvestre",86,0,0,0,79,14,17,2,0,198,1,6,205,233,0.399,0.88
"22024","Santa Cruz","Santa Cruz de La Sierra","Col. San Silvestre",96,1,0,1,59,17,25,3,0,202,0,4,206,230,0.292,0.896
"22025","Santa Cruz","Santa Cruz de La Sierra","Col. San Silvestre",62,0,1,0,97,13,17,0,1,191,3,6,200,232,0.508,0.862
"22026","Santa Cruz","Santa Cruz de La Sierra","Col. San Silvestre",84,1,0,0,78,13,18,3,1,198,2,10,210,229,0.394,0.917
"22027","Santa Cruz","Santa Cruz de La Sierra","Col. San Silvestre",86,0,0,0,75,19,18,1,0,199,1,6,206,233,0.377,0.884
"22028","Santa Cruz","Santa Cruz de La Sierra","Col. San Silvestre",81,1,0,1,66,22,20,1,0,192,2,9,203,229,0.344,0.886
"22029","Santa Cruz","Santa Cruz de La Sierra","Col. San Silvestre",91,1,0,0,55,28,15,7,0,197,1,5,203,227,0.279,0.894
"22030","Santa Cruz","Santa Cruz de La Sierra","Col. San Silvestre",62,0,0,0,101,18,18,2,0,201,1,6,208,224,0.502,0.929
"22031","Santa Cruz","Santa Cruz de La Sierra","Col. San Silvestre",80,0,0,2,76,16,17,6,1,198,1,8,207,229,0.384,0.904
"22032","Santa Cruz","Santa Cruz de La Sierra","Col. San Silvestre",81,0,0,0,71,21,17,1,1,192,3,8,203,231,0.37,0.879
"22033","Santa Cruz","Santa Cruz de La Sierra","Col. San Silvestre",81,1,0,0,67,24,18,3,0,194,0,6,200,230,0.345,0.87
"22034","Santa Cruz","Santa Cruz de La Sierra","Col. San Silvestre",75,1,1,0,65,27,19,2,1,191,2,15,208,231,0.34,0.9
"22035","Santa Cruz","Santa Cruz de La Sierra","Col. San Silvestre",82,0,0,0,78,15,26,0,0,201,1,3,205,232,0.388,0.884
"22036","Santa Cruz","Santa Cruz de La Sierra","Col. San Silvestre",84,0,0,2,60,18,18,0,2,184,1,25,210,231,0.326,0.909
"22037","Santa Cruz","Santa Cruz de La Sierra","Col. San Silvestre",71,0,0,0,70,24,17,1,2,185,3,5,193,219,0.378,0.881
"22038","Santa Cruz","Santa Cruz de La Sierra","Col. M. Nelly Vda. De Bertero",84,1,0,0,71,16,10,6,0,188,5,7,200,227,0.378,0.881
"22039","Santa Cruz","Santa Cruz de La Sierra","Col. M. Nelly Vda. De Bertero",66,0,2,0,103,15,15,3,1,205,1,5,211,232,0.502,0.909
"22040","Santa Cruz","Santa Cruz de La Sierra","Col. M. Nelly Vda. De Bertero",67,0,0,0,91,19,18,0,1,196,1,6,203,229,0.464,0.886
"22041","Santa Cruz","Santa Cruz de La Sierra","Col. M. Nelly Vda. De Bertero",64,1,1,1,94,19,18,0,1,199,1,3,203,225,0.472,0.902
"22042","Santa Cruz","Santa Cruz de La Sierra","Col. M. Nelly Vda. De Bertero",77,0,0,1,64,25,16,3,1,187,0,11,198,228,0.342,0.868
"22043","Santa Cruz","Santa Cruz de La Sierra","Col. M. Nelly Vda. De Bertero",84,0,0,2,72,21,17,1,1,198,1,6,205,231,0.364,0.887
"22044","Santa Cruz","Santa Cruz de La Sierra","Col. M. Nelly Vda. De Bertero",70,0,0,0,74,27,21,3,1,196,2,6,204,231,0.378,0.883
"22045","Santa Cruz","Santa Cruz de La Sierra","Col. M. Nelly Vda. De Bertero",79,0,1,1,76,23,16,0,1,197,2,9,208,231,0.386,0.9
"22046","Santa Cruz","Santa Cruz de La Sierra","Col. Cañada Pailitas",118,2,0,0,49,12,23,1,0,205,1,0,206,229,0.239,0.9
"22047","Santa Cruz","Santa Cruz de La Sierra","Col. Cañada Pailitas",120,1,1,1,37,15,15,2,0,192,0,6,198,230,0.193,0.861
"22048","Santa Cruz","Santa Cruz de La Sierra","Col. Cañada Pailitas",106,1,0,0,51,27,14,1,0,200,3,1,204,226,0.255,0.903
"22049","Santa Cruz","Santa Cruz de La Sierra","Col. Cañada Pailitas",114,1,0,1,45,18,14,1,0,194,0,6,200,230,0.232,0.87
"22050","Santa Cruz","Santa Cruz de La Sierra","Col. Cañada Pailitas",113,0,2,0,39,27,12,0,3,196,1,7,204,231,0.199,0.883
"22051","Santa Cruz","Santa Cruz de La Sierra","Col. Cañada Pailitas",116,1,1,0,34,20,16,0,1,189,3,3,195,225,0.18,0.867
"22052","Santa Cruz","Santa Cruz de La Sierra","Col. Cañada Pailitas",89,0,1,0,77,21,14,1,1,204,3,4,211,229,0.377,0.921
"22053","Santa Cruz","Santa Cruz de La Sierra","Col. Cañada Pailitas",121,0,0,0,43,18,14,1,0,197,0,8,205,224,0.218,0.915
"22054","Santa Cruz","Santa Cruz de La Sierra","Col. Cañada Pailitas",130,0,0,0,38,20,10,1,0,199,3,5,207,229,0.191,0.904
"22055","Santa Cruz","Santa Cruz de La Sierra","Col. Cañada Pailitas",136,0,1,0,39,9,12,0,3,200,3,9,212,231,0.195,0.918
"22056","Santa Cruz","Santa Cruz de La Sierra","Col. Cañada Pailitas",127,0,0,1,41,15,14,1,1,200,0,5,205,228,0.205,0.899
"22057","Santa Cruz","Santa Cruz de La Sierra","Col. Cañada Pailitas",118,0,2,0,45,22,15,1,0,203,0,7,210,231,0.222,0.909
"22058","Santa Cruz","Santa Cruz de La Sierra","Col. Cañada Pailitas",121,0,0,0,40,21,9,0,0,191,3,7,201,230,0.209,0.874
"22059","Santa Cruz","Santa Cruz de La Sierra","Col. Santa Rafaela",112,0,0,1,50,29,16,4,0,212,2,4,218,226,0.236,0.965
"22060","Santa Cruz","Santa Cruz de La Sierra","Col. Santa Rafaela",111,1,0,2,45,19,16,1,1,196,2,31,229,229,0.23,1
"22061","Santa Cruz","Santa Cruz de La Sierra","Col. Santa Rafaela",104,0,0,2,52,13,14,3,3,191,0,3,194,227,0.272,0.855
"22062","Santa Cruz","Santa Cruz de La Sierra","Col. Santa Rafaela",118,0,0,0,38,19,11,1,0,187,3,35,225,225,0.203,1
"22063","Santa Cruz","Santa Cruz de La Sierra","Col. Santa Rafaela",109,2,0,6,42,18,21,5,0,203,0,4,207,228,0.207,0.908
"22064","Santa Cruz","Santa Cruz de La Sierra","Col. Santa Rafaela",111,0,1,0,61,16,14,2,0,205,3,7,215,225,0.298,0.956
"22065","Santa Cruz","Santa Cruz de La Sierra","Col. Santa Rafaela",121,0,0,0,32,23,9,3,0,188,2,3,193,227,0.17,0.85
"22066","Santa Cruz","Santa Cruz de La Sierra","Col. Santa Rafaela",115,0,0,1,34,31,9,0,1,191,3,8,202,227,0.178,0.89
"22067","Santa Cruz","Santa Cruz de La Sierra","Col. Santa Rafaela",116,0,0,1,45,17,7,2,0,188,1,4,193,227,0.239,0.85
"22068","Santa Cruz","Santa Cruz de La Sierra","Col. Santa Rafaela",129,0,0,1,32,17,11,1,2,193,30,1,224,224,0.166,1
"22069","Santa Cruz","Santa Cruz de La Sierra","Col. Santa Rafaela",115,1,0,1,41,21,15,4,0,198,0,4,202,230,0.207,0.878
"22070","Santa Cruz","Santa Cruz de La Sierra","U.E. 2 de Abril",131,1,2,0,34,18,16,3,0,205,0,9,214,238,0.166,0.899
"22071","Santa Cruz","Santa Cruz de La Sierra","U.E. 2 de Abril",136,1,0,0,41,20,19,0,0,217,0,6,223,239,0.189,0.933
"22072","Santa Cruz","Santa Cruz de La Sierra","U.E. 2 de Abril",107,1,0,1,32,15,17,0,1,174,1,10,185,198,0.184,0.934
"22073","Santa Cruz","Santa Cruz de La Sierra","Col. Rafael Bustillos",64,1,0,0,88,17,18,1,0,189,0,4,193,226,0.466,0.854
"22074","Santa Cruz","Santa Cruz de La Sierra","Col. Rafael Bustillos",102,0,0,0,64,20,9,0,0,195,0,9,204,227,0.328,0.899
"22075","Santa Cruz","Santa Cruz de La Sierra","Col. Rafael Bustillos",73,0,0,2,85,26,13,1,1,201,0,7,208,226,0.423,0.92
"22076","Santa Cruz","Santa Cruz de La Sierra","Col. Rafael Bustillos",69,1,1,1,83,19,17,1,2,194,1,3,198,228,0.428,0.868
"22077","Santa Cruz","Santa Cruz de La Sierra","Col. Rafael Bustillos",65,0,0,1,97,19,17,4,3,206,1,0,207,230,0.471,0.9
"22078","Santa Cruz","Santa Cruz de La Sierra","Col. Rafael Bustillos",97,0,0,0,68,21,15,0,2,203,3,2,208,236,0.335,0.881
"22079","Santa Cruz","Santa Cruz de La Sierra","Col. Rafael Bustillos",84,2,1,0,64,26,15,0,1,193,1,8,202,228,0.332,0.886
"22080","Santa Cruz","Santa Cruz de La Sierra","Col. Rafael Bustillos",82,1,0,3,80,14,19,0,1,200,1,5,206,227,0.4,0.907
"22081","Santa Cruz","Santa Cruz de La Sierra","Col. Rafael Bustillos",71,1,2,0,88,12,9,1,2,186,3,6,195,221,0.473,0.882
"22082","Santa Cruz","Santa Cruz de La Sierra","Col. Rafael Bustillos",77,1,0,0,81,26,16,3,1,205,0,4,209,231,0.395,0.905
"22083","Santa Cruz","Santa Cruz de La Sierra","Col. Rafael Bustillos",91,0,1,1,76,15,18,2,1,205,0,8,213,233,0.371,0.914
"22084","Santa Cruz","Santa Cruz de La Sierra","Col. Rafael Bustillos",83,0,0,1,78,27,14,0,2,205,0,4,209,226,0.38,0.925
"22085","Santa Cruz","Santa Cruz de La Sierra","Col. Rafael Bustillos",76,0,3,1,90,13,17,1,0,201,2,2,205,228,0.448,0.899
"22086","Santa Cruz","Santa Cruz de La Sierra","Col. Rafael Bustillos",83,0,0,1,85,23,8,1,1,202,0,5,207,229,0.421,0.904
"22087","Santa Cruz","Santa Cruz de La Sierra","Col. Rafael Bustillos",84,1,1,1,67,18,15,2,1,190,0,9,199,231,0.353,0.861
"22088","Santa Cruz","Santa Cruz de La Sierra","Col. Rafael Bustillos",83,0,0,2,75,21,14,3,1,199,0,4,203,230,0.377,0.883
"22089","Santa Cruz","Santa Cruz de La Sierra","Col. Rafael Bustillos",82,1,0,2,73,19,20,2,1,200,4,2,206,229,0.365,0.9
"22090","Santa Cruz","Santa Cruz de La Sierra","Col. Rafael Bustillos",74,0,1,0,92,14,12,0,1,194,1,2,197,223,0.474,0.883
"22091","Santa Cruz","Santa Cruz de La Sierra","Colegio Simon Bolivar",72,0,1,1,83,10,15,1,3,186,1,6,193,231,0.446,0.835
"22092","Santa Cruz","Santa Cruz de La Sierra","Colegio Simon Bolivar",70,0,0,2,96,12,11,0,1,192,3,4,199,227,0.5,0.877
"22093","Santa Cruz","Santa Cruz de La Sierra","Colegio Simon Bolivar",63,0,0,1,85,19,21,3,2,194,2,5,201,230,0.438,0.874
"22094","Santa Cruz","Santa Cruz de La Sierra","Colegio Simon Bolivar",67,2,1,2,87,14,15,2,1,191,3,5,199,231,0.455,0.861
"22095","Santa Cruz","Santa Cruz de La Sierra","Colegio Simon Bolivar",54,0,1,2,117,7,17,1,0,199,3,8,210,231,0.588,0.909
"22096","Santa Cruz","Santa Cruz de La Sierra","Colegio Simon Bolivar",45,2,0,1,121,16,22,0,1,208,1,3,212,233,0.582,0.91
"22097","Santa Cruz","Santa Cruz de La Sierra","Colegio Simon Bolivar",67,0,0,2,95,19,21,0,0,204,4,3,211,231,0.466,0.913
"22098","Santa Cruz","Santa Cruz de La Sierra","Colegio Simon Bolivar",58,0,1,0,97,20,16,2,0,194,1,12,207,231,0.5,0.896
"22099","Santa Cruz","Santa Cruz de La Sierra","Colegio Simon Bolivar",74,1,1,1,88,13,21,0,0,199,4,3,206,229,0.442,0.9
"22100","Santa Cruz","Santa Cruz de La Sierra","Colegio Simon Bolivar",80,0,0,1,81,20,15,0,2,199,0,1,200,228,0.407,0.877
"22101","Santa Cruz","Santa Cruz de La Sierra","Colegio Simon Bolivar",73,1,1,1,92,15,12,0,2,197,1,4,202,229,0.467,0.882
"22102","Santa Cruz","Santa Cruz de La Sierra","Colegio Simon Bolivar",77,1,0,1,88,11,14,1,1,194,1,7,202,223,0.454,0.906
"22103","Santa Cruz","Santa Cruz de La Sierra","Colegio Simon Bolivar",61,1,1,0,93,19,23,2,2,202,2,8,212,226,0.46,0.938
"22104","Santa Cruz","Santa Cruz de La Sierra","Colegio Simon Bolivar",73,0,0,0,78,17,18,2,0,188,1,11,200,222,0.415,0.901
"22105","Santa Cruz","Santa Cruz de La Sierra","Colegio Simon Bolivar",75,1,1,0,73,16,20,2,0,188,0,12,200,230,0.388,0.87
"22106","Santa Cruz","Santa Cruz de La Sierra","Colegio Simon Bolivar",87,1,1,0,84,16,3,0,1,193,1,1,195,231,0.435,0.844
"22107","Santa Cruz","Santa Cruz de La Sierra","Colegio Simon Bolivar",71,2,0,1,80,25,17,0,0,196,1,10,207,232,0.408,0.892
"22108","Santa Cruz","Santa Cruz de La Sierra","Colegio Simon Bolivar",58,0,2,0,125,10,7,0,0,202,0,7,209,229,0.619,0.913
"22109","Santa Cruz","Santa Cruz de La Sierra","Colegio Simon Bolivar",83,1,0,1,77,16,12,0,1,191,2,1,194,222,0.403,0.874
"22110","Santa Cruz","Santa Cruz de La Sierra","Colegio Simon Bolivar",76,1,0,1,82,20,8,0,0,188,0,8,196,228,0.436,0.86
"22111","Santa Cruz","Santa Cruz de La Sierra","Colegio Simon Bolivar",66,1,0,0,94,19,14,2,2,198,1,6,205,228,0.475,0.899
"22112","Santa Cruz","Santa Cruz de La Sierra","Colegio Simon Bolivar",69,0,1,1,80,16,11,3,1,182,2,6,190,220,0.44,0.864
"22113","Santa Cruz","Santa Cruz de La Sierra","Colegio Simon Bolivar",66,0,1,1,96,13,16,2,0,195,1,10,206,235,0.492,0.877
"22114","Santa Cruz","Santa Cruz de La Sierra","Colegio Simon Bolivar",60,0,0,2,96,14,19,2,0,193,0,5,198,220,0.497,0.9
"22115","Santa Cruz","Santa Cruz de La Sierra","Colegio Villa Gladys Theveneth",69,1,0,0,91,18,18,0,0,197,2,4,203,232,0.462,0.875
"22116","Santa Cruz","Santa Cruz de La Sierra","Colegio Villa Gladys Theveneth",73,1,1,0,79,16,20,1,0,191,2,6,199,225,0.414,0.884
"22117","Santa Cruz","Santa Cruz de La Sierra","Colegio Villa Gladys Theveneth",82,0,0,1,76,23,12,0,0,194,1,7,202,229,0.392,0.882
"22118","Santa Cruz","Santa Cruz de La Sierra","Colegio Villa Gladys Theveneth",49,2,1,0,121,12,14,2,1,202,1,4,207,228,0.599,0.908
"22119","Santa Cruz","Santa Cruz de La Sierra","Colegio Villa Gladys Theveneth",62,1,0,0,87,21,23,0,1,195,4,5,204,230,0.446,0.887
"22120","Santa Cruz","Santa Cruz de La Sierra","Colegio Villa Gladys Theveneth",41,2,0,2,120,14,18,1,0,198,1,5,204,227,0.606,0.899
"22121","Santa Cruz","Santa Cruz de La Sierra","Colegio Villa Gladys Theveneth",57,0,2,1,112,12,19,0,1,204,1,5,210,234,0.549,0.897
"22122","Santa Cruz","Santa Cruz de La Sierra","Colegio Villa Gladys Theveneth",71,1,1,0,77,11,18,4,0,183,4,4,191,227,0.421,0.841
"22123","Santa Cruz","Santa Cruz de La Sierra","Colegio Villa Gladys Theveneth",55,2,0,0,95,20,18,2,1,193,0,11,204,226,0.492,0.903
"22124","Santa Cruz","Santa Cruz de La Sierra","Colegio Villa Gladys Theveneth",61,0,1,0,106,15,14,0,1,198,1,7,206,228,0.535,0.904
"22125","Santa Cruz","Santa Cruz de La Sierra","Colegio Villa Gladys Theveneth",63,0,2,0,98,22,19,1,0,205,0,7,212,229,0.478,0.926
"22126","Santa Cruz","Santa Cruz de La Sierra","Colegio Villa Gladys Theveneth",58,0,3,1,97,12,11,2,0,184,5,4,193,226,0.527,0.854
"22127","Santa Cruz","Santa Cruz de La Sierra","Colegio Villa Gladys Theveneth",58,1,2,1,109,10,22,0,1,204,0,7,211,229,0.534,0.921
"22128","Santa Cruz","Santa Cruz de La Sierra","Colegio Villa Gladys Theveneth",44,0,0,0,119,13,22,2,1,201,3,6,210,233,0.592,0.901
"22129","Santa Cruz","Santa Cruz de La Sierra","Colegio Villa Gladys Theveneth",70,4,0,0,71,27,16,3,0,191,2,4,197,229,0.372,0.86
"22130","Santa Cruz","Santa Cruz de La Sierra","Colegio Villa Gladys Theveneth",74,1,1,1,83,23,16,1,1,201,1,3,205,231,0.413,0.887
"22131","Santa Cruz","Santa Cruz de La Sierra","Colegio Villa Gladys Theveneth",56,2,1,1,86,21,21,3,0,191,1,10,202,222,0.45,0.91
"22132","Santa Cruz","Santa Cruz de La Sierra","Colegio Villa Gladys Theveneth",80,0,0,0,63,29,29,3,0,204,1,2,207,231,0.309,0.896
"22133","Santa Cruz","Santa Cruz de La Sierra","Colegio Villa Gladys Theveneth",38,1,4,0,115,10,21,3,0,192,1,6,199,227,0.599,0.877
"22134","Santa Cruz","Santa Cruz de La Sierra","Colegio Villa Gladys Theveneth",68,0,0,3,90,14,17,0,1,193,0,8,201,228,0.466,0.882
"22135","Santa Cruz","Santa Cruz de La Sierra","Colegio Villa Gladys Theveneth",70,1,0,2,76,28,21,3,1,202,1,3,206,230,0.376,0.896
"22136","Santa Cruz","Santa Cruz de La Sierra","Colegio Villa Gladys Theveneth",65,0,0,0,77,26,23,1,3,195,1,7,203,229,0.395,0.886
"22137","Santa Cruz","Santa Cruz de La Sierra","Colegio Villa Gladys Theveneth",64,2,2,0,90,21,16,1,2,198,0,6,204,228,0.455,0.895
"22138","Santa Cruz","Santa Cruz de La Sierra","Colegio Villa Gladys Theveneth",62,0,0,0,86,24,22,1,0,195,2,6,203,232,0.441,0.875
"22139","Santa Cruz","Santa Cruz de La Sierra","Colegio Villa Gladys Theveneth",64,1,0,0,105,8,24,0,1,203,0,2,205,231,0.517,0.887
"22140","Santa Cruz","Santa Cruz de La Sierra","Col. 12 de Diciembre",96,0,0,1,72,21,9,3,0,202,1,6,209,230,0.356,0.909
"22141","Santa Cruz","Santa Cruz de La Sierra","Col. 12 de Diciembre",86,0,1,0,56,24,19,4,0,190,2,4,196,230,0.295,0.852
"22142","Santa Cruz","Santa Cruz de La Sierra","Col. 12 de Diciembre",101,2,1,2,47,18,18,1,0,190,2,12,204,231,0.247,0.883
"22143","Santa Cruz","Santa Cruz de La Sierra","Col. 12 de Diciembre",90,1,0,1,63,22,18,2,0,197,0,8,205,231,0.32,0.887
"22144","Santa Cruz","Santa Cruz de La Sierra","Col. 12 de Diciembre",104,1,0,0,53,18,20,1,0,197,2,12,211,232,0.269,0.909
"22145","Santa Cruz","Santa Cruz de La Sierra","Col. 12 de Diciembre",85,0,1,0,82,15,19,1,1,204,3,2,209,226,0.402,0.925
"22146","Santa Cruz","Santa Cruz de La Sierra","Col. 12 de Diciembre",91,0,0,0,54,25,8,1,1,180,2,13,195,227,0.3,0.859
"22147","Santa Cruz","Santa Cruz de La Sierra","Col. 12 de Diciembre",60,0,1,0,94,12,19,0,1,187,2,8,197,227,0.503,0.868
"22148","Santa Cruz","Santa Cruz de La Sierra","Col. 12 de Diciembre",88,0,0,0,84,16,11,1,2,202,0,8,210,226,0.416,0.929
"22149","Santa Cruz","Santa Cruz de La Sierra","Col. 12 de Diciembre",91,1,0,0,72,22,22,1,0,209,0,2,211,232,0.344,0.909
"22150","Santa Cruz","Santa Cruz de La Sierra","Col. 12 de Diciembre",98,0,0,0,49,23,13,1,2,186,0,2,188,219,0.263,0.858
"22151","Santa Cruz","Santa Cruz de La Sierra","Col. 12 de Diciembre",95,0,0,0,67,13,21,3,0,199,0,7,206,232,0.337,0.888
"22152","Santa Cruz","Santa Cruz de La Sierra","Col. 12 de Diciembre",102,0,1,1,64,17,17,1,0,203,0,3,206,233,0.315,0.884
"22153","Santa Cruz","Santa Cruz de La Sierra","Col. 12 de Diciembre",78,0,0,0,77,19,27,0,0,201,1,6,208,231,0.383,0.9
"22154","Santa Cruz","Santa Cruz de La Sierra","Col. 12 de Diciembre",85,3,0,1,76,25,17,2,1,210,1,6,217,236,0.362,0.919
"22155","Santa Cruz","Santa Cruz de La Sierra","Col. 12 de Diciembre",68,1,1,2,80,14,21,1,0,188,0,9,197,232,0.426,0.849
"22156","Santa Cruz","Santa Cruz de La Sierra","Col. 12 de Diciembre",94,0,0,0,47,24,11,2,0,178,2,44,224,224,0.264,1
"22157","Santa Cruz","Santa Cruz de La Sierra","Col. 12 de Diciembre",87,0,0,1,68,25,13,3,1,198,1,5,204,229,0.343,0.891
"22158","Santa Cruz","Santa Cruz de La Sierra","Col. 12 de Diciembre",60,0,0,0,103,12,15,1,2,193,2,2,197,224,0.534,0.879
"22159","Santa Cruz","Santa Cruz de La Sierra","Col. 12 de Diciembre",95,1,0,0,58,18,14,3,0,189,0,6,195,224,0.307,0.871
"22160","Santa Cruz","Santa Cruz de La Sierra","Col. 12 de Diciembre",112,1,0,1,49,23,7,4,1,198,2,6,206,231,0.247,0.892
"22161","Santa Cruz","Santa Cruz de La Sierra","Col. 12 de Diciembre",97,0,0,0,69,21,10,2,1,200,0,6,206,226,0.345,0.912
"22162","Santa Cruz","Santa Cruz de La Sierra","Col. 12 de Diciembre",82,0,0,4,54,24,20,0,2,186,2,6,194,226,0.29,0.858
"22163","Santa Cruz","Santa Cruz de La Sierra","Col. 12 de Diciembre",89,1,1,0,76,14,14,0,0,195,1,4,200,228,0.39,0.877
"22164","Santa Cruz","Santa Cruz de La Sierra","Col. 12 de Diciembre",119,1,0,2,43,19,5,1,1,191,1,7,199,228,0.225,0.873
"22165","Santa Cruz","Santa Cruz de La Sierra","Col. 12 de Diciembre",110,1,1,0,51,21,10,1,0,195,1,6,202,227,0.262,0.89
"22166","Santa Cruz","Santa Cruz de La Sierra","Col. 12 de Diciembre",66,1,0,1,90,12,13,1,1,185,2,7,194,222,0.486,0.874
"22167","Santa Cruz","Santa Cruz de La Sierra","Col. 12 de Diciembre",87,0,1,1,68,18,16,1,0,192,2,6,200,225,0.354,0.889
"22168","Santa Cruz","Santa Cruz de La Sierra","Col. 12 de Diciembre",98,0,0,0,57,23,13,1,0,192,1,3,196,224,0.297,0.875
"22169","Santa Cruz","Santa Cruz de La Sierra","Col. 12 de Diciembre",95,2,0,0,60,19,12,2,0,190,3,11,204,231,0.316,0.883
"22170","Santa Cruz","Santa Cruz de La Sierra","Col. 12 de Diciembre",105,0,1,0,42,25,22,2,0,197,2,3,202,226,0.213,0.894
"22171","Santa Cruz","Santa Cruz de La Sierra","Col. 12 de Diciembre",93,1,0,0,68,24,10,0,0,196,1,5,202,231,0.347,0.874
"22172","Santa Cruz","Santa Cruz de La Sierra","Col. 12 de Diciembre",94,5,1,0,56,26,13,0,1,196,1,2,199,223,0.286,0.892
"22173","Santa Cruz","Santa Cruz de La Sierra","Col. 12 de Diciembre",97,0,0,0,52,30,13,0,2,194,1,5,200,235,0.268,0.851
"22174","Santa Cruz","Santa Cruz de La Sierra","Col. 12 de Diciembre",89,1,1,2,68,16,14,0,0,191,1,6,198,225,0.356,0.88
"22175","Santa Cruz","Santa Cruz de La Sierra","Col. 12 de Diciembre",97,0,1,0,59,19,15,4,2,197,2,5,204,223,0.299,0.915
"22176","Santa Cruz","Santa Cruz de La Sierra","Col. 12 de Diciembre",94,2,1,1,67,12,14,1,1,193,0,7,200,227,0.347,0.881
"22177","Santa Cruz","Santa Cruz de La Sierra","Col. 12 de Diciembre",94,0,2,1,63,20,17,1,1,199,1,6,206,233,0.317,0.884
"22178","Santa Cruz","Santa Cruz de La Sierra","Col. 12 de Diciembre",61,0,1,2,54,19,16,0,0,153,1,2,156,177,0.353,0.881
"22179","Santa Cruz","Santa Cruz de La Sierra","Col. Centro Interno Bol. Aleman",75,0,3,0,71,10,21,0,0,180,3,11,194,219,0.394,0.886
"22180","Santa Cruz","Santa Cruz de La Sierra","Col. Centro Interno Bol. Aleman",61,0,0,0,90,23,12,3,1,190,1,9,200,228,0.474,0.877
"22181","Santa Cruz","Santa Cruz de La Sierra","Col. Centro Interno Bol. Aleman",68,2,0,1,82,19,12,0,3,187,3,3,193,219,0.439,0.881
"22182","Santa Cruz","Santa Cruz de La Sierra","Col. Centro Interno Bol. Aleman",66,1,0,0,83,18,15,3,2,188,1,6,195,224,0.441,0.871
"22183","Santa Cruz","Santa Cruz de La Sierra","Col. Centro Interno Bol. Aleman",69,1,1,1,85,14,14,1,2,188,2,5,195,217,0.452,0.899
"22184","Santa Cruz","Santa Cruz de La Sierra","Col. Centro Interno Bol. Aleman",63,0,0,0,96,24,14,1,0,198,0,5,203,232,0.485,0.875
"22185","Santa Cruz","Santa Cruz de La Sierra","Col. Centro Interno Bol. Aleman",48,0,2,1,125,16,12,2,0,206,3,3,212,228,0.607,0.93
"22186","Santa Cruz","Santa Cruz de La Sierra","Col. Centro Interno Bol. Aleman",36,0,0,0,112,6,25,1,3,183,0,6,189,217,0.612,0.871
"22187","Santa Cruz","Santa Cruz de La Sierra","Col. Centro Interno Bol. Aleman",80,0,1,1,67,20,19,3,1,192,0,2,194,221,0.349,0.878
"22188","Santa Cruz","Santa Cruz de La Sierra","Col. Centro Interno Bol. Aleman",84,1,1,1,65,16,15,5,2,190,3,6,199,227,0.342,0.877
"22189","Santa Cruz","Santa Cruz de La Sierra","Col. Centro Interno Bol. Aleman",57,1,0,0,94,13,16,1,1,183,2,7,192,223,0.514,0.861
"22190","Santa Cruz","Santa Cruz de La Sierra","Col. Centro Interno Bol. Aleman",67,2,0,1,77,23,13,1,2,186,0,5,191,227,0.414,0.841
"22191","Santa Cruz","Santa Cruz de La Sierra","Col. Centro Interno Bol. Aleman",71,0,1,0,83,20,12,0,2,189,3,3,195,227,0.439,0.859
"22192","Santa Cruz","Santa Cruz de La Sierra","Col. Centro Interno Bol. Aleman",55,2,0,0,108,10,14,4,1,194,2,6,202,229,0.557,0.882
"22193","Santa Cruz","Santa Cruz de La Sierra","Col. Centro Interno Bol. Aleman",98,2,0,0,56,27,8,3,1,195,1,3,199,219,0.287,0.909
"22194","Santa Cruz","Santa Cruz de La Sierra","Col. Centro Interno Bol. Aleman",74,0,0,0,85,8,16,1,0,184,1,4,189,226,0.462,0.836
"22195","Santa Cruz","Santa Cruz de La Sierra","Col. Centro Interno Bol. Aleman",37,1,2,0,127,5,19,1,3,195,3,1,199,231,0.651,0.861
"22196","Santa Cruz","Santa Cruz de La Sierra","Col. Centro Interno Bol. Aleman",61,0,2,1,84,20,13,1,0,182,3,5,190,223,0.462,0.852
"22197","Santa Cruz","Santa Cruz de La Sierra","Col. Centro Interno Bol. Aleman",77,0,0,0,73,23,15,2,0,190,0,10,200,221,0.384,0.905
"22198","Santa Cruz","Santa Cruz de La Sierra","Col. Centro Interno Bol. Aleman",48,0,1,1,97,12,17,0,2,178,0,9,187,224,0.545,0.835
"22199","Santa Cruz","Santa Cruz de La Sierra","Col. Centro Interno Bol. Aleman",70,0,1,0,65,21,17,2,1,177,1,10,188,220,0.367,0.855
"22200","Santa Cruz","Santa Cruz de La Sierra","Col. Centro Interno Bol. Aleman",88,2,2,1,63,17,15,0,1,189,0,5,194,226,0.333,0.858
"22201","Santa Cruz","Santa Cruz de La Sierra","Col. Centro Interno Bol. Aleman",60,0,1,0,77,17,24,1,1,181,1,11,193,222,0.425,0.869
"22202","Santa Cruz","Santa Cruz de La Sierra","Col. Centro Interno Bol. Aleman",52,0,0,0,108,8,15,3,0,186,1,5,192,221,0.581,0.869
"22203","Santa Cruz","Santa Cruz de La Sierra","Col. Centro Interno Bol. Aleman",81,0,1,1,75,18,15,1,0,192,0,6,198,226,0.391,0.876
"22204","Santa Cruz","Santa Cruz de La Sierra","Col. Centro Interno Bol. Aleman",69,0,1,0,88,16,16,1,0,191,4,3,198,223,0.461,0.888
"22205","Santa Cruz","Santa Cruz de La Sierra","Col. Centro Interno Bol. Aleman",80,0,0,2,80,17,14,0,1,194,0,5,199,225,0.412,0.884
"22206","Santa Cruz","Santa Cruz de La Sierra","Col. Centro Interno Bol. Aleman",74,0,1,1,79,27,11,2,1,196,2,1,199,226,0.403,0.881
"22207","Santa Cruz","Santa Cruz de La Sierra","Col. Centro Interno Bol. Aleman",58,0,0,0,94,16,11,2,1,182,0,7,189,222,0.516,0.851
"22208","Santa Cruz","Santa Cruz de La Sierra","Col. Centro Interno Bol. Aleman",87,3,1,0,63,24,9,1,0,188,2,6,196,227,0.335,0.863
"22209","Santa Cruz","Santa Cruz de La Sierra","Col. Centro Interno Bol. Aleman",69,0,0,0,86,21,15,2,1,194,0,7,201,226,0.443,0.889
"22210","Santa Cruz","Santa Cruz de La Sierra","Col. Centro Interno Bol. Aleman",81,0,1,0,81,13,23,2,1,202,3,3,208,226,0.401,0.92
"22211","Santa Cruz","Santa Cruz de La Sierra","U.E. 3 de Mayo",66,1,0,0,98,27,15,2,1,210,2,2,214,233,0.467,0.918
"22212","Santa Cruz","Santa Cruz de La Sierra","U.E. 3 de Mayo",60,0,0,0,106,20,18,0,3,207,0,7,214,234,0.512,0.915
"22213","Santa Cruz","Santa Cruz de La Sierra","U.E. 3 de Mayo",60,0,1,0,98,17,28,0,2,206,1,4,211,234,0.476,0.902
"22214","Santa Cruz","Santa Cruz de La Sierra","U.E. 3 de Mayo",74,0,0,0,80,25,22,1,1,203,1,8,212,237,0.394,0.895
"22215","Santa Cruz","Santa Cruz de La Sierra","U.E. 3 de Mayo",59,0,0,0,112,22,19,0,0,212,1,3,216,240,0.528,0.9
"22216","Santa Cruz","Santa Cruz de La Sierra","U.E. 3 de Mayo",72,1,0,0,89,18,17,0,2,199,2,6,207,238,0.447,0.87
"22217","Santa Cruz","Santa Cruz de La Sierra","U.E. 3 de Mayo",73,1,0,0,85,22,27,4,0,212,2,5,219,238,0.401,0.92
"22218","Santa Cruz","Santa Cruz de La Sierra","U.E. 3 de Mayo",78,2,0,0,83,25,17,0,1,206,1,8,215,238,0.403,0.903
"22219","Santa Cruz","Santa Cruz de La Sierra","Col. Fe y Alegria Nueva America",84,3,0,0,75,13,10,1,0,186,1,4,191,220,0.403,0.868
"22220","Santa Cruz","Santa Cruz de La Sierra","Col. Fe y Alegria Nueva America",76,0,0,0,78,16,16,0,2,188,0,7,195,224,0.415,0.871
"22221","Santa Cruz","Santa Cruz de La Sierra","Col. Fe y Alegria Nueva America",93,1,0,0,71,11,10,2,0,188,2,6,196,226,0.378,0.867
"22222","Santa Cruz","Santa Cruz de La Sierra","Col. Fe y Alegria Nueva America",76,0,1,0,89,11,9,3,0,189,2,2,193,225,0.471,0.858
"22223","Santa Cruz","Santa Cruz de La Sierra","Col. Fe y Alegria Nueva America",68,0,1,0,96,11,19,3,1,199,3,4,206,227,0.482,0.907
"22224","Santa Cruz","Santa Cruz de La Sierra","Col. Fe y Alegria Nueva America",88,0,1,1,65,17,12,1,1,186,1,4,191,221,0.349,0.864
"22225","Santa Cruz","Santa Cruz de La Sierra","Col. Fe y Alegria Nueva America",71,0,3,2,91,14,12,1,1,195,1,3,199,223,0.467,0.892
"22226","Santa Cruz","Santa Cruz de La Sierra","Col. Fe y Alegria Nueva America",36,1,1,2,76,41,0,6,0,163,33,3,199,222,0.466,0.896
"22227","Santa Cruz","Santa Cruz de La Sierra","Col. Fe y Alegria Nueva America",62,1,1,1,97,9,12,1,0,184,1,1,186,226,0.527,0.823
"22228","Santa Cruz","Santa Cruz de La Sierra","Col. Fe y Alegria Nueva America",86,0,0,1,53,17,15,2,0,174,1,5,180,227,0.305,0.793
"22229","Santa Cruz","Santa Cruz de La Sierra","Col. Fe y Alegria Nueva America",66,3,0,0,96,9,10,4,0,188,1,3,192,227,0.511,0.846
"22230","Santa Cruz","Santa Cruz de La Sierra","Col. Fe y Alegria Nueva America",82,0,1,0,82,13,8,0,2,188,2,4,194,228,0.436,0.851
"22231","Santa Cruz","Santa Cruz de La Sierra","Col. Fe y Alegria Nueva America",82,1,0,0,77,9,17,1,2,189,27,2,218,219,0.407,0.995
"22232","Santa Cruz","Santa Cruz de La Sierra","Col. Fe y Alegria Nueva America",81,4,0,0,79,13,17,1,0,195,0,7,202,224,0.405,0.902
"22233","Santa Cruz","Santa Cruz de La Sierra","Col. Fe y Alegria Nueva America",86,0,0,1,74,14,15,4,0,194,2,13,209,234,0.381,0.893
"22234","Santa Cruz","Santa Cruz de La Sierra","Col. Fe y Alegria Nueva America",80,0,0,0,70,19,21,0,1,191,4,0,195,221,0.366,0.882
"22235","Santa Cruz","Santa Cruz de La Sierra","Col. Fe y Alegria Nueva America",65,1,1,0,99,12,17,0,2,197,1,3,201,228,0.503,0.882
"22236","Santa Cruz","Santa Cruz de La Sierra","Col. Fe y Alegria Nueva America",52,0,0,1,98,7,18,2,3,181,0,4,185,227,0.541,0.815
"22237","Santa Cruz","Santa Cruz de La Sierra","Col. Fe y Alegria Nueva America",101,0,1,1,51,26,9,0,1,190,1,5,196,228,0.268,0.86
"22238","Santa Cruz","Santa Cruz de La Sierra","Col. Fe y Alegria Nueva America",84,0,1,0,71,13,17,2,0,188,0,8,196,223,0.378,0.879
"22239","Santa Cruz","Santa Cruz de La Sierra","Col. Fe y Alegria Nueva America",65,0,0,0,71,22,13,4,2,177,7,5,189,223,0.401,0.848
"22240","Santa Cruz","Santa Cruz de La Sierra","Col. Fe y Alegria Nueva America",79,0,1,1,65,23,15,1,2,187,2,2,191,225,0.348,0.849
"22241","Santa Cruz","Santa Cruz de La Sierra","Col. Fe y Alegria Nueva America",84,0,0,1,57,28,10,0,0,180,1,12,193,223,0.317,0.865
"22242","Santa Cruz","Santa Cruz de La Sierra","Col. Fe y Alegria Nueva America",52,1,1,2,100,15,11,3,2,187,1,4,192,216,0.535,0.889
"22243","Santa Cruz","Santa Cruz de La Sierra","Col. Fe y Alegria Nueva America",70,1,1,0,62,28,27,4,1,194,0,6,200,224,0.32,0.893
"22244","Santa Cruz","Santa Cruz de La Sierra","Col. Fe y Alegria Nueva America",96,0,1,1,61,17,7,0,1,184,1,7,192,223,0.332,0.861
"22245","Santa Cruz","Santa Cruz de La Sierra","Col. Fe y Alegria Nueva America",108,0,0,0,49,12,20,1,1,191,2,4,197,222,0.257,0.887
"22246","Santa Cruz","Santa Cruz de La Sierra","Col. Fe y Alegria Nueva America",92,0,0,2,61,16,16,0,2,189,1,5,195,226,0.323,0.863
"22247","Santa Cruz","Santa Cruz de La Sierra","Col. Fe y Alegria Nueva America",92,0,1,0,58,19,8,2,3,183,1,7,191,224,0.317,0.853
"22248","Santa Cruz","Santa Cruz de La Sierra","Col. Fe y Alegria Nueva America",86,0,1,1,84,5,12,0,2,191,0,5,196,222,0.44,0.883
"22249","Santa Cruz","Santa Cruz de La Sierra","Col. Fe y Alegria Nueva America",97,0,0,2,47,27,13,3,1,190,0,8,198,223,0.247,0.888
"22250","Santa Cruz","Santa Cruz de La Sierra","Col. Fe y Alegria Nueva America",72,0,0,2,79,18,13,4,3,191,2,7,200,227,0.414,0.881
"22251","Santa Cruz","Santa Cruz de La Sierra","Col. Fe y Alegria Nueva America",64,0,0,0,80,16,14,2,5,181,6,3,190,225,0.442,0.844
"22252","Santa Cruz","Santa Cruz de La Sierra","U. E. Santa Claudina Thevenet",78,0,0,1,92,19,18,4,0,212,3,12,227,239,0.434,0.95
"22253","Santa Cruz","Santa Cruz de La Sierra","U. E. Santa Claudina Thevenet",78,0,0,1,94,22,23,4,1,223,3,4,230,239,0.422,0.962
"22254","Santa Cruz","Santa Cruz de La Sierra","U. E. Santa Claudina Thevenet",84,1,0,0,78,25,28,0,2,218,1,10,229,240,0.358,0.954
"22255","Santa Cruz","Santa Cruz de La Sierra","U. E. Santa Claudina Thevenet",87,0,0,2,86,27,13,2,0,217,2,10,229,237,0.396,0.966
"22256","Santa Cruz","Santa Cruz de La Sierra","U. E. Santa Claudina Thevenet",84,0,0,0,54,15,18,2,0,173,0,8,181,189,0.312,0.958
"22257","Santa Cruz","Santa Cruz de La Sierra","Col. Buenas Nuevas",89,0,1,2,68,14,21,2,0,197,0,3,200,224,0.345,0.893
"22258","Santa Cruz","Santa Cruz de La Sierra","Col. Buenas Nuevas",86,2,1,0,64,16,21,2,0,192,4,13,209,226,0.333,0.925
"22259","Santa Cruz","Santa Cruz de La Sierra","Col. Buenas Nuevas",105,0,1,1,64,12,19,1,0,203,0,7,210,231,0.315,0.909
"22260","Santa Cruz","Santa Cruz de La Sierra","Col. Buenas Nuevas",97,1,0,4,68,15,10,1,0,196,3,6,205,230,0.347,0.891
"22261","Santa Cruz","Santa Cruz de La Sierra","Col. Buenas Nuevas",95,0,4,0,72,17,24,1,2,215,1,4,220,234,0.335,0.94
"22262","Santa Cruz","Santa Cruz de La Sierra","Col. Buenas Nuevas",94,0,0,2,63,20,17,4,0,200,0,3,203,231,0.315,0.879
"22263","Santa Cruz","Santa Cruz de La Sierra","Col. Buenas Nuevas",78,1,0,1,54,18,13,0,1,166,0,44,210,232,0.325,0.905
"22264","Santa Cruz","Santa Cruz de La Sierra","Col. Buenas Nuevas",82,0,0,2,65,16,17,4,1,187,1,7,195,224,0.348,0.871
"22265","Santa Cruz","Santa Cruz de La Sierra","Col. Buenas Nuevas",94,0,0,0,70,11,18,2,1,196,2,15,213,232,0.357,0.918
"22266","Santa Cruz","Santa Cruz de La Sierra","Col. Buenas Nuevas",122,0,0,1,33,22,7,2,0,187,2,13,202,232,0.176,0.871
"22267","Santa Cruz","Santa Cruz de La Sierra","Col. Buenas Nuevas",84,0,0,1,62,21,26,2,1,197,0,8,205,233,0.315,0.88
"22268","Santa Cruz","Santa Cruz de La Sierra","Col. Buenas Nuevas",100,0,3,0,71,20,15,0,1,210,0,2,212,232,0.338,0.914
"22269","Santa Cruz","Santa Cruz de La Sierra","Col. Buenas Nuevas",97,0,0,1,70,19,16,0,0,203,0,5,208,231,0.345,0.9
"22270","Santa Cruz","Santa Cruz de La Sierra","Col. Buenas Nuevas",101,0,0,0,47,21,23,2,0,194,2,7,203,228,0.242,0.89
"22271","Santa Cruz","Santa Cruz de La Sierra","Col. Buenas Nuevas",88,0,0,2,69,22,17,3,1,202,1,9,212,227,0.342,0.934
"22272","Santa Cruz","Santa Cruz de La Sierra","Col. Buenas Nuevas",103,0,0,0,55,23,12,0,1,194,0,8,202,230,0.284,0.878
"22273","Santa Cruz","Santa Cruz de La Sierra","Col. Buenas Nuevas",81,0,1,0,65,18,18,3,0,186,1,4,191,229,0.349,0.834
"22274","Santa Cruz","Santa Cruz de La Sierra","Col. Buenas Nuevas",64,0,1,1,91,19,22,2,1,201,0,6,207,228,0.453,0.908
"22275","Santa Cruz","Santa Cruz de La Sierra","Col. Buenas Nuevas",103,1,3,0,50,19,17,1,0,194,1,5,200,223,0.258,0.897
"22276","Santa Cruz","Santa Cruz de La Sierra","Col. Buenas Nuevas",108,1,0,0,68,20,13,0,1,211,0,3,214,229,0.322,0.934
"22277","Santa Cruz","Santa Cruz de La Sierra","Col. Buenas Nuevas",108,0,1,0,63,16,17,0,1,206,0,7,213,231,0.306,0.922
"22278","Santa Cruz","Santa Cruz de La Sierra","Col. Buenas Nuevas",85,0,1,0,75,14,18,2,0,195,1,3,199,231,0.385,0.861
"22279","Santa Cruz","Santa Cruz de La Sierra","Col. Buenas Nuevas",113,4,1,0,45,27,11,1,0,202,0,5,207,227,0.223,0.912
"22280","Santa Cruz","Santa Cruz de La Sierra","Col. Buenas Nuevas",107,0,1,4,54,20,17,1,1,205,2,4,211,233,0.263,0.906
"22281","Santa Cruz","Santa Cruz de La Sierra","Col. Buenas Nuevas",72,1,2,0,83,16,25,1,1,201,0,9,210,233,0.413,0.901
"22282","Santa Cruz","Santa Cruz de La Sierra","Col. Buenas Nuevas",95,1,0,2,61,18,20,1,1,199,1,9,209,234,0.307,0.893
"22283","Santa Cruz","Santa Cruz de La Sierra","Col. Buenas Nuevas",103,1,0,0,56,21,20,2,1,204,0,2,206,226,0.275,0.912
"22284","Santa Cruz","Santa Cruz de La Sierra","Col. Buenas Nuevas",103,0,2,3,51,16,15,2,0,192,2,8,202,225,0.266,0.898
"22285","Santa Cruz","Santa Cruz de La Sierra","Col. Buenas Nuevas",110,0,1,4,54,15,16,1,0,201,4,3,208,228,0.269,0.912
"22286","Santa Cruz","Santa Cruz de La Sierra","Col. Buenas Nuevas",116,1,0,1,44,15,21,1,0,199,1,4,204,227,0.221,0.899
"22287","Santa Cruz","Santa Cruz de La Sierra","Col. Buenas Nuevas",103,0,0,1,66,14,17,1,2,204,2,2,208,229,0.324,0.908
"22288","Santa Cruz","Santa Cruz de La Sierra","Col. Buenas Nuevas",128,0,1,0,31,22,10,1,3,196,2,6,204,227,0.158,0.899
"22289","Santa Cruz","Santa Cruz de La Sierra","Col. Buenas Nuevas",100,0,1,0,61,21,19,0,0,202,2,10,214,232,0.302,0.922
"22290","Santa Cruz","Santa Cruz de La Sierra","Col. Buenas Nuevas",95,1,0,3,75,16,6,2,1,199,2,12,213,231,0.377,0.922
"22291","Santa Cruz","Santa Cruz de La Sierra","Col. Buenas Nuevas",77,0,1,0,51,20,11,1,1,162,0,4,166,183,0.315,0.907
"22292","Santa Cruz","Santa Cruz de La Sierra","Col. Primavera",60,0,0,0,101,25,21,0,1,208,1,4,213,230,0.486,0.926
"22293","Santa Cruz","Santa Cruz de La Sierra","Col. Primavera",63,1,1,1,75,24,13,5,0,183,3,14,200,228,0.41,0.877
"22294","Santa Cruz","Santa Cruz de La Sierra","Col. Primavera",80,1,1,1,83,16,15,1,0,198,2,8,208,224,0.419,0.929
"22295","Santa Cruz","Santa Cruz de La Sierra","Col. Primavera",59,1,0,1,98,10,16,5,3,193,3,6,202,227,0.508,0.89
"22296","Santa Cruz","Santa Cruz de La Sierra","Col. Primavera",66,1,1,1,79,23,12,4,1,188,3,10,201,230,0.42,0.874
"22297","Santa Cruz","Santa Cruz de La Sierra","Col. Primavera",70,0,0,1,89,17,12,6,0,195,2,8,205,234,0.456,0.876
"22298","Santa Cruz","Santa Cruz de La Sierra","Col. Primavera",45,1,0,0,107,14,28,4,1,200,0,5,205,228,0.535,0.899
"22299","Santa Cruz","Santa Cruz de La Sierra","Col. Primavera",65,0,1,0,103,12,20,1,2,204,3,5,212,232,0.505,0.914
"22300","Santa Cruz","Santa Cruz de La Sierra","Col. Primavera",72,1,0,1,80,34,11,3,1,203,2,9,214,232,0.394,0.922
"22301","Santa Cruz","Santa Cruz de La Sierra","Col. Primavera",68,1,0,1,90,18,19,2,2,201,3,7,211,229,0.448,0.921
"22302","Santa Cruz","Santa Cruz de La Sierra","Col. Primavera",53,0,0,3,103,24,16,0,1,200,3,10,213,231,0.515,0.922
"22303","Santa Cruz","Santa Cruz de La Sierra","Col. Primavera",59,0,0,0,98,27,13,2,1,200,0,10,210,228,0.49,0.921
"22304","Santa Cruz","Santa Cruz de La Sierra","Col. Primavera",56,1,1,1,94,16,19,2,1,191,2,4,197,227,0.492,0.868
"22305","Santa Cruz","Santa Cruz de La Sierra","Col. Primavera",64,0,0,0,81,29,16,1,0,191,3,8,202,228,0.424,0.886
"22306","Santa Cruz","Santa Cruz de La Sierra","Col. Primavera",57,0,0,0,96,14,24,4,0,195,1,7,203,225,0.492,0.902
"22307","Santa Cruz","Santa Cruz de La Sierra","Col. Primavera",38,1,1,0,113,9,23,1,2,188,3,11,202,230,0.601,0.878
"22308","Santa Cruz","Santa Cruz de La Sierra","Col. Primavera",77,0,0,0,69,25,13,2,0,186,0,4,190,223,0.371,0.852
"22309","Santa Cruz","Santa Cruz de La Sierra","Col. Primavera",77,0,0,1,76,18,10,4,5,191,1,6,198,231,0.398,0.857
"22310","Santa Cruz","Santa Cruz de La Sierra","Col. Primavera",91,0,0,1,75,19,18,5,1,210,2,3,215,231,0.357,0.931
"22311","Santa Cruz","Santa Cruz de La Sierra","Col. Primavera",71,0,1,0,77,21,14,0,1,185,3,13,201,228,0.416,0.882
"22312","Santa Cruz","Santa Cruz de La Sierra","Col. Primavera",75,1,3,1,69,23,25,1,0,198,20,10,228,228,0.348,1
"22313","Santa Cruz","Santa Cruz de La Sierra","Col. Primavera",58,1,1,1,106,16,17,3,1,204,1,9,214,232,0.52,0.922
"22314","Santa Cruz","Santa Cruz de La Sierra","Col. Primavera",76,1,1,0,84,19,16,2,0,199,1,6,206,229,0.422,0.9
"22315","Santa Cruz","Santa Cruz de La Sierra","Col. Primavera",70,0,0,1,82,27,13,4,4,201,3,8,212,229,0.408,0.926
"22316","Santa Cruz","Santa Cruz de La Sierra","Col. Primavera",78,0,0,0,74,17,18,3,1,191,3,3,197,228,0.387,0.864
"22317","Santa Cruz","Santa Cruz de La Sierra","Col. Primavera",69,0,1,1,67,30,19,1,4,192,3,5,200,227,0.349,0.881
"22318","Santa Cruz","Santa Cruz de La Sierra","Col. Primavera",75,0,1,2,72,17,18,1,4,190,1,8,199,224,0.379,0.888
"22319","Santa Cruz","Santa Cruz de La Sierra","Col. Primavera",72,0,1,0,78,29,17,4,0,201,1,4,206,233,0.388,0.884
"22320","Santa Cruz","Santa Cruz de La Sierra","Col. Primavera",66,2,0,0,78,13,13,1,0,173,3,17,193,227,0.451,0.85
"22321","Santa Cruz","Santa Cruz de La Sierra","Col. Primavera",56,0,0,0,88,17,18,0,1,180,1,14,195,226,0.489,0.863
"22322","Santa Cruz","Santa Cruz de La Sierra","U.E. Victoria",55,1,1,1,103,15,24,0,1,201,2,6,209,233,0.512,0.897
"22323","Santa Cruz","Santa Cruz de La Sierra","U.E. Victoria",55,1,2,1,86,27,32,1,1,206,2,6,214,236,0.417,0.907
"22324","Santa Cruz","Santa Cruz de La Sierra","Colegio Cupeso De Los Reyes",69,2,0,0,87,21,18,2,0,199,0,4,203,231,0.437,0.879
"22325","Santa Cruz","Santa Cruz de La Sierra","Colegio Cupeso De Los Reyes",71,0,0,0,79,19,23,2,1,195,0,7,202,228,0.405,0.886
"22326","Santa Cruz","Santa Cruz de La Sierra","Colegio Cupeso De Los Reyes",54,0,2,2,99,15,18,0,1,191,1,16,208,227,0.518,0.916
"22327","Santa Cruz","Santa Cruz de La Sierra","Colegio Cupeso De Los Reyes",58,1,1,1,98,10,20,2,1,192,2,4,198,227,0.51,0.872
"22328","Santa Cruz","Santa Cruz de La Sierra","Colegio Cupeso De Los Reyes",48,0,2,0,115,7,21,0,0,193,1,7,201,229,0.596,0.878
"22329","Santa Cruz","Santa Cruz de La Sierra","Colegio Cupeso De Los Reyes",84,0,0,0,84,25,8,1,0,202,0,3,205,229,0.416,0.895
"22330","Santa Cruz","Santa Cruz de La Sierra","Colegio Cupeso De Los Reyes",53,1,0,0,106,18,15,4,0,197,5,4,206,228,0.538,0.904
"22331","Santa Cruz","Santa Cruz de La Sierra","Colegio Cupeso De Los Reyes",67,0,1,2,78,20,13,1,1,183,0,6,189,228,0.426,0.829
"22332","Santa Cruz","Santa Cruz de La Sierra","Colegio Cupeso De Los Reyes",66,0,0,0,107,9,15,1,0,198,0,6,204,226,0.54,0.903
"22333","Santa Cruz","Santa Cruz de La Sierra","Colegio Cupeso De Los Reyes",59,1,0,0,108,10,24,3,1,206,3,3,212,231,0.524,0.918
"22334","Santa Cruz","Santa Cruz de La Sierra","Colegio Cupeso De Los Reyes",50,0,1,0,118,13,19,0,2,203,0,3,206,229,0.581,0.9
"22335","Santa Cruz","Santa Cruz de La Sierra","Colegio Cupeso De Los Reyes",62,0,0,1,78,17,18,7,1,184,2,5,191,219,0.424,0.872
"22336","Santa Cruz","Santa Cruz de La Sierra","Colegio Cupeso De Los Reyes",60,0,1,1,95,15,14,1,1,188,1,5,194,221,0.505,0.878
"22337","Santa Cruz","Santa Cruz de La Sierra","Colegio Cupeso De Los Reyes",66,2,1,2,89,20,21,2,0,203,2,4,209,232,0.438,0.901
"22338","Santa Cruz","Santa Cruz de La Sierra","Colegio Cupeso De Los Reyes",51,0,0,1,117,15,11,3,0,198,1,6,205,226,0.591,0.907
"22339","Santa Cruz","Santa Cruz de La Sierra","Colegio Cupeso De Los Reyes",74,0,0,1,73,25,22,0,0,195,2,6,203,230,0.374,0.883
"22340","Santa Cruz","Santa Cruz de La Sierra","Colegio Cupeso De Los Reyes",48,1,2,0,69,37,0,13,0,170,31,4,205,229,0.406,0.895
"22341","Santa Cruz","Santa Cruz de La Sierra","Colegio Cupeso De Los Reyes",56,1,0,2,98,13,13,1,0,184,1,6,191,231,0.533,0.827
"22342","Santa Cruz","Santa Cruz de La Sierra","Colegio Cupeso De Los Reyes",65,0,1,2,110,12,15,1,1,207,2,6,215,227,0.531,0.947
"22343","Santa Cruz","Santa Cruz de La Sierra","Col. Maria Teresa Pulido",76,1,0,1,82,22,12,1,0,195,0,5,200,223,0.421,0.897
"22344","Santa Cruz","Santa Cruz de La Sierra","Col. Maria Teresa Pulido",101,1,2,0,65,17,10,1,0,197,1,5,203,227,0.33,0.894
"22345","Santa Cruz","Santa Cruz de La Sierra","Col. Maria Teresa Pulido",95,0,1,0,57,17,21,3,0,194,1,7,202,229,0.294,0.882
"22346","Santa Cruz","Santa Cruz de La Sierra","Col. Maria Teresa Pulido",82,1,0,1,59,22,22,0,1,188,0,5,193,223,0.314,0.865
"22347","Santa Cruz","Santa Cruz de La Sierra","Col. Maria Teresa Pulido",67,0,1,1,89,12,18,4,1,193,0,6,199,222,0.461,0.896
"22348","Santa Cruz","Santa Cruz de La Sierra","Col. Maria Teresa Pulido",79,2,2,1,69,20,16,0,3,192,0,1,193,228,0.359,0.846
"22349","Santa Cruz","Santa Cruz de La Sierra","Col. Maria Teresa Pulido",50,0,0,1,121,12,14,0,2,200,2,5,207,230,0.605,0.9
"22350","Santa Cruz","Santa Cruz de La Sierra","Col. Maria Teresa Pulido",82,0,0,0,67,11,20,1,0,181,0,9,190,221,0.37,0.86
"22351","Santa Cruz","Santa Cruz de La Sierra","Col. Maria Teresa Pulido",72,0,0,0,83,11,13,1,0,180,3,10,193,225,0.461,0.858
"22352","Santa Cruz","Santa Cruz de La Sierra","Col. Maria Teresa Pulido",78,0,0,1,90,14,14,1,1,199,0,31,230,230,0.452,1
"22353","Santa Cruz","Santa Cruz de La Sierra","Col. Maria Teresa Pulido",77,1,1,2,73,19,17,4,1,195,1,8,204,227,0.374,0.899
"22354","Santa Cruz","Santa Cruz de La Sierra","Col. Maria Teresa Pulido",82,0,0,0,90,9,9,3,2,195,0,4,199,229,0.462,0.869
"22355","Santa Cruz","Santa Cruz de La Sierra","Col. Maria Teresa Pulido",84,0,0,0,66,13,14,2,1,180,2,9,191,219,0.367,0.872
"22356","Santa Cruz","Santa Cruz de La Sierra","Col. Maria Teresa Pulido",61,1,1,0,91,11,26,3,2,196,3,1,200,227,0.464,0.881
"22357","Santa Cruz","Santa Cruz de La Sierra","Col. Maria Teresa Pulido",70,2,2,0,80,22,14,3,1,194,1,3,198,224,0.412,0.884
"22358","Santa Cruz","Santa Cruz de La Sierra","Col. Maria Teresa Pulido",78,2,0,1,66,25,9,1,0,182,2,4,188,228,0.363,0.825
"22359","Santa Cruz","Santa Cruz de La Sierra","Col. Maria Teresa Pulido",94,0,0,2,52,22,21,0,1,192,1,5,198,224,0.271,0.884
"22360","Santa Cruz","Santa Cruz de La Sierra","Col. Maria Teresa Pulido",83,0,2,0,65,19,13,0,1,183,0,5,188,221,0.355,0.851
"22361","Santa Cruz","Santa Cruz de La Sierra","Col. Maria Teresa Pulido",101,3,0,0,48,18,13,2,0,185,0,5,190,231,0.259,0.823
"22362","Santa Cruz","Santa Cruz de La Sierra","Col. Maria Teresa Pulido",64,2,0,0,97,10,22,0,2,197,3,4,204,234,0.492,0.872
"22363","Santa Cruz","Santa Cruz de La Sierra","Col. Maria Teresa Pulido",97,1,1,0,45,23,15,1,2,185,2,11,198,223,0.243,0.888
"22364","Santa Cruz","Santa Cruz de La Sierra","Col. Maria Teresa Pulido",89,1,2,1,63,20,12,2,0,190,2,3,195,223,0.332,0.874
"22365","Santa Cruz","Santa Cruz de La Sierra","Col. Maria Teresa Pulido",91,0,0,2,50,19,20,4,2,188,1,7,196,222,0.266,0.883
"22366","Santa Cruz","Santa Cruz de La Sierra","Col. Maria Teresa Pulido",101,0,0,0,65,15,8,0,0,189,1,4,194,230,0.344,0.843
"22367","Santa Cruz","Santa Cruz de La Sierra","Col. Maria Teresa Pulido",81,0,0,1,64,16,20,4,1,187,0,4,191,226,0.342,0.845
"22368","Santa Cruz","Santa Cruz de La Sierra","Col. Maria Teresa Pulido",94,0,0,2,43,24,18,2,2,185,2,5,192,224,0.232,0.857
"22369","Santa Cruz","Santa Cruz de La Sierra","Col. Maria Teresa Pulido",76,0,1,0,76,17,13,1,3,187,9,8,204,227,0.406,0.899
"22370","Santa Cruz","Santa Cruz de La Sierra","U.E. Luis Antonio Añez Campos",71,0,3,0,100,13,13,0,2,202,3,4,209,239,0.495,0.874
"22371","Santa Cruz","Santa Cruz de La Sierra","U.E. Luis Antonio Añez Campos",58,0,1,1,109,16,18,0,1,204,3,6,213,236,0.534,0.903
"22372","Santa Cruz","Santa Cruz de La Sierra","U.E. Luis Antonio Añez Campos",63,1,1,0,118,7,20,0,0,210,5,3,218,236,0.562,0.924
"22373","Santa Cruz","Santa Cruz de La Sierra","U.E. Luis Antonio Añez Campos",53,1,2,1,105,14,30,0,1,207,1,5,213,238,0.507,0.895
"22374","Santa Cruz","Santa Cruz de La Sierra","U.E. Luis Antonio Añez Campos",48,0,1,0,102,25,25,2,1,204,3,5,212,235,0.5,0.902
"22375","Santa Cruz","Santa Cruz de La Sierra","U.E. Luis Antonio Añez Campos",75,0,0,1,83,21,21,1,0,202,2,5,209,238,0.411,0.878
"22376","Santa Cruz","Santa Cruz de La Sierra","Col. Esc. Virgen De Urkupina",43,1,2,1,118,14,14,2,2,197,0,5,202,224,0.599,0.902
"22377","Santa Cruz","Santa Cruz de La Sierra","Col. Esc. Virgen De Urkupina",64,0,2,0,105,8,10,1,0,190,1,6,197,225,0.553,0.876
"22378","Santa Cruz","Santa Cruz de La Sierra","Col. Esc. Virgen De Urkupina",53,0,0,4,96,17,15,2,2,189,1,6,196,232,0.508,0.845
"22379","Santa Cruz","Santa Cruz de La Sierra","Col. Esc. Virgen De Urkupina",48,0,1,0,110,19,13,1,0,192,1,6,199,224,0.573,0.888
"22380","Santa Cruz","Santa Cruz de La Sierra","Col. Esc. Virgen De Urkupina",51,0,0,0,99,21,18,0,1,190,0,4,194,229,0.521,0.847
"22381","Santa Cruz","Santa Cruz de La Sierra","Col. Esc. Virgen De Urkupina",45,0,2,1,117,12,18,2,0,197,1,4,202,230,0.594,0.878
"22382","Santa Cruz","Santa Cruz de La Sierra","Col. Esc. Virgen De Urkupina",59,1,0,4,93,19,22,0,1,199,3,7,209,231,0.467,0.905
"22383","Santa Cruz","Santa Cruz de La Sierra","Col. Esc. Virgen De Urkupina",33,0,0,1,128,8,31,2,1,204,1,4,209,227,0.627,0.921
"22384","Santa Cruz","Santa Cruz de La Sierra","Col. Esc. Virgen De Urkupina",29,0,0,3,131,16,12,0,1,192,3,5,200,224,0.682,0.893
"22385","Santa Cruz","Santa Cruz de La Sierra","Col. Esc. Virgen De Urkupina",61,1,0,1,93,17,14,2,1,190,2,11,203,232,0.489,0.875
"22386","Santa Cruz","Santa Cruz de La Sierra","Col. Esc. Virgen De Urkupina",40,0,0,0,122,12,17,1,0,192,1,6,199,226,0.635,0.881
"22387","Santa Cruz","Santa Cruz de La Sierra","Col. Esc. Virgen De Urkupina",51,0,1,1,110,8,16,0,3,190,2,9,201,228,0.579,0.882
"22388","Santa Cruz","Santa Cruz de La Sierra","Col. Esc. Virgen De Urkupina",50,0,1,1,105,8,15,4,1,185,2,9,196,223,0.568,0.879
"22389","Santa Cruz","Santa Cruz de La Sierra","Col. Esc. Virgen De Urkupina",52,0,1,1,97,16,21,2,0,190,5,4,199,230,0.511,0.865
"22390","Santa Cruz","Santa Cruz de La Sierra","Col. Esc. Virgen De Urkupina",33,0,0,1,131,8,18,2,2,195,1,3,199,228,0.672,0.873
"22391","Santa Cruz","Santa Cruz de La Sierra","Col. Esc. Virgen De Urkupina",57,0,2,0,97,15,12,3,0,186,0,6,192,222,0.522,0.865
"22392","Santa Cruz","Santa Cruz de La Sierra","Col. Esc. Virgen De Urkupina",53,0,2,2,111,7,16,2,0,193,1,6,200,228,0.575,0.877
"22393","Santa Cruz","Santa Cruz de La Sierra","Col. Esc. Virgen De Urkupina",34,1,0,0,129,10,27,2,0,203,2,3,208,231,0.635,0.9
"22394","Santa Cruz","Santa Cruz de La Sierra","Col. Esc. Virgen De Urkupina",32,1,0,1,113,9,24,1,5,186,2,2,190,223,0.608,0.852
"22395","Santa Cruz","Santa Cruz de La Sierra","Col. Esc. Virgen De Urkupina",63,0,0,1,92,16,15,1,2,190,2,5,197,226,0.484,0.872
"22396","Santa Cruz","Santa Cruz de La Sierra","Col. Esc. Virgen De Urkupina",59,2,1,1,92,11,18,1,1,186,0,16,202,221,0.495,0.914
"22397","Santa Cruz","Santa Cruz de La Sierra","Col. Esc. Virgen De Urkupina",62,0,0,0,98,16,17,1,1,195,3,4,202,225,0.503,0.898
"22398","Santa Cruz","Santa Cruz de La Sierra","Col. Esc. Virgen De Urkupina",53,0,2,1,104,10,12,3,1,186,2,7,195,230,0.559,0.848
"22399","Santa Cruz","Santa Cruz de La Sierra","Col. Esc. Virgen De Urkupina",79,1,0,0,78,23,13,2,1,197,1,4,202,224,0.396,0.902
"22400","Santa Cruz","Santa Cruz de La Sierra","Col. Esc. Virgen De Urkupina",38,1,2,0,120,8,21,1,2,193,1,5,199,226,0.622,0.881
"22401","Santa Cruz","Santa Cruz de La Sierra","Col. Esc. Virgen De Urkupina",36,1,2,3,142,7,16,0,4,211,1,1,213,234,0.673,0.91
"22402","Santa Cruz","Santa Cruz de La Sierra","Col. Esc. Virgen De Urkupina",57,0,1,0,93,24,15,0,2,192,2,4,198,230,0.484,0.861
"22403","Santa Cruz","Santa Cruz de La Sierra","Col. Esc. Virgen De Urkupina",48,1,1,0,94,11,18,2,1,176,3,15,194,228,0.534,0.851
"22404","Santa Cruz","Santa Cruz de La Sierra","Col. Esc. Virgen De Urkupina",64,0,1,0,89,19,13,1,2,189,0,6,195,217,0.471,0.899
"22405","Santa Cruz","Santa Cruz de La Sierra","Col. Esc. Virgen De Urkupina",59,0,1,1,95,15,14,0,2,187,0,8,195,226,0.508,0.863
"22406","Santa Cruz","Santa Cruz de La Sierra","Col. Esc. Virgen De Urkupina",60,1,0,1,97,15,16,2,1,193,0,7,200,228,0.503,0.877
"22407","Santa Cruz","Santa Cruz de La Sierra","Col. Esc. Virgen De Urkupina",49,1,0,1,97,9,24,3,1,185,1,7,193,228,0.524,0.846
"22408","Santa Cruz","Santa Cruz de La Sierra","Col. Esc. Virgen De Urkupina",65,2,0,0,85,15,19,0,0,186,1,8,195,230,0.457,0.848
"22409","Santa Cruz","Santa Cruz de La Sierra","Col. Esc. Virgen De Urkupina",45,1,1,0,115,14,13,0,1,190,2,4,196,226,0.605,0.867
"22410","Santa Cruz","Santa Cruz de La Sierra","Col. Esc. Virgen De Urkupina",66,2,1,1,95,13,17,2,2,199,3,4,206,230,0.477,0.896
"22411","Santa Cruz","Santa Cruz de La Sierra","U.E. Sixto Suarez Navarro",60,1,0,1,108,13,19,2,0,204,4,10,218,236,0.529,0.924
"22412","Santa Cruz","Santa Cruz de La Sierra","U.E. Sixto Suarez Navarro",47,0,0,2,119,20,15,3,0,206,5,5,216,237,0.578,0.911
"22413","Santa Cruz","Santa Cruz de La Sierra","U.E. Sixto Suarez Navarro",62,1,1,0,108,18,20,2,0,212,1,9,222,238,0.509,0.933
"22414","Santa Cruz","Santa Cruz de La Sierra","U.E. Sixto Suarez Navarro",58,0,3,0,108,15,29,1,2,216,0,5,221,237,0.5,0.932
"22415","Santa Cruz","Santa Cruz de La Sierra","U.E. Sixto Suarez Navarro",58,1,0,0,107,24,18,3,3,214,1,4,219,238,0.5,0.92
"22416","Santa Cruz","Santa Cruz de La Sierra","U.E. San Juan Bautista",54,1,0,1,117,19,20,5,1,218,0,5,223,238,0.537,0.937
"22417","Santa Cruz","Santa Cruz de La Sierra","U.E. San Juan Bautista",59,1,0,0,94,35,23,4,1,217,2,3,222,236,0.433,0.941
"22418","Santa Cruz","Santa Cruz de La Sierra","U.E. San Juan Bautista",61,0,1,1,112,18,10,5,2,210,4,3,217,235,0.533,0.923
"22419","Santa Cruz","Santa Cruz de La Sierra","U.E. San Juan Bautista",71,1,1,2,79,24,21,3,3,205,1,7,213,228,0.385,0.934
"22420","Santa Cruz","Santa Cruz de La Sierra","Col. Escuela Nueva Esperanza",55,0,0,1,102,17,20,6,0,201,3,6,210,231,0.507,0.909
"22421","Santa Cruz","Santa Cruz de La Sierra","Col. Escuela Nueva Esperanza",35,2,2,1,137,9,10,1,1,198,3,11,212,234,0.692,0.906
"22422","Santa Cruz","Santa Cruz de La Sierra","Col. Escuela Nueva Esperanza",60,0,0,0,90,24,22,0,0,196,1,4,201,230,0.459,0.874
"22423","Santa Cruz","Santa Cruz de La Sierra","Col. Escuela Nueva Esperanza",39,1,0,1,113,17,25,1,0,197,3,6,206,227,0.574,0.907
"22424","Santa Cruz","Santa Cruz de La Sierra","Col. Escuela Nueva Esperanza",57,0,0,0,101,21,17,3,2,201,4,1,206,229,0.502,0.9
"22425","Santa Cruz","Santa Cruz de La Sierra","Col. Escuela Nueva Esperanza",40,2,0,0,104,15,24,1,1,187,4,16,207,227,0.556,0.912
"22426","Santa Cruz","Santa Cruz de La Sierra","Col. Escuela Nueva Esperanza",53,0,1,0,101,30,14,0,1,200,1,8,209,231,0.505,0.905
"22427","Santa Cruz","Santa Cruz de La Sierra","Col. Escuela Nueva Esperanza",57,1,0,0,106,17,12,1,0,194,4,9,207,237,0.546,0.873
"22428","Santa Cruz","Santa Cruz de La Sierra","Col. 30 de Marzo",140,0,1,1,36,13,5,1,0,197,1,6,204,229,0.183,0.891
"22429","Santa Cruz","Santa Cruz de La Sierra","Col. 30 de Marzo",137,1,0,2,33,11,9,0,2,195,2,16,213,230,0.169,0.926
"22430","Santa Cruz","Santa Cruz de La Sierra","Col. 30 de Marzo",144,0,0,1,34,9,10,2,1,201,1,4,206,230,0.169,0.896
"22431","Santa Cruz","Santa Cruz de La Sierra","Col. 30 de Marzo",132,0,0,2,39,15,9,2,1,200,0,6,206,229,0.195,0.9
"22432","Santa Cruz","Santa Cruz de La Sierra","Col. 30 de Marzo",148,1,0,1,31,13,7,1,1,203,2,4,209,231,0.153,0.905
"22433","Santa Cruz","Santa Cruz de La Sierra","Col. 30 de Marzo",137,0,0,0,44,12,4,1,0,198,3,3,204,224,0.222,0.911
"22434","Santa Cruz","Santa Cruz de La Sierra","Col. 30 de Marzo",156,0,0,0,32,9,12,3,1,213,0,4,217,230,0.15,0.943
"22435","Santa Cruz","Santa Cruz de La Sierra","Col. 30 de Marzo",145,0,0,1,34,17,9,1,0,207,0,6,213,228,0.164,0.934
"22436","Santa Cruz","Santa Cruz de La Sierra","Col. 30 de Marzo",149,0,0,0,21,20,4,0,1,195,2,4,201,226,0.108,0.889
"22437","Santa Cruz","Santa Cruz de La Sierra","Col. 30 de Marzo",137,0,0,1,32,14,15,0,0,199,3,6,208,229,0.161,0.908
"22438","Santa Cruz","Santa Cruz de La Sierra","Col. 30 de Marzo",156,1,0,0,24,9,11,0,1,202,0,6,208,226,0.119,0.92
"22439","Santa Cruz","Santa Cruz de La Sierra","Col. 30 de Marzo",134,0,1,0,22,17,11,5,1,191,0,8,199,231,0.115,0.861
"22440","Santa Cruz","Santa Cruz de La Sierra","Col. 30 de Marzo",143,0,0,0,19,17,12,1,0,192,0,6,198,228,0.099,0.868
"22441","Santa Cruz","Santa Cruz de La Sierra","Col. 30 de Marzo",147,0,0,1,32,9,6,1,0,196,0,6,202,228,0.163,0.886
"22442","Santa Cruz","Santa Cruz de La Sierra","Col. 30 de Marzo",136,1,0,0,38,23,9,1,1,209,0,4,213,230,0.182,0.926
"22443","Santa Cruz","Santa Cruz de La Sierra","Col. 30 de Marzo",152,1,0,2,17,14,7,3,0,196,0,7,203,227,0.087,0.894
"22444","Santa Cruz","Santa Cruz de La Sierra","Col. 30 de Marzo",133,1,0,1,39,18,10,0,0,202,0,5,207,228,0.193,0.908
"22445","Santa Cruz","Santa Cruz de La Sierra","Col. 30 de Marzo",135,0,0,0,35,22,0,11,0,203,0,4,207,225,0.172,0.92
"22446","Santa Cruz","Santa Cruz de La Sierra","Col. 30 de Marzo",141,0,0,3,29,15,11,2,0,201,0,3,204,225,0.144,0.907
"22447","Santa Cruz","Santa Cruz de La Sierra","Col. Cupesi Terrado",60,0,0,0,94,0,17,3,2,176,0,2,178,227,0.534,0.784
"22448","Santa Cruz","Santa Cruz de La Sierra","Col. Cupesi Terrado",71,0,0,0,85,14,16,4,1,191,1,8,200,229,0.445,0.873
"22449","Santa Cruz","Santa Cruz de La Sierra","Col. Cupesi Terrado",59,0,0,2,95,23,0,2,0,181,1,5,187,229,0.525,0.817
"22450","Santa Cruz","Santa Cruz de La Sierra","Col. Cupesi Terrado",60,1,1,0,103,13,16,2,0,196,1,11,208,231,0.526,0.9
"22451","Santa Cruz","Santa Cruz de La Sierra","Col. Cupesi Terrado",53,1,0,1,85,32,19,1,2,194,1,8,203,228,0.438,0.89
"22452","Santa Cruz","Santa Cruz de La Sierra","Col. Cupesi Terrado",35,0,1,1,142,15,14,4,1,213,1,4,218,232,0.667,0.94
"22453","Santa Cruz","Santa Cruz de La Sierra","Col. Cupesi Terrado",47,1,0,1,108,19,22,1,1,200,1,1,202,228,0.54,0.886
"22454","Santa Cruz","Santa Cruz de La Sierra","Col. Cupesi Terrado",60,0,0,3,99,20,10,2,0,194,3,4,201,228,0.51,0.882
"22455","Santa Cruz","Santa Cruz de La Sierra","Col. Cupesi Terrado",62,0,1,1,99,24,10,0,1,198,3,7,208,232,0.5,0.897
"22456","Santa Cruz","Santa Cruz de La Sierra","Col. Cupesi Terrado",77,1,2,2,87,22,17,0,1,209,0,8,217,235,0.416,0.923
"22457","Santa Cruz","Santa Cruz de La Sierra","Col. Cupesi Terrado",54,0,1,2,91,16,18,2,0,184,3,17,204,229,0.495,0.891
"22458","Santa Cruz","Santa Cruz de La Sierra","Col. Cupesi Terrado",45,0,0,0,121,16,20,2,2,206,2,3,211,234,0.587,0.902
"22459","Santa Cruz","Santa Cruz de La Sierra","Col. Cupesi Terrado",26,1,0,0,142,15,18,3,0,205,2,5,212,232,0.693,0.914
"22460","Santa Cruz","Santa Cruz de La Sierra","Col. Cupesi Terrado",78,0,2,0,66,27,14,2,2,191,2,5,198,228,0.346,0.868
"22461","Santa Cruz","Santa Cruz de La Sierra","Col. Cupesi Terrado",66,0,0,0,97,25,13,2,1,204,3,3,210,236,0.475,0.89
"22462","Santa Cruz","Santa Cruz de La Sierra","Col. Cupesi Terrado",69,0,0,2,74,23,13,3,1,185,1,4,190,227,0.4,0.837
"22463","Santa Cruz","Santa Cruz de La Sierra","Col. Cupesi Terrado",73,1,0,2,75,19,19,2,1,192,1,10,203,229,0.391,0.886
"22464","Santa Cruz","Santa Cruz de La Sierra","Col. Cupesi Terrado",47,0,1,0,108,18,22,1,1,198,2,9,209,230,0.545,0.909
"22465","Santa Cruz","Santa Cruz de La Sierra","Col. Cupesi Terrado",67,1,1,1,83,29,18,2,0,202,3,3,208,231,0.411,0.9
"22466","Santa Cruz","Santa Cruz de La Sierra","Col. Cupesi Terrado",74,0,2,0,81,25,12,3,1,198,0,5,203,231,0.409,0.879
"22467","Santa Cruz","Santa Cruz de La Sierra","Col. Cupesi Terrado",66,1,0,0,83,22,18,1,3,194,2,8,204,231,0.428,0.883
"22468","Santa Cruz","Santa Cruz de La Sierra","Col. Cupesi Terrado",73,0,2,0,79,32,14,1,1,202,0,6,208,230,0.391,0.904
"22469","Santa Cruz","Santa Cruz de La Sierra","Col. Cupesi Terrado",71,1,0,0,84,29,9,0,1,195,0,9,204,227,0.431,0.899
"22470","Santa Cruz","Santa Cruz de La Sierra","Col. Cupesi Terrado",61,0,0,0,102,15,17,4,2,201,3,3,207,236,0.507,0.877
"22471","Santa Cruz","Santa Cruz de La Sierra","Col. Cupesi Terrado",53,0,2,0,75,22,11,3,0,166,2,8,176,194,0.452,0.907
"22472","Santa Cruz","Santa Cruz de La Sierra","U.E. 25 de Octubre",74,1,1,1,93,14,16,1,0,201,1,10,212,239,0.463,0.887
"22473","Santa Cruz","Santa Cruz de La Sierra","U.E. 25 de Octubre",46,0,0,1,116,21,18,0,0,202,28,8,238,238,0.574,1
"22474","Santa Cruz","Santa Cruz de La Sierra","U.E. 25 de Octubre",72,0,0,0,96,24,15,2,0,209,19,10,238,238,0.459,1
"22475","Santa Cruz","Santa Cruz de La Sierra","U.E. 25 de Octubre",79,1,0,1,76,25,20,2,0,204,1,11,216,238,0.373,0.908
"22476","Santa Cruz","Santa Cruz de La Sierra","Col. Unidad Educativa San Jorge",41,2,0,1,121,15,19,4,0,203,0,2,205,225,0.596,0.911
"22477","Santa Cruz","Santa Cruz de La Sierra","Col. Unidad Educativa San Jorge",53,2,0,1,97,17,15,5,0,190,4,10,204,231,0.511,0.883
"22478","Santa Cruz","Santa Cruz de La Sierra","Col. Unidad Educativa San Jorge",43,1,3,0,120,16,18,0,0,201,2,1,204,225,0.597,0.907
"22479","Santa Cruz","Santa Cruz de La Sierra","Col. Unidad Educativa San Jorge",35,1,1,1,128,11,15,0,2,194,0,5,199,229,0.66,0.869
"22480","Santa Cruz","Santa Cruz de La Sierra","Col. Unidad Educativa San Jorge",48,0,1,2,113,13,20,1,2,200,1,5,206,231,0.565,0.892
"22481","Santa Cruz","Santa Cruz de La Sierra","Col. Unidad Educativa San Jorge",37,2,0,1,127,9,26,1,1,204,1,3,208,231,0.623,0.9
"22482","Santa Cruz","Santa Cruz de La Sierra","Col. Unidad Educativa San Jorge",31,0,0,0,129,7,22,4,0,193,2,8,203,225,0.668,0.902
"22483","Santa Cruz","Santa Cruz de La Sierra","Col. Unidad Educativa San Jorge",52,1,0,0,92,16,23,1,0,185,1,6,192,227,0.497,0.846
"22484","Santa Cruz","Santa Cruz de La Sierra","Col. Unidad Educativa San Jorge",44,0,0,1,117,12,20,2,1,197,0,6,203,228,0.594,0.89
"22485","Santa Cruz","Santa Cruz de La Sierra","Col. Unidad Educativa San Jorge",38,0,0,1,126,11,23,0,0,199,3,7,209,234,0.633,0.893
"22486","Santa Cruz","Santa Cruz de La Sierra","Col. Unidad Educativa San Jorge",29,0,0,0,128,13,25,0,1,196,2,9,207,229,0.653,0.904
"22487","Santa Cruz","Santa Cruz de La Sierra","Col. Unidad Educativa San Jorge",53,0,0,0,103,13,26,2,1,198,1,3,202,232,0.52,0.871
"22488","Santa Cruz","Santa Cruz de La Sierra","Col. Unidad Educativa San Jorge",40,0,1,0,122,7,21,2,2,195,2,3,200,224,0.626,0.893
"22489","Santa Cruz","Santa Cruz de La Sierra","Col. Unidad Educativa San Jorge",24,1,1,2,135,7,30,1,0,201,0,6,207,232,0.672,0.892
"22490","Santa Cruz","Santa Cruz de La Sierra","Col. Unidad Educativa San Jorge",58,0,0,0,91,24,17,1,1,192,0,5,197,219,0.474,0.9
"22491","Santa Cruz","Santa Cruz de La Sierra","Col. Unidad Educativa San Jorge",35,1,0,3,116,15,21,0,1,192,1,5,198,222,0.604,0.892
"22492","Santa Cruz","Santa Cruz de La Sierra","Col. Unidad Educativa San Jorge",35,2,0,3,118,12,25,2,1,198,0,6,204,231,0.596,0.883
"22493","Santa Cruz","Santa Cruz de La Sierra","Col. Unidad Educativa San Jorge",59,0,1,1,88,23,16,4,0,192,2,5,199,226,0.458,0.881
"22494","Santa Cruz","Santa Cruz de La Sierra","Col. Unidad Educativa San Jorge",39,0,0,0,110,11,18,2,2,182,2,7,191,224,0.604,0.853
"22495","Santa Cruz","Santa Cruz de La Sierra","Col. Unidad Educativa San Jorge",43,0,0,1,112,10,16,0,0,182,2,9,193,231,0.615,0.835
"22496","Santa Cruz","Santa Cruz de La Sierra","Col. Unidad Educativa San Jorge",39,0,2,2,111,8,22,1,1,186,1,7,194,226,0.597,0.858
"22497","Santa Cruz","Santa Cruz de La Sierra","Col. Unidad Educativa San Jorge",52,0,0,1,94,15,23,1,1,187,0,5,192,219,0.503,0.877
"22498","Santa Cruz","Santa Cruz de La Sierra","Col. Unidad Educativa San Jorge",53,0,0,1,111,19,13,1,0,198,2,6,206,231,0.561,0.892
"22499","Santa Cruz","Santa Cruz de La Sierra","Col. Unidad Educativa San Jorge",63,1,1,2,108,11,9,2,1,198,1,4,203,230,0.545,0.883
"22500","Santa Cruz","Santa Cruz de La Sierra","Col. Unidad Educativa San Jorge",35,0,0,0,119,18,22,1,1,196,4,5,205,229,0.607,0.895
"22501","Santa Cruz","Santa Cruz de La Sierra","Col. Unidad Educativa San Jorge",27,0,0,1,90,13,24,0,0,155,1,6,162,180,0.581,0.9
"22502","Santa Cruz","Santa Cruz de La Sierra","U.E. Luis Melgar I",50,0,0,0,134,14,20,1,1,220,2,7,229,239,0.609,0.958
"22503","Santa Cruz","Santa Cruz de La Sierra","U.E. Luis Melgar I",51,1,1,1,119,14,28,0,0,215,2,8,225,239,0.553,0.941
"22504","Santa Cruz","Santa Cruz de La Sierra","U.E. Luis Melgar I",71,0,0,2,93,17,30,0,2,215,6,3,224,243,0.433,0.922
"22505","Santa Cruz","Santa Cruz de La Sierra","U.E. 26 de Junio",74,0,0,1,89,16,29,1,0,210,2,5,217,238,0.424,0.912
"22506","Santa Cruz","Santa Cruz de La Sierra","U.E. 26 de Junio",63,0,0,1,102,16,20,0,2,204,3,9,216,236,0.5,0.915
"22507","Santa Cruz","Santa Cruz de La Sierra","U.E. 26 de Junio",63,0,2,2,83,21,25,2,1,199,2,16,217,239,0.417,0.908
"22508","Santa Cruz","Santa Cruz de La Sierra","U.E. 26 de Junio",72,0,0,1,96,14,22,2,3,210,0,10,220,239,0.457,0.921
"22509","Santa Cruz","Santa Cruz de La Sierra","U.E. 26 de Junio",71,0,0,1,86,25,18,2,4,207,0,8,215,234,0.415,0.919
"22510","Santa Cruz","Santa Cruz de La Sierra","U.E. 26 de Junio",92,1,0,3,82,17,19,0,1,215,1,4,220,238,0.381,0.924
"22511","Santa Cruz","Santa Cruz de La Sierra","U.E. 26 de Junio",80,0,0,1,86,21,22,1,1,212,1,7,220,236,0.406,0.932
"22512","Santa Cruz","Santa Cruz de La Sierra","U.E. Andres Ibañez ""A""",40,0,0,0,145,9,22,2,0,218,6,6,230,237,0.665,0.97
"22513","Santa Cruz","Santa Cruz de La Sierra","U.E. Andres Ibañez ""A""",57,0,3,0,125,10,26,2,0,223,2,3,228,239,0.561,0.954
"22514","Santa Cruz","Santa Cruz de La Sierra","U.E. Andres Ibañez ""A""",52,1,0,0,120,17,26,1,0,217,1,9,227,238,0.553,0.954
"22515","Santa Cruz","Santa Cruz de La Sierra","U.E. Andres Ibañez ""A""",34,2,1,0,124,22,35,0,1,219,3,8,230,239,0.566,0.962
"22516","Santa Cruz","Santa Cruz de La Sierra","U.E. Andres Ibañez ""A""",54,0,1,1,128,15,25,0,2,226,3,1,230,240,0.566,0.958
"22517","Santa Cruz","Santa Cruz de La Sierra","U.E. Manos Unidas",91,0,2,0,67,29,22,0,0,211,1,5,217,236,0.318,0.919
"22518","Santa Cruz","Santa Cruz de La Sierra","U.E. Manos Unidas",77,0,0,0,54,12,14,1,0,158,2,7,167,191,0.342,0.874
"22519","Santa Cruz","Santa Cruz de La Sierra","Col. Luis Barranco Alvarez",59,1,0,1,98,12,12,2,1,186,3,9,198,224,0.527,0.884
"22520","Santa Cruz","Santa Cruz de La Sierra","Col. Luis Barranco Alvarez",61,3,0,2,91,16,15,2,4,194,0,7,201,223,0.469,0.901
"22521","Santa Cruz","Santa Cruz de La Sierra","Col. Luis Barranco Alvarez",56,0,1,0,94,19,18,1,0,189,2,7,198,223,0.497,0.888
"22522","Santa Cruz","Santa Cruz de La Sierra","Col. Luis Barranco Alvarez",56,1,1,1,101,10,22,2,1,195,2,2,199,225,0.518,0.884
"22523","Santa Cruz","Santa Cruz de La Sierra","Col. Luis Barranco Alvarez",58,0,0,2,104,23,12,1,2,202,1,5,208,230,0.515,0.904
"22524","Santa Cruz","Santa Cruz de La Sierra","Col. Luis Barranco Alvarez",51,0,0,0,114,15,16,0,3,199,1,6,206,230,0.573,0.896
"22525","Santa Cruz","Santa Cruz de La Sierra","Col. Luis Barranco Alvarez",45,0,1,3,108,20,17,2,1,197,2,6,205,226,0.548,0.907
"22526","Santa Cruz","Santa Cruz de La Sierra","Col. Luis Barranco Alvarez",68,1,0,0,100,15,15,3,3,205,1,5,211,230,0.488,0.917
"22527","Santa Cruz","Santa Cruz de La Sierra","Col. Luis Barranco Alvarez",64,0,1,2,87,14,19,1,0,188,3,11,202,226,0.463,0.894
"22528","Santa Cruz","Santa Cruz de La Sierra","Col. Luis Barranco Alvarez",66,1,1,1,98,21,15,2,0,205,1,4,210,227,0.478,0.925
"22529","Santa Cruz","Santa Cruz de La Sierra","Col. Luis Barranco Alvarez",62,0,0,1,103,12,12,1,0,191,4,5,200,228,0.539,0.877
"22530","Santa Cruz","Santa Cruz de La Sierra","Col. Luis Barranco Alvarez",86,2,2,2,71,16,13,2,1,195,0,4,199,225,0.364,0.884
"22531","Santa Cruz","Santa Cruz de La Sierra","Col. Luis Barranco Alvarez",56,0,1,0,101,18,18,2,1,197,2,4,203,226,0.513,0.898
"22532","Santa Cruz","Santa Cruz de La Sierra","Col. Luis Barranco Alvarez",75,0,0,0,83,16,11,4,1,190,5,4,199,224,0.437,0.888
"22533","Santa Cruz","Santa Cruz de La Sierra","Col. Luis Barranco Alvarez",31,1,1,0,140,10,27,0,1,211,0,23,234,234,0.664,1
"22534","Santa Cruz","Santa Cruz de La Sierra","Col. Luis Barranco Alvarez",70,1,0,0,82,22,16,6,1,198,1,3,202,222,0.414,0.91
"22535","Santa Cruz","Santa Cruz de La Sierra","Col. Luis Barranco Alvarez",58,0,1,1,89,25,21,2,1,198,0,6,204,225,0.449,0.907
"22536","Santa Cruz","Santa Cruz de La Sierra","Col. Luis Barranco Alvarez",90,1,0,0,68,24,13,0,0,196,1,7,204,225,0.347,0.907
"22537","Santa Cruz","Santa Cruz de La Sierra","Col. Luis Barranco Alvarez",84,0,0,1,87,17,14,1,2,206,0,4,210,229,0.422,0.917
"22538","Santa Cruz","Santa Cruz de La Sierra","Col. Luis Barranco Alvarez",85,0,1,0,75,20,15,4,0,200,1,7,208,234,0.375,0.889
"22539","Santa Cruz","Santa Cruz de La Sierra","Col. Luis Barranco Alvarez",37,0,1,0,119,7,28,1,4,197,2,1,200,228,0.604,0.877
"22540","Santa Cruz","Santa Cruz de La Sierra","Col. Luis Barranco Alvarez",69,1,1,0,78,22,10,1,3,185,1,4,190,222,0.422,0.856
"22541","Santa Cruz","Santa Cruz de La Sierra","Col. Luis Barranco Alvarez",73,1,1,1,82,20,17,2,0,197,1,9,207,231,0.416,0.896
"22542","Santa Cruz","Santa Cruz de La Sierra","Col. Luis Barranco Alvarez",74,0,0,0,78,21,18,7,1,199,2,3,204,229,0.392,0.891
"22543","Santa Cruz","Santa Cruz de La Sierra","Col. Luis Barranco Alvarez",67,0,2,1,82,21,11,2,2,188,1,10,199,228,0.436,0.873
"22544","Santa Cruz","Santa Cruz de La Sierra","Col. Luis Barranco Alvarez",71,1,0,1,93,15,12,0,1,194,1,7,202,229,0.479,0.882
"22545","Santa Cruz","Santa Cruz de La Sierra","Col. Luis Barranco Alvarez",71,0,0,0,72,24,16,1,1,185,3,5,193,227,0.389,0.85
"22546","Santa Cruz","Santa Cruz de La Sierra","Col. Luis Barranco Alvarez",90,0,0,1,77,20,8,1,1,198,0,8,206,231,0.389,0.892
"22547","Santa Cruz","Santa Cruz de La Sierra","Col. Luis Barranco Alvarez",53,0,0,0,100,15,12,3,1,184,0,6,190,224,0.543,0.848
"22548","Santa Cruz","Santa Cruz de La Sierra","U.E. Luz del Mundo ""A""",56,0,0,1,98,22,36,3,0,216,2,5,223,239,0.454,0.933
"22549","Santa Cruz","Santa Cruz de La Sierra","U.E. Luz del Mundo ""A""",62,0,0,1,111,17,25,3,2,221,1,3,225,240,0.502,0.938
"22550","Santa Cruz","Santa Cruz de La Sierra","U.E. Luz del Mundo ""A""",68,0,0,0,112,19,22,1,0,222,1,6,229,237,0.505,0.966
"22551","Santa Cruz","Santa Cruz de La Sierra","U.E. Luz del Mundo ""A""",55,1,1,2,113,24,23,2,1,222,1,5,228,239,0.509,0.954
"22552","Santa Cruz","Santa Cruz de La Sierra","Col. Esc. Juana Azurduy De Padilla",80,0,0,0,77,13,19,1,2,192,0,13,205,227,0.401,0.903
"22553","Santa Cruz","Santa Cruz de La Sierra","Col. Esc. Juana Azurduy De Padilla",93,1,0,1,67,17,12,3,0,194,2,8,204,231,0.345,0.883
"22554","Santa Cruz","Santa Cruz de La Sierra","Col. Esc. Juana Azurduy De Padilla",75,0,0,1,86,11,21,2,2,198,2,4,204,228,0.434,0.895
"22555","Santa Cruz","Santa Cruz de La Sierra","Col. Esc. Juana Azurduy De Padilla",75,0,1,0,88,11,15,1,0,191,1,5,197,222,0.461,0.887
"22556","Santa Cruz","Santa Cruz de La Sierra","Col. Esc. Juana Azurduy De Padilla",72,0,0,0,73,17,21,3,1,187,2,12,201,228,0.39,0.882
"22557","Santa Cruz","Santa Cruz de La Sierra","Col. Esc. Juana Azurduy De Padilla",71,0,0,1,98,12,14,1,0,197,0,4,201,230,0.497,0.874
"22558","Santa Cruz","Santa Cruz de La Sierra","Col. Esc. Juana Azurduy De Padilla",59,1,0,1,99,13,21,1,0,195,1,3,199,228,0.508,0.873
"22559","Santa Cruz","Santa Cruz de La Sierra","Col. Esc. Juana Azurduy De Padilla",60,0,1,1,88,26,11,1,4,192,2,10,204,226,0.458,0.903
"22560","Santa Cruz","Santa Cruz de La Sierra","Col. Esc. Juana Azurduy De Padilla",55,1,0,3,101,14,14,2,3,193,4,5,202,230,0.523,0.878
"22561","Santa Cruz","Santa Cruz de La Sierra","Col. Esc. Juana Azurduy De Padilla",57,2,1,0,104,8,20,3,2,197,6,7,210,232,0.528,0.905
"22562","Santa Cruz","Santa Cruz de La Sierra","Col. Esc. Juana Azurduy De Padilla",68,1,0,1,73,18,15,2,1,179,2,12,193,222,0.408,0.869
"22563","Santa Cruz","Santa Cruz de La Sierra","Col. Esc. Juana Azurduy De Padilla",89,0,1,1,65,24,13,2,0,195,2,7,204,225,0.333,0.907
"22564","Santa Cruz","Santa Cruz de La Sierra","Col. Esc. Juana Azurduy De Padilla",68,0,0,1,93,16,10,0,1,189,3,4,196,224,0.492,0.875
"22565","Santa Cruz","Santa Cruz de La Sierra","Col. Esc. Juana Azurduy De Padilla",71,1,0,2,77,22,15,4,1,193,2,8,203,226,0.399,0.898
"22566","Santa Cruz","Santa Cruz de La Sierra","Col. Esc. Juana Azurduy De Padilla",83,0,0,0,63,18,22,2,0,188,1,4,193,228,0.335,0.846
"22567","Santa Cruz","Santa Cruz de La Sierra","Col. Esc. Juana Azurduy De Padilla",60,0,4,1,99,18,9,2,0,193,2,7,202,230,0.513,0.878
"22568","Santa Cruz","Santa Cruz de La Sierra","Col. Esc. Juana Azurduy De Padilla",71,1,0,2,67,25,16,0,0,182,1,7,190,222,0.368,0.856
"22569","Santa Cruz","Santa Cruz de La Sierra","Col. Esc. Juana Azurduy De Padilla",84,0,0,1,63,16,17,7,2,190,2,7,199,231,0.332,0.861
"22570","Santa Cruz","Santa Cruz de La Sierra","Col. Esc. Juana Azurduy De Padilla",54,1,1,0,117,11,10,2,1,197,3,6,206,228,0.594,0.904
"22571","Santa Cruz","Santa Cruz de La Sierra","Col. Esc. Juana Azurduy De Padilla",40,1,2,0,127,5,19,1,0,195,1,4,200,228,0.651,0.877
"22572","Santa Cruz","Santa Cruz de La Sierra","Col. Esc. Juana Azurduy De Padilla",75,1,0,0,69,30,14,1,0,190,0,4,194,224,0.363,0.866
"22573","Santa Cruz","Santa Cruz de La Sierra","Col. Esc. Juana Azurduy De Padilla",93,1,0,0,65,20,17,1,0,197,1,2,200,230,0.33,0.87
"22574","Santa Cruz","Santa Cruz de La Sierra","Col. Esc. Juana Azurduy De Padilla",76,0,0,1,66,24,23,4,0,194,0,7,201,231,0.34,0.87
"22575","Santa Cruz","Santa Cruz de La Sierra","Col. Esc. Juana Azurduy De Padilla",83,0,0,0,81,18,8,1,2,193,1,8,202,228,0.42,0.886
"22576","Santa Cruz","Santa Cruz de La Sierra","Col. Esc. Juana Azurduy De Padilla",65,0,0,0,77,17,20,2,0,181,2,8,191,221,0.425,0.864
"22577","Santa Cruz","Santa Cruz de La Sierra","Col. Esc. Juana Azurduy De Padilla",68,0,0,2,65,20,17,0,0,172,1,11,184,221,0.378,0.833
"22578","Santa Cruz","Santa Cruz de La Sierra","Col. Esc. Juana Azurduy De Padilla",52,0,2,2,106,9,19,0,1,191,2,8,201,232,0.555,0.866
"22579","Santa Cruz","Santa Cruz de La Sierra","Col. Esc. Juana Azurduy De Padilla",67,0,2,0,100,22,11,2,0,204,3,3,210,232,0.49,0.905
"22580","Santa Cruz","Santa Cruz de La Sierra","Col. Esc. Juana Azurduy De Padilla",95,0,0,2,54,19,13,0,0,183,1,10,194,219,0.295,0.886
"22581","Santa Cruz","Santa Cruz de La Sierra","Col. Esc. Juana Azurduy De Padilla",91,0,0,1,65,17,14,1,0,189,0,9,198,221,0.344,0.896
"22582","Santa Cruz","Santa Cruz de La Sierra","Col. Esc. Juana Azurduy De Padilla",97,0,0,0,61,20,19,1,0,198,0,8,206,227,0.308,0.907
"22583","Santa Cruz","Santa Cruz de La Sierra","Col. Esc. Juana Azurduy De Padilla",77,0,0,1,74,21,17,1,0,191,0,8,199,230,0.387,0.865
"22584","Santa Cruz","Santa Cruz de La Sierra","Col. Esc. Juana Azurduy De Padilla",68,1,0,0,74,21,15,1,1,181,2,5,188,228,0.409,0.825
"22585","Santa Cruz","Santa Cruz de La Sierra","Col. Esc. Juana Azurduy De Padilla",69,4,0,1,83,15,19,1,1,193,2,5,200,228,0.43,0.877
"22586","Santa Cruz","Santa Cruz de La Sierra","Col. Esc. Juana Azurduy De Padilla",91,1,0,1,54,25,12,1,0,185,1,10,196,230,0.292,0.852
"22587","Santa Cruz","Santa Cruz de La Sierra","Col. Esc. Juana Azurduy De Padilla",69,1,1,0,83,15,12,2,0,183,2,2,187,230,0.454,0.813
"22588","Santa Cruz","Santa Cruz de La Sierra","Col. Esc. Juana Azurduy De Padilla",70,1,2,2,78,18,22,2,0,195,3,1,199,222,0.4,0.896
"22589","Santa Cruz","Santa Cruz de La Sierra","Col. Esc. Juana Azurduy De Padilla",49,1,0,0,80,17,13,3,0,163,1,8,172,190,0.491,0.905
"22590","Santa Cruz","Santa Cruz de La Sierra","U.E. Francisco Hurtado Pedraza",77,2,2,1,90,16,28,3,0,219,2,6,227,239,0.411,0.95
"22591","Santa Cruz","Santa Cruz de La Sierra","U.E. Francisco Hurtado Pedraza",75,0,0,0,89,23,27,6,0,220,1,7,228,238,0.405,0.958
"22592","Santa Cruz","Santa Cruz de La Sierra","U.E. Francisco Hurtado Pedraza",94,1,1,0,83,18,15,2,2,216,0,14,230,238,0.384,0.966
"22593","Santa Cruz","Santa Cruz de La Sierra","U.E. Francisco Hurtado Pedraza",88,1,0,0,84,24,17,2,0,216,0,5,221,238,0.389,0.929
"22594","Santa Cruz","Santa Cruz de La Sierra","U.E. Francisco Hurtado Pedraza",64,1,0,0,71,14,21,6,0,177,2,2,181,193,0.401,0.938
"22595","Santa Cruz","Santa Cruz de La Sierra","Col. Esc. Roca Coronado",96,1,0,1,83,11,9,1,0,202,0,7,209,230,0.411,0.909
"22596","Santa Cruz","Santa Cruz de La Sierra","Col. Esc. Roca Coronado",70,0,0,0,100,19,9,0,4,202,1,3,206,230,0.495,0.896
"22597","Santa Cruz","Santa Cruz de La Sierra","Col. Esc. Roca Coronado",106,0,0,1,63,13,16,2,0,201,1,14,216,237,0.313,0.911
"22598","Santa Cruz","Santa Cruz de La Sierra","Col. Esc. Roca Coronado",71,0,3,0,87,14,17,4,1,197,2,10,209,227,0.442,0.921
"22599","Santa Cruz","Santa Cruz de La Sierra","Col. Esc. Roca Coronado",71,0,1,1,92,19,14,0,1,199,3,6,208,229,0.462,0.908
"22600","Santa Cruz","Santa Cruz de La Sierra","Col. Esc. Roca Coronado",60,0,2,0,112,8,21,2,2,207,1,3,211,232,0.541,0.909
"22601","Santa Cruz","Santa Cruz de La Sierra","Col. Esc. Roca Coronado",47,0,2,2,89,20,16,1,2,179,5,7,191,218,0.497,0.876
"22602","Santa Cruz","Santa Cruz de La Sierra","Col. Esc. Roca Coronado",90,0,0,0,80,15,13,2,1,201,1,3,205,229,0.398,0.895
"22603","Santa Cruz","Santa Cruz de La Sierra","Col. Esc. Roca Coronado",85,1,1,1,86,16,17,0,1,208,1,6,215,232,0.413,0.927
"22604","Santa Cruz","Santa Cruz de La Sierra","Col. Esc. Roca Coronado",106,1,0,1,64,21,17,5,0,215,1,1,217,235,0.298,0.923
"22605","Santa Cruz","Santa Cruz de La Sierra","Col. Esc. Roca Coronado",86,0,1,0,73,17,11,1,2,191,2,7,200,228,0.382,0.877
"22606","Santa Cruz","Santa Cruz de La Sierra","Col. Esc. Roca Coronado",86,0,1,0,87,18,14,2,1,209,0,6,215,232,0.416,0.927
"22607","Santa Cruz","Santa Cruz de La Sierra","Col. Esc. Roca Coronado",65,0,0,1,112,9,16,1,1,205,1,4,210,227,0.546,0.925
"22608","Santa Cruz","Santa Cruz de La Sierra","Col. Esc. Roca Coronado",65,0,0,0,96,12,22,1,1,197,0,10,207,228,0.487,0.908
"22609","Santa Cruz","Santa Cruz de La Sierra","Col. Esc. Roca Coronado",94,0,0,1,63,17,22,2,1,200,1,5,206,230,0.315,0.896
"22610","Santa Cruz","Santa Cruz de La Sierra","Col. Esc. Roca Coronado",75,1,0,0,88,21,18,2,1,206,0,7,213,233,0.427,0.914
"22611","Santa Cruz","Santa Cruz de La Sierra","Col. Esc. Roca Coronado",65,1,1,0,99,13,13,0,0,192,1,18,211,230,0.516,0.917
"22612","Santa Cruz","Santa Cruz de La Sierra","Col. Esc. Roca Coronado",86,1,0,1,63,18,12,2,0,183,1,9,193,226,0.344,0.854
"22613","Santa Cruz","Santa Cruz de La Sierra","Col. Esc. Roca Coronado",59,0,1,3,104,11,18,2,2,200,4,2,206,228,0.52,0.904
"22614","Santa Cruz","Santa Cruz de La Sierra","Col. Esc. Roca Coronado",90,1,1,1,81,13,10,0,2,199,1,6,206,229,0.407,0.9
"22615","Santa Cruz","Santa Cruz de La Sierra","Col. Esc. Roca Coronado",87,0,0,3,77,16,21,0,0,204,1,7,212,235,0.377,0.902
"22616","Santa Cruz","Santa Cruz de La Sierra","Col. Esc. Roca Coronado",95,1,2,0,71,24,12,1,3,209,1,10,220,235,0.34,0.936
"22617","Santa Cruz","Santa Cruz de La Sierra","Col. Esc. Roca Coronado",76,1,3,0,82,19,12,0,0,193,5,3,201,234,0.425,0.859
"22618","Santa Cruz","Santa Cruz de La Sierra","Col. Esc. Roca Coronado",91,1,1,1,86,15,12,2,1,210,2,4,216,231,0.41,0.935
"22619","Santa Cruz","Santa Cruz de La Sierra","Col. Esc. Roca Coronado",77,0,1,2,93,4,16,2,0,195,0,9,204,235,0.477,0.868
"22620","Santa Cruz","Santa Cruz de La Sierra","Col. Esc. Roca Coronado",56,1,1,2,95,16,30,1,0,202,2,6,210,239,0.47,0.879
"22621","Santa Cruz","Santa Cruz de La Sierra","Col. Escuela Delcy Martinez Salinas",91,0,0,3,65,27,14,3,0,203,0,7,210,229,0.32,0.917
"22622","Santa Cruz","Santa Cruz de La Sierra","Col. Escuela Delcy Martinez Salinas",110,0,0,2,63,17,8,0,1,201,0,11,212,232,0.313,0.914
"22623","Santa Cruz","Santa Cruz de La Sierra","Col. Escuela Delcy Martinez Salinas",68,0,0,2,88,20,22,0,2,202,2,8,212,233,0.436,0.91
"22624","Santa Cruz","Santa Cruz de La Sierra","Col. Escuela Delcy Martinez Salinas",86,2,0,0,83,21,7,0,0,199,0,10,209,236,0.417,0.886
"22625","Santa Cruz","Santa Cruz de La Sierra","Col. Escuela Delcy Martinez Salinas",101,1,0,0,65,14,14,0,1,196,1,10,207,235,0.332,0.881
"22626","Santa Cruz","Santa Cruz de La Sierra","Col. Escuela Delcy Martinez Salinas",101,0,0,1,65,9,15,2,1,194,2,5,201,230,0.335,0.874
"22627","Santa Cruz","Santa Cruz de La Sierra","Col. Escuela Delcy Martinez Salinas",85,0,1,1,78,17,20,4,0,206,1,4,211,235,0.379,0.898
"22628","Santa Cruz","Santa Cruz de La Sierra","Col. Escuela Delcy Martinez Salinas",108,4,1,0,66,14,14,1,0,208,1,3,212,231,0.317,0.918
"22629","Santa Cruz","Santa Cruz de La Sierra","Col. Escuela Delcy Martinez Salinas",88,0,0,0,71,13,17,0,2,191,1,11,203,232,0.372,0.875
"22630","Santa Cruz","Santa Cruz de La Sierra","Col. Escuela Delcy Martinez Salinas",103,1,0,3,63,17,21,1,0,209,1,2,212,235,0.301,0.902
"22631","Santa Cruz","Santa Cruz de La Sierra","Col. Escuela Delcy Martinez Salinas",88,0,0,1,69,22,18,2,0,200,0,5,205,232,0.345,0.884
"22632","Santa Cruz","Santa Cruz de La Sierra","Col. Escuela El Fuerte",78,1,1,0,83,18,11,1,3,196,5,3,204,228,0.423,0.895
"22633","Santa Cruz","Santa Cruz de La Sierra","Col. Escuela El Fuerte",70,3,1,0,97,16,10,1,1,199,1,7,207,233,0.487,0.888
"22634","Santa Cruz","Santa Cruz de La Sierra","Col. Escuela El Fuerte",85,1,1,0,62,21,20,1,2,193,0,8,201,230,0.321,0.874
"22635","Santa Cruz","Santa Cruz de La Sierra","Col. Escuela El Fuerte",85,1,0,1,88,16,12,2,0,205,2,8,215,232,0.429,0.927
"22636","Santa Cruz","Santa Cruz de La Sierra","Col. Escuela El Fuerte",68,0,2,1,84,20,14,1,2,192,2,2,196,229,0.438,0.856
"22637","Santa Cruz","Santa Cruz de La Sierra","Col. Escuela El Fuerte",80,0,0,0,77,22,18,2,0,199,1,5,205,231,0.387,0.887
"22638","Santa Cruz","Santa Cruz de La Sierra","Col. Escuela El Fuerte",82,0,0,1,84,20,17,1,1,206,0,2,208,228,0.408,0.912
"22639","Santa Cruz","Santa Cruz de La Sierra","Col. Escuela El Fuerte",45,0,0,0,108,8,32,2,1,196,0,13,209,230,0.551,0.909
"22640","Santa Cruz","Santa Cruz de La Sierra","Col. Escuela El Fuerte",53,0,2,0,111,6,14,1,4,191,1,9,201,228,0.581,0.882
"22641","Santa Cruz","Santa Cruz de La Sierra","Col. Escuela El Fuerte",85,1,0,1,69,21,16,0,0,193,2,9,204,229,0.358,0.891
"22642","Santa Cruz","Santa Cruz de La Sierra","Col. Escuela El Fuerte",82,0,0,2,87,10,13,0,0,194,0,2,196,233,0.448,0.841
"22643","Santa Cruz","Santa Cruz de La Sierra","Col. Escuela El Fuerte",71,0,3,1,99,9,19,2,2,206,0,4,210,229,0.481,0.917
"22644","Santa Cruz","Santa Cruz de La Sierra","Col. Escuela El Fuerte",79,0,1,2,85,21,9,0,1,198,3,5,206,233,0.429,0.884
"22645","Santa Cruz","Santa Cruz de La Sierra","Col. Escuela El Fuerte",104,0,1,1,58,17,14,3,1,199,2,5,206,232,0.291,0.888
"22646","Santa Cruz","Santa Cruz de La Sierra","Col. Escuela El Fuerte",52,1,2,0,115,17,15,0,1,203,0,5,208,232,0.567,0.897
"22647","Santa Cruz","Santa Cruz de La Sierra","Col. Escuela El Fuerte",84,0,0,0,80,16,19,0,0,199,0,4,203,232,0.402,0.875
"22648","Santa Cruz","Santa Cruz de La Sierra","Col. Escuela El Fuerte",77,0,0,2,87,9,18,0,5,198,0,7,205,230,0.439,0.891
"22649","Santa Cruz","Santa Cruz de La Sierra","Col. Escuela El Fuerte",47,0,1,2,111,9,28,1,7,206,1,5,212,232,0.539,0.914
"22650","Santa Cruz","Santa Cruz de La Sierra","Col. Escuela El Fuerte",88,0,0,2,72,17,12,2,2,195,0,7,202,230,0.369,0.878
"22651","Santa Cruz","Santa Cruz de La Sierra","Col. Escuela El Fuerte",102,1,0,2,60,13,12,0,1,191,1,2,194,224,0.314,0.866
"22652","Santa Cruz","Santa Cruz de La Sierra","Col. Escuela El Fuerte",84,0,0,3,71,20,11,1,3,193,1,10,204,223,0.368,0.915
"22653","Santa Cruz","Santa Cruz de La Sierra","Col. Escuela El Fuerte",67,0,0,0,97,22,15,0,0,201,0,3,204,228,0.483,0.895
"22654","Santa Cruz","Santa Cruz de La Sierra","Col. Escuela El Fuerte",81,2,0,0,69,12,19,3,3,189,1,13,203,229,0.365,0.886
"22655","Santa Cruz","Santa Cruz de La Sierra","Col. Escuela El Fuerte",89,0,0,1,69,16,15,0,0,190,1,8,199,226,0.363,0.881
"22656","Santa Cruz","Santa Cruz de La Sierra","Col. Escuela El Fuerte",51,2,0,0,123,11,15,0,2,204,1,5,210,232,0.603,0.905
"22657","Santa Cruz","Santa Cruz de La Sierra","Col. Escuela El Fuerte",99,0,1,0,72,14,10,0,1,197,2,9,208,231,0.365,0.9
"22658","Santa Cruz","Santa Cruz de La Sierra","Col. Escuela El Fuerte",82,0,0,2,84,15,25,0,0,208,0,2,210,235,0.404,0.894
"22659","Santa Cruz","Santa Cruz de La Sierra","Col. Escuela El Fuerte",89,1,0,2,66,17,22,3,2,202,3,3,208,228,0.327,0.912
"22660","Santa Cruz","Santa Cruz de La Sierra","Col. Escuela El Fuerte",73,0,0,1,76,16,19,2,1,188,1,8,197,227,0.404,0.868
"22661","Santa Cruz","Santa Cruz de La Sierra","Col. Escuela El Fuerte",69,1,2,1,81,14,14,0,1,183,2,11,196,228,0.443,0.86
"22662","Santa Cruz","Santa Cruz de La Sierra","Col. Escuela El Fuerte",79,0,0,0,83,16,15,1,0,194,0,6,200,231,0.428,0.866
"22663","Santa Cruz","Santa Cruz de La Sierra","Col. Escuela El Fuerte",68,1,0,0,107,12,17,1,0,206,2,3,211,235,0.519,0.898
"22664","Santa Cruz","Santa Cruz de La Sierra","Col. Escuela El Fuerte",77,0,0,2,88,11,17,1,1,197,0,8,205,235,0.447,0.872
"22665","Santa Cruz","Santa Cruz de La Sierra","Col. Escuela El Fuerte",59,1,0,0,83,13,8,2,2,168,2,2,172,189,0.494,0.91
"22666","Santa Cruz","Santa Cruz de La Sierra","Col. Esc.  Amsterdan",62,0,0,0,106,9,17,2,0,196,0,7,203,229,0.541,0.886
"22667","Santa Cruz","Santa Cruz de La Sierra","Col. Esc.  Amsterdan",57,1,1,0,109,8,29,1,1,207,0,6,213,235,0.527,0.906
"22668","Santa Cruz","Santa Cruz de La Sierra","Col. Esc.  Amsterdan",45,1,0,1,119,14,22,0,0,202,1,7,210,233,0.589,0.901
"22669","Santa Cruz","Santa Cruz de La Sierra","Col. Esc.  Amsterdan",51,2,1,0,112,14,21,0,1,202,2,1,205,229,0.554,0.895
"22670","Santa Cruz","Santa Cruz de La Sierra","Col. Esc.  Amsterdan",34,0,1,7,105,16,14,0,0,177,1,14,192,237,0.593,0.81
"22671","Santa Cruz","Santa Cruz de La Sierra","Col. Esc.  Amsterdan",72,0,0,2,96,12,12,1,1,196,3,8,207,233,0.49,0.888
"22672","Santa Cruz","Santa Cruz de La Sierra","Col. Esc.  Amsterdan",58,1,0,2,88,12,25,1,5,192,1,4,197,222,0.458,0.887
"22673","Santa Cruz","Santa Cruz de La Sierra","Col. Esc.  Amsterdan",66,0,0,1,86,13,16,1,1,184,1,10,195,225,0.467,0.867
"22674","Santa Cruz","Santa Cruz de La Sierra","Col. Esc.  Amsterdan",59,1,1,0,97,20,22,1,1,202,0,6,208,229,0.48,0.908
"22675","Santa Cruz","Santa Cruz de La Sierra","Col. Esc.  Amsterdan",52,0,1,0,112,9,25,3,2,204,1,5,210,232,0.549,0.905
"22676","Santa Cruz","Santa Cruz de La Sierra","Col. Esc.  Amsterdan",76,1,2,1,84,13,23,2,2,204,0,3,207,229,0.412,0.904
"22677","Santa Cruz","Santa Cruz de La Sierra","Col. Esc.  Amsterdan",75,1,0,1,73,9,11,1,2,173,0,33,206,231,0.422,0.892
"22678","Santa Cruz","Santa Cruz de La Sierra","Col. Esc.  Amsterdan",65,0,0,0,80,19,20,0,1,185,0,10,195,225,0.432,0.867
"22679","Santa Cruz","Santa Cruz de La Sierra","Col. Esc.  Amsterdan",37,0,0,2,101,7,12,0,0,159,1,4,164,183,0.635,0.896
"22680","Santa Cruz","Santa Cruz de La Sierra","Colegio San Francisco de Asis",87,1,0,0,69,24,27,1,2,211,2,1,214,237,0.327,0.903
"22681","Santa Cruz","Santa Cruz de La Sierra","Colegio San Francisco de Asis",83,0,0,2,93,18,19,1,0,216,2,6,224,237,0.431,0.945
"22682","Santa Cruz","Santa Cruz de La Sierra","Colegio San Francisco de Asis",85,0,1,3,90,14,17,2,2,214,0,5,219,238,0.421,0.92
"22683","Santa Cruz","Santa Cruz de La Sierra","Colegio San Francisco de Asis",102,0,1,0,65,13,21,0,1,203,3,6,212,236,0.32,0.898
"22684","Santa Cruz","Santa Cruz de La Sierra","Colegio San Francisco de Asis",73,1,0,0,61,16,13,2,2,168,2,9,179,190,0.363,0.942
"22685","Santa Cruz","Santa Cruz de La Sierra","Col. Nacional 9 De Octubre",134,2,0,1,51,4,12,2,0,206,0,5,211,229,0.248,0.921
"22686","Santa Cruz","Santa Cruz de La Sierra","Col. Nacional 9 De Octubre",129,0,1,1,42,9,9,2,1,194,4,5,203,225,0.216,0.902
"22687","Santa Cruz","Santa Cruz de La Sierra","Col. Nacional 9 De Octubre",132,0,0,1,43,12,8,1,1,198,1,7,206,229,0.217,0.9
"22688","Santa Cruz","Santa Cruz de La Sierra","Col. Nacional 9 De Octubre",123,0,0,0,49,9,13,0,0,194,0,2,196,224,0.253,0.875
"22689","Santa Cruz","Santa Cruz de La Sierra","Col. Nacional 9 De Octubre",118,0,0,2,56,8,13,0,2,199,0,8,207,232,0.281,0.892
"22690","Santa Cruz","Santa Cruz de La Sierra","Col. Nacional 9 De Octubre",142,0,0,1,35,17,9,1,0,205,0,5,210,222,0.171,0.946
"22691","Santa Cruz","Santa Cruz de La Sierra","Col. Nacional 9 De Octubre",103,0,2,3,62,10,16,3,0,199,0,3,202,224,0.312,0.902
"22692","Santa Cruz","Santa Cruz de La Sierra","Col. Nacional 9 De Octubre",119,0,0,1,48,11,12,2,0,193,0,30,223,223,0.249,1
"22693","Santa Cruz","Santa Cruz de La Sierra","Col. Nacional 9 De Octubre",141,0,0,1,41,8,11,1,1,204,0,9,213,226,0.201,0.942
"22694","Santa Cruz","Santa Cruz de La Sierra","Col. Nacional 9 De Octubre",112,0,1,1,37,22,11,2,0,186,0,9,195,222,0.199,0.878
"22695","Santa Cruz","Santa Cruz de La Sierra","Col. Nacional 9 De Octubre",94,0,1,1,78,9,16,2,0,201,0,5,206,229,0.388,0.9
"22696","Santa Cruz","Santa Cruz de La Sierra","Col. Nacional 9 De Octubre",130,0,1,2,51,14,9,5,0,212,0,22,234,234,0.241,1
"22697","Santa Cruz","Santa Cruz de La Sierra","Col. Nacional 9 De Octubre",119,0,0,0,53,17,13,4,1,207,3,5,215,228,0.256,0.943
"22698","Santa Cruz","Santa Cruz de La Sierra","Col. Nacional 9 De Octubre",108,0,0,1,44,19,12,1,0,185,0,8,193,223,0.238,0.865
"22699","Santa Cruz","Santa Cruz de La Sierra","Col. Nacional 9 De Octubre",108,0,0,0,65,13,16,0,1,203,1,4,208,227,0.32,0.916
"22700","Santa Cruz","Santa Cruz de La Sierra","Col. Nacional 9 De Octubre",121,0,0,2,48,9,15,0,1,196,0,5,201,228,0.245,0.882
"22701","Santa Cruz","Santa Cruz de La Sierra","Col. Nacional 9 De Octubre",129,0,0,0,37,14,15,0,0,195,0,6,201,225,0.19,0.893
"22702","Santa Cruz","Santa Cruz de La Sierra","Col. Nacional 9 De Octubre",128,0,1,1,40,17,7,0,3,197,1,3,201,228,0.203,0.882
"22703","Santa Cruz","Santa Cruz de La Sierra","Col. Nacional 9 De Octubre",121,0,1,3,57,12,10,1,1,206,0,5,211,232,0.277,0.909
"22704","Santa Cruz","Santa Cruz de La Sierra","Col. Nacional 9 De Octubre",124,0,0,0,44,21,10,0,1,200,1,12,213,234,0.22,0.91
"22705","Santa Cruz","Santa Cruz de La Sierra","Col. Nacional 9 De Octubre",95,0,3,1,44,9,2,2,0,156,1,9,166,184,0.282,0.902
"22706","Santa Cruz","Santa Cruz de La Sierra","U.E. Palmar Del Oriente",109,0,0,0,76,12,17,2,2,218,2,4,224,235,0.349,0.953
"22707","Santa Cruz","Santa Cruz de La Sierra","U.E. Palmar Del Oriente",101,0,1,0,76,10,27,0,1,216,2,2,220,238,0.352,0.924
"22708","Santa Cruz","Santa Cruz de La Sierra","U.E. Palmar Del Oriente",122,0,0,3,60,18,15,4,1,223,1,8,232,239,0.269,0.971
"22709","Santa Cruz","Santa Cruz de La Sierra","U.E. Palmar Del Oriente",87,0,0,0,46,10,16,1,1,161,1,4,166,172,0.286,0.965
"22710","Santa Cruz","Santa Cruz de La Sierra","U.E. Módulo Roca y Coronado",77,0,1,0,89,22,28,0,3,220,3,6,229,238,0.405,0.962
"22711","Santa Cruz","Santa Cruz de La Sierra","U.E. Módulo Roca y Coronado",89,0,1,0,84,17,25,1,3,220,0,8,228,240,0.382,0.95
"22712","Santa Cruz","Santa Cruz de La Sierra","Col. San Francisco Sur",71,0,3,0,99,14,12,0,4,203,3,3,209,235,0.488,0.889
"22713","Santa Cruz","Santa Cruz de La Sierra","Col. San Francisco Sur",74,0,0,1,97,13,21,1,2,209,0,3,212,234,0.464,0.906
"22714","Santa Cruz","Santa Cruz de La Sierra","Col. San Francisco Sur",68,0,0,0,88,19,24,3,1,203,0,6,209,232,0.433,0.901
"22715","Santa Cruz","Santa Cruz de La Sierra","Col. San Francisco Sur",68,0,2,0,97,13,21,1,1,203,5,8,216,235,0.478,0.919
"22716","Santa Cruz","Santa Cruz de La Sierra","Col. San Francisco Sur",58,0,1,0,113,10,15,4,1,202,1,7,210,236,0.559,0.89
"22717","Santa Cruz","Santa Cruz de La Sierra","Col. San Francisco Sur",73,0,0,0,96,9,24,1,2,205,3,5,213,234,0.468,0.91
"22718","Santa Cruz","Santa Cruz de La Sierra","Col. San Francisco Sur",77,0,0,1,88,8,13,1,2,190,1,10,201,230,0.463,0.874
"22719","Santa Cruz","Santa Cruz de La Sierra","Col. San Francisco Sur",68,0,0,3,95,9,22,0,2,199,3,5,207,230,0.477,0.9
"22720","Santa Cruz","Santa Cruz de La Sierra","Col. San Francisco Sur",85,0,0,1,81,16,20,0,1,204,3,5,212,236,0.397,0.898
"22721","Santa Cruz","Santa Cruz de La Sierra","Col. San Francisco Sur",83,0,1,1,73,8,25,3,2,196,1,7,204,230,0.372,0.887
"22722","Santa Cruz","Santa Cruz de La Sierra","Col. San Francisco Sur",57,0,0,0,104,5,32,1,2,201,2,6,209,234,0.517,0.893
"22723","Santa Cruz","Santa Cruz de La Sierra","Col. San Francisco Sur",66,0,0,0,103,11,19,1,1,201,4,6,211,233,0.512,0.906
"22724","Santa Cruz","Santa Cruz de La Sierra","Col. San Francisco Sur",77,0,0,1,81,18,12,0,4,193,3,4,200,231,0.42,0.866
"22725","Santa Cruz","Santa Cruz de La Sierra","Col. San Francisco Sur",73,0,0,0,86,14,17,0,5,195,2,8,205,228,0.441,0.899
"22726","Santa Cruz","Santa Cruz de La Sierra","Col. San Francisco Sur",99,0,0,0,60,17,25,0,2,203,2,3,208,226,0.296,0.92
"22727","Santa Cruz","Santa Cruz de La Sierra","Col. San Francisco Sur",65,1,1,1,103,6,15,0,11,203,0,9,212,233,0.507,0.91
"22728","Santa Cruz","Santa Cruz de La Sierra","Col. San Francisco Sur",80,0,3,0,86,12,24,1,2,208,0,6,214,232,0.413,0.922
"22729","Santa Cruz","Santa Cruz de La Sierra","Col. San Francisco Sur",52,0,4,0,66,37,0,4,0,163,37,6,206,237,0.405,0.869
"22730","Santa Cruz","Santa Cruz de La Sierra","Col. San Francisco Sur",75,0,0,2,98,7,17,1,0,200,1,6,207,233,0.49,0.888
"22731","Santa Cruz","Santa Cruz de La Sierra","Col. San Francisco Sur",69,0,0,0,98,7,11,0,1,186,2,8,196,228,0.527,0.86
"22732","Santa Cruz","Santa Cruz de La Sierra","Col. San Francisco Sur",77,2,1,1,105,10,13,2,2,213,0,8,221,233,0.493,0.948
"22733","Santa Cruz","Santa Cruz de La Sierra","Col. San Francisco Sur",66,0,1,2,104,14,20,0,0,207,1,9,217,232,0.502,0.935
"22734","Santa Cruz","Santa Cruz de La Sierra","Colegio Ignacio Warnes",71,0,0,2,92,9,24,1,1,200,0,8,208,232,0.46,0.897
"22735","Santa Cruz","Santa Cruz de La Sierra","Colegio Ignacio Warnes",69,0,0,0,103,6,22,1,2,203,2,5,210,232,0.507,0.905
"22736","Santa Cruz","Santa Cruz de La Sierra","Colegio Ignacio Warnes",81,0,0,1,61,24,20,4,3,194,1,6,201,230,0.314,0.874
"22737","Santa Cruz","Santa Cruz de La Sierra","Colegio Ignacio Warnes",64,2,1,0,92,18,18,0,2,197,0,15,212,230,0.467,0.922
"22738","Santa Cruz","Santa Cruz de La Sierra","Colegio Ignacio Warnes",46,1,1,1,110,10,22,2,3,196,2,6,204,231,0.561,0.883
"22739","Santa Cruz","Santa Cruz de La Sierra","Colegio Ignacio Warnes",63,1,0,0,95,16,21,0,2,198,1,5,204,230,0.48,0.887
"22740","Santa Cruz","Santa Cruz de La Sierra","Colegio Ignacio Warnes",71,0,1,2,92,14,15,3,2,200,1,7,208,230,0.46,0.904
"22741","Santa Cruz","Santa Cruz de La Sierra","Colegio Ignacio Warnes",71,2,0,1,94,10,15,1,5,199,1,6,206,227,0.472,0.907
"22742","Santa Cruz","Santa Cruz de La Sierra","Colegio Ignacio Warnes",64,3,0,1,102,13,14,0,6,203,2,2,207,231,0.502,0.896
"22743","Santa Cruz","Santa Cruz de La Sierra","Colegio Ignacio Warnes",67,2,0,2,80,14,23,2,1,191,3,5,199,226,0.419,0.881
"22744","Santa Cruz","Santa Cruz de La Sierra","Colegio Ignacio Warnes",54,1,0,0,110,2,25,1,5,198,0,5,203,226,0.556,0.898
"22745","Santa Cruz","Santa Cruz de La Sierra","Colegio Ignacio Warnes",63,1,0,1,106,13,15,1,4,204,0,4,208,231,0.52,0.9
"22746","Santa Cruz","Santa Cruz de La Sierra","Colegio Ignacio Warnes",75,1,1,1,82,19,24,1,1,205,2,4,211,239,0.4,0.883
"22747","Santa Cruz","Santa Cruz de La Sierra","Colegio Ignacio Warnes",66,2,1,1,70,23,20,3,2,188,0,7,195,223,0.372,0.874
"22748","Santa Cruz","Santa Cruz de La Sierra","Colegio Ignacio Warnes",72,2,2,0,75,18,16,1,2,188,2,10,200,230,0.399,0.87
"22749","Santa Cruz","Santa Cruz de La Sierra","Colegio Ignacio Warnes",51,3,1,1,107,14,26,1,1,205,0,4,209,227,0.522,0.921
"22750","Santa Cruz","Santa Cruz de La Sierra","Colegio Ignacio Warnes",65,1,1,1,90,16,18,2,2,196,0,7,203,228,0.459,0.89
"22751","Santa Cruz","Santa Cruz de La Sierra","Colegio Ignacio Warnes",80,2,1,0,81,17,12,2,1,196,3,6,205,231,0.413,0.887
"22752","Santa Cruz","Santa Cruz de La Sierra","Colegio Ignacio Warnes",70,1,0,1,93,8,19,2,4,198,2,3,203,225,0.47,0.902
"22753","Santa Cruz","Santa Cruz de La Sierra","Colegio Ignacio Warnes",56,0,1,2,105,7,16,2,6,195,3,8,206,232,0.538,0.888
"22754","Santa Cruz","Santa Cruz de La Sierra","Colegio Ignacio Warnes",73,1,1,1,92,7,27,2,4,208,0,1,209,228,0.442,0.917
"22755","Santa Cruz","Santa Cruz de La Sierra","Angelina Rivera",102,1,0,1,76,13,13,0,0,206,0,2,208,229,0.369,0.908
"22756","Santa Cruz","Santa Cruz de La Sierra","Angelina Rivera",107,1,1,2,66,16,16,0,1,210,2,3,215,233,0.314,0.923
"22757","Santa Cruz","Santa Cruz de La Sierra","Angelina Rivera",130,0,0,0,55,9,14,1,1,210,0,10,220,233,0.262,0.944
"22758","Santa Cruz","Santa Cruz de La Sierra","Angelina Rivera",109,1,0,0,60,18,20,0,0,208,1,9,218,236,0.288,0.924
"22759","Santa Cruz","Santa Cruz de La Sierra","Angelina Rivera",101,0,0,1,63,20,16,0,2,203,4,6,213,236,0.31,0.903
"22760","Santa Cruz","Santa Cruz de La Sierra","Col. Modulo # 5 Elva Antelo Jordan",95,0,0,0,77,13,18,1,1,205,2,5,212,233,0.376,0.91
"22761","Santa Cruz","Santa Cruz de La Sierra","Col. Modulo # 5 Elva Antelo Jordan",95,0,0,1,75,15,13,0,0,199,1,6,206,229,0.377,0.9
"22762","Santa Cruz","Santa Cruz de La Sierra","Col. Modulo # 5 Elva Antelo Jordan",89,1,0,1,70,15,28,2,1,207,2,2,211,236,0.338,0.894
"22763","Santa Cruz","Santa Cruz de La Sierra","Col. Modulo # 5 Elva Antelo Jordan",82,0,0,3,74,19,20,4,1,203,1,1,205,234,0.365,0.876
"22764","Santa Cruz","Santa Cruz de La Sierra","Col. Modulo # 5 Elva Antelo Jordan",51,1,0,1,112,11,19,0,6,201,0,6,207,234,0.557,0.885
"22765","Santa Cruz","Santa Cruz de La Sierra","Col. Modulo # 5 Elva Antelo Jordan",81,1,0,1,89,14,17,1,2,206,4,4,214,237,0.432,0.903
"22766","Santa Cruz","Santa Cruz de La Sierra","Col. Modulo # 5 Elva Antelo Jordan",84,1,0,1,73,17,18,2,1,197,3,7,207,233,0.371,0.888
"22767","Santa Cruz","Santa Cruz de La Sierra","Col. Modulo # 5 Elva Antelo Jordan",76,0,0,1,82,12,23,0,1,195,1,7,203,233,0.421,0.871
"22768","Santa Cruz","Santa Cruz de La Sierra","Col. Modulo # 5 Elva Antelo Jordan",100,0,0,1,66,15,15,0,3,200,1,4,205,227,0.33,0.903
"22769","Santa Cruz","Santa Cruz de La Sierra","Col. Modulo # 5 Elva Antelo Jordan",66,1,2,0,94,14,17,1,6,201,1,2,204,233,0.468,0.876
"22770","Santa Cruz","Santa Cruz de La Sierra","Col. Modulo # 5 Elva Antelo Jordan",78,0,2,3,70,22,16,1,4,196,0,6,202,230,0.357,0.878
"22771","Santa Cruz","Santa Cruz de La Sierra","Col. Modulo # 5 Elva Antelo Jordan",96,0,1,0,81,11,11,3,0,203,4,6,213,231,0.399,0.922
"22772","Santa Cruz","Santa Cruz de La Sierra","Col. Modulo # 5 Elva Antelo Jordan",92,0,0,5,79,15,12,0,0,203,1,1,205,235,0.389,0.872
"22773","Santa Cruz","Santa Cruz de La Sierra","Col. Modulo # 5 Elva Antelo Jordan",56,0,0,2,101,12,17,1,1,190,1,4,195,227,0.532,0.859
"22774","Santa Cruz","Santa Cruz de La Sierra","Col. Modulo # 5 Elva Antelo Jordan",104,0,1,2,62,10,19,1,1,200,0,2,202,236,0.31,0.856
"22775","Santa Cruz","Santa Cruz de La Sierra","Col. Modulo # 5 Elva Antelo Jordan",95,0,2,2,86,13,7,2,0,207,0,6,213,231,0.415,0.922
"22776","Santa Cruz","Santa Cruz de La Sierra","Col. Modulo # 5 Elva Antelo Jordan",84,0,1,0,87,10,17,1,1,201,2,4,207,234,0.433,0.885
"22777","Santa Cruz","Santa Cruz de La Sierra","Col. Modulo # 5 Elva Antelo Jordan",82,1,0,1,76,15,21,2,1,199,2,0,201,226,0.382,0.889
"22778","Santa Cruz","Santa Cruz de La Sierra","Col. Modulo # 5 Elva Antelo Jordan",81,0,1,1,93,15,10,0,1,202,1,6,209,232,0.46,0.901
"22779","Santa Cruz","Santa Cruz de La Sierra","Col. Luis Espinal Campos",77,1,0,4,79,17,15,1,1,195,3,8,206,231,0.405,0.892
"22780","Santa Cruz","Santa Cruz de La Sierra","Col. Luis Espinal Campos",75,1,0,0,79,23,14,2,0,194,4,8,206,232,0.407,0.888
"22781","Santa Cruz","Santa Cruz de La Sierra","Col. Luis Espinal Campos",81,1,0,0,79,8,21,1,0,191,0,6,197,231,0.414,0.853
"22782","Santa Cruz","Santa Cruz de La Sierra","Col. Luis Espinal Campos",57,0,2,0,88,12,26,1,1,187,1,9,197,232,0.471,0.849
"22783","Santa Cruz","Santa Cruz de La Sierra","Col. Luis Espinal Campos",63,1,1,0,98,16,22,0,0,201,0,5,206,229,0.488,0.9
"22784","Santa Cruz","Santa Cruz de La Sierra","Col. Luis Espinal Campos",59,1,0,2,103,13,25,0,0,203,3,3,209,226,0.507,0.925
"22785","Santa Cruz","Santa Cruz de La Sierra","Col. Luis Espinal Campos",45,1,1,0,119,9,23,1,2,201,0,6,207,230,0.592,0.9
"22786","Santa Cruz","Santa Cruz de La Sierra","Col. Luis Espinal Campos",79,0,1,0,86,14,20,2,0,202,2,2,206,233,0.426,0.884
"22787","Santa Cruz","Santa Cruz de La Sierra","Col. Luis Espinal Campos",59,1,2,1,92,10,24,1,1,191,1,10,202,227,0.482,0.89
"22788","Santa Cruz","Santa Cruz de La Sierra","Col. Luis Espinal Campos",48,1,1,2,94,21,24,0,1,192,2,3,197,231,0.49,0.853
"22789","Santa Cruz","Santa Cruz de La Sierra","Col. Luis Espinal Campos",80,0,0,1,84,19,19,0,1,204,2,6,212,234,0.412,0.906
"22790","Santa Cruz","Santa Cruz de La Sierra","Col. Luis Espinal Campos",62,0,2,1,107,11,20,1,0,204,1,1,206,227,0.525,0.907
"22791","Santa Cruz","Santa Cruz de La Sierra","Col. Luis Espinal Campos",71,1,0,1,86,15,16,1,0,191,3,8,202,231,0.45,0.874
"22792","Santa Cruz","Santa Cruz de La Sierra","Col. Luis Espinal Campos",71,0,0,1,84,15,23,1,1,196,1,7,204,230,0.429,0.887
"22793","Santa Cruz","Santa Cruz de La Sierra","Col. Luis Espinal Campos",42,0,0,1,112,7,25,0,1,188,4,5,197,232,0.596,0.849
"22794","Santa Cruz","Santa Cruz de La Sierra","Col. Luis Espinal Campos",90,0,1,1,62,25,19,1,1,200,1,8,209,228,0.31,0.917
"22795","Santa Cruz","Santa Cruz de La Sierra","Col. Luis Espinal Campos",68,0,0,0,79,18,22,2,1,190,0,10,200,231,0.416,0.866
"22796","Santa Cruz","Santa Cruz de La Sierra","Col. Luis Espinal Campos",70,0,0,4,85,14,20,2,0,195,0,5,200,233,0.436,0.858
"22797","Santa Cruz","Santa Cruz de La Sierra","Col. Luis Espinal Campos",81,1,2,2,84,17,14,1,1,203,1,8,212,230,0.414,0.922
"22798","Santa Cruz","Santa Cruz de La Sierra","Col. Luis Espinal Campos",88,0,0,3,85,13,11,2,0,202,2,2,206,228,0.421,0.904
"22799","Santa Cruz","Santa Cruz de La Sierra","Col. Luis Espinal Campos",52,0,0,0,112,11,20,1,1,197,4,10,211,232,0.569,0.909
"22800","Santa Cruz","Santa Cruz de La Sierra","Col. Luis Espinal Campos",58,0,1,0,101,13,19,1,2,195,0,8,203,233,0.518,0.871
"22801","Santa Cruz","Santa Cruz de La Sierra","Col. Luis Espinal Campos",80,0,0,0,82,10,19,2,1,194,3,4,201,232,0.423,0.866
"22802","Santa Cruz","Santa Cruz de La Sierra","Col. Luis Espinal Campos",75,1,0,2,74,22,24,0,2,200,2,2,204,232,0.37,0.879
"22803","Santa Cruz","Santa Cruz de La Sierra","Col. Luis Espinal Campos",58,1,0,0,86,17,20,1,1,184,1,10,195,230,0.467,0.848
"22804","Santa Cruz","Santa Cruz de La Sierra","Col. Luis Espinal Campos",82,2,0,4,57,30,1,2,0,178,40,9,227,233,0.32,0.974
"22805","Santa Cruz","Santa Cruz de La Sierra","Col. Luis Espinal Campos",82,0,0,3,73,21,21,2,1,203,2,5,210,233,0.36,0.901
"22806","Santa Cruz","Santa Cruz de La Sierra","Col. Luis Espinal Campos",70,0,0,1,87,11,15,3,0,187,2,6,195,229,0.465,0.852
"22807","Santa Cruz","Santa Cruz de La Sierra","Col. Luis Espinal Campos",66,1,1,3,86,10,20,0,1,188,2,8,198,228,0.457,0.868
"22808","Santa Cruz","Santa Cruz de La Sierra","Col. Luis Espinal Campos",52,0,1,0,105,7,22,0,3,190,3,6,199,220,0.553,0.905
"22809","Santa Cruz","Santa Cruz de La Sierra","Colegio Fuente Del Saber",41,0,0,0,135,16,9,0,3,204,3,7,214,232,0.662,0.922
"22810","Santa Cruz","Santa Cruz de La Sierra","Colegio Fuente Del Saber",47,1,0,1,108,28,12,4,2,203,0,9,212,235,0.532,0.902
"22811","Santa Cruz","Santa Cruz de La Sierra","Colegio Fuente Del Saber",51,1,0,1,124,19,11,1,1,209,1,8,218,234,0.593,0.932
"22812","Santa Cruz","Santa Cruz de La Sierra","Colegio Fuente Del Saber",48,0,0,0,122,16,11,1,0,198,7,9,214,233,0.616,0.918
"22813","Santa Cruz","Santa Cruz de La Sierra","Colegio Fuente Del Saber",56,2,1,1,112,20,8,0,1,201,4,9,214,232,0.557,0.922
"22814","Santa Cruz","Santa Cruz de La Sierra","Colegio Fuente Del Saber",61,0,1,3,113,22,9,1,0,210,1,8,219,236,0.538,0.928
"22815","Santa Cruz","Santa Cruz de La Sierra","Colegio Fuente Del Saber",26,0,0,0,101,20,5,4,0,156,0,4,160,173,0.647,0.925
"22816","Santa Cruz","Santa Cruz de La Sierra","Col. Escuela Poly Villarroel",117,0,0,0,49,23,11,2,2,204,0,2,206,229,0.24,0.9
"22817","Santa Cruz","Santa Cruz de La Sierra","Col. Escuela Poly Villarroel",99,1,0,3,70,15,18,0,1,207,1,4,212,232,0.338,0.914
"22818","Santa Cruz","Santa Cruz de La Sierra","Col. Escuela Poly Villarroel",125,1,0,1,52,10,7,2,0,198,2,4,204,227,0.263,0.899
"22819","Santa Cruz","Santa Cruz de La Sierra","Col. Escuela Poly Villarroel",92,0,0,0,50,27,12,3,1,185,4,7,196,234,0.27,0.838
"22820","Santa Cruz","Santa Cruz de La Sierra","Col. Escuela Poly Villarroel",133,1,0,0,48,13,13,2,3,213,1,4,218,236,0.225,0.924
"22821","Santa Cruz","Santa Cruz de La Sierra","Col. Escuela Poly Villarroel",106,0,0,3,61,25,14,0,0,209,0,7,216,234,0.292,0.923
"22822","Santa Cruz","Santa Cruz de La Sierra","Col. Escuela Poly Villarroel",104,1,0,3,58,17,14,6,0,203,2,7,212,233,0.286,0.91
"22823","Santa Cruz","Santa Cruz de La Sierra","Col. Escuela Poly Villarroel",123,2,0,0,49,22,12,1,0,209,1,4,214,233,0.234,0.918
"22824","Santa Cruz","Santa Cruz de La Sierra","Col. Escuela Poly Villarroel",110,1,1,1,54,27,16,3,2,215,0,3,218,232,0.251,0.94
"22825","Santa Cruz","Santa Cruz de La Sierra","Col. Escuela Bolivia Holanda",45,1,2,0,119,11,24,0,1,203,3,5,211,233,0.586,0.906
"22826","Santa Cruz","Santa Cruz de La Sierra","Col. Escuela Bolivia Holanda",55,0,0,1,98,22,23,1,0,200,4,11,215,233,0.49,0.923
"22827","Santa Cruz","Santa Cruz de La Sierra","Col. Escuela Bolivia Holanda",62,0,1,2,93,6,21,2,2,189,3,6,198,229,0.492,0.865
"22828","Santa Cruz","Santa Cruz de La Sierra","Col. Escuela Bolivia Holanda",44,0,1,1,119,11,17,0,2,195,3,9,207,231,0.61,0.896
"22829","Santa Cruz","Santa Cruz de La Sierra","Col. Escuela Bolivia Holanda",29,2,1,1,124,11,27,1,3,199,3,12,214,237,0.623,0.903
"22830","Santa Cruz","Santa Cruz de La Sierra","Col. Escuela Bolivia Holanda",28,0,0,1,144,7,25,2,6,213,1,5,219,233,0.676,0.94
"22831","Santa Cruz","Santa Cruz de La Sierra","Col. Escuela Bolivia Holanda",51,3,1,0,128,12,11,0,1,207,2,4,213,228,0.618,0.934
"22832","Santa Cruz","Santa Cruz de La Sierra","Col. Escuela Bolivia Holanda",40,0,0,1,124,10,19,1,2,197,5,5,207,232,0.629,0.892
"22833","Santa Cruz","Santa Cruz de La Sierra","Col. Escuela Bolivia Holanda",34,2,0,0,126,14,18,2,0,196,2,5,203,231,0.643,0.879
"22834","Santa Cruz","Santa Cruz de La Sierra","Col. Escuela Bolivia Holanda",56,1,0,0,112,15,15,1,4,204,2,6,212,234,0.549,0.906
"22835","Santa Cruz","Santa Cruz de La Sierra","Col. Escuela Bolivia Holanda",35,0,0,0,119,11,26,1,3,195,0,4,199,227,0.61,0.877
"22836","Santa Cruz","Santa Cruz de La Sierra","Col. Escuela Bolivia Holanda",41,1,0,1,124,11,13,1,6,198,1,13,212,234,0.626,0.906
"22837","Santa Cruz","Santa Cruz de La Sierra","Col. Escuela Bolivia Holanda",30,1,0,1,139,12,14,1,6,204,2,1,207,232,0.681,0.892
"22838","Santa Cruz","Santa Cruz de La Sierra","Col. Escuela Bolivia Holanda",47,0,0,0,125,17,17,0,2,208,1,4,213,235,0.601,0.906
"22839","Santa Cruz","Santa Cruz de La Sierra","Col. Escuela Bolivia Holanda",50,2,0,0,125,14,15,0,1,207,0,5,212,233,0.604,0.91
"22840","Santa Cruz","Santa Cruz de La Sierra","Col. Escuela Bolivia Holanda",46,0,1,0,101,18,20,0,5,191,0,7,198,233,0.529,0.85
"22841","Santa Cruz","Santa Cruz de La Sierra","Col. Escuela Bolivia Holanda",53,2,1,3,111,10,16,2,3,201,1,6,208,237,0.552,0.878
"22842","Santa Cruz","Santa Cruz de La Sierra","Col. Escuela Bolivia Holanda",39,3,1,1,128,5,29,0,2,208,2,2,212,231,0.615,0.918
"22843","Santa Cruz","Santa Cruz de La Sierra","Col. Escuela Bolivia Holanda",72,0,0,1,85,21,26,2,2,209,3,5,217,233,0.407,0.931
"22844","Santa Cruz","Santa Cruz de La Sierra","Col. Escuela Bolivia Holanda",56,0,0,0,108,12,20,3,2,201,0,3,204,230,0.537,0.887
"22845","Santa Cruz","Santa Cruz de La Sierra","Col. Escuela Bolivia Holanda",44,0,1,3,106,9,23,0,3,189,4,16,209,231,0.561,0.905
"22846","Santa Cruz","Santa Cruz de La Sierra","Col. Escuela Bolivia Holanda",48,0,0,1,115,16,21,1,1,203,0,4,207,226,0.567,0.916
"22847","Santa Cruz","Santa Cruz de La Sierra","Col. Escuela Bolivia Holanda",38,1,1,2,124,17,20,1,2,206,3,7,216,236,0.602,0.915
"22848","Santa Cruz","Santa Cruz de La Sierra","Col. Normandia Josefina Balsamo",79,0,0,0,101,12,14,1,0,207,2,6,215,232,0.488,0.927
"22849","Santa Cruz","Santa Cruz de La Sierra","Col. Normandia Josefina Balsamo",77,0,1,0,82,14,10,2,1,187,2,5,194,228,0.439,0.851
"22850","Santa Cruz","Santa Cruz de La Sierra","Col. Normandia Josefina Balsamo",60,1,0,0,108,10,8,3,0,190,5,4,199,222,0.568,0.896
"22851","Santa Cruz","Santa Cruz de La Sierra","Col. Normandia Josefina Balsamo",66,0,0,0,103,17,13,1,1,201,1,8,210,234,0.512,0.897
"22852","Santa Cruz","Santa Cruz de La Sierra","Col. Normandia Josefina Balsamo",38,0,0,0,135,18,14,1,1,207,1,4,212,232,0.652,0.914
"22853","Santa Cruz","Santa Cruz de La Sierra","Col. Normandia Josefina Balsamo",69,0,0,0,96,17,12,0,1,195,1,5,201,229,0.492,0.878
"22854","Santa Cruz","Santa Cruz de La Sierra","Col. Normandia Josefina Balsamo",51,1,1,1,109,16,8,0,0,187,2,7,196,217,0.583,0.903
"22855","Santa Cruz","Santa Cruz de La Sierra","Col. Normandia Josefina Balsamo",71,2,0,0,92,24,0,0,2,191,3,6,200,228,0.482,0.877
"22856","Santa Cruz","Santa Cruz de La Sierra","Col. Normandia Josefina Balsamo",81,0,0,0,100,12,8,0,0,201,1,11,213,229,0.498,0.93
"22857","Santa Cruz","Santa Cruz de La Sierra","Col. Normandia Josefina Balsamo",59,0,2,0,112,10,17,1,1,202,4,4,210,227,0.554,0.925
"22858","Santa Cruz","Santa Cruz de La Sierra","Col. Normandia Josefina Balsamo",73,0,0,1,88,16,14,5,0,197,1,10,208,229,0.447,0.908
"22859","Santa Cruz","Santa Cruz de La Sierra","Col. Normandia Josefina Balsamo",72,1,1,0,82,16,8,1,0,181,7,7,195,229,0.453,0.852
"22860","Santa Cruz","Santa Cruz de La Sierra","Col. Normandia Josefina Balsamo",79,1,1,2,81,18,19,1,0,202,2,2,206,235,0.401,0.877
"22861","Santa Cruz","Santa Cruz de La Sierra","Col. Normandia Josefina Balsamo",63,2,1,3,107,12,8,1,0,197,2,4,203,223,0.543,0.91
"22862","Santa Cruz","Santa Cruz de La Sierra","Col. Normandia Josefina Balsamo",72,1,0,0,88,19,13,4,3,200,0,7,207,226,0.44,0.916
"22863","Santa Cruz","Santa Cruz de La Sierra","Col. Normandia Josefina Balsamo",73,2,1,0,83,22,15,1,0,197,1,7,205,228,0.421,0.899
"22864","Santa Cruz","Santa Cruz de La Sierra","Col. Normandia Josefina Balsamo",80,1,0,2,80,17,15,4,1,200,6,27,233,233,0.4,1
"22865","Santa Cruz","Santa Cruz de La Sierra","Col. Normandia Josefina Balsamo",69,0,0,0,83,22,16,0,0,190,3,4,197,226,0.437,0.872
"22866","Santa Cruz","Santa Cruz de La Sierra","Col. Normandia Josefina Balsamo",54,0,0,1,108,18,9,2,2,194,2,5,201,225,0.557,0.893
"22867","Santa Cruz","Santa Cruz de La Sierra","Col. Esc. Inocencio Roman",32,0,0,1,113,23,18,2,0,189,0,10,199,230,0.598,0.865
"22868","Santa Cruz","Santa Cruz de La Sierra","Col. Esc. Inocencio Roman",37,1,0,1,111,14,17,0,0,181,3,7,191,231,0.613,0.827
"22869","Santa Cruz","Santa Cruz de La Sierra","Col. Esc. Inocencio Roman",32,0,0,2,106,25,17,0,2,184,3,6,193,224,0.576,0.862
"22870","Santa Cruz","Santa Cruz de La Sierra","Col. Esc. Inocencio Roman",26,0,0,1,112,35,18,0,2,194,3,5,202,230,0.577,0.878
"22871","Santa Cruz","Santa Cruz de La Sierra","Col. Esc. Inocencio Roman",38,0,0,0,117,24,8,2,2,191,1,9,201,226,0.613,0.889
"22872","Santa Cruz","Santa Cruz de La Sierra","Col. Esc. Inocencio Roman",29,1,0,1,136,15,17,2,1,202,2,5,209,225,0.673,0.929
"22873","Santa Cruz","Santa Cruz de La Sierra","Col. Esc. Inocencio Roman",44,2,1,1,94,30,13,5,0,190,5,6,201,225,0.495,0.893
"22874","Santa Cruz","Santa Cruz de La Sierra","Col. Esc. Inocencio Roman",34,1,0,1,112,14,19,1,1,183,0,4,187,224,0.612,0.835
"22875","Santa Cruz","Santa Cruz de La Sierra","Col. Esc. Inocencio Roman",43,0,1,1,108,29,16,3,1,202,2,6,210,231,0.535,0.909
"22876","Santa Cruz","Santa Cruz de La Sierra","Col. Esc. Inocencio Roman",41,2,1,2,121,15,7,2,1,192,2,5,199,226,0.63,0.881
"22877","Santa Cruz","Santa Cruz de La Sierra","Col. Esc. Inocencio Roman",64,0,1,0,96,25,15,1,0,202,2,3,207,227,0.475,0.912
"22878","Santa Cruz","Santa Cruz de La Sierra","Col. Esc. Inocencio Roman",32,1,2,0,112,17,16,2,1,183,2,7,192,221,0.612,0.869
"22879","Santa Cruz","Santa Cruz de La Sierra","Col. Esc. Inocencio Roman",56,1,1,2,90,17,13,1,0,181,2,6,189,229,0.497,0.825
"22880","Santa Cruz","Santa Cruz de La Sierra","Col. Esc. Inocencio Roman",38,0,2,0,118,14,0,2,0,174,6,5,185,226,0.678,0.819
"22881","Santa Cruz","Santa Cruz de La Sierra","Col. Esc. Inocencio Roman",42,1,2,0,100,25,11,2,1,184,2,5,191,228,0.543,0.838
"22882","Santa Cruz","Santa Cruz de La Sierra","Col. Esc. Inocencio Roman",49,1,0,1,104,20,13,2,2,192,2,3,197,225,0.542,0.876
"22883","Santa Cruz","Santa Cruz de La Sierra","Col. Esc. Inocencio Roman",49,2,1,2,110,16,15,2,0,197,1,6,204,229,0.558,0.891
"22884","Santa Cruz","Santa Cruz de La Sierra","Col. Esc. Inocencio Roman",52,0,2,2,94,13,21,4,0,188,3,6,197,228,0.5,0.864
"22885","Santa Cruz","Santa Cruz de La Sierra","Col. Esc. Inocencio Roman",57,0,1,2,71,24,19,2,1,177,7,13,197,226,0.401,0.872
"22886","Santa Cruz","Santa Cruz de La Sierra","Col. Esc. Inocencio Roman",45,1,1,0,100,36,12,1,0,196,2,7,205,230,0.51,0.891
"22887","Santa Cruz","Santa Cruz de La Sierra","Col. Esc. Inocencio Roman",33,1,1,0,106,25,11,1,2,180,4,7,191,223,0.589,0.857
"22888","Santa Cruz","Santa Cruz de La Sierra","Col. Esc. Inocencio Roman",36,1,0,0,121,21,11,0,0,190,3,7,200,227,0.637,0.881
"22889","Santa Cruz","Santa Cruz de La Sierra","Col. Castilla La Mancha",85,0,1,2,65,17,16,1,0,187,4,10,201,230,0.348,0.874
"22890","Santa Cruz","Santa Cruz de La Sierra","Col. Castilla La Mancha",88,1,2,0,82,12,13,0,0,198,2,3,203,230,0.414,0.883
"22891","Santa Cruz","Santa Cruz de La Sierra","Col. Castilla La Mancha",82,0,1,1,77,18,12,3,1,195,1,8,204,228,0.395,0.895
"22892","Santa Cruz","Santa Cruz de La Sierra","Col. Castilla La Mancha",102,0,0,1,52,16,14,2,0,187,0,5,192,229,0.278,0.838
"22893","Santa Cruz","Santa Cruz de La Sierra","Col. Castilla La Mancha",93,0,0,2,78,16,5,0,2,196,1,4,201,229,0.398,0.878
"22894","Santa Cruz","Santa Cruz de La Sierra","Col. Castilla La Mancha",100,0,1,0,56,9,9,3,0,178,1,14,193,231,0.315,0.835
"22895","Santa Cruz","Santa Cruz de La Sierra","Col. Castilla La Mancha",80,0,0,1,83,6,19,1,0,190,0,14,204,230,0.437,0.887
"22896","Santa Cruz","Santa Cruz de La Sierra","Col. Castilla La Mancha",80,0,3,2,77,15,11,0,1,189,0,6,195,222,0.407,0.878
"22897","Santa Cruz","Santa Cruz de La Sierra","Col. Castilla La Mancha",97,0,0,0,63,21,14,1,0,196,0,5,201,229,0.321,0.878
"22898","Santa Cruz","Santa Cruz de La Sierra","Col. Castilla La Mancha",64,0,0,3,109,10,13,1,1,201,1,5,207,231,0.542,0.896
"22899","Santa Cruz","Santa Cruz de La Sierra","Col. Castilla La Mancha",71,0,3,0,96,13,15,2,1,201,0,5,206,226,0.478,0.912
"22900","Santa Cruz","Santa Cruz de La Sierra","Col. Castilla La Mancha",107,0,0,0,67,17,7,0,0,198,2,8,208,229,0.338,0.908
"22901","Santa Cruz","Santa Cruz de La Sierra","Col. Castilla La Mancha",96,1,0,1,59,10,7,0,0,174,3,13,190,219,0.339,0.868
"22902","Santa Cruz","Santa Cruz de La Sierra","Col. Castilla La Mancha",84,0,0,0,60,29,18,0,0,191,2,4,197,231,0.314,0.853
"22903","Santa Cruz","Santa Cruz de La Sierra","Col. Castilla La Mancha",65,0,1,2,81,18,13,1,1,182,0,10,192,224,0.445,0.857
"22904","Santa Cruz","Santa Cruz de La Sierra","Col. Castilla La Mancha",95,0,1,1,73,14,10,2,1,197,1,5,203,232,0.371,0.875
"22905","Santa Cruz","Santa Cruz de La Sierra","Col. Castilla La Mancha",106,0,0,1,57,17,12,3,0,196,2,9,207,232,0.291,0.892
"22906","Santa Cruz","Santa Cruz de La Sierra","Col. Castilla La Mancha",84,0,1,0,84,16,12,2,0,199,1,9,209,230,0.422,0.909
"22907","Santa Cruz","Santa Cruz de La Sierra","Col. Castilla La Mancha",91,2,1,0,66,15,7,1,0,183,0,8,191,225,0.361,0.849
"22908","Santa Cruz","Santa Cruz de La Sierra","Col. Castilla La Mancha",82,0,0,0,94,15,11,0,2,204,2,6,212,235,0.461,0.902
"22909","Santa Cruz","Santa Cruz de La Sierra","Col. Castilla La Mancha",99,0,1,1,62,14,8,1,0,186,4,7,197,224,0.333,0.879
"22910","Santa Cruz","Santa Cruz de La Sierra","Col. Castilla La Mancha",82,2,0,1,75,12,27,1,1,201,2,5,208,229,0.373,0.908
"22911","Santa Cruz","Santa Cruz de La Sierra","Col. Castilla La Mancha",87,1,0,0,78,13,11,2,0,192,2,8,202,227,0.406,0.89
"22912","Santa Cruz","Santa Cruz de La Sierra","Col. Castilla La Mancha",48,2,2,1,123,8,14,0,1,199,1,4,204,231,0.618,0.883
"22913","Santa Cruz","Santa Cruz de La Sierra","Col. Castilla La Mancha",100,0,0,1,69,15,17,3,1,206,0,7,213,230,0.335,0.926
"22914","Santa Cruz","Santa Cruz de La Sierra","Col. Castilla La Mancha",104,0,0,1,37,24,15,0,1,182,0,4,186,229,0.203,0.812
"22915","Santa Cruz","Santa Cruz de La Sierra","Col. Castilla La Mancha",110,0,0,4,57,14,10,0,0,195,1,9,205,228,0.292,0.899
"22916","Santa Cruz","Santa Cruz de La Sierra","Col. Castilla La Mancha",91,0,1,1,64,18,9,2,0,186,0,4,190,223,0.344,0.852
"22917","Santa Cruz","Santa Cruz de La Sierra","Col. Castilla La Mancha",90,1,1,2,53,17,17,1,0,182,2,7,191,225,0.291,0.849
"22918","Santa Cruz","Santa Cruz de La Sierra","Col. Castilla La Mancha",82,0,2,1,72,20,8,1,1,187,1,5,193,229,0.385,0.843
"22919","Santa Cruz","Santa Cruz de La Sierra","Col. Castilla La Mancha",91,1,2,0,71,17,13,1,1,197,1,6,204,228,0.36,0.895
"22920","Santa Cruz","Santa Cruz de La Sierra","Col. Castilla La Mancha",116,0,0,3,43,21,10,2,0,195,0,2,197,226,0.221,0.872
"22921","Santa Cruz","Santa Cruz de La Sierra","Col. Castilla La Mancha",69,0,0,1,88,18,19,2,2,199,3,4,206,228,0.442,0.904
"22922","Santa Cruz","Santa Cruz de La Sierra","Col. Castilla La Mancha",63,0,1,0,120,10,14,1,1,210,0,4,214,225,0.571,0.951
"22923","Santa Cruz","Santa Cruz de La Sierra","Col. Castilla La Mancha",98,0,0,1,78,12,15,2,1,207,0,8,215,232,0.377,0.927
"22924","Santa Cruz","Santa Cruz de La Sierra","Col. Castilla La Mancha",109,0,0,0,41,22,11,1,0,184,1,5,190,229,0.223,0.83
"22925","Santa Cruz","Santa Cruz de La Sierra","Col. Castilla La Mancha",84,1,0,0,79,20,10,1,0,195,1,8,204,230,0.405,0.887
"22926","Santa Cruz","Santa Cruz de La Sierra","Col. Castilla La Mancha",111,0,0,0,61,14,8,1,0,195,1,5,201,233,0.313,0.863
"22927","Santa Cruz","Santa Cruz de La Sierra","Col. Castilla La Mancha",100,0,0,3,61,17,14,3,0,198,1,5,204,233,0.308,0.876
"22928","Santa Cruz","Santa Cruz de La Sierra","Col. Castilla La Mancha",83,1,0,2,68,19,14,0,3,190,1,5,196,230,0.358,0.852
"22929","Santa Cruz","Santa Cruz de La Sierra","Col. Castilla La Mancha",97,1,1,0,56,12,15,2,0,184,0,10,194,225,0.304,0.862
"22930","Santa Cruz","Santa Cruz de La Sierra","Col. Castilla La Mancha",90,0,0,0,59,24,13,0,0,186,2,9,197,228,0.317,0.864
"22931","Santa Cruz","Santa Cruz de La Sierra","Col. Castilla La Mancha",78,0,1,0,90,13,14,0,0,196,2,3,201,227,0.459,0.885
"22932","Santa Cruz","Santa Cruz de La Sierra","Col. Castilla La Mancha",116,3,0,1,46,20,10,2,1,199,1,4,204,228,0.231,0.895
"22933","Santa Cruz","Santa Cruz de La Sierra","Col. Castilla La Mancha",91,0,0,0,68,19,15,1,0,194,1,8,203,227,0.351,0.894
"22934","Santa Cruz","Santa Cruz de La Sierra","Col. Castilla La Mancha",90,1,2,2,70,11,15,0,0,191,1,7,199,233,0.366,0.854
"22935","Santa Cruz","Santa Cruz de La Sierra","Col. Castilla La Mancha",73,1,0,0,77,22,15,2,1,191,3,4,198,230,0.403,0.861
"22936","Santa Cruz","Santa Cruz de La Sierra","U.E. San Juan del Este",50,0,0,1,128,24,12,3,1,219,1,5,225,237,0.584,0.949
"22937","Santa Cruz","Santa Cruz de La Sierra","U.E. San Juan del Este",23,0,0,0,158,24,12,2,0,219,1,9,229,238,0.721,0.962
"22938","Santa Cruz","Santa Cruz de La Sierra","U.E. San Juan del Este",52,0,1,1,124,21,12,5,0,216,2,6,224,238,0.574,0.941
"22939","Santa Cruz","Santa Cruz de La Sierra","U.E. San Juan del Este",48,1,1,3,118,22,21,2,1,217,1,7,225,240,0.544,0.938
"22940","Santa Cruz","Santa Cruz de La Sierra","U.E. San Juan del Este",56,0,1,3,122,20,15,0,1,218,2,4,224,236,0.56,0.949
"22941","Santa Cruz","Santa Cruz de La Sierra","U.E. 19 de Marzo",51,1,2,0,130,18,15,1,3,221,2,4,227,238,0.588,0.954
"22942","Santa Cruz","Santa Cruz de La Sierra","U.E. 19 de Marzo",39,1,0,1,135,13,21,2,3,215,1,7,223,237,0.628,0.941
"22943","Santa Cruz","Santa Cruz de La Sierra","U.E. 19 de Marzo",45,2,0,0,120,12,35,2,4,220,3,5,228,237,0.545,0.962
"22944","Santa Cruz","Santa Cruz de La Sierra","U.E. 19 de Marzo",60,0,0,0,115,20,26,0,3,224,2,2,228,238,0.513,0.958
"22945","Santa Cruz","Santa Cruz de La Sierra","U.E. 19 de Marzo",49,0,2,0,127,17,13,1,0,209,1,5,215,235,0.608,0.915
"22946","Santa Cruz","Santa Cruz de La Sierra","U.E. Villa Moderna",54,1,0,1,105,20,19,2,1,203,3,6,212,236,0.517,0.898
"22947","Santa Cruz","Santa Cruz de La Sierra","U.E. Villa Moderna",44,0,0,0,115,21,19,1,0,200,3,10,213,237,0.575,0.899
"22948","Santa Cruz","Santa Cruz de La Sierra","U.E. Villa Moderna",52,0,0,0,119,11,19,2,1,204,1,4,209,237,0.583,0.882
"22949","Santa Cruz","Santa Cruz de La Sierra","U.E. Villa Moderna",74,0,1,0,91,16,24,1,1,208,1,5,214,237,0.438,0.903
"22950","Santa Cruz","Santa Cruz de La Sierra","U.E. Villa Moderna",62,0,0,0,101,17,15,4,1,200,1,8,209,239,0.505,0.874
"22951","Santa Cruz","Santa Cruz de La Sierra","U.E. San Diego de Samaria",45,0,1,1,121,19,17,0,0,204,4,7,215,236,0.593,0.911
"22952","Santa Cruz","Santa Cruz de La Sierra","U.E. San Diego de Samaria",55,0,0,0,101,24,18,1,1,200,1,7,208,236,0.505,0.881
"22953","Santa Cruz","Santa Cruz de La Sierra","U.E. San Diego de Samaria",62,0,1,3,97,27,13,1,1,205,1,9,215,236,0.473,0.911
"22954","Santa Cruz","Santa Cruz de La Sierra","U.E. San Diego de Samaria",57,0,0,0,106,25,14,3,1,206,3,10,219,236,0.515,0.928
"22955","Santa Cruz","Santa Cruz de La Sierra","U.E. Paraíso de los Infantes",60,1,0,1,119,23,12,1,1,218,2,5,225,239,0.546,0.941
"22956","Santa Cruz","Santa Cruz de La Sierra","U.E. Paraíso de los Infantes",66,1,1,1,103,22,19,3,3,219,5,4,228,239,0.47,0.954
"22957","Santa Cruz","Santa Cruz de La Sierra","U.E. Paraíso de los Infantes",69,0,0,0,98,23,24,2,3,219,4,4,227,239,0.447,0.95
"22958","Santa Cruz","Santa Cruz de La Sierra","U.E. Manantial De Vida",53,0,1,0,111,29,17,0,0,211,4,4,219,235,0.526,0.932
"22959","Santa Cruz","Santa Cruz de La Sierra","U.E. Manantial De Vida",24,0,1,2,122,21,20,2,0,192,6,9,207,233,0.635,0.888
"22960","Santa Cruz","Santa Cruz de La Sierra","U.E. Manantial De Vida",41,0,2,0,125,11,25,2,0,206,2,7,215,238,0.607,0.903
"22961","Santa Cruz","Santa Cruz de La Sierra","U.E. Manantial De Vida",57,1,1,4,99,27,12,3,1,205,1,4,210,237,0.483,0.886
"22962","Santa Cruz","Santa Cruz de La Sierra","U.E. Manantial De Vida",51,2,0,1,116,19,19,2,2,212,1,7,220,236,0.547,0.932
"22963","Santa Cruz","Santa Cruz de La Sierra","U.E. Manantial De Vida",47,0,0,0,127,20,9,1,1,205,3,3,211,231,0.62,0.913
"22964","Santa Cruz","Santa Cruz de La Sierra","U.E. Manantial De Vida",46,2,1,0,118,25,14,2,0,208,1,11,220,238,0.567,0.924
"22965","Santa Cruz","Santa Cruz de La Sierra","U.E. Manantial De Vida",53,0,0,0,98,24,20,3,1,199,4,9,212,238,0.492,0.891
"22966","Santa Cruz","Santa Cruz de La Sierra","U.E. Juancito Pinto",81,0,0,1,90,22,20,1,2,217,3,6,226,240,0.415,0.942
"22967","Santa Cruz","Santa Cruz de La Sierra","U.E. Juancito Pinto",95,0,0,0,81,14,19,1,2,212,2,9,223,239,0.382,0.933
"22968","Santa Cruz","Santa Cruz de La Sierra","U.E. Juancito Pinto",88,1,0,1,88,15,20,0,2,215,1,10,226,240,0.409,0.942
"22969","Santa Cruz","Santa Cruz de La Sierra","U.E. Juancito Pinto",91,1,0,1,85,13,25,2,0,218,0,4,222,239,0.39,0.929
"22970","Santa Cruz","Santa Cruz de La Sierra","Colegio Martin Sapp",96,0,1,1,54,19,9,2,2,184,1,10,195,220,0.293,0.886
"22971","Santa Cruz","Santa Cruz de La Sierra","Colegio Martin Sapp",118,0,1,0,60,11,11,0,1,202,0,2,204,227,0.297,0.899
"22972","Santa Cruz","Santa Cruz de La Sierra","Colegio Martin Sapp",127,0,0,0,50,11,5,2,2,197,1,25,223,223,0.254,1
"22973","Santa Cruz","Santa Cruz de La Sierra","Colegio Martin Sapp",119,1,0,2,48,15,13,1,0,199,3,28,230,230,0.241,1
"22974","Santa Cruz","Santa Cruz de La Sierra","Colegio Martin Sapp",116,0,1,1,53,15,15,2,0,203,1,27,231,231,0.261,1
"22975","Santa Cruz","Santa Cruz de La Sierra","Colegio Martin Sapp",90,0,0,1,66,11,21,1,2,192,0,32,224,224,0.344,1
"22976","Santa Cruz","Santa Cruz de La Sierra","Colegio Martin Sapp",116,0,0,1,48,11,13,1,2,192,2,1,195,229,0.25,0.852
"22977","Santa Cruz","Santa Cruz de La Sierra","Colegio Martin Sapp",110,0,0,1,58,10,11,0,2,192,2,5,199,227,0.302,0.877
"22978","Santa Cruz","Santa Cruz de La Sierra","Colegio Martin Sapp",118,0,0,1,53,14,8,1,1,196,1,4,201,226,0.27,0.889
"22979","Santa Cruz","Santa Cruz de La Sierra","Colegio Martin Sapp",113,0,0,1,49,12,11,2,0,188,32,7,227,227,0.261,1
"22980","Santa Cruz","Santa Cruz de La Sierra","Colegio Martin Sapp",130,1,0,1,35,19,9,0,0,195,1,2,198,228,0.179,0.868
"22981","Santa Cruz","Santa Cruz de La Sierra","Colegio Martin Sapp",104,0,1,3,58,12,16,0,1,195,2,3,200,227,0.297,0.881
"22982","Santa Cruz","Santa Cruz de La Sierra","Colegio Martin Sapp",106,0,0,0,55,11,17,0,1,190,2,6,198,228,0.289,0.868
"22983","Santa Cruz","Santa Cruz de La Sierra","Colegio Martin Sapp",118,0,0,0,57,8,10,1,0,194,5,2,201,230,0.294,0.874
"22984","Santa Cruz","Santa Cruz de La Sierra","Colegio Martin Sapp",129,0,0,1,43,11,13,1,1,199,2,7,208,231,0.216,0.9
"22985","Santa Cruz","Santa Cruz de La Sierra","Colegio Martin Sapp",111,0,1,2,48,21,13,3,0,199,1,8,208,230,0.241,0.904
"22986","Santa Cruz","Santa Cruz de La Sierra","Colegio Martin Sapp",126,0,0,1,44,13,13,0,2,199,1,6,206,230,0.221,0.896
"22987","Santa Cruz","Santa Cruz de La Sierra","Colegio Martin Sapp",99,1,0,0,64,19,16,0,2,201,0,5,206,222,0.318,0.928
"22988","Santa Cruz","Santa Cruz de La Sierra","Colegio Martin Sapp",95,0,2,0,62,20,15,0,2,196,2,6,204,229,0.316,0.891
"22989","Santa Cruz","Santa Cruz de La Sierra","Colegio Martin Sapp",124,1,0,0,37,17,15,1,1,196,1,4,201,233,0.189,0.863
"22990","Santa Cruz","Santa Cruz de La Sierra","Colegio Martin Sapp",117,0,0,1,46,12,13,0,2,191,1,3,195,224,0.241,0.871
"22991","Santa Cruz","Santa Cruz de La Sierra","Colegio Martin Sapp",121,0,0,1,48,17,11,1,1,200,0,5,205,232,0.24,0.884
"22992","Santa Cruz","Santa Cruz de La Sierra","Colegio Martin Sapp",127,0,1,0,34,17,18,1,0,198,0,5,203,233,0.172,0.871
"22993","Santa Cruz","Santa Cruz de La Sierra","Colegio Martin Sapp",113,0,0,0,64,12,12,1,1,203,0,6,209,229,0.315,0.913
"22994","Santa Cruz","Santa Cruz de La Sierra","U.E. Bautista Vida Nueva",129,0,0,0,55,18,15,1,1,219,2,3,224,240,0.251,0.933
"22995","Santa Cruz","Santa Cruz de La Sierra","U.E. Bautista Vida Nueva",143,1,2,0,41,17,17,2,0,223,0,5,228,235,0.184,0.97
"22996","Santa Cruz","Santa Cruz de La Sierra","Col. Ciudad Niño Jesus",110,0,0,2,44,14,16,1,0,187,1,10,198,231,0.235,0.857
"22997","Santa Cruz","Santa Cruz de La Sierra","Col. Ciudad Niño Jesus",136,0,0,0,34,22,13,1,0,206,0,3,209,229,0.165,0.913
"22998","Santa Cruz","Santa Cruz de La Sierra","Col. Ciudad Niño Jesus",133,0,0,0,38,11,9,0,0,191,2,2,195,227,0.199,0.859
"22999","Santa Cruz","Santa Cruz de La Sierra","Col. Ciudad Niño Jesus",106,0,1,2,58,14,13,2,1,197,4,4,205,226,0.294,0.907
"23000","Santa Cruz","Santa Cruz de La Sierra","Col. Ciudad Niño Jesus",102,0,1,0,65,6,7,0,1,182,1,15,198,226,0.357,0.876
"23001","Santa Cruz","Santa Cruz de La Sierra","Col. Ciudad Niño Jesus",123,0,0,3,36,6,26,2,1,197,0,8,205,229,0.183,0.895
"23002","Santa Cruz","Santa Cruz de La Sierra","Col. Ciudad Niño Jesus",105,0,0,1,61,12,16,0,0,195,2,2,199,225,0.313,0.884
"23003","Santa Cruz","Santa Cruz de La Sierra","Col. Ciudad Niño Jesus",110,0,0,1,53,17,8,0,1,190,0,8,198,226,0.279,0.876
"23004","Santa Cruz","Santa Cruz de La Sierra","Col. Ciudad Niño Jesus",133,0,0,1,36,16,14,0,0,200,1,5,206,228,0.18,0.904
"23005","Santa Cruz","Santa Cruz de La Sierra","Col. Ciudad Niño Jesus",118,0,0,1,45,10,12,2,0,188,1,6,195,226,0.239,0.863
"23006","Santa Cruz","Santa Cruz de La Sierra","Col. Ciudad Niño Jesus",86,1,2,1,79,10,13,1,1,194,2,12,208,230,0.407,0.904
"23007","Santa Cruz","Santa Cruz de La Sierra","Col. Ciudad Niño Jesus",124,0,0,0,48,18,15,0,2,207,0,5,212,230,0.232,0.922
"23008","Santa Cruz","Santa Cruz de La Sierra","Col. Ciudad Niño Jesus",123,0,0,1,42,18,9,1,0,194,0,7,201,223,0.216,0.901
"23009","Santa Cruz","Santa Cruz de La Sierra","Col. Ciudad Niño Jesus",114,0,0,1,67,7,12,0,0,201,0,3,204,223,0.333,0.915
"23010","Santa Cruz","Santa Cruz de La Sierra","Col. Ciudad Niño Jesus",118,1,0,0,48,11,18,1,1,198,0,6,204,228,0.242,0.895
"23011","Santa Cruz","Santa Cruz de La Sierra","Col. Ciudad Niño Jesus",121,0,0,1,46,8,10,1,2,189,2,3,194,222,0.243,0.874
"23012","Santa Cruz","Santa Cruz de La Sierra","Col. Ciudad Niño Jesus",124,0,0,3,52,16,7,2,0,204,2,8,214,232,0.255,0.922
"23013","Santa Cruz","Santa Cruz de La Sierra","Col. Ciudad Niño Jesus",123,0,0,2,41,22,10,0,0,198,1,3,202,228,0.207,0.886
"23014","Santa Cruz","Santa Cruz de La Sierra","Col. Ciudad Niño Jesus",129,0,0,1,30,17,19,2,0,198,2,6,206,227,0.152,0.907
"23015","Santa Cruz","Santa Cruz de La Sierra","Col. Ciudad Niño Jesus",112,1,0,1,59,15,12,2,0,202,0,6,208,230,0.292,0.904
"23016","Santa Cruz","Santa Cruz de La Sierra","Col. Ciudad Niño Jesus",118,1,0,0,53,11,10,1,0,194,0,4,198,225,0.273,0.88
"23017","Santa Cruz","Santa Cruz de La Sierra","U.E. Nestor Paz Zamora",114,0,0,1,49,14,23,4,1,206,0,9,215,238,0.238,0.903
"23018","Santa Cruz","Santa Cruz de La Sierra","U.E. Nestor Paz Zamora",109,0,0,1,61,14,21,1,1,208,2,11,221,238,0.293,0.929
"23019","Santa Cruz","Santa Cruz de La Sierra","U.E. Nestor Paz Zamora",105,0,0,0,57,25,23,1,5,216,2,6,224,240,0.264,0.933
"23020","Santa Cruz","Santa Cruz de La Sierra","U.E. Nestor Paz Zamora",125,1,0,0,60,14,14,0,2,216,2,8,226,239,0.278,0.946
"23021","Santa Cruz","Santa Cruz de La Sierra","U.E. Nestor Paz Zamora",112,0,0,0,74,18,12,0,1,217,0,2,219,236,0.341,0.928
"23022","Santa Cruz","Santa Cruz de La Sierra","U.E. Nestor Paz Zamora",111,0,0,1,64,17,17,1,0,211,0,4,215,238,0.303,0.903
"23023","Santa Cruz","Santa Cruz de La Sierra","U.E. Nestor Paz Zamora",123,0,0,0,54,17,14,0,0,208,0,3,211,235,0.26,0.898
"23024","Santa Cruz","Santa Cruz de La Sierra","U.E. Nestor Paz Zamora",110,0,0,1,66,20,16,1,1,215,1,2,218,236,0.307,0.924
"23025","Santa Cruz","Santa Cruz de La Sierra","Colegio Adela Zamudio",101,0,0,0,85,12,7,0,0,205,0,3,208,232,0.415,0.897
"23026","Santa Cruz","Santa Cruz de La Sierra","Colegio Adela Zamudio",125,2,0,0,54,16,8,0,0,205,0,5,210,230,0.263,0.913
"23027","Santa Cruz","Santa Cruz de La Sierra","Colegio Adela Zamudio",110,0,0,1,61,8,14,1,1,196,2,2,200,230,0.311,0.87
"23028","Santa Cruz","Santa Cruz de La Sierra","Colegio Adela Zamudio",121,0,0,0,54,10,18,0,0,203,0,12,215,233,0.266,0.923
"23029","Santa Cruz","Santa Cruz de La Sierra","Colegio Adela Zamudio",85,0,1,2,79,9,21,0,0,197,2,1,200,230,0.401,0.87
"23030","Santa Cruz","Santa Cruz de La Sierra","Colegio Adela Zamudio",117,0,0,1,71,8,14,3,1,215,1,2,218,234,0.33,0.932
"23031","Santa Cruz","Santa Cruz de La Sierra","Colegio Adela Zamudio",100,0,0,0,64,14,18,2,1,199,0,4,203,233,0.322,0.871
"23032","Santa Cruz","Santa Cruz de La Sierra","Colegio Adela Zamudio",88,0,0,1,87,6,17,1,4,204,26,2,232,232,0.426,1
"23033","Santa Cruz","Santa Cruz de La Sierra","Colegio Adela Zamudio",114,1,0,0,48,15,20,0,0,198,0,9,207,230,0.242,0.9
"23034","Santa Cruz","Santa Cruz de La Sierra","Colegio Adela Zamudio",108,0,0,0,52,9,22,1,0,192,0,5,197,232,0.271,0.849
"23035","Santa Cruz","Santa Cruz de La Sierra","Colegio Adela Zamudio",92,1,0,1,86,11,16,1,1,209,0,2,211,228,0.411,0.925
"23036","Santa Cruz","Santa Cruz de La Sierra","Colegio Adela Zamudio",134,0,0,0,56,16,8,0,0,214,1,3,218,233,0.262,0.936
"23037","Santa Cruz","Santa Cruz de La Sierra","Colegio Adela Zamudio",132,0,0,0,43,7,13,0,1,196,1,4,201,228,0.219,0.882
"23038","Santa Cruz","Santa Cruz de La Sierra","Colegio Adela Zamudio",90,2,1,1,79,10,19,0,2,204,0,3,207,228,0.387,0.908
"23039","Santa Cruz","Santa Cruz de La Sierra","Colegio Adela Zamudio",142,0,0,1,51,13,5,1,1,214,1,1,216,232,0.238,0.931
"23040","Santa Cruz","Santa Cruz de La Sierra","Colegio Adela Zamudio",94,1,0,1,78,10,13,0,1,198,2,9,209,235,0.394,0.889
"23041","Santa Cruz","Santa Cruz de La Sierra","Colegio Adela Zamudio",80,1,0,0,91,8,14,1,3,198,0,3,201,225,0.46,0.893
"23042","Santa Cruz","Santa Cruz de La Sierra","Colegio Adela Zamudio",132,1,0,0,41,7,10,0,1,192,1,4,197,233,0.214,0.845
"23043","Santa Cruz","Santa Cruz de La Sierra","Colegio Adela Zamudio",110,0,0,1,59,15,18,3,2,208,0,4,212,234,0.284,0.906
"23044","Santa Cruz","Santa Cruz de La Sierra","Colegio Adela Zamudio",118,0,0,0,58,12,8,1,1,198,0,4,202,233,0.293,0.867
"23045","Santa Cruz","Santa Cruz de La Sierra","Colegio Adela Zamudio",110,2,0,0,61,9,13,4,3,202,2,8,212,236,0.302,0.898
"23046","Santa Cruz","Santa Cruz de La Sierra","Colegio Adela Zamudio",114,0,1,0,56,13,8,1,2,195,0,7,202,226,0.287,0.894
"23047","Santa Cruz","Santa Cruz de La Sierra","Colegio Adela Zamudio",101,0,0,1,68,14,15,2,0,201,0,3,204,232,0.338,0.879
"23048","Santa Cruz","Santa Cruz de La Sierra","Colegio Adela Zamudio",123,0,0,0,56,11,13,0,1,204,0,6,210,234,0.275,0.897
"23049","Santa Cruz","Santa Cruz de La Sierra","Colegio Adela Zamudio",117,0,1,0,49,9,12,1,1,190,1,9,200,227,0.258,0.881
"23050","Santa Cruz","Santa Cruz de La Sierra","Colegio Adela Zamudio",117,1,0,0,51,15,19,1,0,204,2,8,214,233,0.25,0.918
"23051","Santa Cruz","Santa Cruz de La Sierra","Colegio Adela Zamudio",113,0,0,0,55,20,14,1,0,203,1,5,209,234,0.271,0.893
"23052","Santa Cruz","Santa Cruz de La Sierra","Colegio Adela Zamudio",117,0,0,1,55,13,21,0,0,207,1,7,215,234,0.266,0.919
"23053","Santa Cruz","Santa Cruz de La Sierra","Colegio Adela Zamudio",122,0,0,2,52,10,12,0,1,199,2,4,205,229,0.261,0.895
"23054","Santa Cruz","Santa Cruz de La Sierra","Colegio Adela Zamudio",123,0,1,0,44,14,8,2,1,193,1,4,198,228,0.228,0.868
"23055","Santa Cruz","Santa Cruz de La Sierra","Colegio Adela Zamudio",105,0,0,1,71,12,9,0,2,200,2,7,209,223,0.355,0.937
"23056","Santa Cruz","Santa Cruz de La Sierra","Colegio Adela Zamudio",96,1,0,1,69,10,22,2,2,203,3,8,214,233,0.34,0.918
"23057","Santa Cruz","Santa Cruz de La Sierra","Col. Esc. Naun Fernandez",111,0,0,1,62,15,14,2,2,207,1,3,211,230,0.3,0.917
"23058","Santa Cruz","Santa Cruz de La Sierra","Col. Esc. Naun Fernandez",124,0,0,0,64,12,8,2,0,210,0,5,215,228,0.305,0.943
"23059","Santa Cruz","Santa Cruz de La Sierra","Col. Esc. Naun Fernandez",97,0,0,3,68,6,21,1,1,197,0,9,206,226,0.345,0.912
"23060","Santa Cruz","Santa Cruz de La Sierra","Col. Esc. Naun Fernandez",103,0,1,0,58,8,22,3,1,196,1,11,208,228,0.296,0.912
"23061","Santa Cruz","Santa Cruz de La Sierra","Col. Esc. Naun Fernandez",114,0,0,0,48,16,19,2,1,200,0,7,207,227,0.24,0.912
"23062","Santa Cruz","Santa Cruz de La Sierra","Col. Esc. Naun Fernandez",113,0,0,1,53,11,13,0,2,193,0,7,200,222,0.275,0.901
"23063","Santa Cruz","Santa Cruz de La Sierra","Col. Esc. Naun Fernandez",104,0,1,1,59,7,20,1,2,195,4,3,202,228,0.303,0.886
"23064","Santa Cruz","Santa Cruz de La Sierra","Col. Esc. Naun Fernandez",119,1,0,0,44,27,11,1,1,204,0,4,208,226,0.216,0.92
"23065","Santa Cruz","Santa Cruz de La Sierra","Col. Esc. Naun Fernandez",112,1,0,1,59,13,12,0,2,200,2,12,214,233,0.295,0.918
"23066","Santa Cruz","Santa Cruz de La Sierra","Col. Esc. Naun Fernandez",124,0,0,1,56,11,12,1,4,209,1,3,213,230,0.268,0.926
"23067","Santa Cruz","Santa Cruz de La Sierra","Col. Esc. Naun Fernandez",112,1,0,1,49,18,8,3,3,195,0,5,200,224,0.251,0.893
"23068","Santa Cruz","Santa Cruz de La Sierra","Col. Esc. Naun Fernandez",127,2,0,1,36,14,12,1,0,193,0,12,205,224,0.187,0.915
"23069","Santa Cruz","Santa Cruz de La Sierra","Col. Esc. Naun Fernandez",119,0,0,3,44,17,17,1,4,205,1,13,219,238,0.215,0.92
"23070","Santa Cruz","Santa Cruz de La Sierra","Col. San Pablo",159,0,0,1,24,14,4,1,0,203,2,3,208,226,0.118,0.92
"23071","Santa Cruz","Santa Cruz de La Sierra","Col. San Pablo",151,2,1,0,27,15,11,0,0,207,0,3,210,232,0.13,0.905
"23072","Santa Cruz","Santa Cruz de La Sierra","Col. San Pablo",156,2,1,0,21,12,7,2,0,201,0,4,205,225,0.104,0.911
"23073","Santa Cruz","Santa Cruz de La Sierra","Col. San Pablo",149,0,0,2,24,9,8,2,3,197,1,6,204,227,0.122,0.899
"23074","Santa Cruz","Santa Cruz de La Sierra","Col. San Pablo",151,0,0,3,22,11,8,1,0,196,0,5,201,225,0.112,0.893
"23075","Santa Cruz","Santa Cruz de La Sierra","Col. San Pablo",132,1,0,4,28,9,9,1,1,185,0,5,190,225,0.151,0.844
"23076","Santa Cruz","Santa Cruz de La Sierra","Col. San Pablo",165,0,0,2,24,9,10,0,0,210,0,3,213,230,0.114,0.926
"23077","Santa Cruz","Santa Cruz de La Sierra","Col. San Pablo",165,0,0,0,19,20,5,0,1,210,1,2,213,231,0.09,0.922
"23078","Santa Cruz","Santa Cruz de La Sierra","Col. San Pablo",158,0,0,1,23,9,8,1,0,200,0,9,209,230,0.115,0.909
"23079","Santa Cruz","Santa Cruz de La Sierra","Col. San Pablo",132,0,0,2,17,8,3,0,0,162,0,4,166,183,0.105,0.907
"23080","Santa Cruz","Santa Cruz de La Sierra","Col. Centro Educativo Caritas",146,0,1,0,38,13,12,2,2,214,1,4,219,236,0.178,0.928
"23081","Santa Cruz","Santa Cruz de La Sierra","Col. Centro Educativo Caritas",140,0,0,0,38,7,9,3,0,197,0,5,202,227,0.193,0.89
"23082","Santa Cruz","Santa Cruz de La Sierra","Col. Centro Educativo Caritas",159,0,0,0,32,5,7,2,1,206,3,2,211,228,0.155,0.925
"23083","Santa Cruz","Santa Cruz de La Sierra","Col. Centro Educativo Caritas",157,0,0,0,24,17,7,0,0,205,0,9,214,234,0.117,0.915
"23084","Santa Cruz","Santa Cruz de La Sierra","Col. Centro Educativo Caritas",152,0,0,0,34,11,5,0,2,204,0,6,210,229,0.167,0.917
"23085","Santa Cruz","Santa Cruz de La Sierra","Col. Centro Educativo Caritas",120,0,0,0,61,6,12,5,1,205,0,8,213,230,0.298,0.926
"23086","Santa Cruz","Santa Cruz de La Sierra","Col. Centro Educativo Caritas",153,0,0,1,27,18,10,2,2,213,0,2,215,233,0.127,0.923
"23087","Santa Cruz","Santa Cruz de La Sierra","Col. Centro Educativo Caritas",148,0,2,1,36,12,6,1,1,207,2,2,211,229,0.174,0.921
"23088","Santa Cruz","Santa Cruz de La Sierra","Col. Centro Educativo Caritas",139,0,0,0,36,19,16,1,0,211,2,6,219,236,0.171,0.928
"23089","Santa Cruz","Santa Cruz de La Sierra","Col. Centro Educativo Caritas",160,0,0,0,24,9,8,1,1,203,1,6,210,233,0.118,0.901
"23090","Santa Cruz","Santa Cruz de La Sierra","Col. Centro Educativo Caritas",145,0,1,0,35,9,13,0,1,204,1,7,212,232,0.172,0.914
"23091","Santa Cruz","Santa Cruz de La Sierra","Col. Centro Educativo Caritas",147,1,0,2,29,13,13,3,0,208,1,3,212,233,0.139,0.91
"23092","Santa Cruz","Santa Cruz de La Sierra","Col. Centro Educativo Caritas",113,0,0,0,54,15,13,4,2,201,1,3,205,234,0.269,0.876
"23093","Santa Cruz","Santa Cruz de La Sierra","Col. Centro Educativo Caritas",142,0,1,1,29,24,14,3,0,214,0,0,214,231,0.136,0.926
"23094","Santa Cruz","Santa Cruz de La Sierra","Col. Centro Educativo Caritas",158,0,0,1,22,12,7,0,0,200,1,4,205,235,0.11,0.872
"23095","Santa Cruz","Santa Cruz de La Sierra","Col. Centro Educativo Caritas",147,0,0,2,41,9,11,1,1,212,0,2,214,233,0.193,0.918
"23096","Santa Cruz","Santa Cruz de La Sierra","Col. Centro Educativo Caritas",164,1,0,1,23,6,8,2,2,207,3,5,215,230,0.111,0.935
"23097","Santa Cruz","Santa Cruz de La Sierra","Col. Centro Educativo Caritas",174,0,1,0,22,10,6,1,0,214,0,2,216,232,0.103,0.931
"23098","Santa Cruz","Santa Cruz de La Sierra","Col. Centro Educativo Caritas",138,0,0,0,42,12,13,1,0,206,1,5,212,230,0.204,0.922
"23099","Santa Cruz","Santa Cruz de La Sierra","Col. Centro Educativo Caritas",133,0,0,0,46,10,9,2,0,200,0,3,203,230,0.23,0.883
"23100","Santa Cruz","Santa Cruz de La Sierra","Col. Centro Educativo Caritas",162,0,0,0,19,13,6,0,1,201,0,2,203,232,0.095,0.875
"23101","Santa Cruz","Santa Cruz de La Sierra","Col. Centro Educativo Caritas",156,0,0,0,22,11,12,0,0,201,1,0,202,231,0.109,0.874
"23102","Santa Cruz","Santa Cruz de La Sierra","Col. Centro Educativo Caritas",150,0,1,3,29,14,8,0,0,205,1,5,211,235,0.141,0.898
"23103","Santa Cruz","Santa Cruz de La Sierra","Col. Centro Educativo Caritas",158,1,0,1,35,8,6,0,0,209,0,0,209,232,0.167,0.901
"23104","Santa Cruz","Santa Cruz de La Sierra","Col. Centro Educativo Caritas",150,0,0,0,40,5,7,1,0,203,0,7,210,235,0.197,0.894
"23105","Santa Cruz","Santa Cruz de La Sierra","Col. Centro Educativo Caritas",140,0,0,1,33,12,12,0,1,199,1,6,206,229,0.166,0.9
"23106","Santa Cruz","Santa Cruz de La Sierra","Modulo Educativo Maria De Mattias",156,0,1,1,40,16,10,0,1,225,0,4,229,238,0.178,0.962
"23107","Santa Cruz","Santa Cruz de La Sierra","Modulo Educativo Maria De Mattias",165,0,0,0,34,11,10,2,0,222,1,4,227,236,0.153,0.962
"23108","Santa Cruz","Santa Cruz de La Sierra","Modulo Educativo Maria De Mattias",154,0,0,1,34,9,14,0,0,212,4,8,224,237,0.16,0.945
"23109","Santa Cruz","Santa Cruz de La Sierra","Universitario Sur",116,1,0,1,63,15,12,2,3,213,2,5,220,235,0.296,0.936
"23110","Santa Cruz","Santa Cruz de La Sierra","Universitario Sur",117,1,1,0,76,14,11,0,0,220,2,7,229,238,0.345,0.962
"23111","Santa Cruz","Santa Cruz de La Sierra","Universitario Sur",116,0,0,1,77,8,12,0,1,215,2,6,223,237,0.358,0.941
"23112","Santa Cruz","Santa Cruz de La Sierra","Universitario Sur",113,0,1,0,79,12,13,0,1,219,1,2,222,233,0.361,0.953
"23113","Santa Cruz","Santa Cruz de La Sierra","Universitario Sur",126,0,0,0,57,17,15,1,1,217,3,5,225,237,0.263,0.949
"23114","Santa Cruz","Santa Cruz de La Sierra","Col. Polifuncional Calama",79,1,0,1,94,7,11,3,0,196,1,7,204,228,0.48,0.895
"23115","Santa Cruz","Santa Cruz de La Sierra","Col. Polifuncional Calama",90,1,0,1,91,13,14,1,1,212,1,4,217,233,0.429,0.931
"23116","Santa Cruz","Santa Cruz de La Sierra","Col. Polifuncional Calama",86,0,0,1,91,15,11,1,2,207,2,3,212,232,0.44,0.914
"23117","Santa Cruz","Santa Cruz de La Sierra","Col. Polifuncional Calama",82,0,0,2,85,16,13,2,0,200,1,10,211,234,0.425,0.902
"23118","Santa Cruz","Santa Cruz de La Sierra","Col. Polifuncional Calama",90,0,0,1,92,6,16,2,0,207,2,4,213,227,0.444,0.938
"23119","Santa Cruz","Santa Cruz de La Sierra","Col. Polifuncional Calama",88,1,1,0,81,14,11,0,1,197,1,8,206,228,0.411,0.904
"23120","Santa Cruz","Santa Cruz de La Sierra","Col. Polifuncional Calama",97,0,0,1,72,8,12,2,0,192,1,7,200,221,0.375,0.905
"23121","Santa Cruz","Santa Cruz de La Sierra","Col. Polifuncional Calama",93,0,0,0,91,10,7,0,0,201,1,6,208,232,0.453,0.897
"23122","Santa Cruz","Santa Cruz de La Sierra","Col. Polifuncional Calama",81,0,0,1,75,15,13,0,1,186,0,8,194,228,0.403,0.851
"23123","Santa Cruz","Santa Cruz de La Sierra","Col. Polifuncional Calama",67,0,0,1,103,11,17,3,2,204,0,6,210,228,0.505,0.921
"23124","Santa Cruz","Santa Cruz de La Sierra","Col. Polifuncional Calama",79,1,0,1,76,13,12,0,0,182,5,7,194,230,0.418,0.843
"23125","Santa Cruz","Santa Cruz de La Sierra","Col. Polifuncional Calama",99,0,1,0,80,11,13,1,0,205,1,5,211,232,0.39,0.909
"23126","Santa Cruz","Santa Cruz de La Sierra","Col. Polifuncional Calama",90,1,1,0,83,7,13,0,0,195,0,5,200,225,0.426,0.889
"23127","Santa Cruz","Santa Cruz de La Sierra","Col. Polifuncional Calama",82,1,0,0,78,21,12,3,0,197,0,4,201,226,0.396,0.889
"23128","Santa Cruz","Santa Cruz de La Sierra","Col. Polifuncional Calama",99,0,0,0,85,10,13,1,0,208,2,0,210,233,0.409,0.901
"23129","Santa Cruz","Santa Cruz de La Sierra","Col. Polifuncional Calama",91,0,0,0,79,11,17,1,0,199,1,7,207,230,0.397,0.9
"23130","Santa Cruz","Santa Cruz de La Sierra","Col. Polifuncional Calama",85,0,1,1,77,8,19,2,1,194,0,8,202,230,0.397,0.878
"23131","Santa Cruz","Santa Cruz de La Sierra","Col. Polifuncional Calama",83,1,0,0,89,12,16,1,0,202,1,5,208,228,0.441,0.912
"23132","Santa Cruz","Santa Cruz de La Sierra","Col. Internacional (Bethesda)",111,0,1,1,52,14,19,2,2,202,0,7,209,232,0.257,0.901
"23133","Santa Cruz","Santa Cruz de La Sierra","Col. Internacional (Bethesda)",112,0,1,1,50,12,16,1,1,194,2,8,204,230,0.258,0.887
"23134","Santa Cruz","Santa Cruz de La Sierra","Col. Internacional (Bethesda)",106,0,0,0,55,16,17,2,2,198,2,8,208,233,0.278,0.893
"23135","Santa Cruz","Santa Cruz de La Sierra","Col. Internacional (Bethesda)",106,1,2,2,66,10,9,0,3,199,0,6,205,234,0.332,0.876
"23136","Santa Cruz","Santa Cruz de La Sierra","Col. Internacional (Bethesda)",127,0,1,0,49,9,10,2,2,200,1,8,209,232,0.245,0.901
"23137","Santa Cruz","Santa Cruz de La Sierra","Col. Internacional (Bethesda)",110,0,0,1,49,17,14,0,0,191,3,6,200,223,0.257,0.897
"23138","Santa Cruz","Santa Cruz de La Sierra","Col. Internacional (Bethesda)",112,0,0,0,57,7,15,0,0,191,2,7,200,227,0.298,0.881
"23139","Santa Cruz","Santa Cruz de La Sierra","Col. Internacional (Bethesda)",116,0,0,2,35,13,13,2,3,184,1,11,196,229,0.19,0.856
"23140","Santa Cruz","Santa Cruz de La Sierra","Col. Internacional (Bethesda)",122,0,0,1,34,21,8,1,1,188,0,13,201,219,0.181,0.918
"23141","Santa Cruz","Santa Cruz de La Sierra","Col. Internacional (Bethesda)",121,0,1,0,47,20,10,0,1,200,2,10,212,235,0.235,0.902
"23142","Santa Cruz","Santa Cruz de La Sierra","Col. Internacional (Bethesda)",129,0,0,1,40,13,13,0,0,196,2,8,206,227,0.204,0.907
"23143","Santa Cruz","Santa Cruz de La Sierra","Col. Internacional (Bethesda)",114,1,0,0,52,21,5,1,1,195,3,11,209,234,0.267,0.893
"23144","Santa Cruz","Santa Cruz de La Sierra","Col. Internacional (Bethesda)",124,0,1,0,45,12,17,0,0,199,1,6,206,228,0.226,0.904
"23145","Santa Cruz","Santa Cruz de La Sierra","Colegio Marcelino Champagnat",149,0,1,2,30,14,8,0,1,205,1,8,214,234,0.146,0.915
"23146","Santa Cruz","Santa Cruz de La Sierra","Colegio Marcelino Champagnat",152,0,2,3,33,7,8,1,0,206,2,5,213,229,0.16,0.93
"23147","Santa Cruz","Santa Cruz de La Sierra","Colegio Marcelino Champagnat",147,0,0,0,39,10,8,2,0,206,0,1,207,230,0.189,0.9
"23148","Santa Cruz","Santa Cruz de La Sierra","Colegio Marcelino Champagnat",129,0,0,4,45,13,21,0,1,213,1,5,219,235,0.211,0.932
"23149","Santa Cruz","Santa Cruz de La Sierra","Colegio Marcelino Champagnat",153,0,0,2,29,11,10,1,0,206,0,10,216,232,0.141,0.931
"23150","Santa Cruz","Santa Cruz de La Sierra","Colegio Marcelino Champagnat",163,0,0,1,31,11,7,1,0,214,2,7,223,233,0.145,0.957
"23151","Santa Cruz","Santa Cruz de La Sierra","Colegio Marcelino Champagnat",140,0,0,0,42,13,15,0,0,210,1,1,212,232,0.2,0.914
"23152","Santa Cruz","Santa Cruz de La Sierra","Colegio Marcelino Champagnat",143,0,0,0,37,12,6,1,1,200,2,13,215,231,0.185,0.931
"23153","Santa Cruz","Santa Cruz de La Sierra","Colegio Marcelino Champagnat",143,0,0,0,23,19,6,2,1,194,0,9,203,232,0.119,0.875
"23154","Santa Cruz","Santa Cruz de La Sierra","Colegio Marcelino Champagnat",136,1,0,1,42,8,13,0,3,204,0,3,207,231,0.206,0.896
"23155","Santa Cruz","Santa Cruz de La Sierra","Colegio Marcelino Champagnat",144,1,0,0,42,5,8,1,2,203,2,8,213,234,0.207,0.91
"23156","Santa Cruz","Santa Cruz de La Sierra","Colegio Marcelino Champagnat",155,0,0,1,24,15,17,0,0,212,1,5,218,233,0.113,0.936
"23157","Santa Cruz","Santa Cruz de La Sierra","Colegio Marcelino Champagnat",136,1,0,1,37,15,8,1,0,199,0,3,202,231,0.186,0.874
"23158","Santa Cruz","Santa Cruz de La Sierra","Colegio Marcelino Champagnat",161,0,0,2,24,8,4,4,0,203,1,2,206,230,0.118,0.896
"23159","Santa Cruz","Santa Cruz de La Sierra","Colegio Marcelino Champagnat",137,0,0,3,37,14,11,1,1,204,2,6,212,235,0.181,0.902
"23160","Santa Cruz","Santa Cruz de La Sierra","Col. Part. Alfred B. Nobel",144,0,0,0,30,17,8,3,0,202,0,6,208,225,0.149,0.924
"23161","Santa Cruz","Santa Cruz de La Sierra","Col. Part. Alfred B. Nobel",138,0,0,0,40,18,8,2,0,206,1,4,211,229,0.194,0.921
"23162","Santa Cruz","Santa Cruz de La Sierra","Col. Part. Alfred B. Nobel",143,0,0,0,47,14,9,0,0,213,1,3,217,234,0.221,0.927
"23163","Santa Cruz","Santa Cruz de La Sierra","Col. Part. Alfred B. Nobel",133,0,0,1,42,16,9,2,0,203,3,3,209,231,0.207,0.905
"23164","Santa Cruz","Santa Cruz de La Sierra","Col. Part. Alfred B. Nobel",127,0,0,0,49,22,11,2,1,212,2,2,216,232,0.231,0.931
"23165","Santa Cruz","Santa Cruz de La Sierra","Col. Part. Alfred B. Nobel",154,0,0,0,26,16,7,1,0,204,0,5,209,229,0.127,0.913
"23166","Santa Cruz","Santa Cruz de La Sierra","Col. Part. Alfred B. Nobel",145,0,0,0,43,9,6,1,0,204,1,3,208,232,0.211,0.897
"23167","Santa Cruz","Santa Cruz de La Sierra","Col. Part. Alfred B. Nobel",150,0,0,0,20,16,11,0,0,197,1,3,201,232,0.102,0.866
"23168","Santa Cruz","Santa Cruz de La Sierra","Col. Part. Alfred B. Nobel",134,0,1,0,42,12,9,1,0,199,0,5,204,226,0.211,0.903
"23169","Santa Cruz","Santa Cruz de La Sierra","Col. Esc. Maria Alicia Paz B.",105,1,0,2,70,10,9,1,0,198,3,6,207,233,0.354,0.888
"23170","Santa Cruz","Santa Cruz de La Sierra","Col. Esc. Maria Alicia Paz B.",122,1,0,1,38,16,15,0,2,195,1,7,203,229,0.195,0.886
"23171","Santa Cruz","Santa Cruz de La Sierra","Col. Esc. Maria Alicia Paz B.",121,0,0,0,38,15,13,0,1,188,2,8,198,230,0.202,0.861
"23172","Santa Cruz","Santa Cruz de La Sierra","Col. Esc. Maria Alicia Paz B.",131,0,1,1,48,7,10,2,1,201,0,1,202,226,0.239,0.894
"23173","Santa Cruz","Santa Cruz de La Sierra","Col. Esc. Maria Alicia Paz B.",117,0,0,1,58,15,12,4,1,208,0,6,214,231,0.279,0.926
"23174","Santa Cruz","Santa Cruz de La Sierra","Col. Esc. Maria Alicia Paz B.",93,0,1,0,68,11,11,0,1,185,2,11,198,234,0.368,0.846
"23175","Santa Cruz","Santa Cruz de La Sierra","Col. Esc. Maria Alicia Paz B.",105,0,1,0,65,19,7,2,0,199,1,8,208,227,0.327,0.916
"23176","Santa Cruz","Santa Cruz de La Sierra","Col. Esc. Maria Alicia Paz B.",113,1,1,2,49,14,16,1,2,199,0,5,204,225,0.246,0.907
"23177","Santa Cruz","Santa Cruz de La Sierra","Col. Esc. Maria Alicia Paz B.",114,0,0,0,62,13,7,1,2,199,0,5,204,230,0.312,0.887
"23178","Santa Cruz","Santa Cruz de La Sierra","Col. Esc. Maria Alicia Paz B.",129,0,0,0,42,16,9,0,0,196,0,9,205,225,0.214,0.911
"23179","Santa Cruz","Santa Cruz de La Sierra","Col. Esc. Maria Alicia Paz B.",118,0,0,0,54,15,7,0,3,197,0,10,207,230,0.274,0.9
"23180","Santa Cruz","Santa Cruz de La Sierra","Col. Esc. Maria Alicia Paz B.",115,0,0,0,67,11,5,0,0,198,0,7,205,232,0.338,0.884
"23181","Santa Cruz","Santa Cruz de La Sierra","Col. Esc. Maria Alicia Paz B.",88,0,0,1,81,12,11,0,1,194,2,7,203,227,0.418,0.894
"23182","Santa Cruz","Santa Cruz de La Sierra","Col. Esc. Maria Alicia Paz B.",132,0,0,1,45,12,15,0,0,205,1,5,211,227,0.22,0.93
"23183","Santa Cruz","Santa Cruz de La Sierra","Col. Esc. Maria Alicia Paz B.",124,0,0,1,46,8,11,0,0,190,0,4,194,231,0.242,0.84
"23184","Santa Cruz","Santa Cruz de La Sierra","Col. Esc. Maria Alicia Paz B.",118,0,0,0,43,18,18,1,0,198,2,6,206,231,0.217,0.892
"23185","Santa Cruz","Santa Cruz de La Sierra","Col. Esc. Maria Alicia Paz B.",127,0,1,0,49,9,7,2,3,198,1,2,201,224,0.247,0.897
"23186","Santa Cruz","Santa Cruz de La Sierra","Col. Esc. Maria Alicia Paz B.",101,0,2,0,62,14,18,1,0,198,1,9,208,233,0.313,0.893
"23187","Santa Cruz","Santa Cruz de La Sierra","Col. Esc. Maria Alicia Paz B.",99,0,0,0,61,17,12,0,1,190,2,8,200,221,0.321,0.905
"23188","Santa Cruz","Santa Cruz de La Sierra","Col. Esc. Maria Alicia Paz B.",112,1,1,1,41,25,13,2,3,199,0,7,206,228,0.206,0.904
"23189","Santa Cruz","Santa Cruz de La Sierra","Col. Esc. Maria Alicia Paz B.",108,0,0,1,49,16,13,0,0,187,3,7,197,225,0.262,0.876
"23190","Santa Cruz","Santa Cruz de La Sierra","Col. Esc. Maria Alicia Paz B.",138,0,0,0,38,9,10,4,0,199,0,6,205,226,0.191,0.907
"23191","Santa Cruz","Santa Cruz de La Sierra","Col. Esc. Maria Alicia Paz B.",121,0,2,1,56,13,8,0,0,201,0,7,208,229,0.279,0.908
"23192","Santa Cruz","Santa Cruz de La Sierra","Col. Esc. Maria Alicia Paz B.",110,0,1,1,65,12,6,2,0,197,0,7,204,231,0.33,0.883
"23193","Santa Cruz","Santa Cruz de La Sierra","Col. Esc. Maria Alicia Paz B.",96,1,0,1,66,11,22,0,0,197,3,5,205,229,0.335,0.895
"23194","Santa Cruz","Santa Cruz de La Sierra","Sahara Guardia",136,1,0,1,44,10,15,2,0,209,1,7,217,235,0.211,0.923
"23195","Santa Cruz","Santa Cruz de La Sierra","Sahara Guardia",140,0,1,1,37,19,14,2,1,215,1,7,223,239,0.172,0.933
"23196","Santa Cruz","Santa Cruz de La Sierra","Sahara Guardia",130,0,0,1,53,11,12,0,2,209,2,6,217,240,0.254,0.904
"23197","Santa Cruz","Santa Cruz de La Sierra","Sahara Guardia",137,0,0,0,40,15,13,0,1,206,0,9,215,233,0.194,0.923
"23198","Santa Cruz","Santa Cruz de La Sierra","Sahara Guardia",136,0,1,0,46,19,7,0,2,211,1,9,221,234,0.218,0.944
"23199","Santa Cruz","Santa Cruz de La Sierra","Sahara Guardia",138,0,0,0,47,10,10,1,0,206,2,5,213,239,0.228,0.891
"23200","Santa Cruz","Santa Cruz de La Sierra","Col. Las Americas II",101,0,1,0,60,13,11,1,0,187,1,9,197,228,0.321,0.864
"23201","Santa Cruz","Santa Cruz de La Sierra","Col. Las Americas II",108,1,0,1,58,16,18,1,0,203,0,6,209,233,0.286,0.897
"23202","Santa Cruz","Santa Cruz de La Sierra","Col. Las Americas II",101,0,0,1,57,16,18,0,1,194,1,3,198,230,0.294,0.861
"23203","Santa Cruz","Santa Cruz de La Sierra","Col. Las Americas II",72,0,1,0,81,16,14,2,1,187,3,5,195,230,0.433,0.848
"23204","Santa Cruz","Santa Cruz de La Sierra","Col. Las Americas II",119,0,0,0,42,16,13,1,1,192,0,8,200,221,0.219,0.905
"23205","Santa Cruz","Santa Cruz de La Sierra","Col. Las Americas II",81,0,0,1,98,7,13,0,0,200,0,5,205,234,0.49,0.876
"23206","Santa Cruz","Santa Cruz de La Sierra","Col. Las Americas II",91,0,0,2,69,13,12,2,4,193,1,3,197,224,0.358,0.879
"23207","Santa Cruz","Santa Cruz de La Sierra","Col. Las Americas II",87,2,1,3,71,27,13,3,0,207,1,1,209,227,0.343,0.921
"23208","Santa Cruz","Santa Cruz de La Sierra","Col. Las Americas II",88,1,1,5,66,15,12,2,0,190,1,8,199,230,0.347,0.865
"23209","Santa Cruz","Santa Cruz de La Sierra","Col. Las Americas II",123,0,1,4,41,19,12,0,0,200,2,9,211,230,0.205,0.917
"23210","Santa Cruz","Santa Cruz de La Sierra","Col. Las Americas II",100,0,1,0,66,18,8,2,1,196,3,4,203,228,0.337,0.89
"23211","Santa Cruz","Santa Cruz de La Sierra","Col. Las Americas II",102,0,0,1,59,12,15,3,0,192,23,8,223,230,0.307,0.97
"23212","Santa Cruz","Santa Cruz de La Sierra","Col. Las Americas II",87,0,0,1,79,12,10,1,2,192,2,8,202,225,0.411,0.898
"23213","Santa Cruz","Santa Cruz de La Sierra","Col. Las Americas II",94,0,0,0,71,12,14,2,1,194,2,4,200,228,0.366,0.877
"23214","Santa Cruz","Santa Cruz de La Sierra","Col. Las Americas II",95,0,0,1,62,20,13,0,0,191,2,5,198,228,0.325,0.868
"23215","Santa Cruz","Santa Cruz de La Sierra","Col. Las Americas II",110,0,0,2,43,19,16,0,0,190,6,11,207,229,0.226,0.904
"23216","Santa Cruz","Santa Cruz de La Sierra","Col. Las Americas II",112,0,0,0,42,24,10,2,0,190,0,5,195,227,0.221,0.859
"23217","Santa Cruz","Santa Cruz de La Sierra","Col. Las Americas II",76,0,0,0,96,11,15,3,3,204,1,3,208,230,0.471,0.904
"23218","Santa Cruz","Santa Cruz de La Sierra","Col. Las Americas II",94,1,0,2,64,21,12,1,0,195,0,4,199,225,0.328,0.884
"23219","Santa Cruz","Santa Cruz de La Sierra","Col. Las Americas II",112,0,0,3,54,19,10,4,0,202,2,5,209,229,0.267,0.913
"23220","Santa Cruz","Santa Cruz de La Sierra","Col. Las Americas II",103,1,0,2,52,30,8,0,0,196,0,10,206,227,0.265,0.907
"23221","Santa Cruz","Santa Cruz de La Sierra","Col. Las Americas II",85,0,1,0,78,12,10,0,0,186,0,4,190,220,0.419,0.864
"23222","Santa Cruz","Santa Cruz de La Sierra","Col. Las Americas II",100,1,0,3,42,25,16,0,0,187,1,5,193,231,0.225,0.835
"23223","Santa Cruz","Santa Cruz de La Sierra","Col. Las Americas II",102,0,1,0,58,22,13,2,0,198,1,5,204,228,0.293,0.895
"23224","Santa Cruz","Santa Cruz de La Sierra","Col. Las Americas II",94,0,1,1,53,10,15,0,0,174,1,3,178,202,0.305,0.881
"23225","Santa Cruz","Santa Cruz de La Sierra","Modulo Educativo Republica De Colombia",79,0,0,0,98,17,20,1,0,215,3,4,222,240,0.456,0.925
"23226","Santa Cruz","Santa Cruz de La Sierra","Modulo Educativo Republica De Colombia",72,2,1,1,110,11,15,1,1,214,1,8,223,239,0.514,0.933
"23227","Santa Cruz","Santa Cruz de La Sierra","Modulo Educativo Republica De Colombia",90,1,1,1,83,13,26,1,0,216,0,4,220,238,0.384,0.924
"23228","Santa Cruz","Santa Cruz de La Sierra","Modulo Educativo Republica De Colombia",87,0,0,0,91,10,23,0,2,213,3,6,222,238,0.427,0.933
"23229","Santa Cruz","Santa Cruz de La Sierra","Modulo Educativo Republica De Colombia",77,0,0,1,107,5,25,2,2,219,1,5,225,237,0.489,0.949
"23230","Santa Cruz","Santa Cruz de La Sierra","Modulo Educativo Republica De Colombia",65,0,0,0,69,12,17,0,0,163,3,3,169,185,0.423,0.914
"23231","Santa Cruz","Santa Cruz de La Sierra","Col. Esc. Tierras Nuevas El Carmen",79,0,1,0,89,7,17,0,4,197,0,5,202,230,0.452,0.878
"23232","Santa Cruz","Santa Cruz de La Sierra","Col. Esc. Tierras Nuevas El Carmen",80,0,0,0,73,17,15,1,0,186,2,7,195,228,0.392,0.855
"23233","Santa Cruz","Santa Cruz de La Sierra","Col. Esc. Tierras Nuevas El Carmen",96,0,0,0,66,12,18,1,0,193,2,2,197,227,0.342,0.868
"23234","Santa Cruz","Santa Cruz de La Sierra","Col. Esc. Tierras Nuevas El Carmen",109,1,0,0,60,7,17,0,0,194,0,7,201,227,0.309,0.885
"23235","Santa Cruz","Santa Cruz de La Sierra","Col. Esc. Tierras Nuevas El Carmen",63,0,2,2,94,12,10,0,1,184,1,9,194,224,0.511,0.866
"23236","Santa Cruz","Santa Cruz de La Sierra","Col. Esc. Tierras Nuevas El Carmen",111,1,0,0,66,14,5,1,0,198,1,4,203,231,0.333,0.879
"23237","Santa Cruz","Santa Cruz de La Sierra","Col. Esc. Tierras Nuevas El Carmen",81,1,0,0,100,4,12,4,0,202,1,6,209,233,0.495,0.897
"23238","Santa Cruz","Santa Cruz de La Sierra","Col. Esc. Tierras Nuevas El Carmen",93,0,1,1,66,10,11,1,2,185,6,4,195,227,0.357,0.859
"23239","Santa Cruz","Santa Cruz de La Sierra","Col. Esc. Tierras Nuevas El Carmen",77,0,0,2,77,14,20,1,0,191,0,10,201,227,0.403,0.885
"23240","Santa Cruz","Santa Cruz de La Sierra","Col. Esc. Tierras Nuevas El Carmen",59,3,0,0,100,8,23,0,2,195,0,11,206,231,0.513,0.892
"23241","Santa Cruz","Santa Cruz de La Sierra","Col. Esc. Tierras Nuevas El Carmen",67,0,0,2,100,10,7,1,3,190,2,10,202,226,0.526,0.894
"23242","Santa Cruz","Santa Cruz de La Sierra","Col. Esc. Tierras Nuevas El Carmen",62,0,0,1,98,8,16,3,1,189,2,9,200,225,0.519,0.889
"23243","Santa Cruz","Santa Cruz de La Sierra","Col. Esc. Tierras Nuevas El Carmen",91,0,2,1,64,15,10,1,1,185,4,7,196,229,0.346,0.856
"23244","Santa Cruz","Santa Cruz de La Sierra","Col. Esc. Tierras Nuevas El Carmen",87,1,0,0,75,10,13,0,1,187,2,4,193,227,0.401,0.85
"23245","Santa Cruz","Santa Cruz de La Sierra","Col. Esc. Tierras Nuevas El Carmen",65,0,2,1,86,13,14,0,2,183,1,5,189,227,0.47,0.833
"23246","Santa Cruz","Santa Cruz de La Sierra","Col. Esc. Tierras Nuevas El Carmen",86,0,0,2,73,12,15,0,1,189,2,3,194,220,0.386,0.882
"23247","Santa Cruz","Santa Cruz de La Sierra","Col. Esc. Tierras Nuevas El Carmen",72,1,0,2,85,9,20,0,1,190,2,3,195,227,0.447,0.859
"23248","Santa Cruz","Santa Cruz de La Sierra","Col. Esc. Tierras Nuevas El Carmen",111,1,1,1,69,9,11,0,1,204,1,5,210,236,0.338,0.89
"23249","Santa Cruz","Santa Cruz de La Sierra","Col. Esc. Tierras Nuevas El Carmen",63,0,0,0,99,15,19,0,0,196,1,5,202,223,0.505,0.906
"23250","Santa Cruz","Santa Cruz de La Sierra","Col. Esc. Tierras Nuevas El Carmen",92,1,0,2,47,18,21,1,1,183,2,4,189,226,0.257,0.836
"23251","Santa Cruz","Santa Cruz de La Sierra","Col. Esc. Tierras Nuevas El Carmen",69,2,1,2,92,8,20,0,0,194,1,3,198,226,0.474,0.876
"23252","Santa Cruz","Santa Cruz de La Sierra","Col. Esc. Tierras Nuevas El Carmen",63,3,2,1,97,11,16,0,1,194,1,10,205,232,0.5,0.884
"23253","Santa Cruz","Santa Cruz de La Sierra","Col. Esc. Tierras Nuevas El Carmen",42,1,1,0,115,6,23,0,1,189,2,4,195,230,0.608,0.848
"23254","Santa Cruz","Santa Cruz de La Sierra","Col. Esc. Tierras Nuevas El Carmen",88,0,0,0,75,11,17,0,1,192,2,7,201,229,0.391,0.878
"23255","Santa Cruz","Santa Cruz de La Sierra","Col. Esc. Tierras Nuevas El Carmen",83,1,0,3,85,13,8,2,0,195,2,3,200,226,0.436,0.885
"23256","Santa Cruz","Santa Cruz de La Sierra","Col. Esc. Tierras Nuevas El Carmen",94,2,0,1,60,19,7,1,0,184,2,6,192,224,0.326,0.857
"23257","Santa Cruz","Santa Cruz de La Sierra","Col. Esc. Tierras Nuevas El Carmen",66,0,1,0,101,9,9,0,0,186,3,1,190,227,0.543,0.837
"23258","Santa Cruz","Santa Cruz de La Sierra","Col. Esc. Tierras Nuevas El Carmen",64,1,0,1,91,9,13,0,2,181,3,4,188,224,0.503,0.839
"23259","Santa Cruz","Santa Cruz de La Sierra","Col. Esc. Tierras Nuevas El Carmen",96,1,0,0,68,13,12,1,2,193,1,8,202,225,0.352,0.898
"23260","Santa Cruz","Santa Cruz de La Sierra","Col. Esc. Tierras Nuevas El Carmen",104,1,0,2,60,8,8,0,2,185,1,9,195,227,0.324,0.859
"23261","Santa Cruz","Santa Cruz de La Sierra","Col. Esc. Tierras Nuevas El Carmen",59,0,2,0,92,11,15,0,0,179,2,4,185,219,0.514,0.845
"23262","Santa Cruz","Santa Cruz de La Sierra","Col. Esc. Tierras Nuevas El Carmen",66,1,0,1,92,8,16,0,2,186,2,7,195,231,0.495,0.844
"23263","Santa Cruz","Santa Cruz de La Sierra","Col. Esc. Tierras Nuevas El Carmen",94,0,0,0,76,10,11,1,0,192,1,13,206,223,0.396,0.924
"23264","Santa Cruz","Santa Cruz de La Sierra","Col. Esc. Tierras Nuevas El Carmen",99,0,0,0,71,16,8,0,0,194,1,6,201,223,0.366,0.901
"23265","Santa Cruz","Santa Cruz de La Sierra","Col. Esc. Tierras Nuevas El Carmen",98,1,0,0,59,10,9,2,0,179,1,13,193,223,0.33,0.865
"23266","Santa Cruz","Santa Cruz de La Sierra","Col. Esc. Tierras Nuevas El Carmen",88,2,0,1,59,14,11,0,0,175,1,11,187,220,0.337,0.85
"23267","Santa Cruz","Santa Cruz de La Sierra","Col. Esc. Tierras Nuevas El Carmen",86,1,0,0,83,15,14,1,2,202,3,2,207,229,0.411,0.904
"23268","Santa Cruz","Santa Cruz de La Sierra","Col. Esc. Tierras Nuevas El Carmen",102,0,0,1,57,18,11,1,1,191,1,12,204,226,0.298,0.903
"23269","Santa Cruz","Santa Cruz de La Sierra","Col. Esc. Tierras Nuevas El Carmen",78,2,1,0,82,18,5,1,1,188,3,5,196,227,0.436,0.863
"23270","Santa Cruz","Santa Cruz de La Sierra","Col. Esc. Tierras Nuevas El Carmen",79,0,2,0,88,15,9,2,2,197,1,3,201,226,0.447,0.889
"23271","Santa Cruz","Santa Cruz de La Sierra","Col. Esc. Tierras Nuevas El Carmen",80,0,0,1,80,12,12,2,0,187,1,12,200,224,0.428,0.893
"23272","Santa Cruz","Santa Cruz de La Sierra","Col. Esc. Tierras Nuevas El Carmen",68,0,1,1,102,13,19,1,1,206,0,3,209,228,0.495,0.917
"23273","Santa Cruz","Santa Cruz de La Sierra","Col. Esc. Tierras Nuevas El Carmen",89,0,0,0,76,12,14,1,2,194,0,4,198,235,0.392,0.843
"23274","Santa Cruz","Santa Cruz de La Sierra","Col. Esc. Tierras Nuevas El Carmen",87,0,0,0,71,12,12,0,0,182,1,14,197,231,0.39,0.853
"23275","Santa Cruz","Santa Cruz de La Sierra","Misiones De Jesus",87,0,1,2,95,13,15,0,0,213,1,7,221,238,0.446,0.929
"23276","Santa Cruz","Santa Cruz de La Sierra","Misiones De Jesus",77,0,0,0,97,20,20,2,0,216,0,4,220,237,0.449,0.928
"23277","Santa Cruz","Santa Cruz de La Sierra","Misiones De Jesus",83,0,1,0,85,19,18,0,1,207,0,7,214,235,0.411,0.911
"23278","Santa Cruz","Santa Cruz de La Sierra","Misiones De Jesus",92,1,1,0,74,16,23,0,1,208,1,7,216,234,0.356,0.923
"23279","Santa Cruz","Santa Cruz de La Sierra","Misiones De Jesus",98,0,0,0,79,12,15,1,1,206,1,5,212,237,0.383,0.895
"23280","Santa Cruz","Santa Cruz de La Sierra","Kinder Cariñosito",87,0,0,1,94,16,26,0,0,224,3,4,231,240,0.42,0.963
"23281","Santa Cruz","Santa Cruz de La Sierra","Kinder Cariñosito",87,0,0,0,101,12,15,1,0,216,3,4,223,237,0.468,0.941
"23282","Santa Cruz","Santa Cruz de La Sierra","Kinder Cariñosito",95,0,1,0,84,16,12,0,1,209,0,10,219,238,0.402,0.92
"23283","Santa Cruz","Santa Cruz de La Sierra","U.E. San Marcos",89,0,1,1,85,12,22,3,3,216,2,7,225,238,0.394,0.945
"23284","Santa Cruz","Santa Cruz de La Sierra","U.E. San Marcos",101,0,0,1,74,16,24,0,2,218,2,7,227,238,0.339,0.954
"23285","Santa Cruz","Santa Cruz de La Sierra","Col. Mateo Kuljis Secundario",85,0,0,0,68,12,24,1,1,191,0,4,195,227,0.356,0.859
"23286","Santa Cruz","Santa Cruz de La Sierra","Col. Mateo Kuljis Secundario",92,0,0,4,64,23,9,1,2,195,2,1,198,229,0.328,0.865
"23287","Santa Cruz","Santa Cruz de La Sierra","Col. Mateo Kuljis Secundario",124,0,0,0,45,20,11,0,0,200,0,6,206,231,0.225,0.892
"23288","Santa Cruz","Santa Cruz de La Sierra","Col. Mateo Kuljis Secundario",89,0,0,0,73,9,20,0,0,191,3,4,198,223,0.382,0.888
"23289","Santa Cruz","Santa Cruz de La Sierra","Col. Mateo Kuljis Secundario",84,0,0,1,80,8,15,1,1,190,1,8,199,233,0.421,0.854
"23290","Santa Cruz","Santa Cruz de La Sierra","Col. Mateo Kuljis Secundario",95,0,0,1,80,6,18,0,1,201,0,7,208,233,0.398,0.893
"23291","Santa Cruz","Santa Cruz de La Sierra","Col. Mateo Kuljis Secundario",92,0,0,2,70,11,19,3,0,197,0,6,203,227,0.355,0.894
"23292","Santa Cruz","Santa Cruz de La Sierra","Col. Mateo Kuljis Secundario",103,1,0,1,57,23,0,0,1,186,1,7,194,235,0.306,0.826
"23293","Santa Cruz","Santa Cruz de La Sierra","Col. Mateo Kuljis Secundario",90,0,1,2,69,18,12,1,0,193,0,9,202,231,0.358,0.874
"23294","Santa Cruz","Santa Cruz de La Sierra","Col. Mateo Kuljis Secundario",87,2,0,1,62,22,14,4,2,194,0,7,201,226,0.32,0.889
"23295","Santa Cruz","Santa Cruz de La Sierra","Col. Mateo Kuljis Secundario",76,1,0,0,70,18,29,1,0,195,2,3,200,230,0.359,0.87
"23296","Santa Cruz","Santa Cruz de La Sierra","Col. Mateo Kuljis Secundario",89,0,0,1,66,15,28,1,1,201,2,7,210,232,0.328,0.905
"23297","Santa Cruz","Santa Cruz de La Sierra","Col. Mateo Kuljis Secundario",87,1,1,2,79,15,20,1,0,206,0,2,208,230,0.383,0.904
"23298","Santa Cruz","Santa Cruz de La Sierra","Col. Mateo Kuljis Secundario",116,0,0,2,53,14,13,0,2,200,1,2,203,229,0.265,0.886
"23299","Santa Cruz","Santa Cruz de La Sierra","Col. Mateo Kuljis Secundario",113,0,1,2,52,14,13,2,0,197,1,3,201,232,0.264,0.866
"23300","Santa Cruz","Santa Cruz de La Sierra","Col. Mateo Kuljis Secundario",113,0,0,0,35,24,15,3,2,192,2,8,202,230,0.182,0.878
"23301","Santa Cruz","Santa Cruz de La Sierra","Col. Mateo Kuljis Secundario",94,0,0,0,77,12,22,0,0,205,0,4,209,231,0.376,0.905
"23302","Santa Cruz","Santa Cruz de La Sierra","Col. Mateo Kuljis Secundario",109,0,0,2,64,12,11,1,0,199,2,3,204,232,0.322,0.879
"23303","Santa Cruz","Santa Cruz de La Sierra","Col. Mateo Kuljis Secundario",105,0,0,2,50,22,13,3,0,195,2,3,200,223,0.256,0.897
"23304","Santa Cruz","Santa Cruz de La Sierra","Col. Mateo Kuljis Secundario",110,0,1,1,61,10,21,2,1,207,2,6,215,232,0.295,0.927
"23305","Santa Cruz","Santa Cruz de La Sierra","Col. Mateo Kuljis Secundario",115,0,0,0,48,15,16,4,1,199,1,6,206,232,0.241,0.888
"23306","Santa Cruz","Santa Cruz de La Sierra","Col. Mateo Kuljis Secundario",97,0,0,1,68,13,21,1,0,201,2,3,206,229,0.338,0.9
"23307","Santa Cruz","Santa Cruz de La Sierra","Col. Mateo Kuljis Secundario",104,0,1,0,65,16,21,1,1,209,0,3,212,232,0.311,0.914
"23308","Santa Cruz","Santa Cruz de La Sierra","Col. Mateo Kuljis Secundario",101,1,0,3,68,12,14,0,2,201,0,7,208,229,0.338,0.908
"23309","Santa Cruz","Santa Cruz de La Sierra","U.E. Mateo Kuljis Llic II",93,0,0,1,73,10,29,0,1,207,3,5,215,238,0.353,0.903
"23310","Santa Cruz","Santa Cruz de La Sierra","Pedro Diez",76,1,1,1,90,14,18,1,1,203,2,2,207,233,0.443,0.888
"23311","Santa Cruz","Santa Cruz de La Sierra","Pedro Diez",98,0,2,3,59,19,19,2,1,203,3,4,210,236,0.291,0.89
"23312","Santa Cruz","Santa Cruz de La Sierra","Pedro Diez",79,0,1,0,60,14,11,0,0,165,1,3,169,195,0.364,0.867
"23313","Santa Cruz","Santa Cruz de La Sierra","Col. Hernando Siles",74,0,0,3,84,23,15,1,2,202,2,6,210,231,0.416,0.909
"23314","Santa Cruz","Santa Cruz de La Sierra","Col. Hernando Siles",63,1,0,0,70,18,17,0,4,173,4,9,186,223,0.405,0.834
"23315","Santa Cruz","Santa Cruz de La Sierra","Col. Hernando Siles",73,0,0,1,77,15,17,1,0,184,0,10,194,226,0.418,0.858
"23316","Santa Cruz","Santa Cruz de La Sierra","Col. Hernando Siles",78,0,0,1,80,21,12,1,1,194,2,5,201,232,0.412,0.866
"23317","Santa Cruz","Santa Cruz de La Sierra","Col. Hernando Siles",79,0,0,1,83,16,21,0,1,201,2,4,207,228,0.413,0.908
"23318","Santa Cruz","Santa Cruz de La Sierra","Col. Hernando Siles",68,0,0,1,81,23,10,0,1,184,3,9,196,225,0.44,0.871
"23319","Santa Cruz","Santa Cruz de La Sierra","Col. Hernando Siles",73,1,0,2,92,9,21,1,1,200,0,5,205,231,0.46,0.887
"23320","Santa Cruz","Santa Cruz de La Sierra","Col. Hernando Siles",54,1,0,2,75,23,26,2,2,185,4,17,206,228,0.405,0.904
"23321","Santa Cruz","Santa Cruz de La Sierra","Col. Hernando Siles",83,0,1,0,78,17,15,0,0,194,0,10,204,230,0.402,0.887
"23322","Santa Cruz","Santa Cruz de La Sierra","Col. Hernando Siles",75,1,0,1,73,19,20,0,0,189,1,7,197,225,0.386,0.876
"23323","Santa Cruz","Santa Cruz de La Sierra","Col. Hernando Siles",58,0,2,1,81,11,33,0,4,190,1,5,196,228,0.426,0.86
"23324","Santa Cruz","Santa Cruz de La Sierra","Col. Hernando Siles",62,1,0,0,114,13,19,0,2,211,0,3,214,233,0.54,0.918
"23325","Santa Cruz","Santa Cruz de La Sierra","Col. Hernando Siles",59,0,1,1,83,18,22,0,1,185,2,4,191,226,0.449,0.845
"23326","Santa Cruz","Santa Cruz de La Sierra","Col. Hernando Siles",66,0,0,0,94,19,14,2,0,195,1,8,204,231,0.482,0.883
"23327","Santa Cruz","Santa Cruz de La Sierra","Col. Hernando Siles",80,0,0,1,81,11,20,1,0,194,2,3,199,232,0.418,0.858
"23328","Santa Cruz","Santa Cruz de La Sierra","Col. Hernando Siles",67,0,0,4,97,12,21,0,0,201,2,3,206,231,0.483,0.892
"23329","Santa Cruz","Santa Cruz de La Sierra","Col. Hernando Siles",66,0,0,3,93,11,18,1,2,194,2,7,203,228,0.479,0.89
"23330","Santa Cruz","Santa Cruz de La Sierra","Col. Hernando Siles",81,0,1,3,76,13,19,2,1,196,6,5,207,230,0.388,0.9
"23331","Santa Cruz","Santa Cruz de La Sierra","Col. Hernando Siles",95,0,0,1,61,19,11,2,3,192,1,10,203,229,0.318,0.886
"23332","Santa Cruz","Santa Cruz de La Sierra","Col. Hernando Siles",69,1,1,2,61,21,18,3,2,178,3,9,190,230,0.343,0.826
"23333","Santa Cruz","Santa Cruz de La Sierra","Col. Hernando Siles",90,0,2,2,54,17,23,0,0,188,3,5,196,229,0.287,0.856
"23334","Santa Cruz","Santa Cruz de La Sierra","Col. Hernando Siles",80,0,0,0,79,17,26,0,4,206,0,4,210,229,0.383,0.917
"23335","Santa Cruz","Santa Cruz de La Sierra","Col. Hernando Siles",89,0,0,2,62,24,18,2,1,198,2,2,202,227,0.313,0.89
"23336","Santa Cruz","Santa Cruz de La Sierra","Col. Hernando Siles",65,0,1,1,77,23,18,3,3,191,1,4,196,223,0.403,0.879
"23337","Santa Cruz","Santa Cruz de La Sierra","Col. Hernando Siles",87,0,0,1,63,21,16,2,5,195,2,11,208,234,0.323,0.889
"23338","Santa Cruz","Santa Cruz de La Sierra","Col. Hernando Siles",48,0,0,2,105,11,19,0,1,186,0,7,193,222,0.565,0.869
"23339","Santa Cruz","Santa Cruz de La Sierra","Col. Hernando Siles",58,0,0,0,94,15,17,1,3,188,2,7,197,224,0.5,0.879
"23340","Santa Cruz","Santa Cruz de La Sierra","Col. Hernando Siles",101,0,1,3,54,19,9,2,2,191,2,2,195,222,0.283,0.878
"23341","Santa Cruz","Santa Cruz de La Sierra","Col. Hernando Siles",68,1,0,0,84,14,26,1,0,194,2,8,204,222,0.433,0.919
"23342","Santa Cruz","Santa Cruz de La Sierra","Col. Hernando Siles",99,0,0,0,58,20,9,3,0,189,1,4,194,224,0.307,0.866
"23343","Santa Cruz","Santa Cruz de La Sierra","Col. Hernando Siles",69,0,2,0,70,22,14,2,0,179,1,9,189,230,0.391,0.822
"23344","Santa Cruz","Santa Cruz de La Sierra","Col. Hernando Siles",72,0,0,0,93,8,24,0,2,199,2,5,206,231,0.467,0.892
"23345","Santa Cruz","Santa Cruz de La Sierra","Col. Hernando Siles",75,0,0,2,83,18,12,0,0,190,0,5,195,228,0.437,0.855
"23346","Santa Cruz","Santa Cruz de La Sierra","Col. Hernando Siles",82,0,0,3,71,16,8,0,0,180,0,17,197,232,0.394,0.849
"23347","Santa Cruz","Santa Cruz de La Sierra","Col. Hernando Siles",101,1,1,1,53,13,18,2,0,190,0,6,196,224,0.279,0.875
"23348","Santa Cruz","Santa Cruz de La Sierra","Col. Hernando Siles",86,0,0,3,68,23,9,2,2,193,1,4,198,229,0.352,0.865
"23349","Santa Cruz","Santa Cruz de La Sierra","Col. Hernando Siles",71,0,0,0,83,11,23,3,1,192,3,5,200,226,0.432,0.885
"23350","Santa Cruz","Santa Cruz de La Sierra","Col. Hernando Siles",53,0,1,0,99,10,23,1,2,189,2,5,196,227,0.524,0.863
"23351","Santa Cruz","Santa Cruz de La Sierra","Col. Hernando Siles",83,0,0,1,82,11,14,2,4,197,1,6,204,227,0.416,0.899
"23352","Santa Cruz","Santa Cruz de La Sierra","Col. Hernando Siles",96,1,2,0,65,16,10,0,1,191,1,8,200,226,0.34,0.885
"23353","Santa Cruz","Santa Cruz de La Sierra","Col. Hernando Siles",73,0,0,0,81,17,12,0,1,184,1,12,197,223,0.44,0.883
"23354","Santa Cruz","Santa Cruz de La Sierra","Col. Hernando Siles",92,0,0,0,74,17,13,0,1,197,1,5,203,234,0.376,0.868
"23355","Santa Cruz","Santa Cruz de La Sierra","Col. Hernando Siles",80,0,0,0,69,26,16,1,0,192,1,5,198,227,0.359,0.872
"23356","Santa Cruz","Santa Cruz de La Sierra","Col. Hernando Siles",84,1,0,2,66,13,14,2,2,184,2,11,197,223,0.359,0.883
"23357","Santa Cruz","Santa Cruz de La Sierra","Col. Hernando Siles",88,0,0,0,80,11,12,2,1,194,1,10,205,227,0.412,0.903
"23358","Santa Cruz","Santa Cruz de La Sierra","Col. Hernando Siles",91,0,1,2,60,14,17,0,2,187,0,5,192,228,0.321,0.842
"23359","Santa Cruz","Santa Cruz de La Sierra","Col. Hernando Siles",66,1,0,0,88,15,18,1,2,191,2,3,196,225,0.461,0.871
"23360","Santa Cruz","Santa Cruz de La Sierra","Col. Hernando Siles",83,0,0,3,80,17,10,1,0,194,3,6,203,224,0.412,0.906
"23361","Santa Cruz","Santa Cruz de La Sierra","Col. Hernando Siles",76,0,0,3,83,18,15,3,0,198,2,6,206,232,0.419,0.888
"23362","Santa Cruz","Santa Cruz de La Sierra","Col. Hernando Siles",58,0,0,0,86,14,21,0,3,182,1,13,196,225,0.473,0.871
"23363","Santa Cruz","Santa Cruz de La Sierra","Col. Hernando Siles",81,0,0,0,75,10,21,7,0,194,0,7,201,228,0.387,0.882
"23364","Santa Cruz","Santa Cruz de La Sierra","Col. Hernando Siles",72,0,0,1,84,17,17,2,0,193,0,6,199,225,0.435,0.884
"23365","Santa Cruz","Santa Cruz de La Sierra","Col. Esc. Peregrina Davalos",45,0,1,2,100,16,21,0,2,187,1,7,195,232,0.535,0.841
"23366","Santa Cruz","Santa Cruz de La Sierra","Col. Esc. Peregrina Davalos",66,0,0,1,86,32,17,1,1,204,2,3,209,231,0.422,0.905
"23367","Santa Cruz","Santa Cruz de La Sierra","Col. Esc. Peregrina Davalos",63,1,0,3,81,21,22,3,2,196,2,7,205,226,0.413,0.907
"23368","Santa Cruz","Santa Cruz de La Sierra","Col. Esc. Peregrina Davalos",64,0,0,1,88,18,19,1,3,194,1,3,198,230,0.454,0.861
"23369","Santa Cruz","Santa Cruz de La Sierra","Col. Esc. Peregrina Davalos",48,1,0,2,100,21,23,2,3,200,0,5,205,229,0.5,0.895
"23370","Santa Cruz","Santa Cruz de La Sierra","Col. Esc. Peregrina Davalos",68,1,0,1,75,17,18,0,1,181,2,9,192,226,0.414,0.85
"23371","Santa Cruz","Santa Cruz de La Sierra","Col. Esc. Peregrina Davalos",69,0,0,0,90,24,18,1,1,203,1,3,207,232,0.443,0.892
"23372","Santa Cruz","Santa Cruz de La Sierra","Col. Esc. Peregrina Davalos",57,0,0,1,95,16,20,1,2,192,0,7,199,228,0.495,0.873
"23373","Santa Cruz","Santa Cruz de La Sierra","Col. Esc. Peregrina Davalos",62,0,2,1,112,10,14,2,1,204,1,4,209,232,0.549,0.901
"23374","Santa Cruz","Santa Cruz de La Sierra","Col. Esc. Peregrina Davalos",69,2,0,2,93,15,16,1,5,203,2,3,208,226,0.458,0.92
"23375","Santa Cruz","Santa Cruz de La Sierra","Col. Esc. Peregrina Davalos",63,2,1,2,97,20,19,1,0,205,2,6,213,232,0.473,0.918
"23376","Santa Cruz","Santa Cruz de La Sierra","Col. Esc. Peregrina Davalos",55,1,0,1,86,28,16,3,1,191,0,9,200,223,0.45,0.897
"23377","Santa Cruz","Santa Cruz de La Sierra","Col. Esc. Peregrina Davalos",35,0,0,2,123,13,15,1,4,193,3,5,201,225,0.637,0.893
"23378","Santa Cruz","Santa Cruz de La Sierra","Col. Esc. Peregrina Davalos",76,1,0,2,69,13,18,0,3,182,2,5,189,226,0.379,0.836
"23379","Santa Cruz","Santa Cruz de La Sierra","Col. Esc. Peregrina Davalos",67,0,0,2,97,18,14,0,1,199,0,4,203,225,0.487,0.902
"23380","Santa Cruz","Santa Cruz de La Sierra","Col. Esc. Peregrina Davalos",77,0,0,2,84,19,8,1,2,193,5,10,208,231,0.435,0.9
"23381","Santa Cruz","Santa Cruz de La Sierra","Col. Esc. Peregrina Davalos",73,0,0,2,76,20,17,1,3,192,3,6,201,227,0.396,0.885
"23382","Santa Cruz","Santa Cruz de La Sierra","Col. Esc. Peregrina Davalos",65,0,0,2,92,18,18,1,1,197,3,3,203,224,0.467,0.906
"23383","Santa Cruz","Santa Cruz de La Sierra","Col. Villa Alegre",60,0,0,2,110,11,17,3,7,210,0,3,213,231,0.524,0.922
"23384","Santa Cruz","Santa Cruz de La Sierra","Col. Villa Alegre",33,1,2,0,122,13,15,0,2,188,3,8,199,225,0.649,0.884
"23385","Santa Cruz","Santa Cruz de La Sierra","Col. Villa Alegre",37,1,0,2,140,6,11,1,4,202,2,6,210,233,0.693,0.901
"23386","Santa Cruz","Santa Cruz de La Sierra","Col. Villa Alegre",46,0,0,0,103,7,27,1,4,188,35,11,234,234,0.548,1
"23387","Santa Cruz","Santa Cruz de La Sierra","Col. Villa Alegre",53,0,0,0,110,11,20,0,7,201,4,3,208,231,0.547,0.9
"23388","Santa Cruz","Santa Cruz de La Sierra","Col. Villa Alegre",38,1,1,3,128,5,16,1,6,199,1,4,204,229,0.643,0.891
"23389","Santa Cruz","Santa Cruz de La Sierra","Col. Villa Alegre",54,1,0,0,116,16,20,0,0,207,1,5,213,230,0.56,0.926
"23390","Santa Cruz","Santa Cruz de La Sierra","Col. Villa Alegre",44,0,0,2,117,10,13,0,5,191,1,16,208,233,0.613,0.893
"23391","Santa Cruz","Santa Cruz de La Sierra","Col. Villa Alegre",68,0,0,2,101,12,17,0,2,202,1,8,211,229,0.5,0.921
"23392","Santa Cruz","Santa Cruz de La Sierra","Col. Villa Alegre",44,0,1,0,120,11,13,0,3,192,2,7,201,227,0.625,0.885
"23393","Santa Cruz","Santa Cruz de La Sierra","Modulo Educativo Cenetrop",78,0,1,1,89,24,20,0,0,213,2,8,223,236,0.418,0.945
"23394","Santa Cruz","Santa Cruz de La Sierra","Modulo Educativo Cenetrop",68,0,0,1,59,24,18,1,2,173,3,7,183,202,0.341,0.906
"23395","Santa Cruz","Santa Cruz de La Sierra","Col. Esc. Max Fernandez Rojas B",65,0,1,1,96,15,20,0,2,200,1,1,202,230,0.48,0.878
"23396","Santa Cruz","Santa Cruz de La Sierra","Col. Esc. Max Fernandez Rojas B",64,0,0,3,87,23,17,3,1,198,2,4,204,233,0.439,0.876
"23397","Santa Cruz","Santa Cruz de La Sierra","Col. Esc. Max Fernandez Rojas B",54,1,0,3,89,19,28,0,0,194,0,10,204,226,0.459,0.903
"23398","Santa Cruz","Santa Cruz de La Sierra","Col. Esc. Max Fernandez Rojas B",38,2,1,0,113,20,13,0,2,189,2,9,200,226,0.598,0.885
"23399","Santa Cruz","Santa Cruz de La Sierra","Col. Esc. Max Fernandez Rojas B",63,1,0,0,87,18,21,2,3,195,0,6,201,225,0.446,0.893
"23400","Santa Cruz","Santa Cruz de La Sierra","Col. Esc. Max Fernandez Rojas B",70,1,0,4,78,19,17,3,2,194,6,6,206,231,0.402,0.892
"23401","Santa Cruz","Santa Cruz de La Sierra","Col. Esc. Max Fernandez Rojas B",69,1,0,2,84,22,18,0,3,199,3,8,210,228,0.422,0.921
"23402","Santa Cruz","Santa Cruz de La Sierra","Col. Esc. Max Fernandez Rojas B",66,0,2,0,88,13,23,0,4,196,0,11,207,227,0.449,0.912
"23403","Santa Cruz","Santa Cruz de La Sierra","Col. Esc. Max Fernandez Rojas B",45,0,1,1,111,12,18,1,2,191,2,8,201,226,0.581,0.889
"23404","Santa Cruz","Santa Cruz de La Sierra","Col. Esc. Max Fernandez Rojas B",68,0,0,2,88,14,15,2,2,191,2,6,199,227,0.461,0.877
"23405","Santa Cruz","Santa Cruz de La Sierra","Col. Esc. Max Fernandez Rojas B",53,1,0,1,92,13,22,3,10,195,3,8,206,232,0.472,0.888
"23406","Santa Cruz","Santa Cruz de La Sierra","Col. Esc. Max Fernandez Rojas B",52,1,3,0,96,16,25,1,2,196,0,6,202,228,0.49,0.886
"23407","Santa Cruz","Santa Cruz de La Sierra","Col. Esc. Max Fernandez Rojas B",52,1,0,2,98,13,21,0,9,196,5,6,207,225,0.5,0.92
"23408","Santa Cruz","Santa Cruz de La Sierra","Col. Esc. Max Fernandez Rojas B",68,1,0,3,91,15,19,0,1,198,1,7,206,232,0.46,0.888
"23409","Santa Cruz","Santa Cruz de La Sierra","Col. Esc. Max Fernandez Rojas B",68,0,2,2,80,22,19,1,2,196,0,4,200,222,0.408,0.901
"23410","Santa Cruz","Santa Cruz de La Sierra","Col. Esc. Max Fernandez Rojas B",64,0,0,3,96,14,23,3,1,204,2,9,215,233,0.471,0.923
"23411","Santa Cruz","Santa Cruz de La Sierra","U.E. Rep. del Paraguay",92,0,0,0,84,7,20,0,2,205,1,7,213,234,0.41,0.91
"23412","Santa Cruz","Santa Cruz de La Sierra","U.E. Rep. del Paraguay",104,0,0,0,70,13,18,0,2,207,2,8,217,234,0.338,0.927
"23413","Santa Cruz","Santa Cruz de La Sierra","Col. Esc. Magisterio Sur",67,0,0,0,92,10,16,2,0,187,4,7,198,234,0.492,0.846
"23414","Santa Cruz","Santa Cruz de La Sierra","Col. Esc. Magisterio Sur",100,2,0,1,70,19,10,2,1,205,1,7,213,234,0.341,0.91
"23415","Santa Cruz","Santa Cruz de La Sierra","Col. Esc. Magisterio Sur",83,0,1,2,73,17,22,0,1,199,5,10,214,234,0.367,0.915
"23416","Santa Cruz","Santa Cruz de La Sierra","Col. Esc. Magisterio Sur",65,0,0,2,98,6,19,1,3,194,3,5,202,229,0.505,0.882
"23417","Santa Cruz","Santa Cruz de La Sierra","Col. Esc. Magisterio Sur",77,0,0,0,89,14,13,1,1,195,1,8,204,230,0.456,0.887
"23418","Santa Cruz","Santa Cruz de La Sierra","Col. Esc. Magisterio Sur",105,0,0,0,58,22,16,4,1,206,0,4,210,233,0.282,0.901
"23419","Santa Cruz","Santa Cruz de La Sierra","Col. Esc. Magisterio Sur",79,1,1,1,82,21,14,1,3,203,0,2,205,231,0.404,0.887
"23420","Santa Cruz","Santa Cruz de La Sierra","Col. Esc. Magisterio Sur",64,0,0,0,100,20,22,0,0,206,0,4,210,228,0.485,0.921
"23421","Santa Cruz","Santa Cruz de La Sierra","Col. Esc. Magisterio Sur",78,2,1,1,73,16,18,1,1,191,1,10,202,232,0.382,0.871
"23422","Santa Cruz","Santa Cruz de La Sierra","Col. Esc. Magisterio Sur",87,0,0,0,79,17,11,1,2,197,1,9,207,230,0.401,0.9
"23423","Santa Cruz","Santa Cruz de La Sierra","Col. Esc. Magisterio Sur",64,2,0,1,93,8,21,0,4,193,2,15,210,233,0.482,0.901
"23424","Santa Cruz","Santa Cruz de La Sierra","Col. Esc. Magisterio Sur",100,0,2,0,73,16,12,0,0,203,0,6,209,229,0.36,0.913
"23425","Santa Cruz","Santa Cruz de La Sierra","Col. Esc. Magisterio Sur",92,0,0,0,64,13,18,0,1,188,1,10,199,230,0.34,0.865
"23426","Santa Cruz","Santa Cruz de La Sierra","Col. Esc. Magisterio Sur",73,0,1,1,85,20,8,1,0,189,1,8,198,232,0.45,0.853
"23427","Santa Cruz","Santa Cruz de La Sierra","Col. Esc. Magisterio Sur",87,0,0,1,65,11,11,2,1,178,2,8,188,210,0.365,0.895
"23428","Santa Cruz","Santa Cruz de La Sierra","Colegio San Jorge",67,1,0,5,77,19,14,0,2,185,2,11,198,229,0.416,0.865
"23429","Santa Cruz","Santa Cruz de La Sierra","Colegio San Jorge",71,0,1,2,86,12,11,0,1,184,0,6,190,226,0.467,0.841
"23430","Santa Cruz","Santa Cruz de La Sierra","Colegio San Jorge",68,0,1,2,78,17,20,4,1,191,3,10,204,228,0.408,0.895
"23431","Santa Cruz","Santa Cruz de La Sierra","Colegio San Jorge",54,1,1,1,88,23,14,2,1,185,6,7,198,230,0.476,0.861
"23432","Santa Cruz","Santa Cruz de La Sierra","Colegio San Jorge",70,0,0,1,80,17,17,5,0,190,2,3,195,221,0.421,0.882
"23433","Santa Cruz","Santa Cruz de La Sierra","Colegio San Jorge",66,0,0,3,92,14,15,1,0,191,0,7,198,226,0.482,0.876
"23434","Santa Cruz","Santa Cruz de La Sierra","Colegio San Jorge",66,0,1,0,98,13,17,0,5,200,2,9,211,231,0.49,0.913
"23435","Santa Cruz","Santa Cruz de La Sierra","Colegio San Jorge",84,1,0,1,62,21,15,0,1,185,4,4,193,231,0.335,0.835
"23436","Santa Cruz","Santa Cruz de La Sierra","Colegio San Jorge",77,0,1,0,84,26,14,1,0,203,1,2,206,232,0.414,0.888
"23437","Santa Cruz","Santa Cruz de La Sierra","Colegio San Jorge",57,1,0,1,105,9,17,2,5,197,1,8,206,232,0.533,0.888
"23438","Santa Cruz","Santa Cruz de La Sierra","Colegio San Jorge",90,0,0,1,63,15,15,2,1,187,3,5,195,227,0.337,0.859
"23439","Santa Cruz","Santa Cruz de La Sierra","Colegio San Jorge",66,0,0,1,87,23,10,1,2,190,2,11,203,230,0.458,0.883
"23440","Santa Cruz","Santa Cruz de La Sierra","Colegio San Jorge",76,0,0,2,72,14,16,3,2,185,4,4,193,232,0.389,0.832
"23441","Santa Cruz","Santa Cruz de La Sierra","Col. Esc. Honorato Mejia",91,0,0,0,76,19,14,1,1,202,0,8,210,231,0.376,0.909
"23442","Santa Cruz","Santa Cruz de La Sierra","Col. Esc. Honorato Mejia",100,1,1,0,72,15,15,2,0,206,1,4,211,233,0.35,0.906
"23443","Santa Cruz","Santa Cruz de La Sierra","Col. Esc. Honorato Mejia",108,0,1,0,77,13,12,1,0,212,1,5,218,231,0.363,0.944
"23444","Santa Cruz","Santa Cruz de La Sierra","Col. Esc. Honorato Mejia",88,0,1,0,87,14,17,0,0,207,2,4,213,231,0.42,0.922
"23445","Santa Cruz","Santa Cruz de La Sierra","Col. Esc. Honorato Mejia",105,0,1,1,67,21,13,0,0,208,2,2,212,235,0.322,0.902
"23446","Santa Cruz","Santa Cruz de La Sierra","Col. Esc. Honorato Mejia",100,1,0,0,82,9,9,0,0,201,1,5,207,230,0.408,0.9
"23447","Santa Cruz","Santa Cruz de La Sierra","Col. Esc. Honorato Mejia",99,0,0,0,70,19,15,1,2,206,0,3,209,228,0.34,0.917
"23448","Santa Cruz","Santa Cruz de La Sierra","Col. Esc. Honorato Mejia",78,0,0,1,78,20,19,3,0,199,3,9,211,230,0.392,0.917
"23449","Santa Cruz","Santa Cruz de La Sierra","Col. Esc. Honorato Mejia",103,1,0,1,59,20,16,1,0,201,0,12,213,231,0.294,0.922
"23450","Santa Cruz","Santa Cruz de La Sierra","Col. Esc. Honorato Mejia",116,0,0,1,64,7,14,1,2,205,7,9,221,235,0.312,0.94
"23451","Santa Cruz","Santa Cruz de La Sierra","Col. Esc. Honorato Mejia",84,0,0,0,105,11,8,2,1,211,0,4,215,234,0.498,0.919
"23452","Santa Cruz","Santa Cruz de La Sierra","Col. Esc. Honorato Mejia",99,1,0,0,31,81,7,2,1,222,0,8,230,234,0.14,0.983
"23453","Santa Cruz","Santa Cruz de La Sierra","Col. Esc. Honorato Mejia",112,0,0,0,51,21,16,1,1,202,3,5,210,226,0.252,0.929
"23454","Santa Cruz","Santa Cruz de La Sierra","Col. Esc. Honorato Mejia",93,0,0,0,71,24,19,1,0,208,0,9,217,234,0.341,0.927
"23455","Santa Cruz","Santa Cruz de La Sierra","Col. Esc. Honorato Mejia",93,0,0,1,76,18,14,1,1,204,1,5,210,227,0.373,0.925
"23456","Santa Cruz","Santa Cruz de La Sierra","Col. Covipal",71,0,0,0,97,7,32,1,0,208,2,10,220,229,0.466,0.961
"23457","Santa Cruz","Santa Cruz de La Sierra","Col. Covipal",50,1,0,1,110,16,15,1,0,194,3,5,202,226,0.567,0.894
"23458","Santa Cruz","Santa Cruz de La Sierra","Col. Covipal",46,0,0,1,121,13,24,0,2,207,1,5,213,232,0.585,0.918
"23459","Santa Cruz","Santa Cruz de La Sierra","Col. Covipal",66,1,0,0,105,12,22,1,0,207,2,6,215,233,0.507,0.923
"23460","Santa Cruz","Santa Cruz de La Sierra","Col. Covipal",50,0,0,1,111,9,31,1,4,207,1,2,210,230,0.536,0.913
"23461","Santa Cruz","Santa Cruz de La Sierra","Col. Covipal",58,1,2,0,89,10,23,0,1,184,3,4,191,211,0.484,0.905
"23462","Santa Cruz","Santa Cruz de La Sierra","Colegio Plan 4000",39,1,0,1,120,9,29,0,2,201,1,6,208,228,0.597,0.912
"23463","Santa Cruz","Santa Cruz de La Sierra","Colegio Plan 4000",39,1,1,0,119,14,23,1,1,199,3,3,205,227,0.598,0.903
"23464","Santa Cruz","Santa Cruz de La Sierra","Colegio Plan 4000",66,2,0,2,84,20,22,1,2,199,5,9,213,227,0.422,0.938
"23465","Santa Cruz","Santa Cruz de La Sierra","Colegio Plan 4000",62,1,0,0,99,22,15,1,0,200,3,9,212,233,0.495,0.91
"23466","Santa Cruz","Santa Cruz de La Sierra","Colegio Plan 4000",40,0,1,1,111,20,31,0,2,206,0,9,215,234,0.539,0.919
"23467","Santa Cruz","Santa Cruz de La Sierra","Colegio Plan 4000",35,1,1,0,120,13,17,0,4,191,4,15,210,231,0.628,0.909
"23468","Santa Cruz","Santa Cruz de La Sierra","Colegio Plan 4000",32,1,3,1,118,15,22,3,3,198,2,7,207,230,0.596,0.9
"23469","Santa Cruz","Santa Cruz de La Sierra","Colegio Plan 4000",27,0,0,1,145,9,25,0,2,209,2,10,221,235,0.694,0.94
"23470","Santa Cruz","Santa Cruz de La Sierra","Colegio Plan 4000",59,3,0,0,105,17,18,1,1,204,0,27,231,231,0.515,1
"23471","Santa Cruz","Santa Cruz de La Sierra","Colegio Plan 4000",40,1,1,0,119,22,18,1,2,204,1,6,211,232,0.583,0.909
"23472","Santa Cruz","Santa Cruz de La Sierra","Colegio Plan 4000",36,0,2,0,118,16,27,1,2,202,4,9,215,234,0.584,0.919
"23473","Santa Cruz","Santa Cruz de La Sierra","Colegio Plan 4000",60,0,0,1,107,19,17,0,1,205,0,10,215,234,0.522,0.919
"23474","Santa Cruz","Santa Cruz de La Sierra","Colegio Plan 4000",38,0,0,2,119,17,22,1,0,199,3,3,205,233,0.598,0.88
"23475","Santa Cruz","Santa Cruz de La Sierra","Colegio Plan 4000",40,0,0,0,131,8,20,3,4,206,1,8,215,230,0.636,0.935
"23476","Santa Cruz","Santa Cruz de La Sierra","Colegio Plan 4000",46,2,0,2,118,13,20,0,0,201,2,6,209,228,0.587,0.917
"23477","Santa Cruz","Santa Cruz de La Sierra","Colegio Plan 4000",45,0,0,1,123,8,25,3,2,207,1,4,212,233,0.594,0.91
"23478","Santa Cruz","Santa Cruz de La Sierra","Colegio Plan 4000",12,0,0,0,164,15,20,2,2,215,0,6,221,235,0.763,0.94
"23479","Santa Cruz","Santa Cruz de La Sierra","Colegio Plan 4000",60,1,0,0,98,21,22,0,1,203,5,10,218,236,0.483,0.924
"23480","Santa Cruz","Santa Cruz de La Sierra","Colegio Plan 4000",61,0,0,1,99,22,24,1,1,209,0,10,219,231,0.474,0.948
"23481","Santa Cruz","Santa Cruz de La Sierra","Colegio Plan 4000",33,1,3,1,123,18,22,1,0,202,2,9,213,234,0.609,0.91
"23482","Santa Cruz","Santa Cruz de La Sierra","Colegio Plan 4000",45,0,0,1,116,17,13,2,1,195,1,17,213,235,0.595,0.906
"23483","Santa Cruz","Santa Cruz de La Sierra","Colegio Plan 4000",45,1,0,1,114,23,21,2,0,207,1,9,217,235,0.551,0.923
"23484","Santa Cruz","Santa Cruz de La Sierra","Colegio Plan 4000",38,0,1,1,124,12,24,1,1,202,0,8,210,231,0.614,0.909
"23485","Santa Cruz","Santa Cruz de La Sierra","Colegio Plan 4000",18,0,0,0,147,11,33,0,3,212,1,3,216,237,0.693,0.911
"23486","Santa Cruz","Santa Cruz de La Sierra","Colegio Plan 4000",51,1,0,2,117,16,10,3,1,201,1,9,211,232,0.582,0.909
"23487","Santa Cruz","Santa Cruz de La Sierra","Colegio Plan 4000",45,1,0,1,116,13,24,0,1,201,0,7,208,232,0.577,0.897
"23488","Santa Cruz","Santa Cruz de La Sierra","Colegio Plan 4000",49,1,1,0,93,28,23,3,2,200,3,7,210,228,0.465,0.921
"23489","Santa Cruz","Santa Cruz de La Sierra","Colegio Plan 4000",42,0,0,3,116,6,17,1,0,185,7,14,206,234,0.627,0.88
"23490","Santa Cruz","Santa Cruz de La Sierra","Colegio Plan 4000",28,3,0,1,132,13,17,2,0,196,4,5,205,234,0.673,0.876
"23491","Santa Cruz","Santa Cruz de La Sierra","Colegio Plan 4000",57,0,1,2,89,31,19,0,1,200,2,7,209,230,0.445,0.909
"23492","Santa Cruz","Santa Cruz de La Sierra","Colegio Plan 4000",41,0,0,2,116,13,20,2,2,196,1,14,211,233,0.592,0.906
"23493","Santa Cruz","Santa Cruz de La Sierra","Colegio Plan 4000",51,0,1,0,115,13,19,1,0,200,0,3,203,227,0.575,0.894
"23494","Santa Cruz","Santa Cruz de La Sierra","Colegio Luz Y Verdad",54,0,0,5,93,11,24,1,2,190,2,7,199,227,0.489,0.877
"23495","Santa Cruz","Santa Cruz de La Sierra","Colegio Luz Y Verdad",66,0,1,1,84,22,19,0,3,196,2,4,202,226,0.429,0.894
"23496","Santa Cruz","Santa Cruz de La Sierra","Colegio Luz Y Verdad",58,0,1,1,101,18,12,0,3,194,0,8,202,229,0.521,0.882
"23497","Santa Cruz","Santa Cruz de La Sierra","Colegio Luz Y Verdad",47,0,1,1,112,15,20,2,3,201,2,1,204,232,0.557,0.879
"23498","Santa Cruz","Santa Cruz de La Sierra","Colegio Luz Y Verdad",74,1,0,7,85,14,14,1,5,201,1,6,208,228,0.423,0.912
"23499","Santa Cruz","Santa Cruz de La Sierra","Colegio Luz Y Verdad",47,1,1,3,110,18,16,0,1,197,3,7,207,227,0.558,0.912
"23500","Santa Cruz","Santa Cruz de La Sierra","Colegio Luz Y Verdad",80,0,0,1,70,21,13,0,0,185,2,5,192,230,0.378,0.835
"23501","Santa Cruz","Santa Cruz de La Sierra","Colegio Luz Y Verdad",46,1,0,0,127,6,15,2,2,199,0,6,205,231,0.638,0.887
"23502","Santa Cruz","Santa Cruz de La Sierra","Colegio Luz Y Verdad",57,0,1,1,101,15,17,0,4,196,3,31,230,230,0.515,1
"23503","Santa Cruz","Santa Cruz de La Sierra","Colegio Luz Y Verdad",74,0,0,2,92,9,21,2,1,201,2,28,231,231,0.458,1
"23504","Santa Cruz","Santa Cruz de La Sierra","Colegio Luz Y Verdad",63,1,2,1,84,13,21,1,3,189,3,36,228,228,0.444,1
"23505","Santa Cruz","Santa Cruz de La Sierra","Colegio Luz Y Verdad",75,0,0,1,87,19,11,0,4,197,1,6,204,230,0.442,0.887
"23506","Santa Cruz","Santa Cruz de La Sierra","Colegio Luz Y Verdad",72,0,0,2,88,18,17,1,2,200,0,29,229,229,0.44,1
"23507","Santa Cruz","Santa Cruz de La Sierra","Colegio Luz Y Verdad",75,0,0,3,93,15,12,0,3,201,2,29,232,232,0.463,1
"23508","Santa Cruz","Santa Cruz de La Sierra","Colegio Luz Y Verdad",53,0,0,2,94,14,23,0,3,189,0,6,195,224,0.497,0.871
"23509","Santa Cruz","Santa Cruz de La Sierra","Col. Esc. Holanda",77,0,1,0,88,16,15,2,1,200,1,8,209,237,0.44,0.882
"23510","Santa Cruz","Santa Cruz de La Sierra","Col. Esc. Holanda",49,2,1,0,108,13,15,0,0,188,1,11,200,229,0.574,0.873
"23511","Santa Cruz","Santa Cruz de La Sierra","Col. Esc. Holanda",57,1,1,2,124,9,20,0,2,216,1,2,219,232,0.574,0.944
"23512","Santa Cruz","Santa Cruz de La Sierra","Col. Esc. Holanda",61,0,0,2,106,14,28,1,0,212,0,3,215,236,0.5,0.911
"23513","Santa Cruz","Santa Cruz de La Sierra","Col. Esc. Holanda",63,1,1,0,85,7,18,0,2,177,3,19,199,229,0.48,0.869
"23514","Santa Cruz","Santa Cruz de La Sierra","Col. Esc. Holanda",53,0,1,1,108,9,15,2,0,189,0,10,199,227,0.571,0.877
"23515","Santa Cruz","Santa Cruz de La Sierra","Col. Esc. Holanda",65,1,0,1,89,17,26,0,0,199,7,9,215,228,0.447,0.943
"23516","Santa Cruz","Santa Cruz de La Sierra","Col. Esc. Holanda",68,0,2,0,104,13,20,0,0,207,1,4,212,234,0.502,0.906
"23517","Santa Cruz","Santa Cruz de La Sierra","Col. Esc. Holanda",77,1,0,3,90,21,22,0,0,214,1,0,215,234,0.421,0.919
"23518","Santa Cruz","Santa Cruz de La Sierra","Col. Esc. Holanda",57,0,1,1,88,12,25,2,1,187,4,10,201,229,0.471,0.878
"23519","Santa Cruz","Santa Cruz de La Sierra","Col. Rodolfo Joem",110,0,1,0,58,20,11,2,0,202,0,24,226,226,0.287,1
"23520","Santa Cruz","Santa Cruz de La Sierra","Col. Rodolfo Joem",102,1,1,1,47,12,13,0,0,177,0,8,185,223,0.266,0.83
"23521","Santa Cruz","Santa Cruz de La Sierra","Col. Rodolfo Joem",109,1,1,2,52,21,8,1,0,195,0,2,197,220,0.267,0.895
"23522","Santa Cruz","Santa Cruz de La Sierra","Col. Rodolfo Joem",110,0,1,2,50,13,8,3,0,187,2,3,192,222,0.267,0.865
"23523","Santa Cruz","Santa Cruz de La Sierra","Col. Rodolfo Joem",101,0,0,0,62,11,11,2,1,188,3,7,198,223,0.33,0.888
"23524","Santa Cruz","Santa Cruz de La Sierra","Col. Rodolfo Joem",89,0,0,0,78,10,16,1,1,195,0,7,202,228,0.4,0.886
"23525","Santa Cruz","Santa Cruz de La Sierra","Col. Rodolfo Joem",98,0,1,2,68,9,15,1,1,195,0,5,200,225,0.349,0.889
"23526","Santa Cruz","Santa Cruz de La Sierra","Col. Rodolfo Joem",93,1,1,0,56,20,15,2,1,189,1,4,194,226,0.296,0.858
"23527","Santa Cruz","Santa Cruz de La Sierra","Col. Rodolfo Joem",79,0,0,2,74,12,22,2,2,193,1,3,197,224,0.383,0.879
"23528","Santa Cruz","Santa Cruz de La Sierra","Col. Rodolfo Joem",86,0,2,1,77,21,12,1,1,201,0,5,206,227,0.383,0.907
"23529","Santa Cruz","Santa Cruz de La Sierra","Col. Rodolfo Joem",91,0,0,1,57,31,15,4,0,199,1,4,204,233,0.286,0.876
"23530","Santa Cruz","Santa Cruz de La Sierra","Col. Rodolfo Joem",94,0,0,1,57,15,16,1,0,184,1,7,192,231,0.31,0.831
"23531","Santa Cruz","Santa Cruz de La Sierra","Col. Rodolfo Joem",78,0,1,1,85,15,17,0,1,198,1,4,203,226,0.429,0.898
"23532","Santa Cruz","Santa Cruz de La Sierra","Col. Rodolfo Joem",108,0,0,0,53,20,9,0,4,194,1,8,203,229,0.273,0.886
"23533","Santa Cruz","Santa Cruz de La Sierra","Col. Rodolfo Joem",90,1,0,3,79,6,14,0,1,194,0,3,197,227,0.407,0.868
"23534","Santa Cruz","Santa Cruz de La Sierra","Col. Rodolfo Joem",115,0,0,0,51,21,7,2,1,197,1,7,205,228,0.259,0.899
"23535","Santa Cruz","Santa Cruz de La Sierra","Col. Rodolfo Joem",88,1,1,1,56,14,22,0,0,183,4,7,194,225,0.306,0.862
"23536","Santa Cruz","Santa Cruz de La Sierra","Col. Rodolfo Joem",90,0,0,2,55,22,12,2,0,183,0,4,187,211,0.301,0.886
"23537","Santa Cruz","Santa Cruz de La Sierra","Col. Rodolfo Joem",106,0,0,0,49,19,16,0,4,194,2,5,201,219,0.253,0.918
"23538","Santa Cruz","Santa Cruz de La Sierra","Col. Rodolfo Joem",61,1,2,1,104,11,17,1,0,198,0,4,202,228,0.525,0.886
"23539","Santa Cruz","Santa Cruz de La Sierra","Col. Rodolfo Joem",106,0,2,1,61,9,11,0,0,190,1,3,194,223,0.321,0.87
"23540","Santa Cruz","Santa Cruz de La Sierra","Col. Rodolfo Joem",110,0,0,0,52,16,11,1,1,191,0,6,197,226,0.272,0.872
"23541","Santa Cruz","Santa Cruz de La Sierra","Col. Rodolfo Joem",112,0,0,1,47,21,11,0,1,193,2,7,202,230,0.244,0.878
"23542","Santa Cruz","Santa Cruz de La Sierra","Col. Rodolfo Joem",99,0,0,0,56,25,9,0,1,190,1,6,197,229,0.295,0.86
"23543","Santa Cruz","Santa Cruz de La Sierra","Col. Rodolfo Joem",97,2,0,0,58,15,19,0,2,193,2,7,202,229,0.301,0.882
"23544","Santa Cruz","Santa Cruz de La Sierra","Col. Rodolfo Joem",103,0,0,0,40,22,10,1,4,180,1,7,188,223,0.222,0.843
"23545","Santa Cruz","Santa Cruz de La Sierra","Col. Rodolfo Joem",123,0,0,1,48,13,7,1,3,196,1,5,202,231,0.245,0.874
"23546","Santa Cruz","Santa Cruz de La Sierra","Col. Rodolfo Joem",85,0,2,1,78,6,17,1,4,194,3,3,200,222,0.402,0.901
"23547","Santa Cruz","Santa Cruz de La Sierra","Col. Rodolfo Joem",81,2,0,2,69,15,17,1,1,188,3,3,194,227,0.367,0.855
"23548","Santa Cruz","Santa Cruz de La Sierra","Col. Rodolfo Joem",103,0,0,0,42,22,12,0,2,181,1,2,184,222,0.232,0.829
"23549","Santa Cruz","Santa Cruz de La Sierra","Col. Rodolfo Joem",88,0,0,1,53,12,21,1,4,180,1,14,195,218,0.294,0.894
"23550","Santa Cruz","Santa Cruz de La Sierra","Col. Rodolfo Joem",111,1,0,1,40,20,12,0,0,185,2,13,200,226,0.216,0.885
"23551","Santa Cruz","Santa Cruz de La Sierra","Col. Rodolfo Joem",103,0,0,1,57,11,14,2,0,188,1,6,195,227,0.303,0.859
"23552","Santa Cruz","Santa Cruz de La Sierra","Col. Rodolfo Joem",108,0,1,2,60,18,15,1,0,205,0,2,207,233,0.293,0.888
"23553","Santa Cruz","Santa Cruz de La Sierra","Col. Rodolfo Joem",91,0,0,2,67,14,15,0,0,189,2,6,197,221,0.354,0.891
"23554","Santa Cruz","Santa Cruz de La Sierra","Col. Rodolfo Joem",115,0,0,3,39,25,10,1,1,194,0,7,201,223,0.201,0.901
"23555","Santa Cruz","Santa Cruz de La Sierra","Col. Rodolfo Joem",114,2,1,2,44,13,12,0,0,188,2,3,193,220,0.234,0.877
"23556","Santa Cruz","Santa Cruz de La Sierra","Col. Rodolfo Joem",113,1,1,1,43,14,14,1,1,189,2,5,196,231,0.228,0.848
"23557","Santa Cruz","Santa Cruz de La Sierra","Col. Rodolfo Joem",99,1,1,0,50,14,12,2,2,181,0,7,188,216,0.276,0.87
"23558","Santa Cruz","Santa Cruz de La Sierra","U.E. Victoria Diez",102,0,0,1,75,18,18,0,0,214,0,6,220,239,0.35,0.921
"23559","Santa Cruz","Santa Cruz de La Sierra","Col. Julio A. Gutierrez",143,0,0,1,23,12,6,1,1,187,1,8,196,223,0.123,0.879
"23560","Santa Cruz","Santa Cruz de La Sierra","Col. Julio A. Gutierrez",121,0,1,0,41,12,11,4,0,190,1,7,198,230,0.216,0.861
"23561","Santa Cruz","Santa Cruz de La Sierra","Col. Julio A. Gutierrez",127,0,0,2,24,14,15,1,0,183,0,2,185,224,0.131,0.826
"23562","Santa Cruz","Santa Cruz de La Sierra","Col. Julio A. Gutierrez",132,0,0,1,29,16,13,0,0,191,0,2,193,222,0.152,0.869
"23563","Santa Cruz","Santa Cruz de La Sierra","Col. Julio A. Gutierrez",112,1,1,1,36,16,9,1,1,178,0,2,180,219,0.202,0.822
"23564","Santa Cruz","Santa Cruz de La Sierra","Col. Julio A. Gutierrez",138,0,0,1,28,20,5,0,2,194,0,5,199,229,0.144,0.869
"23565","Santa Cruz","Santa Cruz de La Sierra","Col. Julio A. Gutierrez",119,1,0,2,20,29,8,2,0,181,1,3,185,222,0.11,0.833
"23566","Santa Cruz","Santa Cruz de La Sierra","Col. Julio A. Gutierrez",119,1,0,2,26,22,4,1,2,177,1,2,180,216,0.147,0.833
"23567","Santa Cruz","Santa Cruz de La Sierra","Col. Club De Leones #6",109,0,1,1,43,9,6,2,1,172,1,5,178,218,0.25,0.817
"23568","Santa Cruz","Santa Cruz de La Sierra","Col. Club De Leones #6",107,0,1,3,50,12,9,0,1,183,2,4,189,218,0.273,0.867
"23569","Santa Cruz","Santa Cruz de La Sierra","Col. Club De Leones #6",117,0,0,0,43,19,6,1,1,187,1,4,192,222,0.23,0.865
"23570","Santa Cruz","Santa Cruz de La Sierra","Col. Unidad Educativa Lorenzo Caballero",130,0,0,0,32,16,8,2,0,188,0,8,196,220,0.17,0.891
"23571","Santa Cruz","Santa Cruz de La Sierra","Col. Unidad Educativa Lorenzo Caballero",97,0,0,2,36,17,6,0,1,159,0,30,189,220,0.226,0.859
"23572","Santa Cruz","Santa Cruz de La Sierra","Col. Unidad Educativa Lorenzo Caballero",108,2,0,0,42,12,12,1,0,177,1,3,181,218,0.237,0.83
"23573","Santa Cruz","Santa Cruz de La Sierra","Col. Unidad Educativa Lorenzo Caballero",134,0,1,0,32,11,10,0,0,188,1,5,194,217,0.17,0.894
"23574","Santa Cruz","Santa Cruz de La Sierra","Col. Unidad Educativa Lorenzo Caballero",120,0,2,0,35,18,6,1,0,182,1,6,189,225,0.192,0.84
"23575","Santa Cruz","Santa Cruz de La Sierra","Col. Unidad Educativa Lorenzo Caballero",158,1,0,1,16,10,4,1,0,191,0,2,193,222,0.084,0.869
"23576","Santa Cruz","Santa Cruz de La Sierra","Col. Unidad Educativa Lorenzo Caballero",124,2,0,1,37,18,8,2,1,193,0,6,199,225,0.192,0.884
"23577","Santa Cruz","Santa Cruz de La Sierra","Col. Unidad Educativa Lorenzo Caballero",140,1,0,0,24,17,10,1,3,196,0,4,200,221,0.122,0.905
"23578","Santa Cruz","Santa Cruz de La Sierra","Col.  Placido Molilna",93,0,0,0,65,12,12,0,1,183,0,6,189,222,0.355,0.851
"23579","Santa Cruz","Santa Cruz de La Sierra","Col.  Placido Molilna",91,2,2,2,57,7,20,1,0,182,1,5,188,222,0.313,0.847
"23580","Santa Cruz","Santa Cruz de La Sierra","Col.  Placido Molilna",86,2,0,1,73,8,7,4,1,182,1,0,183,221,0.401,0.828
"23581","Santa Cruz","Santa Cruz de La Sierra","Col.  Placido Molilna",103,1,0,1,58,13,15,0,0,191,3,6,200,231,0.304,0.866
"23582","Santa Cruz","Santa Cruz de La Sierra","Col.  Placido Molilna",84,0,0,0,64,18,15,1,3,185,0,0,185,226,0.346,0.819
"23583","Santa Cruz","Santa Cruz de La Sierra","Col.  Placido Molilna",89,0,1,1,70,13,11,1,1,187,0,5,192,222,0.374,0.865
"23584","Santa Cruz","Santa Cruz de La Sierra","Col.  Placido Molilna",88,0,0,0,83,10,7,2,1,191,1,4,196,222,0.435,0.883
"23585","Santa Cruz","Santa Cruz de La Sierra","Col.  Placido Molilna",99,0,2,0,57,10,11,0,1,180,0,6,186,218,0.317,0.853
"23586","Santa Cruz","Santa Cruz de La Sierra","Col.  Placido Molilna",72,0,2,3,62,13,21,1,1,175,1,7,183,215,0.354,0.851
"23587","Santa Cruz","Santa Cruz de La Sierra","Col.  Placido Molilna",115,0,0,0,34,8,12,0,2,171,1,10,182,219,0.199,0.831
"23588","Santa Cruz","Santa Cruz de La Sierra","Col.  Placido Molilna",98,1,0,1,51,15,18,0,0,184,0,5,189,220,0.277,0.859
"23589","Santa Cruz","Santa Cruz de La Sierra","Col.  Placido Molilna",102,0,0,1,57,12,16,0,0,188,1,4,193,225,0.303,0.858
"23590","Santa Cruz","Santa Cruz de La Sierra","Col. Fe y Alegria La Merced",129,0,0,0,35,16,5,1,1,187,0,3,190,220,0.187,0.864
"23591","Santa Cruz","Santa Cruz de La Sierra","Col. Fe y Alegria La Merced",142,0,1,0,22,15,9,2,0,191,0,3,194,224,0.115,0.866
"23592","Santa Cruz","Santa Cruz de La Sierra","Col. Fe y Alegria La Merced",127,1,0,1,34,14,7,0,2,186,2,4,192,228,0.183,0.842
"23593","Santa Cruz","Santa Cruz de La Sierra","Col. Fe y Alegria La Merced",149,0,0,0,27,11,6,3,1,197,0,4,201,223,0.137,0.901
"23594","Santa Cruz","Santa Cruz de La Sierra","Col. Fe y Alegria La Merced",104,0,0,2,54,14,7,2,0,183,0,6,189,221,0.295,0.855
"23595","Santa Cruz","Santa Cruz de La Sierra","Col. Fe y Alegria La Merced",151,0,0,0,29,13,5,0,1,199,0,6,205,226,0.146,0.907
"23596","Santa Cruz","Santa Cruz de La Sierra","Col. Fe y Alegria La Merced",125,0,0,3,38,12,4,0,0,182,0,5,187,218,0.209,0.858
"23597","Santa Cruz","Santa Cruz de La Sierra","Col. Fe y Alegria La Merced",147,0,0,2,30,15,5,0,1,200,1,2,203,224,0.15,0.906
"23598","Santa Cruz","Santa Cruz de La Sierra","Col. Fe y Alegria La Merced",129,0,0,0,39,14,11,1,0,194,0,6,200,224,0.201,0.893
"23599","Santa Cruz","Santa Cruz de La Sierra","Col. Fe y Alegria La Merced",112,0,0,3,49,16,9,0,0,189,2,8,199,228,0.259,0.873
"23600","Santa Cruz","Santa Cruz de La Sierra","Col. Fe y Alegria La Merced",138,0,0,1,26,14,10,0,0,189,0,2,191,221,0.138,0.864
"23601","Santa Cruz","Santa Cruz de La Sierra","Col. Fe y Alegria La Merced",137,0,0,1,34,6,9,0,2,189,0,4,193,223,0.18,0.865
"23602","Santa Cruz","Santa Cruz de La Sierra","Col. Fe y Alegria La Merced",145,0,1,0,28,14,8,0,0,196,2,5,203,223,0.143,0.91
"23603","Santa Cruz","Santa Cruz de La Sierra","Col. Fe y Alegria La Merced",141,0,1,1,25,14,4,0,0,186,0,6,192,222,0.134,0.865
"23604","Santa Cruz","Santa Cruz de La Sierra","Col. Fe y Alegria La Merced",115,2,1,0,58,7,11,0,0,194,1,4,199,222,0.299,0.896
"23605","Santa Cruz","Santa Cruz de La Sierra","Col. Fe y Alegria La Merced",148,0,0,1,29,11,4,0,0,193,2,2,197,217,0.15,0.908
"23606","Santa Cruz","Santa Cruz de La Sierra","Col. Fe y Alegria La Merced",156,1,0,1,27,3,4,0,1,193,0,3,196,219,0.14,0.895
"23607","Santa Cruz","Santa Cruz de La Sierra","Col. Fe y Alegria La Merced",130,0,0,2,37,16,12,1,0,198,0,4,202,228,0.187,0.886
"23608","Santa Cruz","Santa Cruz de La Sierra","Col. Fe y Alegria La Merced",135,0,0,0,31,10,11,1,3,191,0,6,197,221,0.162,0.891
"23609","Santa Cruz","Santa Cruz de La Sierra","Col. Fe y Alegria La Merced",142,0,0,0,30,15,3,2,1,193,0,3,196,223,0.155,0.879
"23610","Santa Cruz","Santa Cruz de La Sierra","Col. Fe y Alegria La Merced",150,0,0,3,27,8,7,1,0,196,0,1,197,215,0.138,0.916
"23611","Santa Cruz","Santa Cruz de La Sierra","Col. Jose Malky Jesus Maria",131,0,1,3,40,13,10,0,2,200,0,1,201,230,0.2,0.874
"23612","Santa Cruz","Santa Cruz de La Sierra","Col. Jose Malky Jesus Maria",138,0,0,3,32,15,6,0,0,194,0,2,196,226,0.165,0.867
"23613","Santa Cruz","Santa Cruz de La Sierra","Col. Jose Malky Jesus Maria",138,0,0,0,32,15,6,1,0,192,2,2,196,225,0.167,0.871
"23614","Santa Cruz","Santa Cruz de La Sierra","Col. Jose Malky Jesus Maria",136,0,0,1,32,15,9,0,2,195,2,6,203,229,0.164,0.886
"23615","Santa Cruz","Santa Cruz de La Sierra","Col. Jose Malky Jesus Maria",109,0,0,1,56,7,15,3,2,193,0,4,197,225,0.29,0.876
"23616","Santa Cruz","Santa Cruz de La Sierra","Col. Jose Malky Jesus Maria",109,1,1,0,56,14,15,0,1,197,2,2,201,230,0.284,0.874
"23617","Santa Cruz","Santa Cruz de La Sierra","Col. Jose Malky Jesus Maria",152,1,1,1,33,7,6,0,1,202,0,5,207,231,0.163,0.896
"23618","Santa Cruz","Santa Cruz de La Sierra","Col. Jose Malky Jesus Maria",121,0,0,1,39,13,15,2,1,192,0,1,193,227,0.203,0.85
"23619","Santa Cruz","Santa Cruz de La Sierra","Col. Jose Malky Jesus Maria",146,0,1,1,25,17,6,0,0,196,1,6,203,225,0.128,0.902
"23620","Santa Cruz","Santa Cruz de La Sierra","Col. Jose Malky Jesus Maria",133,0,0,1,35,13,14,0,1,197,1,4,202,228,0.178,0.886
"23621","Santa Cruz","Santa Cruz de La Sierra","Col. Jose Malky Jesus Maria",138,0,0,1,32,13,12,0,0,196,0,5,201,223,0.163,0.901
"23622","Santa Cruz","Santa Cruz de La Sierra","Col. Jose Malky Jesus Maria",140,0,0,1,35,21,9,2,2,210,2,5,217,231,0.167,0.939
"23623","Santa Cruz","Santa Cruz de La Sierra","Col. Jose Malky Jesus Maria",108,0,0,1,58,11,17,2,2,199,2,2,203,228,0.291,0.89
"23624","Santa Cruz","Santa Cruz de La Sierra","Col. Jose Malky Jesus Maria",144,0,0,0,26,13,11,1,0,195,0,6,201,226,0.133,0.889
"23625","Santa Cruz","Santa Cruz de La Sierra","Col. Jose Malky Jesus Maria",133,0,0,0,34,14,13,1,0,195,0,5,200,229,0.174,0.873
"23626","Santa Cruz","Santa Cruz de La Sierra","Col. Jose Malky Jesus Maria",135,0,0,0,33,11,9,1,0,189,1,5,195,229,0.175,0.852
"23627","Santa Cruz","Santa Cruz de La Sierra","Col. Jose Malky Jesus Maria",122,0,1,1,44,9,10,2,1,190,1,4,195,228,0.232,0.855
"23628","Santa Cruz","Santa Cruz de La Sierra","Col. Jose Malky Jesus Maria",138,0,0,0,34,19,6,1,1,199,1,1,201,225,0.171,0.893
"23629","Santa Cruz","Santa Cruz de La Sierra","Col. Jose Malky Jesus Maria",139,0,0,0,24,11,16,1,0,191,1,7,199,231,0.126,0.861
"23630","Santa Cruz","Santa Cruz de La Sierra","Col. Jose Malky Jesus Maria",159,1,0,0,23,12,5,1,1,202,0,5,207,226,0.114,0.916
"23631","Santa Cruz","Santa Cruz de La Sierra","Col. Jose Malky Jesus Maria",130,0,0,1,36,11,7,1,0,186,0,6,192,226,0.194,0.85
"23632","Santa Cruz","Santa Cruz de La Sierra","Col. Jose Malky Jesus Maria",134,0,0,1,36,12,8,0,3,194,0,4,198,230,0.186,0.861
"23633","Santa Cruz","Santa Cruz de La Sierra","Col. Jose Malky Jesus Maria",132,0,0,1,45,11,8,1,1,199,0,0,199,229,0.226,0.869
"23634","Santa Cruz","Santa Cruz de La Sierra","Col. Jose Malky Jesus Maria",119,1,0,0,42,17,10,0,0,189,0,1,190,224,0.222,0.848
"23635","Santa Cruz","Santa Cruz de La Sierra","Col. Nucleo Escolar Ramafa",131,0,1,6,22,17,6,0,1,184,0,8,192,225,0.12,0.853
"23636","Santa Cruz","Santa Cruz de La Sierra","Col. Nucleo Escolar Ramafa",126,0,0,4,22,17,8,0,0,177,0,8,185,219,0.124,0.845
"23637","Santa Cruz","Santa Cruz de La Sierra","Col. Nucleo Escolar Ramafa",140,1,0,3,14,25,7,1,1,192,0,3,195,226,0.073,0.863
"23638","Santa Cruz","Santa Cruz de La Sierra","Col. Nucleo Escolar Ramafa",162,1,0,2,19,14,4,1,1,204,2,4,210,223,0.093,0.942
"23639","Santa Cruz","Santa Cruz de La Sierra","Col. Nucleo Escolar Ramafa",142,1,0,0,25,16,3,0,0,187,0,5,192,214,0.134,0.897
"23640","Santa Cruz","Santa Cruz de La Sierra","Col. Nucleo Escolar Ramafa",149,0,0,1,22,18,7,0,0,197,0,4,201,218,0.112,0.922
"23641","Santa Cruz","Santa Cruz de La Sierra","Col. Nucleo Escolar Ramafa",153,0,0,1,21,12,7,1,0,195,1,4,200,220,0.108,0.909
"23642","Santa Cruz","Santa Cruz de La Sierra","Col. Nucleo Escolar Ramafa",148,0,1,2,21,14,8,1,0,195,1,4,200,221,0.108,0.905
"23643","Santa Cruz","Santa Cruz de La Sierra","Col. Complejo Educativo Japon",105,0,0,1,62,14,13,0,1,196,2,7,205,229,0.316,0.895
"23644","Santa Cruz","Santa Cruz de La Sierra","Col. Complejo Educativo Japon",109,1,0,2,54,10,11,2,1,190,1,1,192,229,0.284,0.838
"23645","Santa Cruz","Santa Cruz de La Sierra","Col. Complejo Educativo Japon",125,0,0,1,35,22,14,0,2,199,0,2,201,225,0.176,0.893
"23646","Santa Cruz","Santa Cruz de La Sierra","Col. Complejo Educativo Japon",106,0,1,0,71,8,9,0,0,195,1,0,196,221,0.364,0.887
"23647","Santa Cruz","Santa Cruz de La Sierra","Col. Complejo Educativo Japon",107,0,0,0,38,19,16,0,0,180,3,10,193,221,0.211,0.873
"23648","Santa Cruz","Santa Cruz de La Sierra","Col. Complejo Educativo Japon",96,2,0,1,73,9,16,1,1,199,3,3,205,228,0.367,0.899
"23649","Santa Cruz","Santa Cruz de La Sierra","Col. Complejo Educativo Japon",117,0,0,0,50,8,7,1,1,184,0,7,191,223,0.272,0.857
"23650","Santa Cruz","Santa Cruz de La Sierra","Col. Complejo Educativo Japon",119,0,0,2,41,13,9,0,2,186,3,6,195,223,0.22,0.874
"23651","Santa Cruz","Santa Cruz de La Sierra","Col. Complejo Educativo Japon",101,0,1,2,63,17,6,1,0,191,1,5,197,222,0.33,0.887
"23652","Santa Cruz","Santa Cruz de La Sierra","Col. Complejo Educativo Japon",96,1,0,1,71,9,13,2,0,193,0,5,198,228,0.368,0.868
"23653","Santa Cruz","Santa Cruz de La Sierra","Col. Complejo Educativo Japon",123,0,0,0,53,15,14,0,0,205,0,3,208,230,0.259,0.904
"23654","Santa Cruz","Santa Cruz de La Sierra","Col. Complejo Educativo Japon",119,1,1,0,48,8,13,2,1,193,1,7,201,228,0.249,0.882
"23655","Santa Cruz","Santa Cruz de La Sierra","Col. Complejo Educativo Japon",71,1,0,1,80,11,17,3,0,184,1,15,200,225,0.435,0.889
"23656","Santa Cruz","Santa Cruz de La Sierra","Col. Complejo Educativo Japon",124,1,0,1,50,15,2,2,0,195,1,6,202,227,0.256,0.89
"23657","Santa Cruz","Santa Cruz de La Sierra","Col. Complejo Educativo Japon",112,1,0,0,52,13,15,0,0,193,1,4,198,221,0.269,0.896
"23658","Santa Cruz","Santa Cruz de La Sierra","Col. Complejo Educativo Japon",118,0,0,0,51,10,14,0,0,193,1,9,203,227,0.264,0.894
"23659","Santa Cruz","Santa Cruz de La Sierra","Col. Complejo Educativo Japon",109,0,0,1,32,16,15,1,1,175,2,6,183,222,0.183,0.824
"23660","Santa Cruz","Santa Cruz de La Sierra","Col. Complejo Educativo Japon",96,0,0,0,67,11,15,2,3,194,0,2,196,224,0.345,0.875
"23661","Santa Cruz","Santa Cruz de La Sierra","Col. Complejo Educativo Japon",111,1,1,1,54,14,10,0,0,192,1,3,196,220,0.281,0.891
"23662","Santa Cruz","Santa Cruz de La Sierra","Col. Complejo Educativo Japon",114,0,0,2,46,12,14,0,0,188,3,4,195,226,0.245,0.863
"23663","Santa Cruz","Santa Cruz de La Sierra","Col. Complejo Educativo Japon",130,1,0,0,35,16,7,0,0,189,1,5,195,225,0.185,0.867
"23664","Santa Cruz","Santa Cruz de La Sierra","Col. Complejo Educativo Japon",102,0,0,0,64,18,12,0,0,196,0,3,199,229,0.327,0.869
"23665","Santa Cruz","Santa Cruz de La Sierra","Col. Complejo Educativo Japon",126,0,0,0,51,16,8,0,0,201,0,2,203,224,0.254,0.906
"23666","Santa Cruz","Santa Cruz de La Sierra","Col. Complejo Educativo Japon",100,0,0,0,76,9,17,0,2,204,0,2,206,228,0.373,0.904
"23667","Santa Cruz","Santa Cruz de La Sierra","Col. Alfa y Omega",125,0,1,0,30,21,12,1,0,190,1,6,197,220,0.158,0.895
"23668","Santa Cruz","Santa Cruz de La Sierra","Col. Alfa y Omega",124,0,3,0,38,9,13,0,0,187,1,5,193,224,0.203,0.862
"23669","Santa Cruz","Santa Cruz de La Sierra","Col. Alfa y Omega",127,0,0,1,39,18,12,0,1,198,1,3,202,223,0.197,0.906
"23670","Santa Cruz","Santa Cruz de La Sierra","Col. Alfa y Omega",140,1,0,1,32,12,12,0,1,199,0,4,203,226,0.161,0.898
"23671","Santa Cruz","Santa Cruz de La Sierra","Col. Alfa y Omega",126,0,0,3,37,13,7,0,0,186,0,5,191,218,0.199,0.876
"23672","Santa Cruz","Santa Cruz de La Sierra","Col. Alfa y Omega",115,0,0,3,41,18,11,1,2,191,2,14,207,227,0.215,0.912
"23673","Santa Cruz","Santa Cruz de La Sierra","Col. Alfa y Omega",148,0,0,1,27,18,6,0,0,200,1,5,206,227,0.135,0.907
"23674","Santa Cruz","Santa Cruz de La Sierra","Col. Alfa y Omega",129,0,0,0,35,22,5,0,1,192,0,6,198,221,0.182,0.896
"23675","Santa Cruz","Santa Cruz de La Sierra","Col. El Carmen 16 De Julio",125,0,0,1,43,20,10,2,0,201,2,5,208,226,0.214,0.92
"23676","Santa Cruz","Santa Cruz de La Sierra","Col. El Carmen 16 De Julio",131,0,1,1,25,14,10,2,3,187,1,9,197,225,0.134,0.876
"23677","Santa Cruz","Santa Cruz de La Sierra","Col. El Carmen 16 De Julio",145,1,0,1,26,18,12,0,0,203,2,1,206,230,0.128,0.896
"23678","Santa Cruz","Santa Cruz de La Sierra","Col. El Carmen 16 De Julio",144,1,0,2,39,19,7,1,2,215,0,4,219,226,0.181,0.969
"23679","Santa Cruz","Santa Cruz de La Sierra","Col. El Carmen 16 De Julio",130,0,0,2,32,10,9,1,0,184,1,3,188,226,0.174,0.832
"23680","Santa Cruz","Santa Cruz de La Sierra","Col. El Carmen 16 De Julio",115,0,1,1,47,15,9,1,3,192,0,11,203,229,0.245,0.886
"23681","Santa Cruz","Santa Cruz de La Sierra","Col. El Carmen 16 De Julio",128,2,0,1,32,13,12,1,0,189,1,5,195,219,0.169,0.89
"23682","Santa Cruz","Santa Cruz de La Sierra","Col. El Carmen 16 De Julio",127,0,0,1,31,11,9,0,0,179,0,9,188,219,0.173,0.858
"23683","Santa Cruz","Santa Cruz de La Sierra","Col. El Carmen 16 De Julio",146,0,0,1,32,12,2,1,2,196,1,6,203,221,0.163,0.919
"23684","Santa Cruz","Santa Cruz de La Sierra","Col. El Carmen 16 De Julio",123,1,0,2,41,18,8,0,0,193,1,4,198,225,0.212,0.88
"23685","Santa Cruz","Santa Cruz de La Sierra","Col. Antonio Vicente Seoane",146,0,0,1,31,14,5,1,0,198,0,3,201,224,0.157,0.897
"23686","Santa Cruz","Santa Cruz de La Sierra","Col. Antonio Vicente Seoane",146,0,1,0,24,17,9,0,0,197,1,5,203,224,0.122,0.906
"23687","Santa Cruz","Santa Cruz de La Sierra","Col. Antonio Vicente Seoane",135,0,2,2,33,15,1,1,1,190,1,7,198,223,0.174,0.888
"23688","Santa Cruz","Santa Cruz de La Sierra","Col. Antonio Vicente Seoane",130,2,0,1,27,15,8,1,0,184,1,6,191,223,0.147,0.857
"23689","Santa Cruz","Santa Cruz de La Sierra","Col. Antonio Vicente Seoane",133,0,2,0,27,18,10,1,0,191,0,4,195,221,0.141,0.882
"23690","Santa Cruz","Santa Cruz de La Sierra","Col. Antonio Vicente Seoane",138,0,0,0,37,14,4,0,2,195,1,4,200,223,0.19,0.897
"23691","Santa Cruz","Santa Cruz de La Sierra","Col. Antonio Vicente Seoane",149,1,1,0,17,21,7,1,1,198,2,6,206,228,0.086,0.904
"23692","Santa Cruz","Santa Cruz de La Sierra","Col. Antonio Vicente Seoane",145,0,0,1,28,23,9,0,0,206,0,1,207,226,0.136,0.916
"23693","Santa Cruz","Santa Cruz de La Sierra","Col. Antonio Vicente Seoane",133,0,0,1,34,15,8,0,0,191,1,3,195,218,0.178,0.894
"23694","Santa Cruz","Santa Cruz de La Sierra","Col. Antonio Vicente Seoane",139,1,0,1,34,15,8,0,0,198,2,3,203,227,0.172,0.894
"23695","Santa Cruz","Santa Cruz de La Sierra","Col. Antonio Vicente Seoane",141,1,0,0,32,15,5,0,0,194,0,6,200,226,0.165,0.885
"23696","Santa Cruz","Santa Cruz de La Sierra","Col. Sociedad De Ingenieros",143,0,1,0,22,11,3,1,0,181,0,3,184,221,0.122,0.833
"23697","Santa Cruz","Santa Cruz de La Sierra","Col. Sociedad De Ingenieros",145,0,0,1,18,18,0,1,3,186,0,10,196,218,0.097,0.899
"23698","Santa Cruz","Santa Cruz de La Sierra","Col. Sociedad De Ingenieros",128,1,1,2,35,19,6,1,1,194,2,7,203,224,0.18,0.906
"23699","Santa Cruz","Santa Cruz de La Sierra","Col. Sociedad De Ingenieros",123,0,1,2,41,19,5,0,0,191,0,1,192,219,0.215,0.877
"23700","Santa Cruz","Santa Cruz de La Sierra","Col. Sociedad De Ingenieros",151,0,0,1,20,16,8,1,0,197,1,4,202,220,0.102,0.918
"23701","Santa Cruz","Santa Cruz de La Sierra","Col. Sociedad De Ingenieros",144,1,1,0,25,13,10,3,1,198,0,2,200,222,0.126,0.901
"23702","Santa Cruz","Santa Cruz de La Sierra","Col. Sociedad De Ingenieros",133,0,0,1,34,17,2,0,0,187,0,6,193,225,0.182,0.858
"23703","Santa Cruz","Santa Cruz de La Sierra","Col. Sociedad De Ingenieros",133,0,0,1,27,10,4,0,1,176,0,2,178,217,0.153,0.82
"23704","Santa Cruz","Santa Cruz de La Sierra","Col. Sociedad De Ingenieros",140,0,0,2,26,14,13,0,0,195,2,6,203,223,0.133,0.91
"23705","Santa Cruz","Santa Cruz de La Sierra","Col. Sociedad De Ingenieros",145,0,0,0,21,8,8,0,1,183,0,4,187,218,0.115,0.858
"23706","Santa Cruz","Santa Cruz de La Sierra","Col. Sociedad De Ingenieros",149,1,0,0,17,18,4,0,0,189,0,6,195,226,0.09,0.863
"23707","Santa Cruz","Santa Cruz de La Sierra","Col. Sociedad De Ingenieros",156,0,0,2,25,13,3,1,1,201,0,2,203,226,0.124,0.898
"23708","Santa Cruz","Santa Cruz de La Sierra","Col. Sociedad De Ingenieros",142,0,0,2,22,18,5,1,0,190,1,2,193,223,0.116,0.865
"23709","Santa Cruz","Santa Cruz de La Sierra","Col. Sociedad De Ingenieros",148,0,0,1,23,10,7,0,0,189,0,8,197,223,0.122,0.883
"23710","Santa Cruz","Santa Cruz de La Sierra","Col. Sociedad De Ingenieros",144,0,0,3,21,13,11,1,0,193,2,7,202,230,0.109,0.878
"23711","Santa Cruz","Santa Cruz de La Sierra","Col. Sociedad De Ingenieros",147,0,0,0,38,9,6,3,0,203,3,0,206,221,0.187,0.932
"23712","Santa Cruz","Santa Cruz de La Sierra","Col. Sociedad De Ingenieros",140,0,0,0,34,9,5,0,0,188,0,4,192,216,0.181,0.889
"23713","Santa Cruz","Santa Cruz de La Sierra","U.E. Melvin Jones",158,0,0,0,32,11,12,1,0,214,0,2,216,237,0.15,0.911
"23714","Santa Cruz","Santa Cruz de La Sierra","Col. Jhon Kennedy",123,0,0,3,40,9,21,0,0,196,1,8,205,230,0.204,0.891
"23715","Santa Cruz","Santa Cruz de La Sierra","Col. Jhon Kennedy",114,1,0,0,43,14,13,2,0,187,1,2,190,225,0.23,0.844
"23716","Santa Cruz","Santa Cruz de La Sierra","Col. Jhon Kennedy",135,0,0,0,31,16,6,2,1,191,1,5,197,226,0.162,0.872
"23717","Santa Cruz","Santa Cruz de La Sierra","Col. Jhon Kennedy",137,1,0,0,32,14,7,1,1,193,0,3,196,223,0.166,0.879
"23718","Santa Cruz","Santa Cruz de La Sierra","Col. Jhon Kennedy",138,0,0,2,29,12,15,0,0,196,0,5,201,228,0.148,0.882
"23719","Santa Cruz","Santa Cruz de La Sierra","Col. Jhon Kennedy",137,0,0,0,37,10,7,1,0,192,1,4,197,228,0.193,0.864
"23720","Santa Cruz","Santa Cruz de La Sierra","Col. Jhon Kennedy",103,0,1,3,48,8,10,2,1,176,1,6,183,227,0.273,0.806
"23721","Santa Cruz","Santa Cruz de La Sierra","Col. Jhon Kennedy",128,0,0,0,53,4,10,0,2,197,0,4,201,228,0.269,0.882
"23722","Santa Cruz","Santa Cruz de La Sierra","Col. Jhon Kennedy",148,1,0,2,23,11,5,0,0,190,0,10,200,228,0.121,0.877
"23723","Santa Cruz","Santa Cruz de La Sierra","Col. Jhon Kennedy",145,1,0,0,24,12,4,2,0,188,1,2,191,222,0.128,0.86
"23724","Santa Cruz","Santa Cruz de La Sierra","Col. Jhon Kennedy",128,0,0,2,40,17,8,1,3,199,1,7,207,229,0.201,0.904
"23725","Santa Cruz","Santa Cruz de La Sierra","Col. Jhon Kennedy",131,0,0,1,26,7,13,1,1,180,1,8,189,224,0.144,0.844
"23726","Santa Cruz","Santa Cruz de La Sierra","Col. Jhon Kennedy",139,0,0,1,37,12,9,0,0,198,1,2,201,223,0.187,0.901
"23727","Santa Cruz","Santa Cruz de La Sierra","Col. Jhon Kennedy",131,0,0,1,34,10,14,2,0,192,1,4,197,224,0.177,0.879
"23728","Santa Cruz","Santa Cruz de La Sierra","Col. Jhon Kennedy",131,1,1,1,27,17,7,4,1,190,0,5,195,224,0.142,0.871
"23729","Santa Cruz","Santa Cruz de La Sierra","Col. Jhon Kennedy",132,0,0,0,41,12,11,0,0,196,2,3,201,231,0.209,0.87
"23730","Santa Cruz","Santa Cruz de La Sierra","Col. Jhon Kennedy",118,0,0,1,47,7,12,0,0,185,1,9,195,230,0.254,0.848
"23731","Santa Cruz","Santa Cruz de La Sierra","Col. Jhon Kennedy",129,0,1,1,30,20,5,1,0,187,1,3,191,223,0.16,0.857
"23732","Santa Cruz","Santa Cruz de La Sierra","Col. Jhon Kennedy",128,0,0,3,31,15,12,0,1,190,1,4,195,224,0.163,0.871
"23733","Santa Cruz","Santa Cruz de La Sierra","Col. Jhon Kennedy",136,0,0,1,39,10,11,1,0,198,1,4,203,229,0.197,0.886
"23734","Santa Cruz","Santa Cruz de La Sierra","Col. Jhon Kennedy",153,0,1,1,16,16,7,0,0,194,1,4,199,219,0.082,0.909
"23735","Santa Cruz","Santa Cruz de La Sierra","Col. Jhon Kennedy",153,0,0,0,24,12,9,2,0,200,0,0,200,226,0.12,0.885
"23736","Santa Cruz","Santa Cruz de La Sierra","Col. Jhon Kennedy",121,0,0,1,44,11,8,1,1,187,0,5,192,221,0.235,0.869
"23737","Santa Cruz","Santa Cruz de La Sierra","Col. Jhon Kennedy",141,0,0,1,34,7,7,3,0,193,1,6,200,223,0.176,0.897
"23738","Santa Cruz","Santa Cruz de La Sierra","Col. Jhon Kennedy",144,0,0,0,27,15,3,1,0,190,1,9,200,223,0.142,0.897
"23739","Santa Cruz","Santa Cruz de La Sierra","Col. Jhon Kennedy",125,0,0,1,36,23,4,2,1,192,0,7,199,230,0.188,0.865
"23740","Santa Cruz","Santa Cruz de La Sierra","Col. Jhon Kennedy",143,0,0,1,20,17,5,0,0,186,0,5,191,223,0.108,0.857
"23741","Santa Cruz","Santa Cruz de La Sierra","Col. Jhon Kennedy",144,0,1,0,28,8,13,4,1,199,3,2,204,224,0.141,0.911
"23742","Santa Cruz","Santa Cruz de La Sierra","Col. Jhon Kennedy",135,0,0,3,27,7,8,1,0,181,0,3,184,216,0.149,0.852
"23743","Santa Cruz","Santa Cruz de La Sierra","Col. Jhon Kennedy",138,0,1,2,35,13,9,0,2,200,1,4,205,231,0.175,0.887
"23744","Santa Cruz","Santa Cruz de La Sierra","Col. Jhon Kennedy",129,0,1,1,44,9,11,0,1,196,0,6,202,224,0.224,0.902
"23745","Santa Cruz","Santa Cruz de La Sierra","Col. Jhon Kennedy",146,0,0,0,31,16,3,0,0,196,2,3,201,225,0.158,0.893
"23746","Santa Cruz","Santa Cruz de La Sierra","Col. Victor Paz Estensoro",116,1,0,1,39,13,16,1,0,187,3,4,194,229,0.209,0.847
"23747","Santa Cruz","Santa Cruz de La Sierra","Col. Victor Paz Estensoro",116,0,1,2,47,14,16,3,2,201,0,3,204,229,0.234,0.891
"23748","Santa Cruz","Santa Cruz de La Sierra","Col. Victor Paz Estensoro",131,0,0,0,32,11,15,0,0,189,1,4,194,228,0.169,0.851
"23749","Santa Cruz","Santa Cruz de La Sierra","Col. Victor Paz Estensoro",114,1,0,0,56,8,15,0,0,194,1,7,202,228,0.289,0.886
"23750","Santa Cruz","Santa Cruz de La Sierra","Col. Victor Paz Estensoro",94,1,2,0,62,11,12,1,0,183,1,5,189,225,0.339,0.84
"23751","Santa Cruz","Santa Cruz de La Sierra","Col. Victor Paz Estensoro",79,2,2,2,82,12,9,0,1,189,1,8,198,227,0.434,0.872
"23752","Santa Cruz","Santa Cruz de La Sierra","Col. Victor Paz Estensoro",122,1,0,3,48,10,4,0,0,188,1,4,193,224,0.255,0.862
"23753","Santa Cruz","Santa Cruz de La Sierra","Col. Victor Paz Estensoro",113,2,3,0,51,15,11,2,1,198,1,5,204,228,0.258,0.895
"23754","Santa Cruz","Santa Cruz de La Sierra","Col. Victor Paz Estensoro",125,0,0,2,35,13,8,3,0,186,3,8,197,221,0.188,0.891
"23755","Santa Cruz","Santa Cruz de La Sierra","Col. Victor Paz Estensoro",111,2,0,2,53,12,20,1,0,201,0,4,205,234,0.264,0.876
"23756","Santa Cruz","Santa Cruz de La Sierra","Col. Victor Paz Estensoro",123,0,0,0,58,11,13,3,0,208,0,1,209,231,0.279,0.905
"23757","Santa Cruz","Santa Cruz de La Sierra","Col. Victor Paz Estensoro",81,0,0,1,71,19,19,0,1,192,2,4,198,226,0.37,0.876
"23758","Santa Cruz","Santa Cruz de La Sierra","Col. Victor Paz Estensoro",107,2,1,0,48,11,9,0,0,178,1,11,190,225,0.27,0.844
"23759","Santa Cruz","Santa Cruz de La Sierra","Col. Victor Paz Estensoro",129,0,0,2,34,19,6,0,0,190,2,9,201,224,0.179,0.897
"23760","Santa Cruz","Santa Cruz de La Sierra","Col. Victor Paz Estensoro",107,0,0,2,42,12,14,3,3,183,0,3,186,220,0.23,0.845
"23761","Santa Cruz","Santa Cruz de La Sierra","Col. Victor Paz Estensoro",127,0,0,0,46,18,10,0,1,202,2,6,210,230,0.228,0.913
"23762","Santa Cruz","Santa Cruz de La Sierra","Col. Victor Paz Estensoro",109,0,0,0,66,8,12,2,1,198,1,12,211,228,0.333,0.925
"23763","Santa Cruz","Santa Cruz de La Sierra","Col. Victor Paz Estensoro",90,0,0,1,72,8,20,0,1,192,0,3,195,222,0.375,0.878
"23764","Santa Cruz","Santa Cruz de La Sierra","Col. Victor Paz Estensoro",122,0,0,2,53,10,11,2,0,200,1,4,205,224,0.265,0.915
"23765","Santa Cruz","Santa Cruz de La Sierra","Col. Victor Paz Estensoro",131,1,0,2,38,15,8,4,1,200,2,5,207,225,0.19,0.92
"23766","Santa Cruz","Santa Cruz de La Sierra","Col. Victor Paz Estensoro",133,0,0,0,46,12,7,0,0,198,1,6,205,229,0.232,0.895
"23767","Santa Cruz","Santa Cruz de La Sierra","Col. Victor Paz Estensoro",107,0,0,0,65,12,18,0,1,203,0,9,212,234,0.32,0.906
"23768","Santa Cruz","Santa Cruz de La Sierra","Col. Victor Paz Estensoro",104,2,1,0,61,12,8,0,1,189,0,5,194,227,0.323,0.855
"23769","Santa Cruz","Santa Cruz de La Sierra","Col. Victor Paz Estensoro",117,0,0,1,56,14,11,0,0,199,2,6,207,229,0.281,0.904
"23770","Santa Cruz","Santa Cruz de La Sierra","Col. Monseñor Luis Rodriguez P.",91,1,0,2,66,16,11,2,2,191,1,5,197,220,0.346,0.895
"23771","Santa Cruz","Santa Cruz de La Sierra","Col. Monseñor Luis Rodriguez P.",93,1,1,1,59,10,13,1,1,180,1,12,193,223,0.328,0.865
"23772","Santa Cruz","Santa Cruz de La Sierra","Col. Monseñor Luis Rodriguez P.",105,1,1,0,50,24,15,0,0,196,0,6,202,234,0.255,0.863
"23773","Santa Cruz","Santa Cruz de La Sierra","Col. Monseñor Luis Rodriguez P.",114,0,0,0,55,13,12,0,0,194,3,8,205,231,0.284,0.887
"23774","Santa Cruz","Santa Cruz de La Sierra","Col. Monseñor Luis Rodriguez P.",132,0,1,0,56,5,13,1,1,209,1,4,214,232,0.268,0.922
"23775","Santa Cruz","Santa Cruz de La Sierra","Col. Monseñor Luis Rodriguez P.",84,0,0,0,85,9,21,1,0,200,0,4,204,229,0.425,0.891
"23776","Santa Cruz","Santa Cruz de La Sierra","Col. Monseñor Luis Rodriguez P.",98,1,0,0,62,15,15,1,0,192,0,6,198,225,0.323,0.88
"23777","Santa Cruz","Santa Cruz de La Sierra","Col. Monseñor Luis Rodriguez P.",113,0,0,1,55,14,13,1,0,197,1,3,201,227,0.279,0.885
"23778","Santa Cruz","Santa Cruz de La Sierra","Col. Monseñor Luis Rodriguez P.",100,1,0,3,66,14,12,1,0,197,0,4,201,227,0.335,0.885
"23779","Santa Cruz","Santa Cruz de La Sierra","Col. Monseñor Luis Rodriguez P.",109,0,1,0,62,8,13,0,0,193,0,3,196,228,0.321,0.86
"23780","Santa Cruz","Santa Cruz de La Sierra","Col. Monseñor Luis Rodriguez P.",115,1,0,2,54,9,7,0,1,189,1,5,195,228,0.286,0.855
"23781","Santa Cruz","Santa Cruz de La Sierra","Col. Monseñor Luis Rodriguez P.",108,0,0,0,61,11,13,1,0,194,0,8,202,224,0.314,0.902
"23782","Santa Cruz","Santa Cruz de La Sierra","Col. Monseñor Luis Rodriguez P.",105,0,0,2,72,7,12,2,1,201,1,7,209,235,0.358,0.889
"23783","Santa Cruz","Santa Cruz de La Sierra","Col. Monseñor Luis Rodriguez P.",84,2,0,2,79,16,18,1,2,204,3,3,210,229,0.387,0.917
"23784","Santa Cruz","Santa Cruz de La Sierra","Col. Monseñor Luis Rodriguez P.",111,0,0,2,47,14,17,3,0,194,0,2,196,221,0.242,0.887
"23785","Santa Cruz","Santa Cruz de La Sierra","Col. Monseñor Luis Rodriguez P.",142,0,0,0,37,14,10,4,1,208,1,2,211,230,0.178,0.917
"23786","Santa Cruz","Santa Cruz de La Sierra","Col. Monseñor Luis Rodriguez P.",109,0,0,1,51,9,13,0,0,183,1,11,195,231,0.279,0.844
"23787","Santa Cruz","Santa Cruz de La Sierra","Col. Monseñor Luis Rodriguez P.",129,1,0,3,40,11,5,1,1,191,1,12,204,229,0.209,0.891
"23788","Santa Cruz","Santa Cruz de La Sierra","Col. Monseñor Luis Rodriguez P.",114,1,0,1,58,8,11,3,0,196,2,4,202,230,0.296,0.878
"23789","Santa Cruz","Santa Cruz de La Sierra","Col. Monseñor Luis Rodriguez P.",100,0,0,1,65,12,12,1,1,192,3,6,201,230,0.339,0.874
"23790","Santa Cruz","Santa Cruz de La Sierra","Col. Monseñor Luis Rodriguez P.",114,0,0,3,55,11,12,0,0,195,2,3,200,221,0.282,0.905
"23791","Santa Cruz","Santa Cruz de La Sierra","Col. Monseñor Luis Rodriguez P.",119,1,0,0,43,14,16,1,2,196,0,6,202,229,0.219,0.882
"23792","Santa Cruz","Santa Cruz de La Sierra","Col. Monseñor Luis Rodriguez P.",121,0,0,1,46,20,5,2,1,196,2,3,201,226,0.235,0.889
"23793","Santa Cruz","Santa Cruz de La Sierra","Col. Monseñor Luis Rodriguez P.",102,1,0,0,60,12,10,1,3,189,0,5,194,228,0.317,0.851
"23794","Santa Cruz","Santa Cruz de La Sierra","Col. Monseñor Luis Rodriguez P.",112,1,0,1,54,16,8,0,0,192,0,3,195,223,0.281,0.874
"23795","Santa Cruz","Santa Cruz de La Sierra","Col. Monseñor Luis Rodriguez P.",98,0,1,0,52,17,15,3,2,188,0,5,193,226,0.277,0.854
"23796","Santa Cruz","Santa Cruz de La Sierra","Col. Monseñor Luis Rodriguez P.",122,2,1,0,50,9,11,2,1,198,0,5,203,233,0.253,0.871
"23797","Santa Cruz","Santa Cruz de La Sierra","Col. Henrry Prince",144,0,0,0,42,3,6,1,0,196,0,9,205,228,0.214,0.899
"23798","Santa Cruz","Santa Cruz de La Sierra","Col. Henrry Prince",135,0,1,0,38,10,9,1,1,195,0,8,203,229,0.195,0.886
"23799","Santa Cruz","Santa Cruz de La Sierra","Col. Henrry Prince",139,0,0,0,35,8,6,1,0,189,1,5,195,229,0.185,0.852
"23800","Santa Cruz","Santa Cruz de La Sierra","Col. Henrry Prince",130,2,0,2,41,7,11,0,0,193,1,5,199,229,0.212,0.869
"23801","Santa Cruz","Santa Cruz de La Sierra","Col. Henrry Prince",143,0,0,0,27,4,11,1,0,186,1,8,195,221,0.145,0.882
"23802","Santa Cruz","Santa Cruz de La Sierra","Col. Henrry Prince",139,1,0,1,32,13,7,2,1,196,2,2,200,227,0.163,0.881
"23803","Santa Cruz","Santa Cruz de La Sierra","Col. Henrry Prince",136,0,1,0,29,10,8,1,0,185,1,7,193,220,0.157,0.877
"23804","Santa Cruz","Santa Cruz de La Sierra","Col. Villa Fatima",111,0,0,0,48,17,17,0,1,194,0,12,206,228,0.247,0.904
"23805","Santa Cruz","Santa Cruz de La Sierra","Col. Villa Fatima",129,0,0,0,45,15,12,0,0,201,2,0,203,226,0.224,0.898
"23806","Santa Cruz","Santa Cruz de La Sierra","Col. Villa Fatima",128,0,1,1,44,13,7,0,1,195,2,4,201,229,0.226,0.878
"23807","Santa Cruz","Santa Cruz de La Sierra","Col. Villa Fatima",105,0,0,4,54,10,7,3,1,184,0,7,191,220,0.293,0.868
"23808","Santa Cruz","Santa Cruz de La Sierra","Col. Villa Fatima",102,0,0,2,60,10,10,0,1,185,0,6,191,225,0.324,0.849
"23809","Santa Cruz","Santa Cruz de La Sierra","Col. Villa Fatima",136,0,0,1,40,10,11,0,0,198,5,3,206,226,0.202,0.912
"23810","Santa Cruz","Santa Cruz de La Sierra","Col. Villa Fatima",122,0,0,2,44,15,9,2,1,195,0,5,200,231,0.226,0.866
"23811","Santa Cruz","Santa Cruz de La Sierra","Col. Villa Fatima",133,0,1,1,37,15,14,0,0,201,2,5,208,227,0.184,0.916
"23812","Santa Cruz","Santa Cruz de La Sierra","Col. Villa Fatima",139,1,0,0,32,16,9,0,1,198,1,3,202,225,0.162,0.898
"23813","Santa Cruz","Santa Cruz de La Sierra","Col. Villa Fatima",128,1,0,0,44,16,10,3,0,202,0,6,208,228,0.218,0.912
"23814","Santa Cruz","Santa Cruz de La Sierra","Col. Villa Fatima",112,0,0,3,47,11,15,1,1,190,0,3,193,224,0.247,0.862
"23815","Santa Cruz","Santa Cruz de La Sierra","Col. Villa Fatima",133,0,0,1,42,14,7,1,0,198,1,0,199,224,0.212,0.888
"23816","Santa Cruz","Santa Cruz de La Sierra","Col. Villa Fatima",113,2,0,1,46,6,7,0,1,176,0,11,187,221,0.261,0.846
"23817","Santa Cruz","Santa Cruz de La Sierra","Col. Villa Fatima",122,0,0,0,41,10,13,2,1,189,1,7,197,222,0.217,0.887
"23818","Santa Cruz","Santa Cruz de La Sierra","Col. Villa Fatima",142,0,0,0,33,16,12,0,0,203,1,5,209,224,0.163,0.933
"23819","Santa Cruz","Santa Cruz de La Sierra","Col. Villa Fatima",105,0,0,2,57,14,12,1,1,192,1,4,197,227,0.297,0.868
"23820","Santa Cruz","Santa Cruz de La Sierra","Col. Villa Fatima",140,0,0,3,32,11,10,2,1,199,2,5,206,229,0.161,0.9
"23821","Santa Cruz","Santa Cruz de La Sierra","Col. Villa Fatima",113,1,0,1,41,8,14,1,1,180,1,8,189,220,0.228,0.859
"23822","Santa Cruz","Santa Cruz de La Sierra","Col. Villa Fatima",134,0,0,0,29,16,8,4,0,191,1,7,199,229,0.152,0.869
"23823","Santa Cruz","Santa Cruz de La Sierra","Col. Villa Fatima",145,0,1,0,39,10,7,1,0,203,1,9,213,234,0.192,0.91
"23824","Santa Cruz","Santa Cruz de La Sierra","Col. Villa Fatima",118,0,0,2,32,14,12,3,2,183,0,2,185,222,0.175,0.833
"23825","Santa Cruz","Santa Cruz de La Sierra","Col. Villa Fatima",127,0,0,3,41,13,13,0,1,198,0,2,200,227,0.207,0.881
"23826","Santa Cruz","Santa Cruz de La Sierra","Col. American School Coop.",149,0,0,0,16,25,2,0,0,192,1,4,197,231,0.083,0.853
"23827","Santa Cruz","Santa Cruz de La Sierra","Col. American School Coop.",131,0,0,2,14,26,4,2,0,179,0,1,180,223,0.078,0.807
"23828","Santa Cruz","Santa Cruz de La Sierra","Col. American School Coop.",140,0,0,1,9,23,3,3,0,179,0,4,183,220,0.05,0.832
"23829","Santa Cruz","Santa Cruz de La Sierra","Col. American School Coop.",162,0,0,2,12,21,1,0,0,198,1,1,200,230,0.061,0.87
"23830","Santa Cruz","Santa Cruz de La Sierra","Col. American School Coop.",145,0,1,3,10,17,2,2,0,180,0,2,182,224,0.056,0.812
"23831","Santa Cruz","Santa Cruz de La Sierra","Col. American School Coop.",126,0,0,0,8,39,3,1,1,178,1,3,182,226,0.045,0.805
"23832","Santa Cruz","Santa Cruz de La Sierra","Col. American School Coop.",148,0,1,0,12,28,0,0,0,189,1,1,191,224,0.063,0.853
"23833","Santa Cruz","Santa Cruz de La Sierra","Col. American School Coop.",138,0,0,1,15,17,6,1,0,178,0,2,180,227,0.084,0.793
"23834","Santa Cruz","Santa Cruz de La Sierra","Col. American School Coop.",153,0,0,1,8,25,2,0,0,189,0,2,191,227,0.042,0.841
"23835","Santa Cruz","Santa Cruz de La Sierra","Col. American School Coop.",172,0,0,0,4,18,1,0,0,195,1,1,197,228,0.021,0.864
"23836","Santa Cruz","Santa Cruz de La Sierra","Col. American School Coop.",160,0,0,1,10,14,4,0,2,191,0,2,193,230,0.052,0.839
"23837","Santa Cruz","Santa Cruz de La Sierra","Col. Villa Rosario",89,1,1,0,71,12,16,1,0,191,1,5,197,229,0.372,0.86
"23838","Santa Cruz","Santa Cruz de La Sierra","Col. Villa Rosario",101,1,2,1,63,13,12,2,0,195,2,5,202,231,0.323,0.874
"23839","Santa Cruz","Santa Cruz de La Sierra","Col. Villa Rosario",76,0,0,1,78,22,6,1,0,184,3,10,197,221,0.424,0.891
"23840","Santa Cruz","Santa Cruz de La Sierra","Col. Villa Rosario",97,2,0,0,71,6,10,1,1,188,3,10,201,226,0.378,0.889
"23841","Santa Cruz","Santa Cruz de La Sierra","Col. Villa Rosario",70,0,0,2,93,10,15,0,1,191,2,8,201,223,0.487,0.901
"23842","Santa Cruz","Santa Cruz de La Sierra","Col. Villa Rosario",87,0,1,3,79,8,17,1,2,198,0,2,200,226,0.399,0.885
"23843","Santa Cruz","Santa Cruz de La Sierra","Col. Villa Rosario",83,0,0,3,70,13,16,2,2,189,1,4,194,227,0.37,0.855
"23844","Santa Cruz","Santa Cruz de La Sierra","Col. Villa Rosario",58,0,0,1,107,10,13,1,3,193,2,7,202,234,0.554,0.863
"23845","Santa Cruz","Santa Cruz de La Sierra","Col. Villa Rosario",78,0,1,1,65,13,15,2,2,177,1,5,183,229,0.367,0.799
"23846","Santa Cruz","Santa Cruz de La Sierra","Col. Villa Rosario",82,0,0,1,86,9,15,0,0,193,3,3,199,229,0.446,0.869
"23847","Santa Cruz","Santa Cruz de La Sierra","Col. Villa Rosario",63,1,1,3,94,14,18,1,1,196,0,3,199,228,0.48,0.873
"23848","Santa Cruz","Santa Cruz de La Sierra","Col. Villa Rosario",82,0,0,3,78,12,20,2,0,197,0,4,201,228,0.396,0.882
"23849","Santa Cruz","Santa Cruz de La Sierra","Col. Villa Rosario",110,1,0,1,54,6,11,1,1,185,3,4,192,226,0.292,0.85
"23850","Santa Cruz","Santa Cruz de La Sierra","Col. Villa Rosario",92,0,0,0,74,15,13,0,2,196,0,6,202,232,0.378,0.871
"23851","Santa Cruz","Santa Cruz de La Sierra","Col. Villa Rosario",92,1,0,0,60,18,16,0,0,187,1,10,198,225,0.321,0.88
"23852","Santa Cruz","Santa Cruz de La Sierra","Col. Villa Rosario",71,0,0,1,98,3,11,0,0,184,0,5,189,229,0.533,0.825
"23853","Santa Cruz","Santa Cruz de La Sierra","Col. Villa Rosario",91,1,0,2,71,13,7,1,0,186,0,3,189,225,0.382,0.84
"23854","Santa Cruz","Santa Cruz de La Sierra","Col. Villa Rosario",109,0,1,3,48,17,15,1,0,194,1,0,195,228,0.247,0.855
"23855","Santa Cruz","Santa Cruz de La Sierra","Col. Villa Rosario",82,2,0,2,77,6,10,0,2,181,0,5,186,219,0.425,0.849
"23856","Santa Cruz","Santa Cruz de La Sierra","Col. Villa Rosario",98,0,2,0,60,13,13,0,0,186,2,3,191,224,0.323,0.853
"23857","Santa Cruz","Santa Cruz de La Sierra","Col. Villa Rosario",105,1,1,1,65,7,11,0,1,192,1,2,195,224,0.339,0.871
"23858","Santa Cruz","Santa Cruz de La Sierra","Col. Villa Rosario",83,1,1,0,64,4,12,0,3,168,1,7,176,223,0.381,0.789
"23859","Santa Cruz","Santa Cruz de La Sierra","Col. UV. La Madre",137,0,0,1,24,10,8,0,0,180,1,5,186,222,0.133,0.838
"23860","Santa Cruz","Santa Cruz de La Sierra","Col. UV. La Madre",143,0,0,0,30,20,5,1,0,199,0,1,200,223,0.151,0.897
"23861","Santa Cruz","Santa Cruz de La Sierra","Col. UV. La Madre",136,0,0,1,22,22,9,1,4,195,1,4,200,221,0.113,0.905
"23862","Santa Cruz","Santa Cruz de La Sierra","Col. UV. La Madre",143,2,1,2,21,12,4,2,0,187,1,6,194,226,0.112,0.858
"23863","Santa Cruz","Santa Cruz de La Sierra","Col. UV. La Madre",142,0,0,2,30,15,6,0,0,195,0,3,198,221,0.154,0.896
"23864","Santa Cruz","Santa Cruz de La Sierra","Col. UV. La Madre",116,0,0,1,42,17,12,1,0,189,1,4,194,226,0.222,0.858
"23865","Santa Cruz","Santa Cruz de La Sierra","Col. UV. La Madre",113,0,1,2,33,21,10,0,0,180,0,12,192,219,0.183,0.877
"23866","Santa Cruz","Santa Cruz de La Sierra","Col. UV. La Madre",137,1,1,0,25,9,3,2,0,178,0,8,186,222,0.14,0.838
"23867","Santa Cruz","Santa Cruz de La Sierra","Col. UV. La Madre",114,1,2,2,44,29,8,2,1,203,1,2,206,227,0.217,0.907
"23868","Santa Cruz","Santa Cruz de La Sierra","Col. UV. La Madre",130,1,0,1,32,13,14,0,0,191,0,4,195,225,0.168,0.867
"23869","Santa Cruz","Santa Cruz de La Sierra","Col. UV. La Madre",137,0,0,0,47,9,3,1,1,198,1,7,206,232,0.237,0.888
"23870","Santa Cruz","Santa Cruz de La Sierra","Col. UV. La Madre",147,0,0,0,22,9,6,2,0,186,2,5,193,222,0.118,0.869
"23871","Santa Cruz","Santa Cruz de La Sierra","Col. UV. La Madre",125,1,0,0,46,8,9,0,1,190,0,6,196,226,0.242,0.867
"23872","Santa Cruz","Santa Cruz de La Sierra","Col. UV. La Madre",114,0,1,3,43,13,11,1,0,186,0,7,193,224,0.231,0.862
"23873","Santa Cruz","Santa Cruz de La Sierra","Col. UV. La Madre",124,0,1,0,34,28,8,3,0,198,1,9,208,227,0.172,0.916
"23874","Santa Cruz","Santa Cruz de La Sierra","Col. UV. La Madre",133,0,0,0,28,14,11,2,0,188,0,6,194,221,0.149,0.878
"23875","Santa Cruz","Santa Cruz de La Sierra","Col. UV. La Madre",126,0,1,2,33,19,6,1,0,188,1,3,192,217,0.176,0.885
"23876","Santa Cruz","Santa Cruz de La Sierra","Col. UV. La Madre",154,0,0,0,20,19,8,0,0,201,1,9,211,228,0.1,0.925
"23877","Santa Cruz","Santa Cruz de La Sierra","Col. UV. La Madre",123,0,1,3,36,17,8,0,0,188,1,5,194,225,0.191,0.862
"23878","Santa Cruz","Santa Cruz de La Sierra","Col. UV. La Madre",141,1,0,1,34,16,5,1,0,199,0,2,201,226,0.171,0.889
"23879","Santa Cruz","Santa Cruz de La Sierra","Col. UV. La Madre",141,0,0,1,30,10,11,1,1,195,0,9,204,228,0.154,0.895
"23880","Santa Cruz","Santa Cruz de La Sierra","Col. UV. La Madre",137,0,0,0,21,12,5,3,0,178,1,6,185,217,0.118,0.853
"23881","Santa Cruz","Santa Cruz de La Sierra","Col. UV. La Madre",115,0,0,0,35,19,6,0,0,175,1,8,184,221,0.2,0.833
"23882","Santa Cruz","Santa Cruz de La Sierra","Col. UV. La Madre",133,0,0,0,35,9,8,0,0,185,0,5,190,212,0.189,0.896
"23883","Santa Cruz","Santa Cruz de La Sierra","Col. UV. La Madre",132,0,0,0,30,22,7,1,0,192,1,6,199,222,0.156,0.896
"23884","Santa Cruz","Santa Cruz de La Sierra","Col. UV. La Madre",128,0,0,1,37,13,10,0,0,189,0,2,191,218,0.196,0.876
"23885","Santa Cruz","Santa Cruz de La Sierra","U.E. Union y Progreso",94,1,0,0,80,14,18,0,1,208,0,3,211,232,0.385,0.909
"23886","Santa Cruz","Santa Cruz de La Sierra","U.E. Union y Progreso",96,0,0,0,67,20,16,1,0,200,1,6,207,230,0.335,0.9
"23887","Santa Cruz","Santa Cruz de La Sierra","U.E. Union y Progreso",85,1,0,2,75,10,22,0,0,195,3,8,206,227,0.385,0.907
"23888","Santa Cruz","Santa Cruz de La Sierra","U.E. Union y Progreso",81,0,1,3,85,14,11,0,0,195,1,5,201,229,0.436,0.878
"23889","Santa Cruz","Santa Cruz de La Sierra","U.E. Union y Progreso",89,0,2,1,69,12,17,2,1,193,1,8,202,229,0.358,0.882
"23890","Santa Cruz","Santa Cruz de La Sierra","U.E. Union y Progreso",42,0,0,1,123,7,19,1,3,196,1,7,204,227,0.628,0.899
"23891","Santa Cruz","Santa Cruz de La Sierra","U.E. Union y Progreso",78,1,1,0,67,17,21,2,1,188,5,8,201,226,0.356,0.889
"23892","Santa Cruz","Santa Cruz de La Sierra","U.E. Union y Progreso",85,0,0,0,63,15,15,4,0,182,1,4,187,231,0.346,0.81
"23893","Santa Cruz","Santa Cruz de La Sierra","U.E. Union y Progreso",95,0,0,0,69,11,16,1,0,192,1,11,204,230,0.359,0.887
"23894","Santa Cruz","Santa Cruz de La Sierra","U.E. Union y Progreso",94,0,1,0,73,12,12,2,1,195,0,9,204,233,0.374,0.876
"23895","Santa Cruz","Santa Cruz de La Sierra","U.E. Union y Progreso",68,0,0,0,90,15,19,1,2,195,3,9,207,234,0.462,0.885
"23896","Santa Cruz","Santa Cruz de La Sierra","U.E. Union y Progreso",74,0,0,0,81,19,19,0,1,194,1,2,197,229,0.418,0.86
"23897","Santa Cruz","Santa Cruz de La Sierra","U.E. Union y Progreso",74,0,0,0,99,7,17,4,0,201,3,7,211,231,0.493,0.913
"23898","Santa Cruz","Santa Cruz de La Sierra","U.E. Union y Progreso",72,0,0,1,89,19,0,1,1,183,0,7,190,231,0.486,0.823
"23899","Santa Cruz","Santa Cruz de La Sierra","U.E. Union y Progreso",98,1,0,2,64,15,17,2,2,201,0,3,204,229,0.318,0.891
"23900","Santa Cruz","Santa Cruz de La Sierra","U.E. Union y Progreso",75,0,1,0,86,12,18,0,0,192,0,6,198,224,0.448,0.884
"23901","Santa Cruz","Santa Cruz de La Sierra","U.E. Union y Progreso",92,2,0,0,80,16,8,1,0,199,1,8,208,233,0.402,0.893
"23902","Santa Cruz","Santa Cruz de La Sierra","U.E. Union y Progreso",75,1,2,5,91,7,18,2,0,201,1,4,206,231,0.453,0.892
"23903","Santa Cruz","Santa Cruz de La Sierra","U.E. Union y Progreso",85,0,0,0,72,18,15,0,0,190,1,3,194,226,0.379,0.858
"23904","Santa Cruz","Santa Cruz de La Sierra","U.E. Union y Progreso",100,0,0,0,62,19,11,3,1,196,1,3,200,226,0.316,0.885
"23905","Santa Cruz","Santa Cruz de La Sierra","U.E. Union y Progreso",97,0,0,0,81,14,9,0,2,203,3,2,208,232,0.399,0.897
"23906","Santa Cruz","Santa Cruz de La Sierra","U.E. Union y Progreso",85,2,1,3,69,18,16,0,1,195,0,11,206,230,0.354,0.896
"23907","Santa Cruz","Santa Cruz de La Sierra","U.E. Union y Progreso",82,0,0,0,83,13,13,1,1,193,1,7,201,230,0.43,0.874
"23908","Santa Cruz","Santa Cruz de La Sierra","U.E. Union y Progreso",70,1,0,3,93,6,16,0,1,190,3,2,195,226,0.489,0.863
"23909","Santa Cruz","Santa Cruz de La Sierra","U.E. Union y Progreso",86,1,0,1,81,17,24,0,0,210,1,7,218,237,0.386,0.92
"23910","Santa Cruz","Santa Cruz de La Sierra","Col. Unidad Educativa La Colina",122,0,1,0,51,16,12,1,0,203,0,7,210,229,0.251,0.917
"23911","Santa Cruz","Santa Cruz de La Sierra","Col. Unidad Educativa La Colina",130,0,0,1,42,13,9,3,1,199,0,7,206,224,0.211,0.92
"23912","Santa Cruz","Santa Cruz de La Sierra","Col. Unidad Educativa La Colina",115,0,0,1,48,26,8,1,0,199,1,3,203,230,0.241,0.883
"23913","Santa Cruz","Santa Cruz de La Sierra","Col. Unidad Educativa La Colina",114,0,0,1,61,17,9,0,0,202,0,4,206,229,0.302,0.9
"23914","Santa Cruz","Santa Cruz de La Sierra","Col. Unidad Educativa La Colina",110,0,2,0,53,16,18,0,0,199,3,6,208,230,0.266,0.904
"23915","Santa Cruz","Santa Cruz de La Sierra","Col. Unidad Educativa La Colina",111,0,0,2,51,10,11,1,0,186,0,10,196,222,0.274,0.883
"23916","Santa Cruz","Santa Cruz de La Sierra","Col. Unidad Educativa La Colina",127,0,0,2,50,17,6,1,0,203,0,3,206,229,0.246,0.9
"23917","Santa Cruz","Santa Cruz de La Sierra","Col. Unidad Educativa La Colina",107,0,0,0,65,20,9,3,0,204,1,7,212,233,0.319,0.91
"23918","Santa Cruz","Santa Cruz de La Sierra","Col. Unidad Educativa La Colina",123,0,1,0,40,13,7,0,0,184,1,3,188,221,0.217,0.851
"23919","Santa Cruz","Santa Cruz de La Sierra","Col. Unidad Educativa La Colina",117,0,0,0,59,10,13,0,2,201,1,6,208,223,0.294,0.933
"23920","Santa Cruz","Santa Cruz de La Sierra","Col. Unidad Educativa La Colina",130,1,0,0,37,17,9,1,0,195,0,5,200,223,0.19,0.897
"23921","Santa Cruz","Santa Cruz de La Sierra","Col. Unidad Educativa La Colina",109,0,0,2,54,13,21,1,1,201,0,5,206,231,0.269,0.892
"23922","Santa Cruz","Santa Cruz de La Sierra","Col. Unidad Educativa La Colina",126,0,0,3,31,19,12,0,0,191,1,0,192,228,0.162,0.842
"23923","Santa Cruz","Santa Cruz de La Sierra","Col. Unidad Educativa La Colina",123,0,0,0,40,23,13,0,0,199,1,7,207,223,0.201,0.928
"23924","Santa Cruz","Santa Cruz de La Sierra","Col. Unidad Educativa La Colina",124,0,0,0,40,20,10,1,1,196,0,8,204,226,0.204,0.903
"23925","Santa Cruz","Santa Cruz de La Sierra","Col. Unidad Educativa La Colina",138,0,0,0,53,12,0,7,0,210,1,3,214,230,0.252,0.93
"23926","Santa Cruz","Santa Cruz de La Sierra","Col. Unidad Educativa La Colina",111,1,0,0,58,14,7,1,0,192,0,9,201,226,0.302,0.889
"23927","Santa Cruz","Santa Cruz de La Sierra","Col. Unidad Educativa La Colina",120,1,0,0,38,23,9,1,0,192,1,3,196,220,0.198,0.891
"23928","Santa Cruz","Santa Cruz de La Sierra","Col. Unidad Educativa La Colina",131,0,0,0,46,14,9,0,0,200,0,3,203,232,0.23,0.875
"23929","Santa Cruz","Santa Cruz de La Sierra","Col. Unidad Educativa La Colina",107,1,0,1,40,26,14,2,0,191,0,5,196,229,0.209,0.856
"23930","Santa Cruz","Santa Cruz de La Sierra","Col. Unidad Educativa La Colina",118,2,0,1,53,13,13,3,0,203,2,4,209,227,0.261,0.921
"23931","Santa Cruz","Santa Cruz de La Sierra","Col. Unidad Educativa La Colina",117,0,1,0,55,13,3,1,0,190,5,4,199,224,0.289,0.888
"23932","Santa Cruz","Santa Cruz de La Sierra","Modulo Educativo 24 De Septiembre",126,0,1,1,39,10,9,1,0,187,2,7,196,237,0.209,0.827
"23933","Santa Cruz","Santa Cruz de La Sierra","Modulo Educativo 24 De Septiembre",100,0,0,1,36,16,10,0,1,164,0,4,168,195,0.22,0.862
"23934","Santa Cruz","Santa Cruz de La Sierra","Col. Esc. 29 De Diciembre",106,0,0,1,44,18,14,2,0,185,1,8,194,230,0.238,0.843
"23935","Santa Cruz","Santa Cruz de La Sierra","Col. Esc. 29 De Diciembre",122,0,0,0,54,11,13,1,0,201,1,2,204,228,0.269,0.895
"23936","Santa Cruz","Santa Cruz de La Sierra","Col. Esc. 29 De Diciembre",92,0,2,1,72,10,19,2,1,199,2,7,208,228,0.362,0.912
"23937","Santa Cruz","Santa Cruz de La Sierra","Col. Esc. 29 De Diciembre",98,0,0,3,63,20,11,4,0,199,3,4,206,227,0.317,0.907
"23938","Santa Cruz","Santa Cruz de La Sierra","Col. Esc. 29 De Diciembre",110,0,0,1,52,16,16,1,0,196,1,7,204,231,0.265,0.883
"23939","Santa Cruz","Santa Cruz de La Sierra","Col. Esc. 29 De Diciembre",104,0,1,1,70,9,11,2,1,199,0,5,204,232,0.352,0.879
"23940","Santa Cruz","Santa Cruz de La Sierra","Col. Esc. 29 De Diciembre",116,0,0,1,45,13,15,3,0,193,3,5,201,230,0.233,0.874
"23941","Santa Cruz","Santa Cruz de La Sierra","Col. Esc. 29 De Diciembre",94,0,1,1,68,16,13,0,2,195,2,3,200,226,0.349,0.885
"23942","Santa Cruz","Santa Cruz de La Sierra","Col. Esc. 29 De Diciembre",97,0,0,0,67,14,10,2,0,190,2,7,199,219,0.353,0.909
"23943","Santa Cruz","Santa Cruz de La Sierra","Col. Esc. 29 De Diciembre",97,1,0,0,75,18,13,1,0,205,1,7,213,244,0.366,0.873
"23944","Santa Cruz","Santa Cruz de La Sierra","Col. Esc. Hilanderia",119,0,0,1,47,18,9,0,0,194,4,6,204,231,0.242,0.883
"23945","Santa Cruz","Santa Cruz de La Sierra","Col. Esc. Hilanderia",124,0,0,1,46,7,13,2,0,193,1,8,202,227,0.238,0.89
"23946","Santa Cruz","Santa Cruz de La Sierra","Col. Esc. Hilanderia",134,2,0,1,48,10,5,2,0,202,0,3,205,221,0.238,0.928
"23947","Santa Cruz","Santa Cruz de La Sierra","Col. Esc. Hilanderia",100,0,1,2,57,15,23,0,0,198,0,7,205,236,0.288,0.869
"23948","Santa Cruz","Santa Cruz de La Sierra","Col. Esc. Hilanderia",113,1,0,4,39,20,13,0,0,190,1,7,198,225,0.205,0.88
"23949","Santa Cruz","Santa Cruz de La Sierra","Col. Esc. Hilanderia",116,1,1,0,50,13,18,0,0,199,0,3,202,229,0.251,0.882
"23950","Santa Cruz","Santa Cruz de La Sierra","Col. Esc. Hilanderia",120,1,2,0,41,11,11,2,0,188,1,2,191,230,0.218,0.83
"23951","Santa Cruz","Santa Cruz de La Sierra","Col. Esc. Hilanderia",118,1,0,2,42,10,17,1,0,191,0,7,198,222,0.22,0.892
"23952","Santa Cruz","Santa Cruz de La Sierra","Col. Esc. Hilanderia",113,0,0,0,51,12,14,1,1,192,1,4,197,224,0.266,0.879
"23953","Santa Cruz","Santa Cruz de La Sierra","Col. Esc. Hilanderia",128,2,1,6,35,18,8,2,1,201,1,6,208,225,0.174,0.924
"23954","Santa Cruz","Santa Cruz de La Sierra","Col. Esc. Hilanderia",105,0,0,1,53,14,19,0,0,192,2,5,199,223,0.276,0.892
"23955","Santa Cruz","Santa Cruz de La Sierra","Col. Esc. Hilanderia",129,0,1,0,47,9,11,0,1,198,0,7,205,226,0.237,0.907
"23956","Santa Cruz","Santa Cruz de La Sierra","Col. Esc. Hilanderia",126,0,0,3,41,22,5,1,0,198,0,4,202,228,0.207,0.886
"23957","Santa Cruz","Santa Cruz de La Sierra","Col. Esc. Hilanderia",131,0,1,2,40,14,7,0,0,195,0,2,197,222,0.205,0.887
"23958","Santa Cruz","Santa Cruz de La Sierra","Col. Esc. Hilanderia",119,0,0,2,43,18,10,0,1,193,0,9,202,225,0.223,0.898
"23959","Santa Cruz","Santa Cruz de La Sierra","Col. Esc. Hilanderia",122,1,0,0,36,16,15,0,1,191,1,11,203,230,0.188,0.883
"23960","Santa Cruz","Santa Cruz de La Sierra","Col. Esc. Hilanderia",91,0,0,1,42,8,10,0,1,153,1,4,158,174,0.275,0.908
"23961","Santa Cruz","Santa Cruz de La Sierra","Col. Escuela Sara Porras De Pinto",132,0,0,1,41,20,6,2,0,202,1,5,208,230,0.203,0.904
"23962","Santa Cruz","Santa Cruz de La Sierra","Col. Escuela Sara Porras De Pinto",142,2,0,2,28,14,8,0,1,197,3,9,209,225,0.142,0.929
"23963","Santa Cruz","Santa Cruz de La Sierra","Col. Escuela Sara Porras De Pinto",127,0,1,1,42,17,13,1,1,203,0,4,207,226,0.207,0.916
"23964","Santa Cruz","Santa Cruz de La Sierra","Col. Escuela Sara Porras De Pinto",117,0,2,0,49,16,4,0,0,188,2,4,194,220,0.261,0.882
"23965","Santa Cruz","Santa Cruz de La Sierra","Col. Escuela Sara Porras De Pinto",142,1,0,0,25,7,8,1,0,184,3,6,193,224,0.136,0.862
"23966","Santa Cruz","Santa Cruz de La Sierra","Col. Escuela Sara Porras De Pinto",130,1,2,0,32,18,7,0,0,190,0,9,199,226,0.168,0.881
"23967","Santa Cruz","Santa Cruz de La Sierra","Col. Escuela Sara Porras De Pinto",111,0,0,1,61,11,8,1,0,193,1,7,201,224,0.316,0.897
"23968","Santa Cruz","Santa Cruz de La Sierra","Col. Escuela Sara Porras De Pinto",140,0,0,1,38,12,10,3,0,204,0,3,207,230,0.186,0.9
"23969","Santa Cruz","Santa Cruz de La Sierra","Col. Escuela Sara Porras De Pinto",126,0,0,0,28,18,9,0,0,181,0,21,202,226,0.155,0.894
"23970","Santa Cruz","Santa Cruz de La Sierra","Col. Escuela Sara Porras De Pinto",125,1,0,0,45,18,8,0,0,197,1,4,202,220,0.228,0.918
"23971","Santa Cruz","Santa Cruz de La Sierra","Col. Escuela Sara Porras De Pinto",131,0,0,3,41,14,8,0,0,197,2,3,202,220,0.208,0.918
"23972","Santa Cruz","Santa Cruz de La Sierra","Col. Escuela Sara Porras De Pinto",137,0,0,0,27,24,10,1,0,199,2,10,211,229,0.136,0.921
"23973","Santa Cruz","Santa Cruz de La Sierra","Col. Escuela Sara Porras De Pinto",134,0,0,1,35,21,10,1,1,203,2,5,210,229,0.172,0.917
"23974","Santa Cruz","Santa Cruz de La Sierra","Col. Escuela Sara Porras De Pinto",97,1,2,0,30,16,14,0,0,160,2,6,168,192,0.188,0.875
"23975","Santa Cruz","Santa Cruz de La Sierra","Col. Escuela Ambrocio Villarroel",102,1,0,1,68,14,0,0,0,186,1,6,193,227,0.366,0.85
"23976","Santa Cruz","Santa Cruz de La Sierra","Col. Escuela Ambrocio Villarroel",75,2,0,1,83,22,17,2,0,202,0,3,205,231,0.411,0.887
"23977","Santa Cruz","Santa Cruz de La Sierra","Col. Escuela Ambrocio Villarroel",90,1,0,1,75,12,9,1,0,189,2,7,198,229,0.397,0.865
"23978","Santa Cruz","Santa Cruz de La Sierra","Col. Escuela Ambrocio Villarroel",88,0,0,1,68,11,20,0,0,188,3,4,195,229,0.362,0.852
"23979","Santa Cruz","Santa Cruz de La Sierra","Col. Escuela Ambrocio Villarroel",94,1,1,1,75,17,8,0,0,197,2,5,204,229,0.381,0.891
"23980","Santa Cruz","Santa Cruz de La Sierra","Col. Escuela Ambrocio Villarroel",75,1,0,1,80,11,15,3,1,187,1,2,190,227,0.428,0.837
"23981","Santa Cruz","Santa Cruz de La Sierra","Col. Escuela Ambrocio Villarroel",89,0,0,2,65,16,12,0,0,184,0,11,195,228,0.353,0.855
"23982","Santa Cruz","Santa Cruz de La Sierra","Col. Escuela Ambrocio Villarroel",94,0,0,2,75,18,10,1,2,202,1,3,206,230,0.371,0.896
"23983","Santa Cruz","Santa Cruz de La Sierra","Col. Escuela Ambrocio Villarroel",95,1,1,0,64,17,9,1,1,189,2,7,198,223,0.339,0.888
"23984","Santa Cruz","Santa Cruz de La Sierra","Col. Escuela Ambrocio Villarroel",87,1,2,1,64,19,19,3,0,196,1,3,200,225,0.327,0.889
"23985","Santa Cruz","Santa Cruz de La Sierra","Colegio Domingo Savio - Don Bosco",107,0,0,0,61,16,11,1,0,196,3,8,207,231,0.311,0.896
"23986","Santa Cruz","Santa Cruz de La Sierra","Colegio Domingo Savio - Don Bosco",123,0,1,0,46,15,6,2,2,195,0,3,198,227,0.236,0.872
"23987","Santa Cruz","Santa Cruz de La Sierra","Colegio Domingo Savio - Don Bosco",106,0,1,2,45,24,9,0,0,187,0,6,193,220,0.241,0.877
"23988","Santa Cruz","Santa Cruz de La Sierra","Colegio Domingo Savio - Don Bosco",120,0,0,1,54,11,9,0,0,195,1,2,198,226,0.277,0.876
"23989","Santa Cruz","Santa Cruz de La Sierra","Colegio Domingo Savio - Don Bosco",115,1,0,0,48,6,21,0,0,191,1,6,198,223,0.251,0.888
"23990","Santa Cruz","Santa Cruz de La Sierra","Colegio Domingo Savio - Don Bosco",111,0,0,0,63,14,12,1,0,201,1,3,205,228,0.313,0.899
"23991","Santa Cruz","Santa Cruz de La Sierra","Colegio Domingo Savio - Don Bosco",101,2,1,1,65,12,16,2,0,200,1,6,207,229,0.325,0.904
"23992","Santa Cruz","Santa Cruz de La Sierra","Colegio Domingo Savio - Don Bosco",91,0,0,1,91,8,14,2,1,208,3,3,214,232,0.438,0.922
"23993","Santa Cruz","Santa Cruz de La Sierra","Colegio Domingo Savio - Don Bosco",117,0,0,0,43,16,7,2,0,185,2,7,194,231,0.232,0.84
"23994","Santa Cruz","Santa Cruz de La Sierra","Colegio Domingo Savio - Don Bosco",96,0,1,0,72,12,8,0,1,190,1,2,193,228,0.379,0.846
"23995","Santa Cruz","Santa Cruz de La Sierra","Colegio Domingo Savio - Don Bosco",117,0,1,2,53,13,11,2,1,200,0,8,208,227,0.265,0.916
"23996","Santa Cruz","Santa Cruz de La Sierra","Colegio Domingo Savio - Don Bosco",119,0,0,1,49,12,10,0,0,191,4,6,201,227,0.257,0.885
"23997","Santa Cruz","Santa Cruz de La Sierra","Colegio Domingo Savio - Don Bosco",112,0,1,2,60,14,12,1,0,202,3,8,213,231,0.297,0.922
"23998","Santa Cruz","Santa Cruz de La Sierra","Colegio Domingo Savio - Don Bosco",98,0,3,0,71,8,8,1,2,191,2,5,198,228,0.372,0.868
"23999","Santa Cruz","Santa Cruz de La Sierra","Colegio Domingo Savio - Don Bosco",116,1,0,1,49,17,11,3,0,198,2,5,205,230,0.247,0.891
"24000","Santa Cruz","Santa Cruz de La Sierra","Colegio Domingo Savio - Don Bosco",112,2,0,0,51,19,10,0,0,194,0,15,209,233,0.263,0.897
"24001","Santa Cruz","Santa Cruz de La Sierra","Colegio Domingo Savio - Don Bosco",83,0,0,1,89,13,4,2,0,192,2,4,198,227,0.464,0.872
"24002","Santa Cruz","Santa Cruz de La Sierra","Colegio Domingo Savio - Don Bosco",109,0,0,1,61,15,9,1,1,197,0,5,202,227,0.31,0.89
"24003","Santa Cruz","Santa Cruz de La Sierra","Colegio Domingo Savio - Don Bosco",111,0,0,0,52,18,13,0,0,194,0,9,203,223,0.268,0.91
"24004","Santa Cruz","Santa Cruz de La Sierra","Colegio Domingo Savio - Don Bosco",104,0,0,1,63,11,15,1,1,196,0,5,201,229,0.321,0.878
"24005","Santa Cruz","Santa Cruz de La Sierra","Colegio Domingo Savio - Don Bosco",110,1,0,2,55,11,14,0,0,193,2,3,198,226,0.285,0.876
"24006","Santa Cruz","Santa Cruz de La Sierra","Colegio Domingo Savio - Don Bosco",119,0,0,2,57,12,6,0,0,196,0,13,209,227,0.291,0.921
"24007","Santa Cruz","Santa Cruz de La Sierra","Colegio Domingo Savio - Don Bosco",102,1,1,0,61,11,13,1,2,192,1,7,200,229,0.318,0.873
"24008","Santa Cruz","Santa Cruz de La Sierra","Colegio Domingo Savio - Don Bosco",96,0,0,0,84,10,17,0,2,209,1,4,214,233,0.402,0.918
"24009","Santa Cruz","Santa Cruz de La Sierra","Colegio Domingo Savio - Don Bosco",119,1,0,0,50,13,14,3,2,202,1,5,208,227,0.248,0.916
"24010","Santa Cruz","Santa Cruz de La Sierra","Colegio Domingo Savio - Don Bosco",115,1,0,2,64,12,8,0,0,202,2,2,206,227,0.317,0.907
"24011","Santa Cruz","Santa Cruz de La Sierra","Colegio Domingo Savio - Don Bosco",113,0,1,2,59,11,12,0,0,198,1,6,205,226,0.298,0.907
"24012","Santa Cruz","Santa Cruz de La Sierra","Colegio Domingo Savio - Don Bosco",119,2,0,3,58,4,8,2,0,196,0,7,203,219,0.296,0.927
"24013","Santa Cruz","Santa Cruz de La Sierra","Colegio Domingo Savio - Don Bosco",98,0,2,1,69,13,14,1,0,198,0,7,205,233,0.348,0.88
"24014","Santa Cruz","Santa Cruz de La Sierra","Colegio Domingo Savio - Don Bosco",124,1,0,0,41,14,14,0,1,195,0,3,198,227,0.21,0.872
"24015","Santa Cruz","Santa Cruz de La Sierra","Colegio Domingo Savio - Don Bosco",119,0,0,1,58,10,11,0,0,199,0,5,204,226,0.291,0.903
"24016","Santa Cruz","Santa Cruz de La Sierra","Colegio Domingo Savio - Don Bosco",104,1,0,0,64,8,15,2,1,195,1,5,201,231,0.328,0.87
"24017","Santa Cruz","Santa Cruz de La Sierra","Col. Esc. La Base",108,0,0,4,58,13,6,1,0,190,2,7,199,223,0.305,0.892
"24018","Santa Cruz","Santa Cruz de La Sierra","Col. Esc. La Base",124,1,0,3,52,22,5,0,1,208,1,3,212,231,0.25,0.918
"24019","Santa Cruz","Santa Cruz de La Sierra","Col. Esc. La Base",125,0,0,2,41,21,7,2,0,198,2,6,206,228,0.207,0.904
"24020","Santa Cruz","Santa Cruz de La Sierra","Col. Esc. La Base",113,0,0,0,61,18,9,0,0,201,2,10,213,230,0.303,0.926
"24021","Santa Cruz","Santa Cruz de La Sierra","Col. Esc. La Base",104,0,0,2,63,15,13,1,0,198,0,8,206,226,0.318,0.912
"24022","Santa Cruz","Santa Cruz de La Sierra","Col. Esc. La Base",107,0,1,1,61,16,14,1,1,202,3,1,206,231,0.302,0.892
"24023","Santa Cruz","Santa Cruz de La Sierra","Col. Esc. La Base",107,0,0,1,64,15,9,1,0,197,2,3,202,225,0.325,0.898
"24024","Santa Cruz","Santa Cruz de La Sierra","Col. Esc. La Base",126,1,0,2,49,17,11,3,0,209,1,5,215,230,0.234,0.935
"24025","Santa Cruz","Santa Cruz de La Sierra","Col. Esc. La Base",103,0,1,0,63,11,7,4,1,190,1,6,197,228,0.332,0.864
"24026","Santa Cruz","Santa Cruz de La Sierra","Col. Esc. La Base",122,0,0,0,54,18,7,1,0,202,1,1,204,228,0.267,0.895
"24027","Santa Cruz","Santa Cruz de La Sierra","Col. Esc. La Base",114,1,0,0,51,21,8,3,0,198,1,3,202,228,0.258,0.886
"24028","Santa Cruz","Santa Cruz de La Sierra","Col. Esc. La Base",106,1,0,1,54,17,10,1,0,190,2,4,196,219,0.284,0.895
"24029","Santa Cruz","Santa Cruz de La Sierra","Col. Esc. La Base",113,3,0,0,49,31,11,1,1,209,1,10,220,232,0.234,0.948
"24030","Santa Cruz","Santa Cruz de La Sierra","Col. Modulo Flamingo",144,0,0,0,27,14,10,1,1,197,2,3,202,227,0.137,0.89
"24031","Santa Cruz","Santa Cruz de La Sierra","Col. Modulo Flamingo",157,0,0,1,17,17,7,1,1,201,0,4,205,228,0.085,0.899
"24032","Santa Cruz","Santa Cruz de La Sierra","Col. Modulo Flamingo",144,0,0,1,33,19,7,0,0,204,3,2,209,232,0.162,0.901
"24033","Santa Cruz","Santa Cruz de La Sierra","Col. Modulo Flamingo",154,1,0,1,28,8,7,3,0,202,1,3,206,231,0.139,0.892
"24034","Santa Cruz","Santa Cruz de La Sierra","Col. Modulo Flamingo",144,0,1,0,35,11,14,0,0,205,0,3,208,232,0.171,0.897
"24035","Santa Cruz","Santa Cruz de La Sierra","Col. Modulo Flamingo",144,0,0,0,32,14,8,0,1,199,0,6,205,225,0.161,0.911
"24036","Santa Cruz","Santa Cruz de La Sierra","Col. Modulo Flamingo",140,0,0,1,26,18,6,0,0,191,0,3,194,221,0.136,0.878
"24037","Santa Cruz","Santa Cruz de La Sierra","Col. Modulo Flamingo",138,0,1,0,26,10,10,2,1,188,0,6,194,230,0.138,0.843
"24038","Santa Cruz","Santa Cruz de La Sierra","Col. Modulo Flamingo",149,0,0,0,35,9,7,2,0,202,2,4,208,228,0.173,0.912
"24039","Santa Cruz","Santa Cruz de La Sierra","Col. Modulo Flamingo",156,0,0,0,30,14,5,0,1,206,0,5,211,229,0.146,0.921
"24040","Santa Cruz","Santa Cruz de La Sierra","Col. Modulo Flamingo",157,0,0,1,24,10,7,2,1,202,0,2,204,227,0.119,0.899
"24041","Santa Cruz","Santa Cruz de La Sierra","Col. Modulo Flamingo",161,0,1,1,26,9,7,1,0,206,0,3,209,229,0.126,0.913
"24042","Santa Cruz","Santa Cruz de La Sierra","Col. Modulo Flamingo",140,2,0,2,26,13,7,0,0,190,0,4,194,228,0.137,0.851
"24043","Santa Cruz","Santa Cruz de La Sierra","Col. Modulo Flamingo",113,0,0,1,47,8,6,1,0,176,0,0,176,198,0.267,0.889
"24044","Santa Cruz","Santa Cruz de La Sierra","Col. Hermanos Cavanis",147,1,1,1,36,9,11,1,0,207,0,7,214,231,0.174,0.926
"24045","Santa Cruz","Santa Cruz de La Sierra","Col. Hermanos Cavanis",149,0,0,0,40,5,9,1,0,204,0,2,206,226,0.196,0.912
"24046","Santa Cruz","Santa Cruz de La Sierra","Col. Hermanos Cavanis",140,1,0,0,38,11,6,4,0,200,3,6,209,232,0.19,0.901
"24047","Santa Cruz","Santa Cruz de La Sierra","Col. Hermanos Cavanis",139,0,0,0,29,15,3,3,1,190,0,4,194,220,0.153,0.882
"24048","Santa Cruz","Santa Cruz de La Sierra","Col. Hermanos Cavanis",135,0,0,3,31,19,11,1,0,200,1,6,207,226,0.155,0.916
"24049","Santa Cruz","Santa Cruz de La Sierra","Col. Hermanos Cavanis",124,0,0,1,49,13,12,0,0,199,1,5,205,231,0.246,0.887
"24050","Santa Cruz","Santa Cruz de La Sierra","Col. Hermanos Cavanis",124,0,1,3,43,9,25,1,1,207,1,5,213,233,0.208,0.914
"24051","Santa Cruz","Santa Cruz de La Sierra","Col. Hermanos Cavanis",147,0,0,0,26,6,8,0,0,187,0,4,191,223,0.139,0.857
"24052","Santa Cruz","Santa Cruz de La Sierra","Col. Hermanos Cavanis",143,0,0,0,36,10,15,1,1,206,0,9,215,232,0.175,0.927
"24053","Santa Cruz","Santa Cruz de La Sierra","Col. Hermanos Cavanis",151,0,0,2,32,6,11,0,0,202,1,4,207,231,0.158,0.896
"24054","Santa Cruz","Santa Cruz de La Sierra","Col. Hermanos Cavanis",153,1,0,1,25,11,14,0,1,206,1,7,214,231,0.121,0.926
"24055","Santa Cruz","Santa Cruz de La Sierra","Col. Hermanos Cavanis",146,0,0,0,39,8,5,0,0,198,0,8,206,231,0.197,0.892
"24056","Santa Cruz","Santa Cruz de La Sierra","Col. Hermanos Cavanis",152,0,0,1,26,19,9,1,0,208,1,4,213,230,0.125,0.926
"24057","Santa Cruz","Santa Cruz de La Sierra","Col. Hermanos Cavanis",130,1,0,1,47,8,11,2,1,201,3,7,211,229,0.234,0.921
"24058","Santa Cruz","Santa Cruz de La Sierra","Col. Hermanos Cavanis",137,0,0,3,35,15,3,0,2,195,0,1,196,227,0.179,0.863
"24059","Santa Cruz","Santa Cruz de La Sierra","Col. Hermanos Cavanis",152,0,0,1,20,17,5,1,1,197,0,3,200,232,0.102,0.862
"24060","Santa Cruz","Santa Cruz de La Sierra","Col. Hermanos Cavanis",127,1,0,0,31,15,9,0,0,183,1,10,194,223,0.169,0.87
"24061","Santa Cruz","Santa Cruz de La Sierra","Col. Hermanos Cavanis",145,1,0,0,34,15,10,1,0,206,0,4,210,235,0.165,0.894
"24062","Santa Cruz","Santa Cruz de La Sierra","Col. Hermanos Cavanis",138,0,0,2,41,11,7,0,2,201,0,5,206,232,0.204,0.888
"24063","Santa Cruz","Santa Cruz de La Sierra","Col. Hermanos Cavanis",137,0,2,4,40,9,6,1,2,201,2,9,212,233,0.199,0.91
"24064","Santa Cruz","Santa Cruz de La Sierra","Col. Hermanos Cavanis",154,1,0,0,27,19,7,1,1,210,0,2,212,229,0.129,0.926
"24065","Santa Cruz","Santa Cruz de La Sierra","Col. Hermanos Cavanis",157,0,0,2,23,7,7,0,0,196,0,1,197,223,0.117,0.883
"24066","Santa Cruz","Santa Cruz de La Sierra","Col. Hermanos Cavanis",158,0,0,0,23,10,8,0,1,200,0,5,205,231,0.115,0.887
"24067","Santa Cruz","Santa Cruz de La Sierra","Col. Hermanos Cavanis",153,0,0,0,33,14,10,2,0,212,1,2,215,229,0.156,0.939
"24068","Santa Cruz","Santa Cruz de La Sierra","Col. Hermanos Cavanis",150,0,0,0,22,13,9,2,4,200,1,6,207,227,0.11,0.912
"24069","Santa Cruz","Santa Cruz de La Sierra","Col. Hermanos Cavanis",152,0,0,0,18,13,6,1,2,192,0,1,193,225,0.094,0.858
"24070","Santa Cruz","Santa Cruz de La Sierra","Col. Hermanos Cavanis",149,0,0,0,32,10,13,0,0,204,2,6,212,230,0.157,0.922
"24071","Santa Cruz","Santa Cruz de La Sierra","Col. Hermanos Cavanis",149,0,0,1,32,13,11,1,0,207,2,3,212,230,0.155,0.922
"24072","Santa Cruz","Santa Cruz de La Sierra","Modulo Educativo Jardin Latino",166,1,0,0,22,8,9,4,1,211,1,1,213,232,0.104,0.918
"24073","Santa Cruz","Santa Cruz de La Sierra","Col. Esc. Unzaga De La Vega",80,1,0,0,70,11,20,0,1,183,2,10,195,228,0.383,0.855
"24074","Santa Cruz","Santa Cruz de La Sierra","Col. Esc. Unzaga De La Vega",95,0,0,2,65,17,13,1,0,193,1,4,198,225,0.337,0.88
"24075","Santa Cruz","Santa Cruz de La Sierra","Col. Esc. Unzaga De La Vega",97,0,0,2,47,15,16,1,2,180,3,8,191,222,0.261,0.86
"24076","Santa Cruz","Santa Cruz de La Sierra","Col. Esc. Unzaga De La Vega",105,0,0,0,70,13,6,1,0,195,2,7,204,231,0.359,0.883
"24077","Santa Cruz","Santa Cruz de La Sierra","Col. Esc. Unzaga De La Vega",115,2,1,0,58,20,12,2,0,210,1,3,214,236,0.276,0.907
"24078","Santa Cruz","Santa Cruz de La Sierra","Col. Esc. Unzaga De La Vega",119,1,0,1,46,13,7,3,0,190,0,7,197,227,0.242,0.868
"24079","Santa Cruz","Santa Cruz de La Sierra","Col. Esc. Unzaga De La Vega",96,0,1,0,62,14,11,0,2,186,2,5,193,225,0.333,0.858
"24080","Santa Cruz","Santa Cruz de La Sierra","Col. Esc. Unzaga De La Vega",104,1,0,0,57,16,14,0,2,194,3,3,200,231,0.294,0.866
"24081","Santa Cruz","Santa Cruz de La Sierra","Col. Esc. Unzaga De La Vega",93,0,0,2,65,17,23,1,0,201,1,4,206,230,0.323,0.896
"24082","Santa Cruz","Santa Cruz de La Sierra","Col. Esc. Unzaga De La Vega",85,0,0,0,73,12,17,2,2,191,0,2,193,227,0.382,0.85
"24083","Santa Cruz","Santa Cruz de La Sierra","Col. Esc. Unzaga De La Vega",79,0,1,1,88,11,17,0,0,197,1,12,210,234,0.447,0.897
"24084","Santa Cruz","Santa Cruz de La Sierra","Col. Esc. Unzaga De La Vega",102,0,0,0,52,14,12,3,0,183,0,8,191,231,0.284,0.827
"24085","Santa Cruz","Santa Cruz de La Sierra","Col. Esc. Unzaga De La Vega",106,0,0,0,50,17,18,1,0,192,1,8,201,228,0.26,0.882
"24086","Santa Cruz","Santa Cruz de La Sierra","Col. Esc. Unzaga De La Vega",110,0,0,1,47,14,16,0,2,190,0,14,204,226,0.247,0.903
"24087","Santa Cruz","Santa Cruz de La Sierra","Col. Esc. Unzaga De La Vega",103,0,0,0,66,4,15,4,1,193,1,3,197,227,0.342,0.868
"24088","Santa Cruz","Santa Cruz de La Sierra","Col. Esc. Unzaga De La Vega",87,0,0,1,77,12,14,1,1,193,1,5,199,230,0.399,0.865
"24089","Santa Cruz","Santa Cruz de La Sierra","Col. Esc. Unzaga De La Vega",98,0,0,0,55,17,14,2,1,187,2,10,199,233,0.294,0.854
"24090","Santa Cruz","Santa Cruz de La Sierra","Col. Esc. Unzaga De La Vega",97,0,0,3,56,15,19,2,0,192,2,8,202,228,0.292,0.886
"24091","Santa Cruz","Santa Cruz de La Sierra","Col. Esc. Unzaga De La Vega",107,0,0,1,48,21,14,2,3,196,1,2,199,228,0.245,0.873
"24092","Santa Cruz","Santa Cruz de La Sierra","Col. Esc. Unzaga De La Vega",89,0,0,0,50,17,26,1,0,183,0,13,196,225,0.273,0.871
"24093","Santa Cruz","Santa Cruz de La Sierra","Col. Esc. Unzaga De La Vega",104,1,1,2,62,13,10,1,3,197,0,6,203,226,0.315,0.898
"24094","Santa Cruz","Santa Cruz de La Sierra","Col. Esc. Unzaga De La Vega",94,0,0,1,63,10,19,1,0,188,1,5,194,220,0.335,0.882
"24095","Santa Cruz","Santa Cruz de La Sierra","Col. Esc. Unzaga De La Vega",73,1,0,0,89,6,14,1,2,186,3,4,193,225,0.478,0.858
"24096","Santa Cruz","Santa Cruz de La Sierra","Col. Esc. Unzaga De La Vega",69,2,1,1,87,18,12,2,0,192,2,8,202,228,0.453,0.886
"24097","Santa Cruz","Santa Cruz de La Sierra","Col. Esc. Unzaga De La Vega",78,0,1,17,37,27,6,2,0,168,19,5,192,228,0.22,0.842
"24098","Santa Cruz","Santa Cruz de La Sierra","Col. Esc. Unzaga De La Vega",100,1,0,0,57,24,8,0,0,190,2,7,199,226,0.3,0.881
"24099","Santa Cruz","Santa Cruz de La Sierra","Col. Esc. Unzaga De La Vega",115,0,0,1,47,14,11,2,0,190,1,5,196,228,0.247,0.86
"24100","Santa Cruz","Santa Cruz de La Sierra","Col. Esc. Unzaga De La Vega",102,3,0,1,57,15,9,4,2,193,1,5,199,232,0.295,0.858
"24101","Santa Cruz","Santa Cruz de La Sierra","Col. Esc. Unzaga De La Vega",100,1,0,1,63,9,15,0,2,191,3,9,203,226,0.33,0.898
"24102","Santa Cruz","Santa Cruz de La Sierra","Col. Esc. Unzaga De La Vega",93,0,0,1,62,15,14,2,0,187,1,11,199,231,0.332,0.861
"24103","Santa Cruz","Santa Cruz de La Sierra","Col. Esc. Unzaga De La Vega",126,0,0,0,44,16,6,1,0,193,2,6,201,231,0.228,0.87
"24104","Santa Cruz","Santa Cruz de La Sierra","Col. Esc. Unzaga De La Vega",99,0,1,2,52,17,18,1,2,192,1,4,197,230,0.271,0.857
"24105","Santa Cruz","Santa Cruz de La Sierra","Col. Esc. Unzaga De La Vega",79,0,0,0,77,14,25,1,2,198,2,3,203,232,0.389,0.875
"24106","Santa Cruz","Santa Cruz de La Sierra","Col. Esc. Unzaga De La Vega",104,1,0,0,72,13,9,1,0,200,2,4,206,233,0.36,0.884
"24107","Santa Cruz","Santa Cruz de La Sierra","Col. Esc. Unzaga De La Vega",124,0,0,4,41,16,5,0,2,192,0,5,197,226,0.214,0.872
"24108","Santa Cruz","Santa Cruz de La Sierra","Col. Esc. Unzaga De La Vega",96,1,1,0,49,21,12,2,1,183,0,10,193,224,0.268,0.862
"24109","Santa Cruz","Santa Cruz de La Sierra","Col. Esc. Unzaga De La Vega",104,0,0,0,57,14,12,0,0,187,3,14,204,232,0.305,0.879
"24110","Santa Cruz","Santa Cruz de La Sierra","Col. Esc. Unzaga De La Vega",112,1,0,0,58,14,10,1,1,197,0,5,202,234,0.294,0.863
"24111","Santa Cruz","Santa Cruz de La Sierra","Col. Esc. Unzaga De La Vega",103,0,0,0,46,21,21,1,1,193,0,9,202,227,0.238,0.89
"24112","Santa Cruz","Santa Cruz de La Sierra","Col. Esc. Unzaga De La Vega",109,0,0,0,61,11,14,0,0,195,2,8,205,227,0.313,0.903
"24113","Santa Cruz","Santa Cruz de La Sierra","Col. Esc. Unzaga De La Vega",106,0,1,1,62,16,10,2,1,199,2,4,205,227,0.312,0.903
"24114","Santa Cruz","Santa Cruz de La Sierra","Col. Esc. Unzaga De La Vega",92,1,0,3,52,22,15,2,0,187,1,7,195,226,0.278,0.863
"24115","Santa Cruz","Santa Cruz de La Sierra","Col. Esc. Unzaga De La Vega",78,0,1,1,75,13,16,0,0,184,1,7,192,227,0.408,0.846
"24116","Santa Cruz","Santa Cruz de La Sierra","Col. Esc. Unzaga De La Vega",85,2,0,2,77,13,14,3,1,197,0,6,203,228,0.391,0.89
"24117","Santa Cruz","Santa Cruz de La Sierra","Col. Esc. Unzaga De La Vega",102,1,1,1,55,11,19,3,1,194,5,10,209,225,0.284,0.929
"24118","Santa Cruz","Santa Cruz de La Sierra","Col. Esc. Unzaga De La Vega",103,0,1,3,66,9,15,2,2,201,1,9,211,230,0.328,0.917
"24119","Santa Cruz","Santa Cruz de La Sierra","U.E. Santa Ana C",116,1,0,1,63,12,12,0,0,205,1,5,211,238,0.307,0.887
"24120","Santa Cruz","Santa Cruz de La Sierra","U.E. Santa Ana C",112,0,1,1,54,12,17,2,1,200,0,7,207,234,0.27,0.885
"24121","Santa Cruz","Santa Cruz de La Sierra","Col. Escuela Jorge Urenda Trigo",112,0,0,1,43,28,12,2,2,200,1,4,205,230,0.215,0.891
"24122","Santa Cruz","Santa Cruz de La Sierra","Col. Escuela Jorge Urenda Trigo",144,0,0,1,31,11,7,4,0,198,2,4,204,228,0.157,0.895
"24123","Santa Cruz","Santa Cruz de La Sierra","Col. Escuela Jorge Urenda Trigo",144,0,0,1,44,16,9,0,0,214,2,5,221,232,0.206,0.953
"24124","Santa Cruz","Santa Cruz de La Sierra","Col. Escuela Jorge Urenda Trigo",116,1,0,3,41,11,22,2,0,196,0,1,197,225,0.209,0.876
"24125","Santa Cruz","Santa Cruz de La Sierra","Col. Escuela Jorge Urenda Trigo",127,0,0,3,35,25,13,0,0,203,4,6,213,230,0.172,0.926
"24126","Santa Cruz","Santa Cruz de La Sierra","Col. Escuela Jorge Urenda Trigo",111,0,0,0,43,14,18,2,0,188,1,5,194,228,0.229,0.851
"24127","Santa Cruz","Santa Cruz de La Sierra","Col. Escuela Jorge Urenda Trigo",141,1,1,2,48,14,7,1,0,215,2,5,222,237,0.223,0.937
"24128","Santa Cruz","Santa Cruz de La Sierra","Col. Escuela Jorge Urenda Trigo",136,0,0,1,40,15,6,1,0,199,0,2,201,231,0.201,0.87
"24129","Santa Cruz","Santa Cruz de La Sierra","Col. Escuela Jorge Urenda Trigo",131,0,2,1,42,22,9,1,0,208,0,4,212,233,0.202,0.91
"24130","Santa Cruz","Santa Cruz de La Sierra","Col. Escuela Jorge Urenda Trigo",127,0,0,0,36,16,12,3,0,194,0,4,198,223,0.186,0.888
"24131","Santa Cruz","Santa Cruz de La Sierra","Col. Escuela Jorge Urenda Trigo",120,0,0,4,40,16,13,1,1,195,3,4,202,229,0.205,0.882
"24132","Santa Cruz","Santa Cruz de La Sierra","Col. Escuela Jorge Urenda Trigo",129,0,0,1,35,14,17,2,0,198,1,4,203,230,0.177,0.883
"24133","Santa Cruz","Santa Cruz de La Sierra","Col. Escuela Jorge Urenda Trigo",140,0,0,1,30,20,10,1,0,202,1,3,206,231,0.149,0.892
"24134","Santa Cruz","Santa Cruz de La Sierra","Col. Escuela Jorge Urenda Trigo",142,0,0,0,24,22,6,2,2,198,0,5,203,224,0.121,0.906
"24135","Santa Cruz","Santa Cruz de La Sierra","Col. Escuela Jorge Urenda Trigo",139,1,1,3,38,20,5,0,1,208,0,6,214,233,0.183,0.918
"24136","Santa Cruz","Santa Cruz de La Sierra","Col. Escuela Jorge Urenda Trigo",124,1,0,3,48,16,11,0,0,203,0,3,206,222,0.236,0.928
"24137","Santa Cruz","Santa Cruz de La Sierra","Col. Escuela Jorge Urenda Trigo",130,0,0,1,38,19,11,1,1,201,0,2,203,231,0.189,0.879
"24138","Santa Cruz","Santa Cruz de La Sierra","Col. Oscar Arnulfo",105,1,0,0,47,14,17,1,0,185,0,4,189,218,0.254,0.867
"24139","Santa Cruz","Santa Cruz de La Sierra","Col. Oscar Arnulfo",95,0,0,0,66,15,20,3,0,199,0,10,209,232,0.332,0.901
"24140","Santa Cruz","Santa Cruz de La Sierra","Col. Oscar Arnulfo",130,0,1,1,45,13,20,0,1,211,5,2,218,232,0.213,0.94
"24141","Santa Cruz","Santa Cruz de La Sierra","Col. Oscar Arnulfo",85,1,1,2,79,15,15,1,0,199,1,10,210,233,0.397,0.901
"24142","Santa Cruz","Santa Cruz de La Sierra","Col. Oscar Arnulfo",95,1,1,0,60,16,19,3,0,195,1,3,199,230,0.308,0.865
"24143","Santa Cruz","Santa Cruz de La Sierra","Col. Oscar Arnulfo",87,0,0,1,79,20,5,1,1,194,2,5,201,225,0.407,0.893
"24144","Santa Cruz","Santa Cruz de La Sierra","Col. Oscar Arnulfo",119,0,0,3,46,12,15,0,1,196,1,7,204,225,0.235,0.907
"24145","Santa Cruz","Santa Cruz de La Sierra","Col. Oscar Arnulfo",98,0,0,3,69,12,14,0,3,199,3,7,209,231,0.347,0.905
"24146","Santa Cruz","Santa Cruz de La Sierra","Col. Oscar Arnulfo",110,1,1,0,44,17,15,1,0,189,2,5,196,219,0.233,0.895
"24147","Santa Cruz","Santa Cruz de La Sierra","Col. Oscar Arnulfo",105,0,0,0,62,13,7,2,1,190,1,8,199,231,0.326,0.861
"24148","Santa Cruz","Santa Cruz de La Sierra","Col. Oscar Arnulfo",80,0,0,2,78,19,13,1,1,194,4,5,203,228,0.402,0.89
"24149","Santa Cruz","Santa Cruz de La Sierra","Col. Oscar Arnulfo",103,0,1,3,52,18,16,2,0,195,0,9,204,229,0.267,0.891
"24150","Santa Cruz","Santa Cruz de La Sierra","Col. Oscar Arnulfo",108,0,1,1,55,18,13,0,1,197,2,4,203,233,0.279,0.871
"24151","Santa Cruz","Santa Cruz de La Sierra","Col. Oscar Arnulfo",108,1,2,3,59,15,12,0,0,200,1,8,209,227,0.295,0.921
"24152","Santa Cruz","Santa Cruz de La Sierra","Col. Oscar Arnulfo",100,0,0,0,69,8,18,1,1,197,3,8,208,229,0.35,0.908
"24153","Santa Cruz","Santa Cruz de La Sierra","Col. Oscar Arnulfo",113,2,0,0,54,15,11,1,0,196,1,5,202,227,0.276,0.89
"24154","Santa Cruz","Santa Cruz de La Sierra","Col. Oscar Arnulfo",122,0,1,1,47,14,16,0,0,201,1,4,206,225,0.234,0.916
"24155","Santa Cruz","Santa Cruz de La Sierra","Col. Oscar Arnulfo",122,1,0,1,53,15,13,1,0,206,3,2,211,237,0.257,0.89
"24156","Santa Cruz","Santa Cruz de La Sierra","Col. Oscar Arnulfo",106,1,1,1,61,14,9,0,2,195,3,8,206,230,0.313,0.896
"24157","Santa Cruz","Santa Cruz de La Sierra","Col. Oscar Arnulfo",119,0,0,0,44,15,10,2,0,190,2,9,201,227,0.232,0.885
"24158","Santa Cruz","Santa Cruz de La Sierra","Col. Oscar Arnulfo",103,1,1,0,69,12,21,1,0,208,2,7,217,247,0.332,0.879
"24159","Santa Cruz","Santa Cruz de La Sierra","Col.  Anita Suarez De Leygue",82,0,0,0,80,17,14,2,1,196,3,6,205,230,0.408,0.891
"24160","Santa Cruz","Santa Cruz de La Sierra","Col.  Anita Suarez De Leygue",109,0,0,1,61,15,21,0,1,208,0,5,213,232,0.293,0.918
"24161","Santa Cruz","Santa Cruz de La Sierra","Col.  Anita Suarez De Leygue",85,0,1,0,81,18,14,4,0,203,4,3,210,234,0.399,0.897
"24162","Santa Cruz","Santa Cruz de La Sierra","Col.  Anita Suarez De Leygue",101,0,1,1,76,16,10,1,1,207,0,6,213,236,0.367,0.903
"24163","Santa Cruz","Santa Cruz de La Sierra","Col.  Anita Suarez De Leygue",97,0,1,1,76,9,19,2,1,206,2,9,217,231,0.369,0.939
"24164","Santa Cruz","Santa Cruz de La Sierra","Col.  Anita Suarez De Leygue",96,1,0,2,57,25,20,0,2,203,1,6,210,236,0.281,0.89
"24165","Santa Cruz","Santa Cruz de La Sierra","Col.  Anita Suarez De Leygue",103,0,1,1,66,12,9,6,1,199,2,11,212,232,0.332,0.914
"24166","Santa Cruz","Santa Cruz de La Sierra","Col.  Anita Suarez De Leygue",101,0,1,0,66,19,8,2,0,197,2,4,203,229,0.335,0.886
"24167","Santa Cruz","Santa Cruz de La Sierra","Col.  Anita Suarez De Leygue",103,0,0,1,58,20,18,1,0,201,2,5,208,233,0.289,0.893
"24168","Santa Cruz","Santa Cruz de La Sierra","Col.  Anita Suarez De Leygue",114,0,0,1,77,11,7,4,0,214,0,0,214,235,0.36,0.911
"24169","Santa Cruz","Santa Cruz de La Sierra","Col.  Anita Suarez De Leygue",115,0,1,2,54,26,12,2,2,214,0,0,214,232,0.252,0.922
"24170","Santa Cruz","Santa Cruz de La Sierra","Col.  Anita Suarez De Leygue",88,1,0,2,79,16,17,1,0,204,2,5,211,234,0.387,0.902
"24171","Santa Cruz","Santa Cruz de La Sierra","Col.  Anita Suarez De Leygue",94,0,1,0,66,20,18,3,0,202,0,7,209,228,0.327,0.917
"24172","Santa Cruz","Santa Cruz de La Sierra","Colegio El Progreso",74,0,0,2,77,13,29,0,1,196,0,4,200,226,0.393,0.885
"24173","Santa Cruz","Santa Cruz de La Sierra","Colegio El Progreso",91,0,0,0,69,22,14,0,0,196,1,5,202,233,0.352,0.867
"24174","Santa Cruz","Santa Cruz de La Sierra","Colegio El Progreso",73,0,0,0,79,16,16,1,1,186,2,7,195,232,0.425,0.841
"24175","Santa Cruz","Santa Cruz de La Sierra","Colegio El Progreso",83,0,1,0,78,12,17,3,0,194,1,8,203,232,0.402,0.875
"24176","Santa Cruz","Santa Cruz de La Sierra","Colegio El Progreso",68,0,1,0,96,8,16,0,0,189,3,10,202,228,0.508,0.886
"24177","Santa Cruz","Santa Cruz de La Sierra","Colegio El Progreso",53,0,0,2,88,19,26,1,0,189,1,7,197,228,0.466,0.864
"24178","Santa Cruz","Santa Cruz de La Sierra","Colegio El Progreso",86,1,1,0,56,20,14,2,1,181,2,10,193,224,0.309,0.862
"24179","Santa Cruz","Santa Cruz de La Sierra","Colegio El Progreso",81,0,1,1,68,14,29,1,0,195,1,3,199,229,0.349,0.869
"24180","Santa Cruz","Santa Cruz de La Sierra","Colegio El Progreso",69,0,1,1,74,11,19,0,0,175,0,7,182,224,0.423,0.812
"24181","Santa Cruz","Santa Cruz de La Sierra","Colegio El Progreso",81,1,0,0,76,9,17,0,4,188,7,4,199,227,0.404,0.877
"24182","Santa Cruz","Santa Cruz de La Sierra","Colegio El Progreso",88,1,0,2,75,10,11,4,0,191,1,7,199,230,0.393,0.865
"24183","Santa Cruz","Santa Cruz de La Sierra","Colegio El Progreso",65,0,0,1,101,10,16,1,2,196,0,8,204,228,0.515,0.895
"24184","Santa Cruz","Santa Cruz de La Sierra","Colegio El Progreso",78,0,0,0,75,9,10,0,2,174,2,12,188,227,0.431,0.828
"24185","Santa Cruz","Santa Cruz de La Sierra","Colegio El Progreso",86,0,0,3,82,16,4,1,1,193,1,5,199,225,0.425,0.884
"24186","Santa Cruz","Santa Cruz de La Sierra","Colegio El Progreso",81,0,0,1,86,18,6,2,4,198,1,3,202,229,0.434,0.882
"24187","Santa Cruz","Santa Cruz de La Sierra","Colegio El Progreso",96,0,0,4,62,21,12,1,1,197,4,6,207,228,0.315,0.908
"24188","Santa Cruz","Santa Cruz de La Sierra","Colegio El Progreso",59,0,1,1,83,12,22,0,2,180,5,6,191,230,0.461,0.83
"24189","Santa Cruz","Santa Cruz de La Sierra","Colegio El Progreso",84,1,0,1,62,23,10,1,0,182,3,13,198,228,0.341,0.868
"24190","Santa Cruz","Santa Cruz de La Sierra","Colegio El Progreso",99,0,0,2,63,16,14,1,0,195,2,2,199,228,0.323,0.873
"24191","Santa Cruz","Santa Cruz de La Sierra","Colegio El Progreso",99,0,0,0,64,15,10,1,1,190,2,5,197,228,0.337,0.864
"24192","Santa Cruz","Santa Cruz de La Sierra","Colegio El Progreso",96,0,0,0,70,12,9,1,2,190,1,8,199,226,0.368,0.881
"24193","Santa Cruz","Santa Cruz de La Sierra","Colegio El Progreso",74,0,0,2,72,14,12,1,0,175,1,12,188,228,0.411,0.825
"24194","Santa Cruz","Santa Cruz de La Sierra","Colegio El Progreso",96,3,0,0,71,16,15,1,0,202,3,4,209,240,0.351,0.871
"24195","Santa Cruz","Santa Cruz de La Sierra","Col. Cardenal Cushing Jesus Maria",142,0,0,1,24,17,4,0,0,188,0,10,198,220,0.128,0.9
"24196","Santa Cruz","Santa Cruz de La Sierra","Col. Cardenal Cushing Jesus Maria",137,0,0,4,28,13,7,0,0,189,1,6,196,217,0.148,0.903
"24197","Santa Cruz","Santa Cruz de La Sierra","Col. Cardenal Cushing Jesus Maria",126,0,0,1,37,11,4,0,0,179,0,4,183,216,0.207,0.847
"24198","Santa Cruz","Santa Cruz de La Sierra","Col. Cardenal Cushing Jesus Maria",112,0,0,1,36,21,8,0,3,181,2,7,190,217,0.199,0.876
"24199","Santa Cruz","Santa Cruz de La Sierra","Col. Cardenal Cushing Jesus Maria",133,0,0,0,37,10,4,0,2,186,0,3,189,215,0.199,0.879
"24200","Santa Cruz","Santa Cruz de La Sierra","Col. Cardenal Cushing Jesus Maria",143,0,0,5,14,18,7,1,0,188,1,7,196,221,0.074,0.887
"24201","Santa Cruz","Santa Cruz de La Sierra","Col. Cardenal Cushing Jesus Maria",126,0,1,2,26,18,7,0,0,180,2,3,185,219,0.144,0.845
"24202","Santa Cruz","Santa Cruz de La Sierra","Col. Cardenal Cushing Jesus Maria",140,0,0,3,20,15,5,0,0,183,1,6,190,218,0.109,0.872
"24203","Santa Cruz","Santa Cruz de La Sierra","Col. Cardenal Cushing Jesus Maria",135,1,0,2,19,14,4,0,0,175,0,10,185,218,0.109,0.849
"24204","Santa Cruz","Santa Cruz de La Sierra","Col. Cardenal Cushing Jesus Maria",120,1,0,4,14,18,8,0,1,166,0,6,172,224,0.084,0.768
"24205","Santa Cruz","Santa Cruz de La Sierra","Col. Esc. Coronel Ignacio Warnes",121,0,0,1,18,13,3,0,0,156,0,5,161,207,0.115,0.778
"24206","Santa Cruz","Santa Cruz de La Sierra","Col. Esc. Coronel Ignacio Warnes",109,0,0,0,21,10,7,4,0,151,1,6,158,203,0.139,0.778
"24207","Santa Cruz","Santa Cruz de La Sierra","Col. Esc. Coronel Ignacio Warnes",133,0,0,3,9,19,9,0,0,173,1,2,176,211,0.052,0.834
"24208","Santa Cruz","Santa Cruz de La Sierra","Escuela Seccional Zafranilla",77,0,1,0,65,47,5,0,1,196,5,10,211,232,0.332,0.909
"24209","Santa Cruz","Santa Cruz de La Sierra","Escuela Seccional Zafranilla",71,3,1,1,58,47,8,2,0,191,5,11,207,229,0.304,0.904
"24210","Santa Cruz","Santa Cruz de La Sierra","Escuela Seccional Guapilo",108,0,0,0,45,34,10,1,0,198,1,10,209,236,0.227,0.886
"24211","Santa Cruz","Santa Cruz de La Sierra","Escuela Seccional Guapilo",102,1,0,0,55,32,9,1,1,201,1,7,209,232,0.274,0.901
"24212","Santa Cruz","Santa Cruz de La Sierra","Escuela Seccional Guapilo",84,0,1,1,46,24,6,1,0,163,1,49,213,234,0.282,0.91
"24213","Santa Cruz","Santa Cruz de La Sierra","Escuela Seccional Guapilo",83,0,1,0,75,25,10,1,0,195,0,14,209,232,0.385,0.901
"24214","Santa Cruz","Santa Cruz de La Sierra","Escuela Seccional Guapilo",94,0,0,2,49,37,7,2,0,191,4,12,207,232,0.257,0.892
"24215","Santa Cruz","Santa Cruz de La Sierra","Escuela Seccional Guapilo",116,0,0,2,50,30,6,1,0,205,2,11,218,232,0.244,0.94
"24216","Santa Cruz","Santa Cruz de La Sierra","Escuela Seccional Guapilo",118,0,0,1,44,29,4,2,0,198,1,6,205,228,0.222,0.899
"24217","Santa Cruz","Santa Cruz de La Sierra","Escuela Seccional Guapilo",96,0,0,1,60,34,8,3,0,202,2,6,210,232,0.297,0.905
"24218","Santa Cruz","Santa Cruz de La Sierra","Escuela Seccional Guapilo",110,0,0,0,51,33,6,0,0,200,1,12,213,230,0.255,0.926
"24219","Santa Cruz","Santa Cruz de La Sierra","Escuela Seccional Guapilo",105,0,0,1,57,24,11,0,0,198,2,7,207,229,0.288,0.904
"24220","Santa Cruz","Santa Cruz de La Sierra","Escuela Seccional Guapilo",101,0,1,0,41,36,9,1,1,190,2,4,196,224,0.216,0.875
"24221","Santa Cruz","Santa Cruz de La Sierra","Escuela Seccional Guapilo",100,0,4,1,58,27,4,1,1,196,1,7,204,229,0.296,0.891
"24222","Santa Cruz","Santa Cruz de La Sierra","Escuela Seccional Guapilo",108,0,0,0,50,26,13,1,0,198,0,9,207,231,0.253,0.896
"24223","Santa Cruz","Santa Cruz de La Sierra","Escuela Seccional Guapilo",92,0,1,1,58,31,16,0,1,200,1,6,207,230,0.29,0.9
"24224","Santa Cruz","Santa Cruz de La Sierra","Escuela Seccional Guapilo",107,0,0,1,55,34,7,2,0,206,1,4,211,232,0.267,0.909
"24225","Santa Cruz","Santa Cruz de La Sierra","Escuela Seccional Guapilo",100,0,2,0,39,39,9,0,0,189,0,11,200,221,0.206,0.905
"24226","Santa Cruz","Santa Cruz de La Sierra","Escuela Adolfo Roman Hijo",68,1,1,1,72,42,15,1,0,201,3,8,212,234,0.358,0.906
"24227","Santa Cruz","Santa Cruz de La Sierra","Escuela Adolfo Roman Hijo",64,1,1,2,83,37,9,2,0,199,2,8,209,231,0.417,0.905
"24228","Santa Cruz","Santa Cruz de La Sierra","Escuela Adolfo Roman Hijo",76,0,0,0,81,32,16,2,2,209,1,7,217,229,0.388,0.948
"24229","Santa Cruz","Santa Cruz de La Sierra","Escuela Adolfo Roman Hijo",88,2,0,0,71,30,10,2,0,203,3,2,208,227,0.35,0.916
"24230","Santa Cruz","Santa Cruz de La Sierra","Escuela Adolfo Roman Hijo",79,0,1,3,53,56,6,1,2,201,7,4,212,232,0.264,0.914
"24231","Santa Cruz","Santa Cruz de La Sierra","Escuela Adolfo Roman Hijo",72,0,0,1,72,30,13,4,0,192,2,4,198,227,0.375,0.872
"24232","Santa Cruz","Santa Cruz de La Sierra","Escuela Adolfo Roman Hijo",83,0,0,1,46,54,8,0,0,192,4,7,203,225,0.24,0.902
"24233","Santa Cruz","Santa Cruz de La Sierra","Escuela Adolfo Roman Hijo",70,0,0,3,54,42,9,3,1,182,2,0,184,216,0.297,0.852
"24234","Santa Cruz","Santa Cruz de La Sierra","Esc. Gabriel Jose Moreno",120,1,0,0,49,17,3,0,0,190,1,10,201,226,0.258,0.889
"24235","Santa Cruz","Santa Cruz de La Sierra","Esc. Gabriel Jose Moreno",120,0,0,0,45,28,7,0,0,200,0,5,205,221,0.225,0.928
"24236","Santa Cruz","Santa Cruz de La Sierra","Esc. Gabriel Jose Moreno",130,0,0,3,30,25,4,1,0,193,1,9,203,222,0.155,0.914
"24237","Santa Cruz","Santa Cruz de La Sierra","Esc. Gabriel Jose Moreno",126,2,0,2,38,18,5,0,0,191,3,9,203,221,0.199,0.919
"24238","Santa Cruz","Santa Cruz de La Sierra","Esc. Gabriel Jose Moreno",137,0,1,1,39,13,6,3,0,200,0,6,206,223,0.195,0.924
"24239","Santa Cruz","Santa Cruz de La Sierra","Esc. Gabriel Jose Moreno",139,0,0,2,35,29,4,0,0,209,2,5,216,230,0.167,0.939
"24240","Santa Cruz","Santa Cruz de La Sierra","Esc. Gabriel Jose Moreno",119,2,1,0,45,19,4,0,0,190,5,4,199,220,0.237,0.905
"24241","Santa Cruz","Santa Cruz de La Sierra","Esc. Gabriel Jose Moreno",108,1,0,2,46,26,8,0,0,191,1,7,199,226,0.241,0.881
"24242","Santa Cruz","Santa Cruz de La Sierra","Esc. Gabriel Jose Moreno",114,0,0,1,30,18,6,1,0,170,1,2,173,179,0.176,0.966
"24243","Santa Cruz","Santa Cruz de La Sierra","Esc. Hugo Banzer Suarez",85,0,1,1,75,24,23,0,0,209,1,9,219,234,0.359,0.936
"24244","Santa Cruz","Santa Cruz de La Sierra","Esc. Hugo Banzer Suarez",67,0,0,1,107,15,20,0,3,213,3,4,220,234,0.502,0.94
"24245","Santa Cruz","Santa Cruz de La Sierra","Esc. Hugo Banzer Suarez",56,0,0,1,117,12,15,0,2,203,2,11,216,234,0.576,0.923
"24246","Santa Cruz","Santa Cruz de La Sierra","Esc. Hugo Banzer Suarez",57,0,2,1,102,22,15,2,4,205,3,3,211,233,0.498,0.906
"24247","Santa Cruz","Santa Cruz de La Sierra","Esc. Hugo Banzer Suarez",88,0,0,1,85,9,18,0,5,206,3,7,216,231,0.413,0.935
"24248","Santa Cruz","Santa Cruz de La Sierra","Esc. Hugo Banzer Suarez",84,0,0,0,85,17,12,2,2,202,1,7,210,235,0.421,0.894
"24249","Santa Cruz","Santa Cruz de La Sierra","Esc. Hugo Banzer Suarez",74,0,1,1,104,10,9,2,2,203,1,11,215,234,0.512,0.919
"24250","Santa Cruz","Santa Cruz de La Sierra","Esc. Hugo Banzer Suarez",69,1,1,1,107,16,13,2,3,213,1,7,221,233,0.502,0.948
"24251","Santa Cruz","Santa Cruz de La Sierra","Esc. Hugo Banzer Suarez",71,1,0,1,96,18,21,0,1,209,0,6,215,237,0.459,0.907
"24252","Santa Cruz","Santa Cruz de La Sierra","Esc. Hugo Banzer Suarez",63,1,0,0,106,9,19,0,3,201,2,6,209,231,0.527,0.905
"24253","Santa Cruz","Santa Cruz de La Sierra","Esc. Zenovia Aponte",75,0,0,0,90,19,16,0,1,201,0,6,207,229,0.448,0.904
"24254","Santa Cruz","Santa Cruz de La Sierra","Esc. Zenovia Aponte",67,0,1,0,93,23,18,2,2,206,3,1,210,235,0.451,0.894
"24255","Santa Cruz","Santa Cruz de La Sierra","Esc. Zenovia Aponte",65,1,0,0,109,19,11,1,2,208,1,3,212,234,0.524,0.906
"24256","Santa Cruz","Santa Cruz de La Sierra","Esc. Zenovia Aponte",50,1,0,0,124,16,15,2,0,208,0,5,213,233,0.596,0.914
"24257","Santa Cruz","Santa Cruz de La Sierra","Esc. Zenovia Aponte",62,0,1,1,96,20,18,3,0,201,5,7,213,232,0.478,0.918
"24258","Santa Cruz","Santa Cruz de La Sierra","Esc. Zenovia Aponte",62,0,0,0,104,23,14,2,1,206,2,11,219,235,0.505,0.932
"24259","Santa Cruz","Santa Cruz de La Sierra","Esc. Zenovia Aponte",54,0,1,1,104,17,12,1,2,192,3,7,202,236,0.542,0.856
"24260","Santa Cruz","Santa Cruz de La Sierra","Esc. Zenovia Aponte",76,1,0,0,68,32,18,2,2,199,4,7,210,232,0.342,0.905
"24261","Santa Cruz","Santa Cruz de La Sierra","Esc. Zenovia Aponte",72,0,0,1,101,24,12,1,0,211,2,8,221,237,0.479,0.932
"24262","Santa Cruz","Santa Cruz de La Sierra","Esc. Zenovia Aponte",63,0,0,0,111,19,9,2,2,206,2,5,213,236,0.539,0.903
"24263","Santa Cruz","Santa Cruz de La Sierra","Esc. Zenovia Aponte",41,1,1,1,76,41,0,4,0,165,35,7,207,234,0.461,0.885
"24264","Santa Cruz","Santa Cruz de La Sierra","Esc. Zenovia Aponte",76,0,0,0,85,12,19,7,0,199,1,6,206,233,0.427,0.884
"24265","Santa Cruz","Santa Cruz de La Sierra","Esc. Zenovia Aponte",71,0,3,1,86,23,16,1,0,201,2,3,206,233,0.428,0.884
"24266","Santa Cruz","Santa Cruz de La Sierra","Esc. Solidaridad 55",64,2,0,0,108,14,22,1,0,211,1,4,216,237,0.512,0.911
"24267","Santa Cruz","Santa Cruz de La Sierra","Esc. Solidaridad 55",77,1,0,0,78,29,16,4,1,206,0,4,210,230,0.379,0.913
"24268","Santa Cruz","Santa Cruz de La Sierra","Esc. Solidaridad 55",68,3,2,0,83,22,24,2,3,207,1,9,217,230,0.401,0.943
"24269","Santa Cruz","Santa Cruz de La Sierra","Esc. Solidaridad 55",60,0,2,1,109,11,12,1,1,197,2,7,206,230,0.553,0.896
"24270","Santa Cruz","Santa Cruz de La Sierra","Esc. Solidaridad 55",76,1,0,1,98,10,11,1,2,200,5,8,213,238,0.49,0.895
"24271","Santa Cruz","Santa Cruz de La Sierra","Esc. Solidaridad 55",43,1,0,2,125,9,27,1,2,210,2,3,215,229,0.595,0.939
"24272","Santa Cruz","Santa Cruz de La Sierra","Esc. Solidaridad 55",61,0,1,2,119,8,13,1,2,207,2,7,216,235,0.575,0.919
"24273","Santa Cruz","Santa Cruz de La Sierra","Esc. Solidaridad 55",85,0,0,2,92,22,11,2,0,214,0,3,217,234,0.43,0.927
"24274","Santa Cruz","Santa Cruz de La Sierra","Esc. Solidaridad 55",59,0,1,3,104,16,20,2,0,205,1,10,216,232,0.507,0.931
"24275","Santa Cruz","Santa Cruz de La Sierra","Esc. Solidaridad 55",69,0,0,1,101,14,20,2,2,209,0,5,214,235,0.483,0.911
"24276","Santa Cruz","Santa Cruz de La Sierra","Esc. Solidaridad 55",69,0,0,0,112,13,10,1,0,205,3,7,215,232,0.546,0.927
"24277","Santa Cruz","Santa Cruz de La Sierra","Esc. Solidaridad 55",80,2,0,0,100,9,11,0,1,203,0,6,209,227,0.493,0.921
"24278","Santa Cruz","Santa Cruz de La Sierra","Esc. Solidaridad 55",64,2,0,0,88,26,19,2,0,201,1,31,233,233,0.438,1
"24279","Santa Cruz","Santa Cruz de La Sierra","Esc. Solidaridad 55",41,0,0,0,134,11,19,0,3,208,2,6,216,235,0.644,0.919
"24280","Santa Cruz","Santa Cruz de La Sierra","Esc. Solidaridad 55",82,0,0,0,91,17,12,3,2,207,2,5,214,234,0.44,0.915
"24281","Santa Cruz","Santa Cruz de La Sierra","Esc. Solidaridad 55",90,0,0,0,74,23,11,4,2,204,1,8,213,233,0.363,0.914
"24282","Santa Cruz","Santa Cruz de La Sierra","Esc. Solidaridad 55",50,1,0,0,111,21,12,5,2,202,4,4,210,232,0.55,0.905
"24283","Santa Cruz","Santa Cruz de La Sierra","Esc. Solidaridad 55",71,0,2,1,95,22,17,0,2,210,1,5,216,235,0.452,0.919
"24284","Santa Cruz","Santa Cruz de La Sierra","Esc. Solidaridad 55",67,1,1,1,90,19,18,1,0,198,3,2,203,228,0.455,0.89
"24285","Santa Cruz","Santa Cruz de La Sierra","Esc. Solidaridad 55",34,0,0,0,128,11,15,2,1,191,6,8,205,231,0.67,0.887
"24286","Santa Cruz","Santa Cruz de La Sierra","Esc. Solidaridad 55",71,0,0,0,84,23,29,3,0,210,1,4,215,232,0.4,0.927
"24287","Santa Cruz","Santa Cruz de La Sierra","Esc. Solidaridad 55",75,1,0,1,95,10,19,4,2,207,2,3,212,228,0.459,0.93
"24288","Santa Cruz","Santa Cruz de La Sierra","Esc. Solidaridad 55",70,1,1,2,83,24,14,1,1,197,0,6,203,232,0.421,0.875
"24289","Santa Cruz","Santa Cruz de La Sierra","Esc. Solidaridad 55",77,1,1,2,77,25,16,2,0,201,3,5,209,232,0.383,0.901
"24290","Santa Cruz","Santa Cruz de La Sierra","Esc. Solidaridad 55",83,0,1,1,90,13,12,1,0,201,3,7,211,231,0.448,0.913
"24291","Santa Cruz","Santa Cruz de La Sierra","Esc. Solidaridad 55",72,0,1,3,96,15,18,2,1,208,1,2,211,236,0.462,0.894
"24292","Santa Cruz","Santa Cruz de La Sierra","Esc. Solidaridad 55",64,0,1,1,114,15,14,2,1,212,0,6,218,234,0.538,0.932
"24293","Santa Cruz","Santa Cruz de La Sierra","Esc. Seccional Villa Flor",71,1,3,1,99,21,13,1,0,210,1,10,221,230,0.471,0.961
"24294","Santa Cruz","Santa Cruz de La Sierra","Esc. Seccional Villa Flor",51,1,1,6,102,27,13,1,1,203,6,9,218,235,0.502,0.928
"24295","Santa Cruz","Santa Cruz de La Sierra","Esc. Seccional Villa Flor",53,3,0,6,104,17,19,1,0,203,2,6,211,232,0.512,0.909
"24296","Santa Cruz","Santa Cruz de La Sierra","Esc. Seccional Villa Flor",57,1,2,9,98,29,9,2,0,207,4,5,216,232,0.473,0.931
"24297","Santa Cruz","Santa Cruz de La Sierra","Esc. Seccional Villa Flor",61,3,0,1,93,19,16,4,2,199,8,4,211,227,0.467,0.93
"24298","Santa Cruz","Santa Cruz de La Sierra","Esc. Usuri Aponte",64,0,1,1,88,23,9,1,3,190,4,10,204,227,0.463,0.899
"24299","Santa Cruz","Santa Cruz de La Sierra","Esc. Usuri Aponte",61,0,1,2,88,37,5,3,1,198,3,5,206,233,0.444,0.884
"24300","Santa Cruz","Santa Cruz de La Sierra","Esc. La Peña",11,1,1,0,170,5,12,0,0,200,3,5,208,232,0.85,0.897
"24301","Santa Cruz","Santa Cruz de La Sierra","Esc. La Peña",7,1,1,1,167,4,9,0,2,192,3,10,205,223,0.87,0.919
"24302","Santa Cruz","Santa Cruz de La Sierra","Esc. La Peña",9,0,0,0,163,6,16,1,0,195,6,4,205,231,0.836,0.887
"24303","Santa Cruz","Santa Cruz de La Sierra","Esc. La Peña",6,2,0,0,168,7,10,1,0,194,4,14,212,230,0.866,0.922
"24304","Santa Cruz","Santa Cruz de La Sierra","U.E. Aponte De Jorori",46,2,0,2,101,18,21,2,0,192,6,15,213,232,0.526,0.918
"24305","Santa Cruz","Santa Cruz de La Sierra","U.E. Aponte De Jorori",39,0,0,1,133,13,12,0,0,198,3,5,206,223,0.672,0.924
"24306","Santa Cruz","Santa Cruz de La Sierra","U.E. Aponte De Jorori",32,1,1,0,136,16,9,3,0,198,1,11,210,230,0.687,0.913
"24307","Santa Cruz","Santa Cruz de La Sierra","U.E. Aponte De Jorori",47,1,1,1,97,17,14,1,0,179,4,15,198,227,0.542,0.872
"24308","Santa Cruz","Santa Cruz de La Sierra","U.E. Clara Serrano",66,0,0,2,102,29,11,1,2,213,4,3,220,238,0.479,0.924
"24309","Santa Cruz","Santa Cruz de La Sierra","U.E. Clara Serrano",60,0,1,2,99,30,16,0,2,210,1,7,218,235,0.471,0.928
"24310","Santa Cruz","Santa Cruz de La Sierra","U.E. Clara Serrano",65,0,2,1,86,44,13,1,0,212,1,9,222,237,0.406,0.937
"24311","Santa Cruz","Santa Cruz de La Sierra","U.E. Clara Serrano",60,0,0,1,85,47,11,0,0,204,4,7,215,238,0.417,0.903
"24312","Santa Cruz","Santa Cruz de La Sierra","U.E. San Miguel Aponte",60,1,1,1,83,40,13,3,1,203,4,9,216,232,0.409,0.931
"24313","Santa Cruz","Santa Cruz de La Sierra","U.E. Thevenet De Viana",62,0,1,2,89,30,16,1,0,201,4,10,215,231,0.443,0.931
"24314","Santa Cruz","Santa Cruz de La Sierra","U.E. Thevenet De Viana",70,2,1,0,119,13,7,2,1,215,5,5,225,235,0.553,0.957
"24315","Santa Cruz","Santa Cruz de La Sierra","U.E. Tipoy",71,1,0,2,100,25,15,4,2,220,1,7,228,239,0.455,0.954
"24316","Santa Cruz","Santa Cruz de La Sierra","U.E. Tundy",60,0,0,2,99,40,6,7,0,214,8,8,230,239,0.463,0.962
"24317","Santa Cruz","Cotoca","Escuela Colegio Manuel Angel Cortez",87,0,0,0,45,40,12,2,0,186,6,8,200,229,0.242,0.873
"24318","Santa Cruz","Cotoca","Escuela Colegio Manuel Angel Cortez",96,1,0,2,51,24,14,2,0,190,3,3,196,229,0.268,0.856
"24319","Santa Cruz","Cotoca","Escuela Colegio Manuel Angel Cortez",76,2,0,1,71,19,24,2,0,195,1,5,201,225,0.364,0.893
"24320","Santa Cruz","Cotoca","Escuela Colegio Manuel Angel Cortez",63,0,0,0,108,16,15,1,3,206,1,3,210,233,0.524,0.901
"24321","Santa Cruz","Cotoca","Escuela Colegio Manuel Angel Cortez",96,0,0,1,56,22,14,2,2,193,1,6,200,226,0.29,0.885
"24322","Santa Cruz","Cotoca","Escuela Colegio Manuel Angel Cortez",82,2,0,1,59,30,13,1,0,188,1,15,204,231,0.314,0.883
"24323","Santa Cruz","Cotoca","Escuela Colegio Manuel Angel Cortez",102,1,0,0,48,28,7,2,1,189,1,6,196,228,0.254,0.86
"24324","Santa Cruz","Cotoca","Escuela Colegio Manuel Angel Cortez",76,0,1,0,72,12,18,1,1,181,1,12,194,230,0.398,0.843
"24325","Santa Cruz","Cotoca","Escuela Colegio Manuel Angel Cortez",90,1,0,0,50,34,10,1,0,186,0,8,194,227,0.269,0.855
"24326","Santa Cruz","Cotoca","Escuela Colegio Manuel Angel Cortez",102,1,0,2,49,22,10,1,0,187,1,13,201,226,0.262,0.889
"24327","Santa Cruz","Cotoca","Escuela Colegio Manuel Angel Cortez",87,0,0,0,67,16,13,5,0,188,3,6,197,220,0.356,0.895
"24328","Santa Cruz","Cotoca","Escuela Colegio Manuel Angel Cortez",106,0,0,1,51,20,7,2,0,187,2,6,195,222,0.273,0.878
"24329","Santa Cruz","Cotoca","Escuela Colegio Manuel Angel Cortez",112,0,0,3,40,25,7,4,0,191,3,3,197,226,0.209,0.872
"24330","Santa Cruz","Cotoca","Escuela Colegio Manuel Angel Cortez",97,0,0,3,45,37,7,7,0,196,2,9,207,228,0.23,0.908
"24331","Santa Cruz","Cotoca","Escuela Colegio Manuel Angel Cortez",96,0,0,0,53,30,10,1,1,191,1,7,199,224,0.277,0.888
"24332","Santa Cruz","Cotoca","Escuela Colegio Lorenzo Cortez Rivera",99,0,0,3,44,29,10,4,0,189,4,6,199,225,0.233,0.884
"24333","Santa Cruz","Cotoca","Escuela Colegio Lorenzo Cortez Rivera",126,1,2,1,40,27,3,1,0,201,2,6,209,224,0.199,0.933
"24334","Santa Cruz","Cotoca","Escuela Colegio Lorenzo Cortez Rivera",116,1,0,0,31,41,12,2,1,204,3,9,216,226,0.152,0.956
"24335","Santa Cruz","Cotoca","Escuela Colegio Lorenzo Cortez Rivera",90,0,1,2,61,29,9,3,0,195,3,8,206,225,0.313,0.916
"24336","Santa Cruz","Cotoca","Escuela Colegio Lorenzo Cortez Rivera",85,1,0,0,46,31,17,2,1,183,3,10,196,222,0.251,0.883
"24337","Santa Cruz","Cotoca","Escuela Colegio Lorenzo Cortez Rivera",81,2,0,0,56,21,17,4,2,183,4,0,187,226,0.306,0.827
"24338","Santa Cruz","Cotoca","Escuela Colegio Lorenzo Cortez Rivera",96,1,0,2,50,19,10,1,4,183,3,22,208,229,0.273,0.908
"24339","Santa Cruz","Cotoca","Escuela Colegio Lorenzo Cortez Rivera",74,1,0,3,63,31,13,2,0,187,5,8,200,219,0.337,0.913
"24340","Santa Cruz","Cotoca","Escuela Colegio Lorenzo Cortez Rivera",82,2,1,0,59,32,11,4,0,191,1,11,203,222,0.309,0.914
"24341","Santa Cruz","Cotoca","Escuela Colegio Lorenzo Cortez Rivera",99,2,0,2,60,25,11,2,1,202,3,5,210,224,0.297,0.938
"24342","Santa Cruz","Cotoca","Escuela Colegio Lorenzo Cortez Rivera",116,0,0,1,44,29,3,0,0,193,1,7,201,222,0.228,0.905
"24343","Santa Cruz","Cotoca","Escuela Colegio Lorenzo Cortez Rivera",90,2,0,1,68,20,12,3,2,198,2,9,209,227,0.343,0.921
"24344","Santa Cruz","Cotoca","Escuela Colegio Lorenzo Cortez Rivera",109,1,0,0,33,31,15,5,0,194,4,5,203,230,0.17,0.883
"24345","Santa Cruz","Cotoca","Escuela Colegio Lorenzo Cortez Rivera",93,1,0,2,47,27,14,0,0,184,0,7,191,221,0.255,0.864
"24346","Santa Cruz","Cotoca","Escuela Colegio Lorenzo Cortez Rivera",97,0,0,0,52,34,5,7,0,195,1,11,207,230,0.267,0.9
"24347","Santa Cruz","Cotoca","Escuela Colegio Lorenzo Cortez Rivera",107,3,0,0,29,37,8,7,0,191,3,8,202,227,0.152,0.89
"24348","Santa Cruz","Cotoca","Escuela Colegio Lorenzo Cortez Rivera",85,2,0,0,64,19,14,3,1,188,3,10,201,222,0.34,0.905
"24349","Santa Cruz","Cotoca","Escuela Colegio Lorenzo Cortez Rivera",93,2,0,4,36,28,16,5,0,184,3,9,196,224,0.196,0.875
"24350","Santa Cruz","Cotoca","Escuela Colegio Lorenzo Cortez Rivera",94,0,0,0,52,31,10,1,0,188,4,6,198,224,0.277,0.884
"24351","Santa Cruz","Cotoca","Escuela Colegio Lorenzo Cortez Rivera",133,0,0,1,26,24,5,3,0,192,1,10,203,230,0.135,0.883
"24352","Santa Cruz","Cotoca","Escuela Colegio Lorenzo Cortez Rivera",109,1,0,1,43,33,6,3,0,196,4,8,208,226,0.219,0.92
"24353","Santa Cruz","Cotoca","Escuela Colegio Lorenzo Cortez Rivera",106,0,1,2,56,27,12,2,0,206,2,6,214,231,0.272,0.926
"24354","Santa Cruz","Cotoca","Escuela Colegio Lorenzo Cortez Rivera",101,0,0,3,39,31,11,4,0,189,4,4,197,225,0.206,0.876
"24355","Santa Cruz","Cotoca","Escuela Colegio Lorenzo Cortez Rivera",92,0,0,5,35,21,12,2,1,168,2,4,174,193,0.208,0.902
"24356","Santa Cruz","Cotoca","Escuela Col. San Marcos",89,0,0,1,57,30,15,1,0,193,3,8,204,228,0.295,0.895
"24357","Santa Cruz","Cotoca","Escuela Col. San Marcos",81,0,1,0,67,35,9,1,1,195,1,8,204,226,0.344,0.903
"24358","Santa Cruz","Cotoca","Escuela Col. San Marcos",74,0,0,2,59,16,13,1,0,165,5,47,217,234,0.358,0.927
"24359","Santa Cruz","Cotoca","Escuela Col. San Marcos",55,0,0,1,114,24,14,0,2,210,2,2,214,228,0.543,0.939
"24360","Santa Cruz","Cotoca","Escuela Col. San Marcos",68,1,0,1,83,27,14,1,1,196,1,9,206,227,0.423,0.907
"24361","Santa Cruz","Cotoca","Escuela Col. San Marcos",61,0,0,0,102,15,17,1,2,198,0,7,205,229,0.515,0.895
"24362","Santa Cruz","Cotoca","Escuela Col. San Marcos",84,0,0,1,69,28,17,1,0,200,3,5,208,232,0.345,0.897
"24363","Santa Cruz","Cotoca","Escuela Col. San Marcos",75,1,0,0,83,21,12,1,3,196,1,9,206,229,0.423,0.9
"24364","Santa Cruz","Cotoca","Escuela Col. San Marcos",80,1,0,1,68,23,19,4,0,196,1,8,205,227,0.347,0.903
"24365","Santa Cruz","Cotoca","Escuela Col. San Marcos",76,1,0,1,67,21,18,3,0,187,2,8,197,221,0.358,0.891
"24366","Santa Cruz","Cotoca","Escuela Col. San Marcos",94,0,0,1,51,33,9,1,0,189,3,6,198,226,0.27,0.876
"24367","Santa Cruz","Cotoca","Escuela Col. San Marcos",45,2,1,0,103,19,20,1,2,193,1,7,201,229,0.534,0.878
"24368","Santa Cruz","Cotoca","Escuela Col. San Marcos",66,0,0,1,63,18,13,3,0,164,3,33,200,228,0.384,0.877
"24369","Santa Cruz","Cotoca","Escuela Col. San Marcos",76,1,0,2,53,35,13,5,1,186,2,10,198,225,0.285,0.88
"24370","Santa Cruz","Cotoca","Escuela Col. San Marcos",78,2,0,2,73,28,10,5,1,199,3,8,210,234,0.367,0.897
"24371","Santa Cruz","Cotoca","Escuela Col. San Marcos",106,0,0,2,44,24,12,2,1,191,3,8,202,232,0.23,0.871
"24372","Santa Cruz","Cotoca","Escuela Col. San Marcos",71,0,0,1,104,19,7,1,0,203,1,4,208,230,0.512,0.904
"24373","Santa Cruz","Cotoca","Escuela Col. San Marcos",104,0,0,0,62,22,8,3,0,199,1,5,205,225,0.312,0.911
"24374","Santa Cruz","Cotoca","Escuela Col. San Marcos",73,0,0,1,70,36,13,1,0,194,1,5,200,226,0.361,0.885
"24375","Santa Cruz","Cotoca","Escuela Col. San Marcos",109,2,0,0,38,26,8,3,0,186,1,14,201,224,0.204,0.897
"24376","Santa Cruz","Cotoca","Escuela Col. San Marcos",102,1,0,1,46,26,12,2,0,190,3,16,209,229,0.242,0.913
"24377","Santa Cruz","Cotoca","Escuela Col. San Marcos",70,1,1,0,78,42,16,1,0,209,2,3,214,236,0.373,0.907
"24378","Santa Cruz","Cotoca","Escuela Col. San Marcos",90,0,1,0,61,27,12,3,2,196,4,6,206,222,0.311,0.928
"24379","Santa Cruz","Cotoca","Escuela Col. San Marcos",64,0,0,0,80,31,10,1,0,186,4,12,202,227,0.43,0.89
"24380","Santa Cruz","Cotoca","Colegio Nal. Benemeritos de La Patria",130,0,0,0,44,14,19,2,0,209,0,5,214,235,0.211,0.911
"24381","Santa Cruz","Cotoca","Colegio Nal. Benemeritos de La Patria",114,0,0,0,46,25,6,1,0,192,2,3,197,224,0.24,0.879
"24382","Santa Cruz","Cotoca","Colegio Nal. Benemeritos de La Patria",120,0,0,0,42,19,4,2,0,187,2,8,197,228,0.225,0.864
"24383","Santa Cruz","Cotoca","Colegio Nal. Benemeritos de La Patria",96,1,2,1,60,24,19,2,0,205,4,10,219,231,0.293,0.948
"24384","Santa Cruz","Cotoca","Colegio Nal. Benemeritos de La Patria",89,0,1,0,57,29,13,2,1,192,2,11,205,226,0.297,0.907
"24385","Santa Cruz","Cotoca","Colegio Nal. Benemeritos de La Patria",105,3,0,2,63,12,9,1,1,196,3,8,207,234,0.321,0.885
"24386","Santa Cruz","Cotoca","Colegio Nal. Benemeritos de La Patria",99,2,0,1,58,18,13,1,2,194,0,9,203,230,0.299,0.883
"24387","Santa Cruz","Cotoca","Colegio Nal. Benemeritos de La Patria",93,1,0,0,62,29,10,1,0,196,3,8,207,229,0.316,0.904
"24388","Santa Cruz","Cotoca","Colegio Nal. Benemeritos de La Patria",111,1,0,0,46,21,12,3,0,194,3,7,204,228,0.237,0.895
"24389","Santa Cruz","Cotoca","Colegio Nal. Benemeritos de La Patria",144,1,1,0,27,20,4,0,0,197,1,1,199,225,0.137,0.884
"24390","Santa Cruz","Cotoca","Colegio Nal. Benemeritos de La Patria",82,1,1,1,76,8,26,0,0,195,3,8,206,233,0.39,0.884
"24391","Santa Cruz","Cotoca","Colegio Nal. Benemeritos de La Patria",87,2,0,0,40,23,9,3,0,164,3,43,210,234,0.244,0.897
"24392","Santa Cruz","Cotoca","Colegio Nal. Benemeritos de La Patria",124,1,0,2,41,28,11,0,0,207,1,6,214,232,0.198,0.922
"24393","Santa Cruz","Cotoca","Colegio Nal. Benemeritos de La Patria",108,1,2,0,54,29,8,1,1,204,5,6,215,235,0.265,0.915
"24394","Santa Cruz","Cotoca","Colegio Nal. Benemeritos de La Patria",127,0,0,0,36,28,5,1,1,198,3,4,205,230,0.182,0.891
"24395","Santa Cruz","Cotoca","Colegio Nal. Benemeritos de La Patria",109,2,0,0,59,25,13,2,1,211,1,2,214,236,0.28,0.907
"24396","Santa Cruz","Cotoca","Colegio Nal. Benemeritos de La Patria",105,0,0,0,53,20,11,6,0,195,2,10,207,231,0.272,0.896
"24397","Santa Cruz","Cotoca","Colegio Nal. Benemeritos de La Patria",95,0,0,1,42,25,20,2,1,186,3,6,195,228,0.226,0.855
"24398","Santa Cruz","Cotoca","Colegio Nal. Benemeritos de La Patria",128,0,0,0,23,18,18,1,1,189,1,10,200,225,0.122,0.889
"24399","Santa Cruz","Cotoca","Colegio Nal. Benemeritos de La Patria",130,0,0,1,48,18,4,2,1,204,1,6,211,230,0.235,0.917
"24400","Santa Cruz","Cotoca","Colegio Nal. Benemeritos de La Patria",100,0,0,3,57,17,16,0,0,193,2,5,200,227,0.295,0.881
"24401","Santa Cruz","Cotoca","Escuela Callejas",96,2,0,1,35,32,17,2,0,185,2,9,196,226,0.189,0.867
"24402","Santa Cruz","Cotoca","Escuela Callejas",99,1,0,0,48,30,12,1,0,191,1,8,200,228,0.251,0.877
"24403","Santa Cruz","Cotoca","Escuela Callejas",108,0,0,1,41,28,15,3,0,196,3,12,211,231,0.209,0.913
"24404","Santa Cruz","Cotoca","Escuela Callejas",104,0,0,2,40,31,14,2,0,193,0,0,193,224,0.207,0.862
"24405","Santa Cruz","Cotoca","Escuela Callejas",102,1,0,1,45,37,17,0,0,203,2,3,208,235,0.222,0.885
"24406","Santa Cruz","Cotoca","Escuela Callejas",121,0,1,0,45,28,8,1,0,204,0,5,209,229,0.221,0.913
"24407","Santa Cruz","Cotoca","U.E. San Antonio",91,1,0,2,61,31,22,3,1,212,3,8,223,239,0.288,0.933
"24408","Santa Cruz","Cotoca","U.E. San Antonio",87,1,0,1,67,25,26,3,0,210,2,6,218,236,0.319,0.924
"24409","Santa Cruz","Cotoca","U.E. Patuju",99,0,0,1,54,38,15,0,0,207,1,7,215,235,0.261,0.915
"24410","Santa Cruz","Cotoca","U.E. Patuju",96,1,0,0,64,33,20,2,1,217,0,7,224,236,0.295,0.949
"24411","Santa Cruz","Cotoca","U.E. Patuju",102,1,0,1,63,25,18,5,1,216,1,2,219,236,0.292,0.928
"24412","Santa Cruz","Cotoca","Escuela Rep. de Mexico",17,0,0,0,155,7,19,1,0,199,5,3,207,235,0.779,0.881
"24413","Santa Cruz","Cotoca","Escuela Rep. de Mexico",15,1,0,0,145,6,20,2,1,190,5,12,207,237,0.763,0.873
"24414","Santa Cruz","Cotoca","Escuela Rep. de Mexico",14,1,0,1,134,10,33,3,0,196,3,5,204,232,0.684,0.879
"24415","Santa Cruz","Cotoca","Escuela Rep. de Mexico",23,0,0,1,140,10,21,1,0,196,8,3,207,230,0.714,0.9
"24416","Santa Cruz","Cotoca","Escuela Rep. de Mexico",32,2,0,1,136,11,20,1,0,203,6,6,215,230,0.67,0.935
"24417","Santa Cruz","Cotoca","Escuela Rep. de Mexico",18,0,2,1,133,5,31,0,2,192,1,4,197,232,0.693,0.849
"24418","Santa Cruz","Cotoca","Escuela Rep. de Mexico",11,0,1,0,144,8,19,1,0,184,5,8,197,227,0.783,0.868
"24419","Santa Cruz","Cotoca","Escuela Rep. de Mexico",15,2,0,0,149,6,17,1,1,191,4,4,199,232,0.78,0.858
"24420","Santa Cruz","Cotoca","Escuela Rep. de Mexico",17,0,0,1,136,13,26,3,1,197,2,7,206,233,0.69,0.884
"24421","Santa Cruz","Cotoca","Escuela Rep. de Mexico",22,0,0,1,130,17,23,3,0,196,3,4,203,234,0.663,0.868
"24422","Santa Cruz","Cotoca","Escuela Jesus Gomez",84,1,0,3,76,24,5,2,0,195,5,8,208,230,0.39,0.904
"24423","Santa Cruz","Cotoca","Escuela Jesus Gomez",73,1,1,0,113,17,4,2,0,211,3,3,217,232,0.536,0.935
"24424","Santa Cruz","Cotoca","Escuela Jesus Gomez",89,0,0,1,73,29,4,1,0,197,2,8,207,232,0.371,0.892
"24425","Santa Cruz","Cotoca","Escuela Jesus Gomez",99,1,0,2,47,23,7,2,0,181,4,14,199,231,0.26,0.861
"24426","Santa Cruz","Cotoca","Escuela Jesus Gomez",81,2,0,2,75,26,4,1,2,193,4,8,205,229,0.389,0.895
"24427","Santa Cruz","Cotoca","Escuela Jesus Gomez",92,0,0,0,68,22,3,2,0,187,10,11,208,230,0.364,0.904
"24428","Santa Cruz","Cotoca","Escuela Demetrio Añez",104,1,0,0,60,17,11,2,0,195,0,4,199,228,0.308,0.873
"24429","Santa Cruz","Cotoca","Escuela Demetrio Añez",79,0,0,1,81,17,9,0,1,188,2,7,197,225,0.431,0.876
"24430","Santa Cruz","Cotoca","Escuela Demetrio Añez",76,0,0,1,84,15,33,2,0,211,3,5,219,231,0.398,0.948
"24431","Santa Cruz","Cotoca","Escuela Demetrio Añez",68,1,0,1,104,9,20,1,0,204,1,2,207,227,0.51,0.912
"24432","Santa Cruz","Cotoca","Escuela Demetrio Añez",57,1,2,1,107,9,11,1,0,189,1,5,195,226,0.566,0.863
"24433","Santa Cruz","Cotoca","Escuela Demetrio Añez",75,0,0,1,85,18,12,2,0,193,2,6,201,225,0.44,0.893
"24434","Santa Cruz","Cotoca","Escuela Demetrio Añez",52,0,0,2,111,12,15,1,0,193,4,4,201,227,0.575,0.885
"24435","Santa Cruz","Cotoca","Escuela Demetrio Añez",83,2,0,0,57,25,31,1,0,199,4,8,211,224,0.286,0.942
"24436","Santa Cruz","Cotoca","Escuela Demetrio Añez",59,1,1,0,97,17,9,1,0,185,5,8,198,225,0.524,0.88
"24437","Santa Cruz","Cotoca","Escuela Demetrio Añez",86,1,0,1,58,18,21,6,2,193,2,5,200,224,0.301,0.893
"24438","Santa Cruz","Cotoca","Escuela Demetrio Añez",90,0,0,1,71,20,18,1,0,201,1,1,203,229,0.353,0.886
"24439","Santa Cruz","Cotoca","Escuela Demetrio Añez",105,0,1,1,27,36,24,5,0,199,1,9,209,230,0.136,0.909
"24440","Santa Cruz","Cotoca","Escuela Demetrio Añez",62,0,0,0,75,15,29,0,0,181,2,6,189,214,0.414,0.883
"24441","Santa Cruz","Cotoca","Unidad Educativa Fidel Saucedo",75,0,1,0,76,36,14,2,1,205,5,7,217,234,0.371,0.927
"24442","Santa Cruz","Cotoca","Unidad Educativa Fidel Saucedo",73,1,0,2,89,29,11,1,0,206,8,16,230,230,0.432,1
"24443","Santa Cruz","Cotoca","Unidad Educativa Fidel Saucedo",65,1,0,0,79,41,7,4,1,198,5,3,206,230,0.399,0.896
"24444","Santa Cruz","Cotoca","Unidad Educativa Fidel Saucedo",80,4,0,2,62,38,5,0,0,191,7,6,204,230,0.325,0.887
"24445","Santa Cruz","Cotoca","Unidad Educativa Fidel Saucedo",82,1,1,0,82,24,3,8,0,201,1,10,212,229,0.408,0.926
"24446","Santa Cruz","Cotoca","Unidad Educativa Fidel Saucedo",74,1,0,0,75,37,9,3,0,199,3,8,210,230,0.377,0.913
"24447","Santa Cruz","Cotoca","Unidad Educativa Fidel Saucedo",63,0,0,1,85,39,6,1,0,195,3,7,205,225,0.436,0.911
"24448","Santa Cruz","Cotoca","Esc. Mariscal Antonio Jose De Sucre",111,0,0,2,38,38,9,5,1,204,3,4,211,228,0.186,0.925
"24449","Santa Cruz","Cotoca","Esc. Mariscal Antonio Jose De Sucre",87,0,0,1,66,36,13,0,3,206,1,2,209,233,0.32,0.897
"24450","Santa Cruz","Cotoca","Esc. Mariscal Antonio Jose De Sucre",82,0,0,1,70,28,18,1,1,201,1,9,211,235,0.348,0.898
"24451","Santa Cruz","Cotoca","Esc. Mariscal Antonio Jose De Sucre",106,0,0,1,68,22,9,0,2,208,0,9,217,233,0.327,0.931
"24452","Santa Cruz","Cotoca","Esc. Mariscal Antonio Jose De Sucre",110,1,0,0,55,27,17,2,0,212,7,11,230,230,0.259,1
"24453","Santa Cruz","Cotoca","Esc. Mariscal Antonio Jose De Sucre",110,0,0,0,57,35,6,1,3,212,1,2,215,233,0.269,0.923
"24454","Santa Cruz","Cotoca","Esc. Mariscal Antonio Jose De Sucre",102,1,0,0,34,30,5,1,1,174,0,6,180,191,0.195,0.942
"24455","Santa Cruz","Cotoca","Escuela U.E Club Social 24 de Septiembre",85,1,1,1,69,34,9,3,0,203,1,5,209,230,0.34,0.909
"24456","Santa Cruz","Cotoca","Escuela U.E Club Social 24 de Septiembre",88,1,4,1,65,33,13,1,1,207,1,5,213,235,0.314,0.906
"24457","Santa Cruz","Cotoca","Escuela U.E Club Social 24 de Septiembre",74,2,1,0,73,26,18,1,1,196,2,8,206,231,0.372,0.892
"24458","Santa Cruz","Cotoca","Escuela U.E Club Social 24 de Septiembre",72,1,0,0,70,21,21,1,2,188,2,10,200,227,0.372,0.881
"24459","Santa Cruz","Cotoca","Escuela U.E Club Social 24 de Septiembre",62,1,1,1,84,29,22,1,1,202,3,5,210,226,0.416,0.929
"24460","Santa Cruz","Cotoca","Escuela U.E Club Social 24 de Septiembre",83,1,1,1,72,30,13,1,0,202,2,4,208,231,0.356,0.9
"24461","Santa Cruz","Cotoca","Escuela U.E Club Social 24 de Septiembre",59,1,1,1,103,21,22,0,0,208,3,5,216,232,0.495,0.931
"24462","Santa Cruz","Cotoca","Escuela U.E Club Social 24 de Septiembre",94,3,1,0,58,24,15,1,1,197,0,12,209,234,0.294,0.893
"24463","Santa Cruz","Cotoca","Escuela U.E Club Social 24 de Septiembre",78,3,1,1,65,29,18,0,0,195,0,6,201,235,0.333,0.855
"24464","Santa Cruz","Cotoca","Escuela U.E Club Social 24 de Septiembre",86,1,3,0,68,28,16,3,1,206,2,7,215,234,0.33,0.919
"24465","Santa Cruz","Cotoca","Escuela U.E Club Social 24 de Septiembre",83,0,0,1,70,30,12,0,0,196,2,7,205,233,0.357,0.88
"24466","Santa Cruz","Cotoca","Escuela U.E Club Social 24 de Septiembre",77,0,0,0,42,26,17,1,1,164,3,35,202,231,0.256,0.874
"24467","Santa Cruz","Cotoca","Escuela U.E Club Social 24 de Septiembre",58,0,1,3,65,54,14,2,0,197,21,1,219,234,0.33,0.936
"24468","Santa Cruz","Cotoca","Escuela U.E Club Social 24 de Septiembre",60,0,0,2,83,23,17,3,2,190,0,2,192,208,0.437,0.923
"24469","Santa Cruz","Cotoca","U. E. Ciudadela Nueva Jerusalén",63,1,0,0,98,37,14,2,2,217,4,8,229,238,0.452,0.962
"24470","Santa Cruz","Cotoca","U. E. Ciudadela Nueva Jerusalén",83,1,0,0,85,32,19,2,0,222,3,5,230,236,0.383,0.975
"24471","Santa Cruz","Cotoca","U. E. Ciudadela Nueva Jerusalén",98,1,2,0,74,26,14,3,0,218,2,4,224,238,0.339,0.941
"24472","Santa Cruz","Cotoca","U. E. Ciudadela Nueva Jerusalén",85,2,1,0,81,29,13,1,2,214,0,10,224,238,0.379,0.941
"24473","Santa Cruz","Cotoca","U. E. Ciudadela Nueva Jerusalén",70,2,0,0,106,21,6,0,0,205,1,10,216,221,0.517,0.977
"24474","Santa Cruz","Cotoca","Escuela Unidad Educativa Oscar Alfaro",14,1,0,0,160,11,14,4,0,204,2,9,215,238,0.784,0.903
"24475","Santa Cruz","Cotoca","Escuela Unidad Educativa Oscar Alfaro",12,0,0,1,175,4,16,1,0,209,3,3,215,232,0.837,0.927
"24476","Santa Cruz","Cotoca","Escuela Unidad Educativa Oscar Alfaro",13,1,0,0,154,5,21,0,2,196,3,7,206,232,0.786,0.888
"24477","Santa Cruz","Cotoca","Escuela Unidad Educativa Oscar Alfaro",15,0,0,0,162,4,14,0,0,195,0,6,201,231,0.831,0.87
"24478","Santa Cruz","Cotoca","Escuela Unidad Educativa Oscar Alfaro",20,0,1,0,157,10,16,0,2,206,1,5,212,234,0.762,0.906
"24479","Santa Cruz","Cotoca","Escuela Unidad Educativa Oscar Alfaro",26,0,1,0,161,9,15,0,0,212,3,4,219,238,0.759,0.92
"24480","Santa Cruz","Cotoca","Escuela Unidad Educativa Oscar Alfaro",21,2,0,1,166,10,9,0,0,209,1,4,214,233,0.794,0.918
"24481","Santa Cruz","Cotoca","Escuela Unidad Educativa Oscar Alfaro",12,1,1,0,172,4,19,0,0,209,3,6,218,232,0.823,0.94
"24482","Santa Cruz","Cotoca","Escuela Unidad Educativa Oscar Alfaro",16,1,0,2,161,6,15,2,1,204,2,6,212,233,0.789,0.91
"24483","Santa Cruz","Cotoca","Escuela Unidad Educativa Oscar Alfaro",20,0,0,0,159,14,13,1,1,208,2,8,218,232,0.764,0.94
"24484","Santa Cruz","Cotoca","Escuela German Busch",35,2,0,1,133,14,22,1,0,208,1,0,209,230,0.639,0.909
"24485","Santa Cruz","Cotoca","Escuela German Busch",24,1,0,0,143,15,25,1,0,209,5,5,219,231,0.684,0.948
"24486","Santa Cruz","Cotoca","Escuela German Busch",32,0,0,1,130,22,24,0,1,210,3,3,216,229,0.619,0.943
"24487","Santa Cruz","Cotoca","Escuela German Busch",45,0,1,0,139,8,20,0,0,213,1,5,219,232,0.653,0.944
"24488","Santa Cruz","Cotoca","Escuela German Busch",44,0,0,0,123,17,17,5,1,207,2,5,214,237,0.594,0.903
"24489","Santa Cruz","Cotoca","Escuela German Busch",39,0,0,0,133,14,22,0,3,211,4,5,220,234,0.63,0.94
"24490","Santa Cruz","Cotoca","Escuela German Busch",21,0,1,0,115,12,36,1,0,186,1,1,188,205,0.618,0.917
"24491","Santa Cruz","Cotoca","Esc. Gremial Cortez",61,0,0,1,91,27,16,2,0,198,4,9,211,231,0.46,0.913
"24492","Santa Cruz","Cotoca","Esc. Gremial Cortez",45,0,0,0,80,40,14,1,0,180,10,20,210,225,0.444,0.933
"24493","Santa Cruz","Cotoca","Esc. Gremial Cortez",65,1,2,0,84,35,9,1,0,197,8,10,215,233,0.426,0.923
"24494","Santa Cruz","Cotoca","U.E. 6 de Agosto",52,0,0,0,128,9,20,0,0,209,3,6,218,237,0.612,0.92
"24495","Santa Cruz","Cotoca","U.E. 6 de Agosto",56,0,0,0,121,12,20,0,0,209,5,10,224,238,0.579,0.941
"24496","Santa Cruz","Porongo","Esc. Fray Santiago De Rivero",99,2,5,0,48,35,9,0,1,199,3,5,207,226,0.241,0.916
"24497","Santa Cruz","Porongo","Esc. Fray Santiago De Rivero",111,3,0,0,41,33,5,1,0,194,1,4,199,223,0.211,0.892
"24498","Santa Cruz","Porongo","Esc. Fray Santiago De Rivero",93,0,2,2,47,37,5,1,3,190,4,5,199,218,0.247,0.913
"24499","Santa Cruz","Porongo","Esc. Fray Santiago De Rivero",94,1,1,1,61,28,4,1,0,191,4,4,199,219,0.319,0.909
"24500","Santa Cruz","Porongo","Esc. Fray Santiago De Rivero",99,0,3,1,62,32,5,0,2,204,2,4,210,227,0.304,0.925
"24501","Santa Cruz","Porongo","Esc. Fray Santiago De Rivero",114,1,0,0,42,30,8,1,0,196,1,1,198,219,0.214,0.904
"24502","Santa Cruz","Porongo","Esc. Fray Santiago De Rivero",74,0,1,0,81,22,14,0,0,192,3,8,203,226,0.422,0.898
"24503","Santa Cruz","Porongo","Esc. Fray Santiago De Rivero",126,0,2,1,38,24,7,0,0,198,1,6,205,222,0.192,0.923
"24504","Santa Cruz","Porongo","Esc. Fray Santiago De Rivero",90,3,2,0,49,39,4,0,1,188,10,11,209,225,0.261,0.929
"24505","Santa Cruz","Porongo","Esc. Fray Santiago De Rivero",81,1,0,2,59,40,6,3,0,192,4,4,200,223,0.307,0.897
"24506","Santa Cruz","Porongo","Esc. Fray Santiago De Rivero",104,0,0,0,59,24,1,1,1,190,6,9,205,226,0.311,0.907
"24507","Santa Cruz","Porongo","Esc. Fray Santiago De Rivero",90,1,0,0,58,31,7,0,0,187,3,6,196,220,0.31,0.891
"24508","Santa Cruz","Porongo","Esc. Fray Santiago De Rivero",99,0,1,0,60,41,4,2,0,207,2,7,216,227,0.29,0.952
"24509","Santa Cruz","Porongo","Esc. Jose Parada Laguindey",81,0,1,1,48,41,2,2,2,178,0,4,182,213,0.27,0.854
"24510","Santa Cruz","Porongo","Esc. Jose Parada Laguindey",81,0,0,1,52,39,7,2,1,183,2,7,192,222,0.284,0.865
"24511","Santa Cruz","Porongo","Esc. Jose Parada Laguindey",85,1,0,2,54,35,2,0,1,180,1,9,190,221,0.3,0.86
"24512","Santa Cruz","Porongo","Escuela Central Aniceto Parada Roca",131,0,0,1,19,28,9,0,0,188,3,5,196,227,0.101,0.863
"24513","Santa Cruz","Porongo","Esc. Nucleo Central Santa Fe",4,0,0,1,171,20,5,0,0,201,4,3,208,229,0.851,0.908
"24514","Santa Cruz","Porongo","Esc. Nucleo Central Santa Fe",4,2,0,1,123,19,4,0,0,153,4,3,160,182,0.804,0.879
"24515","Santa Cruz","Porongo","Escuela Tarumatu",111,0,0,1,26,31,6,2,0,177,2,9,188,208,0.147,0.904
"24516","Santa Cruz","Porongo","Escuela Tarumatu",119,1,1,1,31,23,2,2,1,181,4,9,194,220,0.171,0.882
"24517","Santa Cruz","Porongo","Escuela San Lorenzo",141,0,0,0,32,23,7,0,0,203,2,4,209,233,0.158,0.897
"24518","Santa Cruz","Porongo","Escuela San Lorenzo",125,0,0,2,28,39,3,3,0,200,2,7,209,227,0.14,0.921
"24519","Santa Cruz","Porongo","Escuela San Lorenzo",135,0,0,2,31,26,8,1,0,203,1,3,207,230,0.153,0.9
"24520","Santa Cruz","Porongo","Escuela San Lorenzo",128,0,0,1,34,31,3,0,0,197,2,8,207,233,0.173,0.888
"24521","Santa Cruz","Porongo","Escuela San Lorenzo",131,2,0,0,26,35,8,3,0,205,1,4,210,232,0.127,0.905
"24522","Santa Cruz","Porongo","Escuela San Lorenzo",134,0,1,0,22,36,3,0,0,196,0,3,199,226,0.112,0.881
"24523","Santa Cruz","Porongo","Escuela San Lorenzo",136,0,0,1,36,19,4,0,1,197,3,6,206,229,0.183,0.9
"24524","Santa Cruz","Porongo","Escuela San Lorenzo",142,1,0,1,26,32,4,0,0,206,3,1,210,231,0.126,0.909
"24525","Santa Cruz","Porongo","Escuela San Lorenzo",125,0,0,0,26,18,4,0,0,173,0,2,175,189,0.15,0.926
"24526","Santa Cruz","Porongo","Escuela Central Sombrerito",68,0,0,2,74,38,8,2,1,193,2,10,205,224,0.383,0.915
"24527","Santa Cruz","Porongo","Escuela 6 de Agosto",161,0,0,1,8,18,2,2,0,192,1,3,196,224,0.042,0.875
"24528","Santa Cruz","Porongo","Escuela 6 de Agosto",140,0,0,0,15,27,3,2,1,188,2,1,191,228,0.08,0.838
"24529","Santa Cruz","Porongo","Escuela 6 de Agosto",165,0,0,2,8,22,1,0,0,198,0,3,201,243,0.04,0.827
"24530","Santa Cruz","Porongo","Escuela Puerto Ichilo",111,0,0,1,45,31,4,3,0,195,3,10,208,230,0.231,0.904
"24531","Santa Cruz","Porongo","Escuela Puerto Ichilo",98,2,1,2,44,32,8,1,2,190,0,2,192,231,0.232,0.831
"24532","Santa Cruz","Porongo","Urubo Open Mall",168,0,0,2,12,13,2,2,0,199,0,1,200,228,0.06,0.877
"24533","Santa Cruz","Porongo","Urubo Open Mall",171,0,0,4,11,8,2,2,0,198,0,1,199,225,0.056,0.884
"24534","Santa Cruz","Porongo","Urubo Open Mall",172,0,0,1,11,13,2,0,0,199,0,1,200,222,0.055,0.901
"24535","Santa Cruz","Porongo","Urubo Open Mall",168,0,0,1,6,16,2,3,0,196,0,1,197,230,0.031,0.857
"24536","Santa Cruz","Porongo","Urubo Open Mall",160,1,0,1,12,19,4,0,0,197,1,2,200,229,0.061,0.873
"24537","Santa Cruz","Porongo","Urubo Open Mall",177,0,0,0,9,13,1,1,0,201,0,2,203,224,0.045,0.906
"24538","Santa Cruz","La Guardia","Esc. Tomas Jose Morales",96,0,1,0,73,15,6,0,1,192,1,4,197,227,0.38,0.868
"24539","Santa Cruz","La Guardia","Esc. Tomas Jose Morales",105,0,1,2,56,13,6,0,0,183,4,7,194,222,0.306,0.874
"24540","Santa Cruz","La Guardia","Esc. Tomas Jose Morales",90,0,1,0,80,12,11,1,1,196,3,7,206,231,0.408,0.892
"24541","Santa Cruz","La Guardia","Esc. Tomas Jose Morales",89,1,1,2,65,13,9,0,1,181,3,7,191,217,0.359,0.88
"24542","Santa Cruz","La Guardia","Esc. Tomas Jose Morales",76,0,1,0,96,12,11,1,0,197,1,7,205,229,0.487,0.895
"24543","Santa Cruz","La Guardia","Esc. Tomas Jose Morales",94,1,0,1,58,16,13,2,2,187,5,4,196,219,0.31,0.895
"24544","Santa Cruz","La Guardia","Esc. Tomas Jose Morales",96,2,0,1,69,22,7,3,2,202,1,7,210,220,0.342,0.955
"24545","Santa Cruz","La Guardia","Esc. Tomas Jose Morales",91,1,0,0,56,20,6,1,2,177,3,9,189,224,0.316,0.844
"24546","Santa Cruz","La Guardia","Esc. Tomas Jose Morales",104,0,0,2,60,18,6,2,1,193,1,8,202,223,0.311,0.906
"24547","Santa Cruz","La Guardia","Esc. Tomas Jose Morales",81,0,1,0,93,11,11,0,1,198,0,10,208,233,0.47,0.893
"24548","Santa Cruz","La Guardia","Esc. Tomas Jose Morales",88,0,1,1,68,26,12,2,0,198,1,5,204,231,0.343,0.883
"24549","Santa Cruz","La Guardia","Esc. Tomas Jose Morales",111,1,0,0,45,20,5,0,0,182,2,4,188,217,0.247,0.866
"24550","Santa Cruz","La Guardia","Esc. Tomas Jose Morales",102,0,0,0,69,8,8,1,0,188,2,13,203,223,0.367,0.91
"24551","Santa Cruz","La Guardia","Esc. Tomas Jose Morales",123,0,1,1,34,17,12,1,0,189,2,11,202,225,0.18,0.898
"24552","Santa Cruz","La Guardia","Esc. Tomas Jose Morales",86,1,0,1,70,16,7,1,1,183,2,9,194,222,0.383,0.874
"24553","Santa Cruz","La Guardia","Esc. Tomas Jose Morales",120,0,0,0,44,21,3,0,0,188,2,4,194,221,0.234,0.878
"24554","Santa Cruz","La Guardia","Esc. Tomas Jose Morales",111,0,0,2,57,17,5,0,0,192,3,9,204,227,0.297,0.899
"24555","Santa Cruz","La Guardia","Esc. Tomas Jose Morales",115,0,0,1,45,17,4,0,2,184,0,5,189,220,0.245,0.859
"24556","Santa Cruz","La Guardia","Esc. Tomas Jose Morales",103,1,0,0,76,13,8,2,1,204,2,5,211,230,0.373,0.917
"24557","Santa Cruz","La Guardia","Esc. Tomas Jose Morales",101,0,0,0,58,20,12,1,2,194,1,10,205,226,0.299,0.907
"24558","Santa Cruz","La Guardia","Esc. Jose Vicente Soliz Y Ramos",94,0,0,0,75,13,12,0,0,194,1,7,202,226,0.387,0.894
"24559","Santa Cruz","La Guardia","Esc. Jose Vicente Soliz Y Ramos",90,0,0,1,74,19,9,0,1,194,0,5,199,229,0.381,0.869
"24560","Santa Cruz","La Guardia","Esc. Jose Vicente Soliz Y Ramos",77,2,1,0,80,15,11,2,3,191,4,3,198,226,0.419,0.876
"24561","Santa Cruz","La Guardia","Esc. Jose Vicente Soliz Y Ramos",77,0,2,0,87,11,11,0,2,190,0,8,198,223,0.458,0.888
"24562","Santa Cruz","La Guardia","Esc. Jose Vicente Soliz Y Ramos",98,0,2,3,75,15,9,0,1,203,4,8,215,234,0.369,0.919
"24563","Santa Cruz","La Guardia","Esc. Jose Vicente Soliz Y Ramos",80,2,0,1,81,19,12,1,2,198,2,7,207,233,0.409,0.888
"24564","Santa Cruz","La Guardia","Esc. Jose Vicente Soliz Y Ramos",78,1,0,1,69,20,12,1,0,182,4,7,193,226,0.379,0.854
"24565","Santa Cruz","La Guardia","Esc. Jose Vicente Soliz Y Ramos",101,0,0,2,62,18,15,0,1,199,3,9,211,228,0.312,0.925
"24566","Santa Cruz","La Guardia","Esc. Jose Vicente Soliz Y Ramos",86,0,1,1,91,21,8,0,0,208,5,2,215,232,0.438,0.927
"24567","Santa Cruz","La Guardia","Esc. Jose Vicente Soliz Y Ramos",71,1,0,0,87,18,16,0,2,195,0,5,200,228,0.446,0.877
"24568","Santa Cruz","La Guardia","Esc. Jose Vicente Soliz Y Ramos",107,0,0,0,59,18,2,2,1,189,1,10,200,230,0.312,0.87
"24569","Santa Cruz","La Guardia","Esc. Jose Vicente Soliz Y Ramos",103,0,0,1,76,21,8,1,0,210,1,9,220,231,0.362,0.952
"24570","Santa Cruz","La Guardia","Esc. Jose Vicente Soliz Y Ramos",100,1,1,0,70,13,9,0,1,195,3,8,206,224,0.359,0.92
"24571","Santa Cruz","La Guardia","Esc. Jose Vicente Soliz Y Ramos",95,0,0,0,64,22,8,1,1,191,2,10,203,228,0.335,0.89
"24572","Santa Cruz","La Guardia","Esc. Jose Vicente Soliz Y Ramos",98,0,1,2,59,16,12,0,0,188,1,9,198,223,0.314,0.888
"24573","Santa Cruz","La Guardia","Esc. Jose Vicente Soliz Y Ramos",83,2,0,1,76,23,11,2,2,200,4,5,209,230,0.38,0.909
"24574","Santa Cruz","La Guardia","Esc. Jose Vicente Soliz Y Ramos",89,0,0,1,63,23,9,0,0,185,3,6,194,232,0.341,0.836
"24575","Santa Cruz","La Guardia","Esc. Jose Vicente Soliz Y Ramos",87,1,0,0,62,16,15,1,1,183,2,7,192,224,0.339,0.857
"24576","Santa Cruz","La Guardia","U.E. Nataniel Garcia Chavez",87,0,0,1,70,22,15,1,1,197,2,7,206,236,0.355,0.873
"24577","Santa Cruz","La Guardia","U.E. Nataniel Garcia Chavez",101,1,1,0,58,24,16,1,2,204,1,6,211,234,0.284,0.902
"24578","Santa Cruz","La Guardia","U.E. Nataniel Garcia Chavez",101,1,0,1,65,26,10,0,1,205,2,10,217,236,0.317,0.919
"24579","Santa Cruz","La Guardia","U.E. Nacional La Guardia",66,1,1,0,105,12,20,0,0,205,2,8,215,237,0.512,0.907
"24580","Santa Cruz","La Guardia","U.E. Nacional La Guardia",65,0,0,1,106,22,11,1,1,207,0,3,210,237,0.512,0.886
"24581","Santa Cruz","La Guardia","U.E. Nacional La Guardia",80,1,0,0,82,19,19,0,1,202,3,8,213,237,0.406,0.899
"24582","Santa Cruz","La Guardia","U.E. Nacional La Guardia",77,2,0,3,85,19,23,0,0,209,1,3,213,237,0.407,0.899
"24583","Santa Cruz","La Guardia","U.E. Nacional La Guardia",93,1,0,1,64,18,14,0,1,192,3,15,210,238,0.333,0.882
"24584","Santa Cruz","La Guardia","U.E. Nacional La Guardia",70,0,0,0,77,25,16,0,1,189,1,17,207,239,0.407,0.866
"24585","Santa Cruz","La Guardia","U.E. Nacional La Guardia",69,0,0,1,85,20,15,0,1,191,1,5,197,227,0.445,0.868
"24586","Santa Cruz","La Guardia","Esc. Jose Miguel De Velasco",79,1,2,0,69,25,3,0,0,179,4,6,189,218,0.385,0.867
"24587","Santa Cruz","La Guardia","Esc. Jose Miguel De Velasco",76,0,0,0,59,15,10,1,1,162,3,4,169,183,0.364,0.923
"24588","Santa Cruz","La Guardia","Esc. Central Basilio",35,3,0,2,117,24,12,0,0,193,3,6,202,232,0.606,0.871
"24589","Santa Cruz","La Guardia","Esc. Central Basilio",36,3,0,1,120,18,12,1,0,191,2,10,203,226,0.628,0.898
"24590","Santa Cruz","La Guardia","Esc. Central Basilio",48,0,3,1,107,10,19,0,1,189,1,10,200,234,0.566,0.855
"24591","Santa Cruz","La Guardia","Esc. Central Basilio",40,1,1,0,108,17,19,0,1,187,6,14,207,230,0.578,0.9
"24592","Santa Cruz","La Guardia","Esc. Central Basilio",60,0,1,2,110,5,10,0,1,189,5,8,202,224,0.582,0.902
"24593","Santa Cruz","La Guardia","Esc. Central Basilio",46,1,2,0,96,22,22,1,0,190,6,6,202,229,0.505,0.882
"24594","Santa Cruz","La Guardia","Esc. Central Basilio",35,1,0,0,109,29,15,0,1,190,2,9,201,223,0.574,0.901
"24595","Santa Cruz","La Guardia","Esc. Central Basilio",52,2,1,0,102,14,18,0,3,192,3,10,205,229,0.531,0.895
"24596","Santa Cruz","La Guardia","Esc. Central Basilio",39,0,1,1,100,8,18,1,0,168,3,3,174,188,0.595,0.926
"24597","Santa Cruz","La Guardia","Escuela Jose Gil Soruco",81,2,0,1,67,33,8,0,2,194,4,11,209,227,0.345,0.921
"24598","Santa Cruz","La Guardia","Escuela Jose Gil Soruco",68,0,0,0,78,44,6,0,0,196,3,9,208,226,0.398,0.92
"24599","Santa Cruz","La Guardia","Escuela Jose Gil Soruco",80,0,1,0,75,32,7,3,2,200,6,10,216,231,0.375,0.935
"24600","Santa Cruz","La Guardia","Escuela Jose Gil Soruco",71,0,0,2,76,29,3,1,0,182,5,7,194,223,0.418,0.87
"24601","Santa Cruz","La Guardia","Escuela Jose Gil Soruco",63,3,0,2,71,45,10,0,1,195,2,11,208,229,0.364,0.908
"24602","Santa Cruz","La Guardia","Esc. Nataniel Verdugez",79,0,0,0,86,13,19,1,0,198,1,6,205,226,0.434,0.907
"24603","Santa Cruz","La Guardia","Esc. Nataniel Verdugez",88,0,1,1,71,12,7,0,2,182,0,9,191,220,0.39,0.868
"24604","Santa Cruz","La Guardia","Esc. Nataniel Verdugez",88,0,1,1,60,12,16,2,0,180,0,11,191,223,0.333,0.857
"24605","Santa Cruz","La Guardia","Esc. Nataniel Verdugez",100,0,0,2,72,14,8,1,0,197,2,4,203,229,0.365,0.886
"24606","Santa Cruz","La Guardia","Esc. Nataniel Verdugez",94,1,1,1,60,21,11,3,0,192,0,6,198,224,0.312,0.884
"24607","Santa Cruz","La Guardia","Esc. Nataniel Verdugez",85,1,1,0,91,12,4,0,1,195,1,11,207,234,0.467,0.885
"24608","Santa Cruz","La Guardia","Esc. Nataniel Verdugez",84,0,0,1,58,18,15,0,1,177,1,7,185,221,0.328,0.837
"24609","Santa Cruz","La Guardia","Esc. Nataniel Verdugez",76,0,0,0,77,16,12,1,2,184,2,9,195,233,0.418,0.837
"24610","Santa Cruz","La Guardia","Esc. Nataniel Verdugez",77,0,0,1,85,11,19,0,1,194,0,6,200,224,0.438,0.893
"24611","Santa Cruz","La Guardia","Esc. Nataniel Verdugez",67,0,2,1,78,24,20,1,1,194,1,4,199,225,0.402,0.884
"24612","Santa Cruz","La Guardia","Esc. Nataniel Verdugez",95,2,0,1,70,19,12,0,1,200,0,4,204,225,0.35,0.907
"24613","Santa Cruz","La Guardia","Esc. Nataniel Verdugez",90,1,0,1,88,14,12,1,0,207,1,1,209,234,0.425,0.893
"24614","Santa Cruz","La Guardia","Esc. Nataniel Verdugez",91,1,2,1,83,12,12,0,2,204,2,5,211,232,0.407,0.909
"24615","Santa Cruz","La Guardia","Esc. Nataniel Verdugez",78,0,0,0,72,19,11,0,0,180,1,9,190,221,0.4,0.86
"24616","Santa Cruz","La Guardia","Esc. Nataniel Verdugez",89,1,0,1,71,20,6,2,1,191,0,4,195,226,0.372,0.863
"24617","Santa Cruz","La Guardia","Esc. Nataniel Verdugez",104,0,3,1,48,18,8,0,0,182,2,7,191,220,0.264,0.868
"24618","Santa Cruz","La Guardia","Esc. Nataniel Verdugez",74,1,0,1,91,14,17,0,1,199,4,8,211,229,0.457,0.921
"24619","Santa Cruz","La Guardia","Esc. Nataniel Verdugez",103,0,1,0,64,19,11,0,0,198,2,7,207,228,0.323,0.908
"24620","Santa Cruz","La Guardia","Esc. Nataniel Verdugez",92,0,1,1,67,16,13,0,0,190,3,9,202,227,0.353,0.89
"24621","Santa Cruz","La Guardia","Esc. Nataniel Verdugez",46,0,0,1,124,11,15,1,3,201,1,2,204,222,0.617,0.919
"24622","Santa Cruz","La Guardia","Esc. Nataniel Verdugez",88,0,0,0,70,20,18,3,0,199,1,3,203,225,0.352,0.902
"24623","Santa Cruz","La Guardia","Esc. Nataniel Verdugez",87,1,0,0,79,19,13,0,0,199,2,3,204,235,0.397,0.868
"24624","Santa Cruz","La Guardia","Esc. Nataniel Verdugez",95,0,0,4,49,29,11,0,0,188,1,4,193,231,0.261,0.835
"24625","Santa Cruz","La Guardia","Esc. Nataniel Verdugez",79,0,0,0,81,17,16,0,0,193,2,8,203,226,0.42,0.898
"24626","Santa Cruz","La Guardia","Esc. Nataniel Verdugez",79,0,0,1,85,9,9,1,1,185,0,8,193,226,0.459,0.854
"24627","Santa Cruz","La Guardia","Esc. Nataniel Verdugez",95,1,0,2,63,16,14,1,0,192,1,4,197,227,0.328,0.868
"24628","Santa Cruz","La Guardia","Esc. Nataniel Verdugez",87,0,1,1,81,17,14,1,1,203,1,4,208,232,0.399,0.897
"24629","Santa Cruz","La Guardia","Esc. Nataniel Verdugez",53,0,1,0,92,13,25,0,1,185,1,5,191,224,0.497,0.853
"24630","Santa Cruz","La Guardia","Esc. Nataniel Verdugez",105,0,0,0,42,25,10,1,0,183,0,6,189,219,0.23,0.863
"24631","Santa Cruz","La Guardia","Esc. Nataniel Verdugez",107,0,0,1,66,13,15,0,0,202,2,7,211,227,0.327,0.93
"24632","Santa Cruz","La Guardia","Esc. Nataniel Verdugez",95,1,0,0,63,19,9,2,0,189,0,7,196,224,0.333,0.875
"24633","Santa Cruz","La Guardia","Esc. Nataniel Verdugez",89,2,1,0,82,14,8,1,0,197,1,8,206,225,0.416,0.916
"24634","Santa Cruz","La Guardia","Esc. Nataniel Verdugez",98,1,1,3,61,13,10,0,1,188,0,7,195,225,0.324,0.867
"24635","Santa Cruz","La Guardia","Esc. Nataniel Verdugez",121,1,1,2,44,20,9,0,0,198,0,3,201,225,0.222,0.893
"24636","Santa Cruz","La Guardia","Esc. Nataniel Verdugez",81,0,1,0,71,18,17,2,0,190,2,6,198,223,0.374,0.888
"24637","Santa Cruz","La Guardia","Esc. Nataniel Verdugez",92,2,0,2,56,22,5,1,0,180,2,11,193,230,0.311,0.839
"24638","Santa Cruz","La Guardia","Esc. Nataniel Verdugez",92,0,0,0,64,22,9,0,0,187,1,5,193,224,0.342,0.862
"24639","Santa Cruz","La Guardia","Esc. Nataniel Verdugez",89,1,0,0,81,19,15,0,0,205,1,4,210,232,0.395,0.905
"24640","Santa Cruz","La Guardia","Esc. Nataniel Verdugez",73,0,1,1,89,18,22,0,1,205,2,5,212,228,0.434,0.93
"24641","Santa Cruz","La Guardia","Esc. U. Educ. Alfredo Ibañez Franco",84,0,1,0,84,12,15,0,3,199,1,6,206,236,0.422,0.873
"24642","Santa Cruz","La Guardia","Esc. U. Educ. Alfredo Ibañez Franco",100,0,0,0,74,17,13,0,0,204,1,5,210,236,0.363,0.89
"24643","Santa Cruz","La Guardia","Esc. U. Educ. Alfredo Ibañez Franco",99,0,0,0,67,22,9,0,1,198,0,7,205,231,0.338,0.887
"24644","Santa Cruz","La Guardia","Esc. U. Educ. Alfredo Ibañez Franco",87,1,2,0,90,5,13,1,1,200,2,5,207,234,0.45,0.885
"24645","Santa Cruz","La Guardia","Esc. U. Educ. Alfredo Ibañez Franco",89,0,0,0,76,13,22,1,2,203,2,8,213,235,0.374,0.906
"24646","Santa Cruz","La Guardia","Esc. U. Educ. Alfredo Ibañez Franco",73,0,0,0,98,18,19,1,1,210,1,2,213,233,0.467,0.914
"24647","Santa Cruz","La Guardia","Esc. U. Educ. Alfredo Ibañez Franco",82,0,0,0,80,21,18,0,1,202,0,11,213,235,0.396,0.906
"24648","Santa Cruz","La Guardia","Esc. U. Educ. Alfredo Ibañez Franco",104,0,0,0,72,17,13,1,0,207,0,7,214,235,0.348,0.911
"24649","Santa Cruz","La Guardia","Esc. U. Educ. Alfredo Ibañez Franco",88,1,0,1,95,11,8,0,0,204,1,3,208,230,0.466,0.904
"24650","Santa Cruz","La Guardia","Esc. U. Educ. Alfredo Ibañez Franco",102,0,0,0,60,16,13,0,0,191,1,7,199,228,0.314,0.873
"24651","Santa Cruz","La Guardia","Esc. U. Educ. Alfredo Ibañez Franco",99,0,0,0,69,15,18,1,0,202,1,6,209,234,0.342,0.893
"24652","Santa Cruz","La Guardia","Esc. U. Educ. Alfredo Ibañez Franco",88,0,0,0,70,29,8,0,0,195,0,8,203,231,0.359,0.879
"24653","Santa Cruz","La Guardia","Esc. U. Educ. Alfredo Ibañez Franco",63,1,0,0,97,13,23,0,0,197,3,7,207,231,0.492,0.896
"24654","Santa Cruz","La Guardia","Esc. U. Educ. Alfredo Ibañez Franco",83,0,2,0,75,17,17,1,0,195,1,9,205,229,0.385,0.895
"24655","Santa Cruz","La Guardia","Esc. U. Educ. Alfredo Ibañez Franco",89,0,0,1,62,18,15,2,1,188,3,12,203,229,0.33,0.886
"24656","Santa Cruz","La Guardia","Esc. U. Educ. Alfredo Ibañez Franco",89,0,0,1,77,14,11,0,3,195,1,4,200,230,0.395,0.87
"24657","Santa Cruz","La Guardia","Esc. U. Educ. Alfredo Ibañez Franco",111,0,0,0,58,14,14,0,1,198,0,14,212,233,0.293,0.91
"24658","Santa Cruz","La Guardia","Esc. U. Educ. Alfredo Ibañez Franco",73,1,1,0,90,12,22,0,3,202,2,5,209,231,0.446,0.905
"24659","Santa Cruz","La Guardia","Esc. U. Educ. Alfredo Ibañez Franco",102,0,0,0,62,19,6,1,1,191,2,6,199,228,0.325,0.873
"24660","Santa Cruz","La Guardia","Esc. U. Educ. Alfredo Ibañez Franco",83,0,0,1,80,11,13,0,1,189,1,9,199,230,0.423,0.865
"24661","Santa Cruz","La Guardia","Esc. U. Educ. Alfredo Ibañez Franco",89,0,0,1,68,23,15,1,0,197,0,6,203,231,0.345,0.879
"24662","Santa Cruz","La Guardia","Esc. U. Educ. Alfredo Ibañez Franco",91,0,0,1,71,18,16,0,0,197,2,9,208,228,0.36,0.912
"24663","Santa Cruz","La Guardia","Esc. U. Educ. Alfredo Ibañez Franco",94,0,0,1,72,19,14,1,1,202,1,4,207,228,0.356,0.908
"24664","Santa Cruz","La Guardia","Esc. U. Educ. Alfredo Ibañez Franco",86,0,0,0,89,17,13,0,1,206,1,4,211,234,0.432,0.902
"24665","Santa Cruz","La Guardia","Cambao",93,0,1,2,70,21,14,2,0,203,1,8,212,237,0.345,0.895
"24666","Santa Cruz","La Guardia","Cambao",81,1,0,1,83,15,26,0,1,208,0,10,218,237,0.399,0.92
"24667","Santa Cruz","La Guardia","Cambao",72,1,0,0,109,14,16,1,2,215,1,6,222,236,0.507,0.941
"24668","Santa Cruz","La Guardia","Cambao",88,1,0,0,90,11,21,1,1,213,0,10,223,237,0.423,0.941
"24669","Santa Cruz","La Guardia","Cambao",91,1,0,0,79,20,17,2,0,210,1,7,218,237,0.376,0.92
"24670","Santa Cruz","La Guardia","Cambao",85,3,1,1,84,16,18,0,0,208,4,6,218,238,0.404,0.916
"24671","Santa Cruz","La Guardia","Cambao",76,0,0,2,105,10,22,0,0,215,3,7,225,238,0.488,0.945
"24672","Santa Cruz","La Guardia","Cambao",89,0,0,0,77,24,25,0,0,215,1,4,220,237,0.358,0.928
"24673","Santa Cruz","La Guardia","Cambao",100,0,0,1,84,13,13,1,1,213,0,6,219,237,0.394,0.924
"24674","Santa Cruz","La Guardia","Cambao",79,0,0,0,92,8,17,1,4,201,1,8,210,222,0.458,0.946
"24675","Santa Cruz","La Guardia","Madre Teresa De Calcuta",73,1,1,2,103,19,18,0,0,217,4,7,228,240,0.475,0.95
"24676","Santa Cruz","La Guardia","Madre Teresa De Calcuta",77,0,1,0,104,11,16,1,1,211,2,9,222,234,0.493,0.949
"24677","Santa Cruz","La Guardia","Madre Teresa De Calcuta",74,0,1,0,103,15,15,0,0,208,1,22,231,240,0.495,0.963
"24678","Santa Cruz","La Guardia","Madre Teresa De Calcuta",89,1,0,0,89,18,13,0,2,212,3,7,222,235,0.42,0.945
"24679","Santa Cruz","La Guardia","Madre Teresa De Calcuta",71,0,1,1,116,15,15,1,2,222,3,10,235,240,0.523,0.979
"24680","Santa Cruz","La Guardia","Madre Teresa De Calcuta",71,1,0,0,106,17,16,2,0,213,3,6,222,239,0.498,0.929
"24681","Santa Cruz","La Guardia","Madre Teresa De Calcuta",77,1,1,0,89,17,21,5,0,211,2,12,225,236,0.422,0.953
"24682","Santa Cruz","La Guardia","Madre Teresa De Calcuta",85,0,1,0,97,23,13,0,0,219,1,9,229,236,0.443,0.97
"24683","Santa Cruz","La Guardia","Madre Teresa De Calcuta",70,0,1,2,112,16,9,2,0,212,3,7,222,233,0.528,0.953
"24684","Santa Cruz","La Guardia","U.E. Ayacucho",61,0,1,0,117,19,22,1,0,221,5,3,229,235,0.529,0.974
"24685","Santa Cruz","La Guardia","U.E. Ayacucho",75,0,0,0,105,23,15,1,1,220,2,2,224,239,0.477,0.937
"24686","Santa Cruz","La Guardia","U.E. Ayacucho",55,1,0,0,87,22,15,0,1,181,1,1,183,193,0.481,0.948
"24687","Santa Cruz","La Guardia","U.E. Cordecruz",114,0,1,0,73,9,21,1,1,220,0,5,225,240,0.332,0.938
"24688","Santa Cruz","La Guardia","U.E. Cordecruz",109,2,1,0,61,20,14,1,0,208,3,4,215,234,0.293,0.919
"24689","Santa Cruz","La Guardia","U.E. Cordecruz",96,1,1,0,68,15,29,0,1,211,2,6,219,234,0.322,0.936
"24690","Santa Cruz","La Guardia","U.E. Cordecruz",97,1,0,0,86,12,15,0,0,211,1,4,216,237,0.408,0.911
"24691","Santa Cruz","La Guardia","U.E. Cordecruz",112,0,0,2,54,16,22,5,0,211,0,4,215,239,0.256,0.9
"24692","Santa Cruz","La Guardia","U.E. Cordecruz",96,2,0,1,71,21,24,0,0,215,0,3,218,236,0.33,0.924
"24693","Santa Cruz","La Guardia","U.E. Cordecruz",87,1,0,0,83,13,13,0,0,197,1,5,203,236,0.421,0.86
"24694","Santa Cruz","La Guardia","U.E. Cordecruz",107,1,0,0,70,14,12,0,2,206,0,7,213,239,0.34,0.891
"24695","Santa Cruz","La Guardia","U.E. Cordecruz",100,0,0,1,82,12,20,0,1,216,0,4,220,240,0.38,0.917
"24696","Santa Cruz","La Guardia","U.E. Cordecruz",114,0,0,1,46,19,18,3,0,201,1,8,210,234,0.229,0.897
"24697","Santa Cruz","La Guardia","U.E. Cordecruz",117,0,1,2,52,16,19,0,1,208,2,10,220,237,0.25,0.928
"24698","Santa Cruz","La Guardia","U.E. Cordecruz",92,0,0,3,68,17,19,1,3,203,3,7,213,238,0.335,0.895
"24699","Santa Cruz","La Guardia","U.E. Jose Mariano Serrano",76,1,0,1,97,9,22,0,0,206,1,9,216,239,0.471,0.904
"24700","Santa Cruz","La Guardia","U.E. Jose Mariano Serrano",75,0,0,1,90,12,31,1,2,212,3,8,223,238,0.425,0.937
"24701","Santa Cruz","La Guardia","U.E. Jose Mariano Serrano",62,0,1,0,122,14,21,2,0,222,0,3,225,240,0.55,0.938
"24702","Santa Cruz","La Guardia","U.E. Jose Mariano Serrano",69,0,0,0,112,12,20,4,2,219,2,5,226,235,0.511,0.962
"24703","Santa Cruz","La Guardia","U.E. Jose Mariano Serrano",58,0,0,0,132,8,13,1,2,214,3,7,224,239,0.617,0.937
"24704","Santa Cruz","La Guardia","U.E. Jose Mariano Serrano",73,1,0,0,109,14,24,0,1,222,2,3,227,240,0.491,0.946
"24705","Santa Cruz","La Guardia","U.E. Jose Mariano Serrano",79,0,0,0,82,31,15,0,1,208,1,10,219,238,0.394,0.92
"24706","Santa Cruz","La Guardia","U.E. Jose Mariano Serrano",87,0,1,0,82,14,25,0,2,211,4,5,220,239,0.389,0.921
"24707","Santa Cruz","La Guardia","U.E. Jose Mariano Serrano",85,0,0,0,91,19,19,0,0,214,0,4,218,235,0.425,0.928
"24708","Santa Cruz","La Guardia","U.E. Jose Mariano Serrano",54,0,1,0,76,7,20,0,0,158,2,7,167,174,0.481,0.96
"24709","Santa Cruz","La Guardia","U.E. Tomas Morales Padilla",59,1,0,0,139,10,13,2,0,224,1,3,228,239,0.621,0.954
"24710","Santa Cruz","La Guardia","U.E. Tomas Morales Padilla",48,1,1,0,131,17,23,1,0,222,0,7,229,239,0.59,0.958
"24711","Santa Cruz","La Guardia","U.E. Tomas Morales Padilla",66,1,1,1,118,17,13,0,0,217,1,8,226,236,0.544,0.958
"24712","Santa Cruz","La Guardia","U.E. Tomas Morales Padilla",49,0,0,1,132,20,19,0,1,222,2,6,230,235,0.595,0.979
"24713","Santa Cruz","La Guardia","U.E. Tomas Morales Padilla",45,0,0,1,147,7,16,0,5,221,12,5,238,238,0.665,1
"24714","Santa Cruz","La Guardia","U.E. Tomas Morales Padilla",45,1,1,1,122,16,20,1,0,207,3,11,221,239,0.589,0.925
"24715","Santa Cruz","La Guardia","U.E. Tomas Morales Padilla",44,0,0,1,142,16,19,0,0,222,1,6,229,238,0.64,0.962
"24716","Santa Cruz","La Guardia","U.E. Tomas Morales Padilla",64,0,2,0,116,17,15,0,0,214,3,5,222,239,0.542,0.929
"24717","Santa Cruz","La Guardia","U.E. Tomas Morales Padilla",61,1,0,1,115,14,22,0,1,215,2,8,225,236,0.535,0.953
"24718","Santa Cruz","La Guardia","U.E. Tomas Morales Padilla",45,0,1,0,134,10,13,0,2,205,1,10,216,226,0.654,0.956
"24719","Santa Cruz","La Guardia","U.E.  Juan Pablo II EPDB",105,0,0,0,90,8,16,0,2,221,2,5,228,239,0.407,0.954
"24720","Santa Cruz","La Guardia","U.E.  Juan Pablo II EPDB",97,0,0,2,80,21,17,1,0,218,1,4,223,237,0.367,0.941
"24721","Santa Cruz","La Guardia","U.E. Hna. Maria del Pilar Mateo",117,1,1,0,58,21,15,0,0,213,1,6,220,235,0.272,0.936
"24722","Santa Cruz","La Guardia","Escuela Nueva Esperanza",115,0,0,1,42,23,12,2,0,195,2,7,204,234,0.215,0.872
"24723","Santa Cruz","La Guardia","Escuela Nueva Esperanza",117,1,0,0,43,13,10,0,1,185,3,6,194,226,0.232,0.858
"24724","Santa Cruz","La Guardia","Escuela Nueva Esperanza",115,0,2,1,56,20,6,0,0,200,1,7,208,229,0.28,0.908
"24725","Santa Cruz","La Guardia","Escuela Nueva Esperanza",86,0,0,2,60,16,13,0,0,177,3,14,194,229,0.339,0.847
"24726","Santa Cruz","La Guardia","Escuela Nueva Esperanza",108,0,0,0,60,22,13,0,0,203,0,6,209,231,0.296,0.905
"24727","Santa Cruz","La Guardia","Escuela Nueva Esperanza",110,1,2,3,38,20,18,3,0,195,2,8,205,225,0.195,0.911
"24728","Santa Cruz","La Guardia","Escuela Nueva Esperanza",104,1,0,0,63,13,8,1,1,191,0,4,195,227,0.33,0.859
"24729","Santa Cruz","La Guardia","Escuela Nueva Esperanza",111,1,0,0,51,14,12,3,0,192,2,7,201,224,0.266,0.897
"24730","Santa Cruz","La Guardia","Escuela Nueva Esperanza",122,0,1,0,47,15,12,0,1,198,1,3,202,226,0.237,0.894
"24731","Santa Cruz","La Guardia","Escuela Nueva Esperanza",118,1,0,0,57,15,13,1,0,205,3,5,213,234,0.278,0.91
"24732","Santa Cruz","La Guardia","Escuela Nueva Esperanza",101,0,0,0,63,21,10,2,0,197,0,8,205,225,0.32,0.911
"24733","Santa Cruz","La Guardia","Escuela Nueva Esperanza",99,2,0,0,64,17,12,0,0,194,2,2,198,229,0.33,0.865
"24734","Santa Cruz","La Guardia","Escuela Nueva Esperanza",138,0,1,1,34,18,8,1,1,202,2,4,208,233,0.168,0.893
"24735","Santa Cruz","La Guardia","Escuela Nueva Esperanza",104,0,0,0,44,21,14,1,2,186,1,12,199,221,0.237,0.9
"24736","Santa Cruz","La Guardia","Escuela Nueva Esperanza",106,1,0,1,45,17,15,1,1,187,2,2,191,229,0.241,0.834
"24737","Santa Cruz","La Guardia","Escuela Nueva Esperanza",95,1,0,0,72,15,17,0,0,200,1,6,207,227,0.36,0.912
"24738","Santa Cruz","La Guardia","U.E. Integracion de las Americas",33,1,0,0,168,3,7,0,0,212,2,3,217,235,0.792,0.923
"24739","Santa Cruz","La Guardia","U.E. Integracion de las Americas",27,0,0,1,175,6,11,0,1,221,1,3,225,238,0.792,0.945
"24740","Santa Cruz","La Guardia","U.E. Integracion de las Americas",26,0,0,0,173,7,13,0,0,219,2,5,226,239,0.79,0.946
"24741","Santa Cruz","La Guardia","U.E. Integracion de las Americas",22,0,4,0,166,6,18,0,1,217,2,7,226,239,0.765,0.946
"24742","Santa Cruz","La Guardia","U.E. Integracion de las Americas",29,0,0,0,153,11,16,0,1,210,3,8,221,237,0.729,0.932
"24743","Santa Cruz","La Guardia","U.E. Integracion de las Americas",27,1,0,0,163,5,15,0,0,211,3,9,223,244,0.773,0.914
"24744","Santa Cruz","La Guardia","U.E. Barrio Lindo",66,1,0,0,111,21,17,0,2,218,1,0,219,237,0.509,0.924
"24745","Santa Cruz","La Guardia","U.E. Barrio Lindo",62,0,1,1,104,19,22,1,1,211,1,10,222,234,0.493,0.949
"24746","Santa Cruz","La Guardia","U.E. Barrio Lindo",70,1,0,0,113,18,14,0,1,217,2,6,225,234,0.521,0.962
"24747","Santa Cruz","La Guardia","U.E. Barrio Lindo",69,1,0,2,108,17,13,1,0,211,3,15,229,240,0.512,0.954
"24748","Santa Cruz","La Guardia","U.E. Barrio Lindo",70,2,0,2,115,20,11,1,0,221,1,4,226,237,0.52,0.954
"24749","Santa Cruz","La Guardia","U.E. Barrio Lindo",79,0,0,1,92,15,26,0,1,214,3,9,226,238,0.43,0.95
"24750","Santa Cruz","La Guardia","U.E. Barrio Lindo",68,0,0,1,106,21,16,1,0,213,3,8,224,236,0.498,0.949
"24751","Santa Cruz","La Guardia","U.E. Barrio Lindo",78,2,0,2,95,28,10,0,1,216,3,7,226,237,0.44,0.954
"24752","Santa Cruz","La Guardia","U.E. Barrio Lindo",70,3,0,1,114,12,16,0,1,217,1,3,221,235,0.525,0.94
"24753","Santa Cruz","La Guardia","U.E. Angel Foianini Banzer II",97,0,1,0,70,20,20,0,0,208,2,8,218,237,0.337,0.92
"24754","Santa Cruz","La Guardia","U.E. Angel Foianini Banzer II",69,0,2,0,86,24,15,1,1,198,0,8,206,239,0.434,0.862
"24755","Santa Cruz","La Guardia","U.E. Angel Foianini Banzer II",72,0,0,0,53,21,14,2,0,162,1,5,168,187,0.327,0.898
"24756","Santa Cruz","La Guardia","U.E. Hernando Zanabria",64,1,2,1,113,17,16,1,0,215,1,14,230,238,0.526,0.966
"24757","Santa Cruz","La Guardia","U.E. Hernando Zanabria",50,1,2,1,127,11,19,0,0,211,2,8,221,236,0.602,0.936
"24758","Santa Cruz","La Guardia","U.E. Hernando Zanabria",64,1,0,1,113,20,13,0,1,213,2,12,227,239,0.531,0.95
"24759","Santa Cruz","La Guardia","U.E. Hernando Zanabria",50,0,1,0,80,15,12,0,1,159,4,5,168,178,0.503,0.944
"24760","Santa Cruz","La Guardia","U.E. Luz De Esperanza",138,0,0,0,44,15,13,1,1,212,2,4,218,235,0.208,0.928
"24761","Santa Cruz","La Guardia","U.E. Luz De Esperanza",128,0,0,0,67,10,15,0,0,220,0,4,224,238,0.305,0.941
"24762","Santa Cruz","La Guardia","U.E. Bicentenario Arco Iris",103,0,0,1,67,23,18,2,0,214,1,4,219,233,0.313,0.94
"24763","Santa Cruz","La Guardia","U.E. Bicentenario Arco Iris",102,1,1,2,64,19,14,0,0,203,4,14,221,236,0.315,0.936
"24764","Santa Cruz","La Guardia","U.E. Bicentenario Arco Iris",104,0,0,1,64,17,21,1,0,208,4,9,221,236,0.308,0.936
"24765","Santa Cruz","La Guardia","Esc. Juana Azurduy De Padilla",90,1,0,1,67,22,10,0,0,191,3,7,201,231,0.351,0.87
"24766","Santa Cruz","La Guardia","Esc. Juana Azurduy De Padilla",97,0,1,1,77,18,4,2,2,202,0,10,212,234,0.381,0.906
"24767","Santa Cruz","La Guardia","Esc. Juana Azurduy De Padilla",75,0,0,0,80,24,17,0,0,196,4,8,208,231,0.408,0.9
"24768","Santa Cruz","La Guardia","Esc. Juana Azurduy De Padilla",94,0,1,1,73,18,10,1,2,200,0,11,211,231,0.365,0.913
"24769","Santa Cruz","La Guardia","Esc. Juana Azurduy De Padilla",82,0,0,1,83,24,11,0,5,206,1,8,215,230,0.403,0.935
"24770","Santa Cruz","La Guardia","Esc. Juana Azurduy De Padilla",79,0,0,0,85,14,11,0,1,190,4,9,203,227,0.447,0.894
"24771","Santa Cruz","La Guardia","Esc. Juana Azurduy De Padilla",96,0,0,1,67,18,11,0,1,194,2,14,210,230,0.345,0.913
"24772","Santa Cruz","La Guardia","Esc. Juana Azurduy De Padilla",106,0,0,0,55,16,15,1,0,193,3,6,202,232,0.285,0.871
"24773","Santa Cruz","La Guardia","Esc. Juana Azurduy De Padilla",105,0,0,1,51,18,14,1,1,191,1,6,198,230,0.267,0.861
"24774","Santa Cruz","La Guardia","Esc. Juana Azurduy De Padilla",124,0,0,1,55,13,12,3,1,209,1,4,214,236,0.263,0.907
"24775","Santa Cruz","La Guardia","Esc. Juana Azurduy De Padilla",91,1,0,0,59,20,26,2,0,199,1,8,208,226,0.296,0.92
"24776","Santa Cruz","La Guardia","Esc. Juana Azurduy De Padilla",95,0,0,2,61,15,17,1,0,191,2,18,211,229,0.319,0.921
"24777","Santa Cruz","La Guardia","Esc. Juana Azurduy De Padilla",100,0,1,0,65,16,9,1,1,193,3,6,202,227,0.337,0.89
"24778","Santa Cruz","La Guardia","Esc. Ruben Dario Soliz",98,1,1,1,66,16,16,0,1,200,2,6,208,226,0.33,0.92
"24779","Santa Cruz","La Guardia","Esc. Ruben Dario Soliz",63,1,0,1,72,12,32,2,1,184,1,9,194,222,0.391,0.874
"24780","Santa Cruz","La Guardia","Esc. Ruben Dario Soliz",56,2,1,4,83,12,32,0,0,190,2,6,198,222,0.437,0.892
"24781","Santa Cruz","La Guardia","Esc. Ruben Dario Soliz",66,1,1,1,84,18,20,0,1,192,5,6,203,219,0.438,0.927
"24782","Santa Cruz","La Guardia","Esc. Ruben Dario Soliz",57,2,0,0,71,21,30,0,0,181,5,13,199,225,0.392,0.884
"24783","Santa Cruz","La Guardia","Esc. Ruben Dario Soliz",74,0,0,1,81,12,23,2,1,194,4,7,205,226,0.418,0.907
"24784","Santa Cruz","La Guardia","Esc. Ruben Dario Soliz",62,1,2,1,87,14,21,1,1,190,6,12,208,228,0.458,0.912
"24785","Santa Cruz","La Guardia","Esc. Ruben Dario Soliz",77,0,1,0,73,12,23,2,1,189,2,6,197,229,0.386,0.86
"24786","Santa Cruz","La Guardia","Esc. Ruben Dario Soliz",52,2,0,1,123,7,21,1,0,207,1,3,211,228,0.594,0.925
"24787","Santa Cruz","La Guardia","Esc. Ruben Dario Soliz",57,1,0,1,98,11,13,2,1,184,2,9,195,226,0.533,0.863
"24788","Santa Cruz","La Guardia","Esc. Ruben Dario Soliz",71,1,2,1,71,21,23,1,0,191,6,8,205,227,0.372,0.903
"24789","Santa Cruz","La Guardia","Esc. Ruben Dario Soliz",59,0,1,0,86,12,21,0,3,182,6,8,196,222,0.473,0.883
"24790","Santa Cruz","La Guardia","Esc. Ruben Dario Soliz",47,1,1,0,73,8,26,0,0,156,2,5,163,176,0.468,0.926
"24791","Santa Cruz","La Guardia","Nucleo San Carlos",62,0,1,2,80,27,18,0,2,192,10,12,214,230,0.417,0.93
"24792","Santa Cruz","La Guardia","U.E. Quebrada Seca",101,1,0,0,59,24,12,1,1,199,8,12,219,232,0.296,0.944
"24793","Santa Cruz","La Guardia","Esc. Central Angel Foianini",75,0,0,1,93,14,14,3,1,201,1,5,207,232,0.463,0.892
"24794","Santa Cruz","La Guardia","Esc. Central Angel Foianini",93,0,0,0,77,21,14,1,0,206,3,0,209,226,0.374,0.925
"24795","Santa Cruz","La Guardia","Esc. Central Angel Foianini",75,0,0,0,83,17,17,1,0,193,0,14,207,225,0.43,0.92
"24796","Santa Cruz","La Guardia","Esc. Central Angel Foianini",72,2,0,1,95,15,14,1,2,202,3,3,208,228,0.47,0.912
"24797","Santa Cruz","La Guardia","Esc. Central Angel Foianini",67,0,0,0,103,22,12,1,1,206,2,6,214,231,0.5,0.926
"24798","Santa Cruz","La Guardia","Esc. Central Angel Foianini",76,1,0,0,83,15,14,1,2,192,1,32,225,225,0.432,1
"24799","Santa Cruz","La Guardia","Esc. Central Angel Foianini",90,0,1,2,61,27,10,0,0,191,2,15,208,234,0.319,0.889
"24800","Santa Cruz","La Guardia","Esc. Central Angel Foianini",93,0,0,2,77,18,13,0,0,203,2,7,212,232,0.379,0.914
"24801","Santa Cruz","La Guardia","Esc. Central Angel Foianini",71,0,1,1,79,22,14,0,1,189,0,7,196,225,0.418,0.871
"24802","Santa Cruz","La Guardia","Esc. Central Angel Foianini",77,0,0,0,94,15,18,1,0,205,2,5,212,231,0.459,0.918
"24803","Santa Cruz","La Guardia","Esc. Central Angel Foianini",89,0,0,0,76,20,12,2,1,200,2,7,209,231,0.38,0.905
"24804","Santa Cruz","La Guardia","Esc. Central Angel Foianini",56,1,1,1,111,16,14,1,3,204,2,3,209,235,0.544,0.889
"24805","Santa Cruz","La Guardia","Esc. Central Angel Foianini",102,0,0,1,66,17,16,0,0,202,1,4,207,232,0.327,0.892
"24806","Santa Cruz","La Guardia","Esc. Central Angel Foianini",111,0,0,0,75,21,8,0,0,215,0,6,221,235,0.349,0.94
"24807","Santa Cruz","La Guardia","Esc. Central Angel Foianini",95,1,1,2,79,17,6,1,1,203,5,7,215,230,0.389,0.935
"24808","Santa Cruz","La Guardia","Esc. Central Angel Foianini",82,2,0,0,86,12,17,0,1,200,2,7,209,231,0.43,0.905
"24809","Santa Cruz","La Guardia","Esc. Central Angel Foianini",104,0,1,1,61,16,13,0,2,198,2,9,209,227,0.308,0.921
"24810","Santa Cruz","La Guardia","Esc. Central Angel Foianini",63,1,0,0,116,9,19,0,0,208,2,5,215,231,0.558,0.931
"24811","Santa Cruz","La Guardia","Esc. Central Angel Foianini",95,2,1,2,62,23,7,1,0,193,1,8,202,223,0.321,0.906
"24812","Santa Cruz","La Guardia","Esc. Central Angel Foianini",88,0,0,2,80,25,10,0,1,206,0,6,212,232,0.388,0.914
"24813","Santa Cruz","La Guardia","Esc. Central Angel Foianini",84,0,0,0,85,15,14,0,4,202,0,10,212,235,0.421,0.902
"24814","Santa Cruz","La Guardia","Esc. Central Angel Foianini",89,0,0,1,76,21,11,2,0,200,1,7,208,227,0.38,0.916
"24815","Santa Cruz","La Guardia","Esc. Central Angel Foianini",92,0,1,1,84,15,12,2,1,208,0,4,212,231,0.404,0.918
"24816","Santa Cruz","La Guardia","Esc. Central Angel Foianini",73,1,2,0,83,26,15,1,0,201,4,6,211,233,0.413,0.906
"24817","Santa Cruz","La Guardia","Esc. Central Angel Foianini",90,2,0,0,89,15,10,1,2,209,1,7,217,235,0.426,0.923
"24818","Santa Cruz","La Guardia","Escuela Maestro Pitagoras",56,0,1,0,112,14,28,1,1,213,0,5,218,232,0.526,0.94
"24819","Santa Cruz","La Guardia","Escuela Maestro Pitagoras",64,0,1,1,108,14,15,0,1,204,2,11,217,232,0.529,0.935
"24820","Santa Cruz","La Guardia","Escuela Maestro Pitagoras",69,1,1,1,96,14,19,0,2,203,1,8,212,237,0.473,0.895
"24821","Santa Cruz","La Guardia","Escuela Maestro Pitagoras",78,0,0,1,87,12,14,0,0,192,1,10,203,226,0.453,0.898
"24822","Santa Cruz","La Guardia","Escuela Maestro Pitagoras",64,1,0,1,104,20,13,0,0,203,4,9,216,233,0.512,0.927
"24823","Santa Cruz","La Guardia","Escuela Maestro Pitagoras",56,0,1,2,122,12,15,0,1,209,1,2,212,235,0.584,0.902
"24824","Santa Cruz","La Guardia","Escuela Maestro Pitagoras",41,0,1,1,131,9,22,0,2,207,2,8,217,235,0.633,0.923
"24825","Santa Cruz","La Guardia","Escuela Maestro Pitagoras",58,1,0,0,114,19,21,0,1,214,2,5,221,235,0.533,0.94
"24826","Santa Cruz","La Guardia","Escuela Maestro Pitagoras",67,0,0,0,116,15,15,0,1,214,0,4,218,231,0.542,0.944
"24827","Santa Cruz","La Guardia","Escuela Maestro Pitagoras",70,0,0,0,102,7,20,1,3,203,2,9,214,235,0.502,0.911
"24828","Santa Cruz","La Guardia","Escuela Maestro Pitagoras",72,0,0,1,102,13,22,0,1,211,2,7,220,232,0.483,0.948
"24829","Santa Cruz","La Guardia","Escuela Maestro Pitagoras",62,0,0,0,110,13,22,2,1,210,0,7,217,233,0.524,0.931
"24830","Santa Cruz","La Guardia","Escuela Maestro Pitagoras",57,0,0,0,107,17,22,2,1,206,0,10,216,231,0.519,0.935
"24831","Santa Cruz","La Guardia","Escuela Maestro Pitagoras",64,1,1,0,106,15,8,1,1,197,3,11,211,232,0.538,0.909
"24832","Santa Cruz","La Guardia","Escuela Maestro Pitagoras",50,0,0,2,122,13,28,0,1,216,1,7,224,235,0.565,0.953
"24833","Santa Cruz","La Guardia","Escuela Maestro Pitagoras",35,0,1,1,140,12,21,0,2,212,2,8,222,237,0.66,0.937
"24834","Santa Cruz","La Guardia","Escuela Maestro Pitagoras",42,0,0,0,120,13,26,0,0,201,7,4,212,233,0.597,0.91
"24835","Santa Cruz","La Guardia","Escuela Maestro Pitagoras",64,0,1,2,115,15,11,1,0,209,0,6,215,233,0.55,0.923
"24836","Santa Cruz","La Guardia","Escuela Maestro Pitagoras",76,0,1,0,94,16,14,0,2,203,3,7,213,230,0.463,0.926
"24837","Santa Cruz","La Guardia","Escuela Maestro Pitagoras",45,0,0,1,118,14,21,0,2,201,3,8,212,231,0.587,0.918
"24838","Santa Cruz","La Guardia","Escuela Maestro Pitagoras",60,0,0,2,110,20,12,0,0,204,3,4,211,233,0.539,0.906
"24839","Santa Cruz","La Guardia","Escuela Maestro Pitagoras",63,0,0,1,99,17,19,0,0,199,0,8,207,232,0.497,0.892
"24840","Santa Cruz","La Guardia","Escuela Maestro Pitagoras",37,0,0,1,134,9,28,0,2,211,2,4,217,234,0.635,0.927
"24841","Santa Cruz","La Guardia","Escuela Maestro Pitagoras",64,1,1,0,83,18,33,1,1,202,1,12,215,235,0.411,0.915
"24842","Santa Cruz","La Guardia","Escuela Maestro Pitagoras",76,1,0,0,90,17,25,0,1,210,2,8,220,235,0.429,0.936
"24843","Santa Cruz","La Guardia","Escuela Maestro Pitagoras",58,0,0,1,106,15,14,0,0,194,2,19,215,233,0.546,0.923
"24844","Santa Cruz","La Guardia","Escuela Maestro Pitagoras",65,0,0,0,100,19,15,1,1,201,0,7,208,228,0.498,0.912
"24845","Santa Cruz","La Guardia","Escuela Maestro Pitagoras",57,1,1,0,107,17,15,2,0,200,0,12,212,229,0.535,0.926
"24846","Santa Cruz","La Guardia","Escuela Maestro Pitagoras",61,1,0,1,92,19,25,0,1,200,3,14,217,233,0.46,0.931
"24847","Santa Cruz","La Guardia","Escuela Maestro Pitagoras",74,1,1,1,89,20,15,1,0,202,1,7,210,232,0.441,0.905
"24848","Santa Cruz","La Guardia","Escuela Maestro Pitagoras",55,0,1,2,117,13,16,0,3,207,5,9,221,236,0.565,0.936
"24849","Santa Cruz","La Guardia","Escuela Maestro Pitagoras",64,1,1,0,113,6,12,1,3,201,2,6,209,228,0.562,0.917
"24850","Santa Cruz","La Guardia","Esc. La Peña- Brecha-3",38,0,1,0,122,20,17,1,0,199,6,7,212,229,0.613,0.926
"24851","Santa Cruz","La Guardia","Esc. La Peña- Brecha-3",43,0,1,2,89,33,10,3,0,181,5,9,195,226,0.492,0.863
"24852","Santa Cruz","La Guardia","Esc. La Peña- Brecha-3",48,1,0,1,100,32,12,1,1,196,2,7,205,226,0.51,0.907
"24853","Santa Cruz","La Guardia","Esc. La Peña- Brecha-3",28,0,1,1,95,14,14,1,0,154,3,4,161,182,0.617,0.885
"24854","Santa Cruz","El Torno","Esc. Naciones Unidas",59,0,0,1,111,11,20,0,0,202,3,4,209,225,0.55,0.929
"24855","Santa Cruz","El Torno","Esc. Naciones Unidas",39,0,0,0,113,8,27,1,0,188,1,8,197,220,0.601,0.895
"24856","Santa Cruz","El Torno","Esc. Naciones Unidas",57,0,0,1,96,12,17,1,0,184,3,9,196,220,0.522,0.891
"24857","Santa Cruz","El Torno","Esc. Naciones Unidas",68,3,1,1,89,12,29,1,1,205,1,4,210,231,0.434,0.909
"24858","Santa Cruz","El Torno","Esc. Naciones Unidas",43,3,0,0,95,14,29,0,1,185,6,5,196,220,0.514,0.891
"24859","Santa Cruz","El Torno","Esc. Naciones Unidas",61,0,0,1,89,16,23,0,1,191,3,10,204,232,0.466,0.879
"24860","Santa Cruz","El Torno","Esc. Naciones Unidas",33,0,0,0,124,6,23,0,1,187,2,7,196,226,0.663,0.867
"24861","Santa Cruz","El Torno","Esc. Naciones Unidas",42,0,1,2,114,5,21,0,1,186,3,8,197,224,0.613,0.879
"24862","Santa Cruz","El Torno","Esc. Naciones Unidas",47,3,1,1,107,11,25,1,2,198,1,11,210,228,0.54,0.921
"24863","Santa Cruz","El Torno","Esc. Naciones Unidas",54,0,0,0,97,15,26,0,0,192,4,15,211,229,0.505,0.921
"24864","Santa Cruz","El Torno","Esc. Naciones Unidas",62,1,1,1,90,12,26,0,0,193,2,4,199,231,0.466,0.861
"24865","Santa Cruz","El Torno","Esc. Naciones Unidas",55,1,1,1,111,14,22,0,0,205,3,5,213,229,0.541,0.93
"24866","Santa Cruz","El Torno","Esc. Naciones Unidas",43,1,0,2,95,12,20,0,1,174,6,8,188,224,0.546,0.839
"24867","Santa Cruz","El Torno","Esc. Naciones Unidas",41,2,0,1,99,9,21,1,1,175,8,14,197,224,0.566,0.879
"24868","Santa Cruz","El Torno","Esc. Naciones Unidas",44,0,1,0,110,10,38,1,1,205,3,4,212,228,0.537,0.93
"24869","Santa Cruz","El Torno","Esc. Naciones Unidas",52,2,0,0,104,12,23,0,2,195,3,8,206,228,0.533,0.904
"24870","Santa Cruz","El Torno","Esc. Naciones Unidas",35,2,0,1,116,8,25,1,1,189,4,11,204,225,0.614,0.907
"24871","Santa Cruz","El Torno","Esc. Naciones Unidas",34,3,1,1,114,9,30,2,0,194,4,10,208,225,0.588,0.924
"24872","Santa Cruz","El Torno","Esc. Naciones Unidas",52,0,1,0,99,9,21,1,1,184,3,7,194,222,0.538,0.874
"24873","Santa Cruz","El Torno","Esc. Naciones Unidas",59,0,1,1,97,9,36,1,0,204,5,9,218,227,0.475,0.96
"24874","Santa Cruz","El Torno","Esc. Naciones Unidas",44,1,1,1,106,10,37,0,3,203,6,6,215,230,0.522,0.935
"24875","Santa Cruz","El Torno","Esc. Naciones Unidas",56,1,0,0,79,15,35,1,0,187,6,11,204,227,0.422,0.899
"24876","Santa Cruz","El Torno","Esc. Naciones Unidas",64,1,1,1,91,15,20,2,1,196,1,13,210,230,0.464,0.913
"24877","Santa Cruz","El Torno","Esc. Naciones Unidas",45,0,0,1,111,7,24,1,0,189,1,15,205,233,0.587,0.88
"24878","Santa Cruz","El Torno","Esc. Naciones Unidas",44,2,0,0,116,7,29,2,1,201,3,3,207,227,0.577,0.912
"24879","Santa Cruz","El Torno","Esc. Naciones Unidas",52,0,0,0,97,11,25,0,0,185,3,10,198,223,0.524,0.888
"24880","Santa Cruz","El Torno","Esc. Naciones Unidas",60,1,0,1,79,11,36,1,1,190,7,9,206,227,0.416,0.907
"24881","Santa Cruz","El Torno","Esc. Naciones Unidas",56,0,1,1,82,16,35,1,0,192,1,8,201,223,0.427,0.901
"24882","Santa Cruz","El Torno","Esc. Naciones Unidas",49,1,1,3,115,6,21,0,0,196,2,14,212,232,0.587,0.914
"24883","Santa Cruz","El Torno","Esc. Naciones Unidas",49,1,1,0,109,15,13,0,0,188,3,11,202,227,0.58,0.89
"24884","Santa Cruz","El Torno","Esc. Naciones Unidas",53,0,0,2,86,10,33,0,0,184,4,11,199,225,0.467,0.884
"24885","Santa Cruz","El Torno","Esc. Naciones Unidas",39,1,0,0,120,5,19,0,0,184,6,7,197,224,0.652,0.879
"24886","Santa Cruz","El Torno","Esc. Naciones Unidas",44,1,1,1,110,11,20,0,0,188,5,7,200,226,0.585,0.885
"24887","Santa Cruz","El Torno","Esc. Elena Vaca Antelo",56,0,1,0,98,18,29,0,0,202,6,7,215,232,0.485,0.927
"24888","Santa Cruz","El Torno","Esc. Elena Vaca Antelo",66,0,0,1,94,19,18,0,2,200,2,3,205,234,0.47,0.876
"24889","Santa Cruz","El Torno","Esc. Elena Vaca Antelo",67,0,0,0,72,15,31,1,0,186,6,11,203,224,0.387,0.906
"24890","Santa Cruz","El Torno","Esc. Elena Vaca Antelo",73,0,0,0,84,15,26,1,0,199,0,6,205,223,0.422,0.919
"24891","Santa Cruz","El Torno","Esc. Elena Vaca Antelo",73,0,3,1,73,11,30,0,0,191,5,11,207,228,0.382,0.908
"24892","Santa Cruz","El Torno","Esc. Elena Vaca Antelo",59,2,0,2,86,20,19,1,2,191,3,6,200,232,0.45,0.862
"24893","Santa Cruz","El Torno","Esc. Elena Vaca Antelo",51,0,3,0,103,12,26,0,0,195,4,9,208,226,0.528,0.92
"24894","Santa Cruz","El Torno","Esc. Elena Vaca Antelo",58,0,2,0,96,10,26,1,0,193,2,12,207,230,0.497,0.9
"24895","Santa Cruz","El Torno","Esc. Elena Vaca Antelo",100,1,1,0,60,15,18,0,0,195,2,6,203,230,0.308,0.883
"24896","Santa Cruz","El Torno","Esc. Elena Vaca Antelo",74,1,1,1,82,9,23,0,0,191,1,4,196,224,0.429,0.875
"24897","Santa Cruz","El Torno","Esc. Elena Vaca Antelo",59,1,0,1,93,20,20,0,0,194,6,6,206,228,0.479,0.904
"24898","Santa Cruz","El Torno","Esc. Elena Vaca Antelo",65,2,1,2,86,21,18,0,0,195,3,10,208,227,0.441,0.916
"24899","Santa Cruz","El Torno","Esc. Elena Vaca Antelo",61,1,1,0,90,10,32,0,0,195,2,6,203,224,0.462,0.906
"24900","Santa Cruz","El Torno","Esc. Elena Vaca Antelo",65,1,0,1,87,11,33,0,1,199,3,6,208,228,0.437,0.912
"24901","Santa Cruz","El Torno","Esc. Elena Vaca Antelo",70,0,0,1,93,14,20,0,3,201,2,10,213,229,0.463,0.93
"24902","Santa Cruz","El Torno","Esc. Elena Vaca Antelo",45,1,2,0,109,20,22,0,2,201,6,8,215,230,0.542,0.935
"24903","Santa Cruz","El Torno","Esc. Elena Vaca Antelo",81,0,0,0,79,12,22,0,3,197,1,6,204,230,0.401,0.887
"24904","Santa Cruz","El Torno","Esc. Elena Vaca Antelo",86,1,0,1,75,9,25,0,0,197,3,5,205,225,0.381,0.911
"24905","Santa Cruz","El Torno","Esc. Elena Vaca Antelo",52,2,0,1,102,15,27,1,2,202,3,6,211,232,0.505,0.909
"24906","Santa Cruz","El Torno","Esc. Elena Vaca Antelo",62,0,0,0,76,18,37,0,0,193,3,8,204,225,0.394,0.907
"24907","Santa Cruz","El Torno","Esc. Elena Vaca Antelo",101,0,1,0,64,18,15,0,0,199,3,7,209,232,0.322,0.901
"24908","Santa Cruz","El Torno","Esc. Elena Vaca Antelo",66,2,0,3,79,17,25,0,0,192,4,7,203,226,0.411,0.898
"24909","Santa Cruz","El Torno","Esc. Elena Vaca Antelo",54,1,2,0,101,5,32,0,0,195,3,6,204,226,0.518,0.903
"24910","Santa Cruz","El Torno","Esc. Elena Vaca Antelo",77,0,1,0,76,12,22,3,0,191,4,7,202,228,0.398,0.886
"24911","Santa Cruz","El Torno","Esc. Elena Vaca Antelo",67,0,1,0,90,14,19,0,0,191,3,6,200,225,0.471,0.889
"24912","Santa Cruz","El Torno","Esc. Elena Vaca Antelo",71,0,1,0,90,16,25,0,1,204,1,5,210,226,0.441,0.929
"24913","Santa Cruz","El Torno","Esc. Elena Vaca Antelo",56,2,1,0,94,14,15,0,0,182,5,12,199,229,0.516,0.869
"24914","Santa Cruz","El Torno","Esc. Elena Vaca Antelo",55,2,0,0,94,14,34,0,0,199,6,7,212,230,0.472,0.922
"24915","Santa Cruz","El Torno","Esc. Elena Vaca Antelo",72,0,3,1,86,18,21,0,0,201,3,13,217,232,0.428,0.935
"24916","Santa Cruz","El Torno","Esc. Elena Vaca Antelo",63,0,0,0,86,11,38,1,0,199,4,9,212,226,0.432,0.938
"24917","Santa Cruz","El Torno","Esc. Elena Vaca Antelo",54,0,0,0,110,13,20,1,1,199,5,11,215,247,0.553,0.87
"24918","Santa Cruz","El Torno","U.E. Bicentenario",45,0,1,2,101,6,43,0,1,199,3,4,206,236,0.508,0.873
"24919","Santa Cruz","El Torno","U.E. Bicentenario",48,0,0,1,107,12,34,0,0,202,4,7,213,237,0.53,0.899
"24920","Santa Cruz","El Torno","U.E. Lic. Zachary Macy",51,2,0,0,109,11,26,2,2,203,1,7,211,233,0.537,0.906
"24921","Santa Cruz","El Torno","U.E. Lic. Zachary Macy",40,0,2,0,121,12,22,0,1,198,5,5,208,235,0.611,0.885
"24922","Santa Cruz","El Torno","U.E. Lic. Zachary Macy",51,1,1,1,106,18,19,2,1,200,3,6,209,237,0.53,0.882
"24923","Santa Cruz","El Torno","U.E. Lic. Zachary Macy",31,1,0,0,89,10,22,2,1,156,3,4,163,182,0.571,0.896
"24924","Santa Cruz","El Torno","Esc. Fe y Alegria",44,1,1,2,121,16,11,1,1,198,10,6,214,223,0.611,0.96
"24925","Santa Cruz","El Torno","Esc. Fe y Alegria",38,0,0,0,114,18,11,1,0,182,5,8,195,213,0.626,0.915
"24926","Santa Cruz","El Torno","Escuela Puerto Rico",47,0,1,1,107,15,22,0,1,194,5,9,208,233,0.552,0.893
"24927","Santa Cruz","El Torno","Escuela Puerto Rico",57,0,0,0,100,20,20,0,1,198,1,10,209,225,0.505,0.929
"24928","Santa Cruz","El Torno","Escuela Puerto Rico",53,0,0,0,110,22,23,1,1,210,2,8,220,234,0.524,0.94
"24929","Santa Cruz","El Torno","Escuela Puerto Rico",35,1,0,0,127,16,26,0,1,206,2,4,212,229,0.617,0.926
"24930","Santa Cruz","El Torno","Escuela Puerto Rico",48,1,0,2,120,18,20,1,0,210,1,7,218,232,0.571,0.94
"24931","Santa Cruz","El Torno","Escuela Puerto Rico",33,1,0,0,99,17,25,1,0,176,2,10,188,215,0.562,0.874
"24932","Santa Cruz","El Torno","Escuela Puerto Rico",54,1,1,0,114,14,16,0,1,201,3,9,213,233,0.567,0.914
"24933","Santa Cruz","El Torno","Escuela Puerto Rico",35,1,0,0,120,11,25,1,1,194,6,8,208,230,0.619,0.904
"24934","Santa Cruz","El Torno","Escuela Puerto Rico",44,0,2,0,119,9,20,0,1,195,5,5,205,228,0.61,0.899
"24935","Santa Cruz","El Torno","Escuela Puerto Rico",64,2,1,2,90,9,28,1,1,198,7,7,212,234,0.455,0.906
"24936","Santa Cruz","El Torno","Escuela Puerto Rico",46,1,0,0,118,20,9,0,1,195,5,4,204,230,0.605,0.887
"24937","Santa Cruz","El Torno","Escuela Puerto Rico",51,0,1,0,89,22,24,0,0,187,5,12,204,227,0.476,0.899
"24938","Santa Cruz","El Torno","Escuela Puerto Rico",62,3,0,0,99,14,26,0,0,204,2,6,212,231,0.485,0.918
"24939","Santa Cruz","El Torno","Escuela Puerto Rico",62,0,0,0,96,22,20,0,0,200,5,7,212,231,0.48,0.918
"24940","Santa Cruz","El Torno","Escuela Puerto Rico",43,0,1,3,97,12,21,2,2,181,5,13,199,231,0.536,0.861
"24941","Santa Cruz","El Torno","U.E. Mi Buen Jesús",11,0,0,0,117,9,21,0,0,158,3,12,173,173,0.741,1
"24942","Santa Cruz","El Torno","Esc. Seccional Santa Rita",55,0,0,1,104,11,25,0,0,196,3,2,201,224,0.531,0.897
"24943","Santa Cruz","El Torno","Esc. Seccional Santa Rita",77,0,0,0,91,16,11,0,1,196,5,3,204,227,0.464,0.899
"24944","Santa Cruz","El Torno","Esc. Seccional Santa Rita",51,1,0,1,116,18,20,1,0,208,3,6,217,233,0.558,0.931
"24945","Santa Cruz","El Torno","Esc. Seccional Santa Rita",46,1,0,0,104,19,17,0,1,188,3,18,209,227,0.553,0.921
"24946","Santa Cruz","El Torno","Esc. Seccional Santa Rita",55,1,1,1,108,19,22,0,0,207,5,4,216,232,0.522,0.931
"24947","Santa Cruz","El Torno","Esc. Seccional Santa Rita",49,0,0,1,115,11,19,0,1,196,4,13,213,231,0.587,0.922
"24948","Santa Cruz","El Torno","Esc. Seccional Santa Rita",74,0,1,0,76,17,23,0,0,191,3,10,204,231,0.398,0.883
"24949","Santa Cruz","El Torno","Esc. Seccional Santa Rita",76,0,1,1,81,8,23,1,2,193,4,10,207,225,0.42,0.92
"24950","Santa Cruz","El Torno","Esc. Seccional Santa Rita",102,0,1,0,63,15,18,0,1,200,4,7,211,227,0.315,0.93
"24951","Santa Cruz","El Torno","Esc. Seccional Santa Rita",60,0,1,0,106,14,23,0,0,204,5,3,212,233,0.52,0.91
"24952","Santa Cruz","El Torno","Escuela Andres Ibañez",73,1,0,3,88,18,14,1,1,199,7,9,215,228,0.442,0.943
"24953","Santa Cruz","El Torno","Escuela Andres Ibañez",69,0,1,1,86,17,21,0,1,196,8,15,219,230,0.439,0.952
"24954","Santa Cruz","El Torno","Escuela Andres Ibañez",72,0,0,1,105,9,17,0,1,205,3,9,217,231,0.512,0.939
"24955","Santa Cruz","El Torno","Escuela Andres Ibañez",40,2,1,0,113,21,18,1,0,196,8,9,213,232,0.577,0.918
"24956","Santa Cruz","El Torno","Escuela Andres Ibañez",61,2,1,2,103,12,19,2,0,202,2,5,209,226,0.51,0.925
"24957","Santa Cruz","El Torno","Escuela Andres Ibañez",75,1,0,0,95,17,14,0,0,202,2,3,207,226,0.47,0.916
"24958","Santa Cruz","El Torno","Escuela Andres Ibañez",48,0,0,1,104,14,18,1,1,187,4,17,208,229,0.556,0.908
"24959","Santa Cruz","El Torno","Escuela Andres Ibañez",65,0,0,0,91,12,38,0,0,206,2,3,211,227,0.442,0.93
"24960","Santa Cruz","El Torno","Escuela Andres Ibañez",49,0,0,1,107,15,18,1,0,191,5,9,205,224,0.56,0.915
"24961","Santa Cruz","El Torno","Escuela Andres Ibañez",59,0,2,2,105,18,20,0,0,206,4,1,211,223,0.51,0.946
"24962","Santa Cruz","El Torno","Esc.  29 de Junio",68,1,0,1,96,14,19,1,1,201,4,8,213,226,0.478,0.942
"24963","Santa Cruz","El Torno","Esc.  29 de Junio",63,1,0,0,69,22,17,1,1,174,6,14,194,223,0.397,0.87
"24964","Santa Cruz","El Torno","Esc.  29 de Junio",63,0,1,1,98,19,14,0,0,196,8,8,212,233,0.5,0.91
"24965","Santa Cruz","El Torno","Esc.  29 de Junio",74,1,0,1,90,17,20,1,0,204,4,4,212,228,0.441,0.93
"24966","Santa Cruz","El Torno","Esc.  29 de Junio",67,1,0,0,81,29,14,1,1,194,9,9,212,224,0.418,0.946
"24967","Santa Cruz","El Torno","Esc.  29 de Junio",56,0,1,2,78,25,20,2,2,186,6,9,201,217,0.419,0.926
"24968","Santa Cruz","El Torno","Esc.  29 de Junio",39,1,1,0,113,18,16,3,1,192,6,9,207,222,0.589,0.932
"24969","Santa Cruz","El Torno","Esc.  29 de Junio",69,2,0,1,84,29,5,4,0,194,6,11,211,229,0.433,0.921
"24970","Santa Cruz","El Torno","Esc.  29 de Junio",62,0,1,1,83,23,17,1,0,188,2,10,200,215,0.441,0.93
"24971","Santa Cruz","El Torno","Esc.  29 de Junio",73,1,1,0,80,13,24,0,0,192,5,6,203,222,0.417,0.914
"24972","Santa Cruz","El Torno","Esc.  29 de Junio",79,0,0,0,57,31,16,3,2,188,1,13,202,223,0.303,0.906
"24973","Santa Cruz","El Torno","Esc.  29 de Junio",66,0,0,3,75,26,21,0,1,192,7,7,206,228,0.391,0.904
"24974","Santa Cruz","El Torno","Esc.  29 de Junio",56,1,0,4,100,19,8,0,0,188,10,7,205,226,0.532,0.907
"24975","Santa Cruz","El Torno","Esc. Nucleo San Luis",79,0,0,0,60,17,12,1,1,170,5,10,185,215,0.353,0.86
"24976","Santa Cruz","El Torno","Esc. Nucleo San Luis",58,0,0,1,97,17,13,1,1,188,4,9,201,224,0.516,0.897
"24977","Santa Cruz","El Torno","Esc. Nucleo San Luis",73,0,1,0,59,20,11,2,0,166,7,10,183,212,0.355,0.863
"24978","Santa Cruz","El Torno","Esc. Nucleo San Luis",52,0,0,4,79,25,15,2,0,177,7,17,201,224,0.446,0.897
"24979","Santa Cruz","El Torno","Esc. Nucleo San Luis",77,1,1,0,82,15,13,0,0,189,5,5,199,222,0.434,0.896
"24980","Santa Cruz","El Torno","Esc. Nucleo San Luis",75,0,0,1,75,27,8,1,0,187,4,6,197,225,0.401,0.876
"24981","Santa Cruz","El Torno","Esc. Nucleo San Luis",51,0,0,1,87,24,2,2,1,168,11,5,184,202,0.518,0.911
"24982","Santa Cruz","El Torno","Nucleo Central Taruma",61,1,0,2,94,19,12,2,0,191,9,10,210,229,0.492,0.917
"24983","Santa Cruz","El Torno","Nucleo Central Taruma",46,0,1,0,102,20,21,3,1,194,2,10,206,226,0.526,0.912
"24984","Santa Cruz","El Torno","Nucleo Central Taruma",59,1,1,1,90,34,9,1,1,197,6,10,213,234,0.457,0.91
"24985","Santa Cruz","El Torno","Esc. Alberto Ribera Tapia",61,1,0,2,89,17,11,0,4,185,9,6,200,216,0.481,0.926
"24986","Santa Cruz","El Torno","Esc. Alberto Ribera Tapia",43,2,0,0,93,23,13,2,1,177,9,10,196,231,0.525,0.848
"24987","Santa Cruz","El Torno","Esc. Alberto Ribera Tapia",40,1,0,1,95,17,18,1,2,175,12,9,196,223,0.543,0.879
"24988","Santa Cruz","El Torno","Esc. Alberto Ribera Tapia",52,0,1,1,93,24,18,0,1,190,10,8,208,225,0.489,0.924
"24989","Santa Cruz","El Torno","Esc. Alberto Ribera Tapia",66,0,1,1,85,28,9,1,0,191,3,9,203,224,0.445,0.906
"24990","Santa Cruz","El Torno","Escuela 23 de Marzo",7,1,0,0,182,6,17,1,0,214,4,4,222,229,0.85,0.969
"24991","Santa Cruz","El Torno","Escuela 23 de Marzo",6,1,1,0,170,5,18,0,1,202,4,8,214,229,0.842,0.934
"24992","Santa Cruz","El Torno","Escuela Tiquipaya",28,1,1,0,139,14,18,0,0,201,6,4,211,228,0.692,0.925
"24993","Santa Cruz","El Torno","Escuela Tiquipaya",36,3,1,1,129,10,13,0,0,193,3,11,207,224,0.668,0.924
"24994","Santa Cruz","El Torno","Escuela Tiquipaya",21,3,0,0,143,10,17,0,0,194,5,5,204,224,0.737,0.911
"24995","Santa Cruz","El Torno","Escuela Tiquipaya",19,0,1,0,149,6,21,3,0,199,1,8,208,231,0.749,0.9
"24996","Santa Cruz","El Torno","Escuela Tiquipaya",30,0,0,2,152,5,15,0,1,205,8,3,216,231,0.741,0.935
"24997","Santa Cruz","El Torno","Escuela Tiquipaya",10,0,0,0,131,5,12,0,0,158,8,7,173,184,0.829,0.94
"24998","Santa Cruz","El Torno","Esc. Central Monteverde",8,1,0,2,174,9,5,0,0,199,2,4,205,229,0.874,0.895
"24999","Santa Cruz","El Torno","Escuela Santa Martha",36,2,1,1,147,5,16,1,0,209,4,4,217,231,0.703,0.939
"25000","Santa Cruz","El Torno","Escuela Santa Martha",38,1,0,0,116,7,40,0,2,204,1,2,207,225,0.569,0.92
"25001","Santa Cruz","El Torno","Escuela Santa Martha",30,2,1,0,118,11,29,0,2,193,2,12,207,226,0.611,0.916
"25002","Santa Cruz","El Torno","Escuela Santa Martha",29,1,2,0,137,5,38,1,0,213,2,5,220,232,0.643,0.948
"25003","Santa Cruz","El Torno","Escuela Santa Martha",31,1,1,1,131,18,20,1,0,204,2,13,219,229,0.642,0.956
"25004","Santa Cruz","El Torno","Escuela Santa Martha",38,1,0,0,129,14,24,0,0,206,2,6,214,224,0.626,0.955
"25005","Santa Cruz","El Torno","Escuela Santa Martha",46,0,0,2,124,8,27,3,0,210,3,5,218,231,0.59,0.944
"25006","Santa Cruz","El Torno","Esc. Quebrada Leon",18,0,0,1,119,25,13,2,1,179,4,6,189,211,0.665,0.896
"25007","Santa Cruz","El Torno","Esc. Cañada Dos",3,0,1,0,181,4,10,0,0,199,5,7,211,228,0.91,0.925
"25008","Santa Cruz","Warnes","Esc. Colegio Julia Said",79,1,0,0,64,16,22,2,3,187,1,11,199,221,0.342,0.9
"25009","Santa Cruz","Warnes","Esc. Colegio Julia Said",88,0,0,2,73,11,10,1,2,187,5,4,196,217,0.39,0.903
"25010","Santa Cruz","Warnes","Esc. Colegio Julia Said",75,0,0,0,87,17,17,1,1,198,0,6,204,228,0.439,0.895
"25011","Santa Cruz","Warnes","Esc. Colegio Julia Said",82,0,1,0,63,16,18,0,1,181,1,14,196,227,0.348,0.863
"25012","Santa Cruz","Warnes","Esc. Colegio Julia Said",81,2,0,1,77,14,13,2,0,190,3,5,198,226,0.405,0.876
"25013","Santa Cruz","Warnes","Esc. Colegio Julia Said",67,0,0,0,92,15,17,1,2,194,3,12,209,231,0.474,0.905
"25014","Santa Cruz","Warnes","Esc. Colegio Julia Said",66,0,0,1,90,16,19,1,1,194,0,5,199,225,0.464,0.884
"25015","Santa Cruz","Warnes","Esc. Colegio Julia Said",38,0,1,0,109,7,19,1,1,176,1,15,192,219,0.619,0.877
"25016","Santa Cruz","Warnes","Esc. Colegio Julia Said",72,0,1,1,83,13,26,3,0,199,1,6,206,229,0.417,0.9
"25017","Santa Cruz","Warnes","Esc. Colegio Julia Said",88,2,0,0,67,16,19,0,0,192,1,6,199,224,0.349,0.888
"25018","Santa Cruz","Warnes","Esc. Colegio Julia Said",64,0,0,1,95,11,17,2,0,190,2,8,200,227,0.5,0.881
"25019","Santa Cruz","Warnes","Esc. Colegio Julia Said",75,0,0,1,66,20,33,0,1,196,1,6,203,231,0.337,0.879
"25020","Santa Cruz","Warnes","Esc. Colegio Julia Said",63,1,1,0,96,18,18,0,0,197,1,8,206,230,0.487,0.896
"25021","Santa Cruz","Warnes","Esc. Colegio Julia Said",79,0,0,0,80,14,15,3,1,192,3,7,202,223,0.417,0.906
"25022","Santa Cruz","Warnes","Esc. Colegio Julia Said",77,1,0,0,86,17,22,0,0,203,2,4,209,231,0.424,0.905
"25023","Santa Cruz","Warnes","Esc. Colegio Julia Said",91,0,0,1,66,23,12,2,0,195,1,6,202,225,0.338,0.898
"25024","Santa Cruz","Warnes","Esc. Colegio Julia Said",77,0,1,0,84,15,21,0,1,199,0,14,213,231,0.422,0.922
"25025","Santa Cruz","Warnes","Esc. Colegio Julia Said",54,1,0,1,110,7,25,1,2,201,0,6,207,228,0.547,0.908
"25026","Santa Cruz","Warnes","Esc. Colegio Julia Said",77,2,0,0,85,13,14,3,0,194,3,8,205,224,0.438,0.915
"25027","Santa Cruz","Warnes","Esc. Colegio Julia Said",94,0,1,0,63,16,21,4,1,200,1,4,205,228,0.315,0.899
"25028","Santa Cruz","Warnes","Esc. Colegio Julia Said",91,2,0,1,73,17,12,1,0,197,3,6,206,226,0.371,0.912
"25029","Santa Cruz","Warnes","Esc. Colegio Julia Said",63,0,0,1,110,8,15,2,2,201,2,6,209,229,0.547,0.913
"25030","Santa Cruz","Warnes","Esc. Colegio Julia Said",103,0,1,0,60,14,17,1,0,196,2,2,200,223,0.306,0.897
"25031","Santa Cruz","Warnes","Esc. Colegio Julia Said",83,0,1,0,63,24,12,3,1,187,1,5,193,223,0.337,0.865
"25032","Santa Cruz","Warnes","Esc. Colegio Julia Said",77,0,0,0,70,18,16,1,1,183,3,11,197,230,0.383,0.857
"25033","Santa Cruz","Warnes","Esc. Colegio Julia Said",47,0,0,1,111,12,30,0,1,202,1,4,207,226,0.55,0.916
"25034","Santa Cruz","Warnes","Esc. Colegio Julia Said",75,0,0,0,63,22,16,1,2,179,1,8,188,223,0.352,0.843
"25035","Santa Cruz","Warnes","Esc. Colegio Julia Said",99,0,1,0,66,15,20,0,1,202,2,7,211,232,0.327,0.909
"25036","Santa Cruz","Warnes","Esc. Colegio Julia Said",92,0,0,0,61,17,20,0,0,190,4,10,204,228,0.321,0.895
"25037","Santa Cruz","Warnes","Esc. Colegio Julia Said",83,0,2,0,76,11,18,0,2,192,0,8,200,227,0.396,0.881
"25038","Santa Cruz","Warnes","Esc. Colegio Julia Said",102,2,0,2,50,17,22,1,0,196,3,7,206,232,0.255,0.888
"25039","Santa Cruz","Warnes","Esc. Colegio Julia Said",73,0,0,0,74,20,15,1,0,183,1,12,196,233,0.404,0.841
"25040","Santa Cruz","Warnes","Esc. Colegio Julia Said",106,0,0,0,62,9,10,3,1,191,1,6,198,229,0.325,0.865
"25041","Santa Cruz","Warnes","Esc. Colegio Julia Said",79,0,1,0,74,22,18,1,0,195,0,8,203,228,0.379,0.89
"25042","Santa Cruz","Warnes","Esc. Colegio Julia Said",85,1,0,0,77,13,17,0,4,197,1,2,200,224,0.391,0.893
"25043","Santa Cruz","Warnes","U.E. Ignacio Warnes",80,1,1,1,68,26,20,1,1,199,0,6,205,223,0.342,0.919
"25044","Santa Cruz","Warnes","U.E. Ignacio Warnes",98,1,0,0,55,21,22,1,1,199,1,6,206,222,0.276,0.928
"25045","Santa Cruz","Warnes","U.E. Ignacio Warnes",107,0,1,0,60,19,9,1,1,198,1,1,200,219,0.303,0.913
"25046","Santa Cruz","Warnes","U.E. Ignacio Warnes",102,0,0,2,57,24,11,0,0,196,0,5,201,223,0.291,0.901
"25047","Santa Cruz","Warnes","U.E. Ignacio Warnes",83,0,0,0,65,11,19,3,1,182,0,11,193,222,0.357,0.869
"25048","Santa Cruz","Warnes","U.E. Ignacio Warnes",89,2,2,0,67,25,16,4,0,205,3,4,212,227,0.327,0.934
"25049","Santa Cruz","Warnes","U.E. Ignacio Warnes",97,0,1,2,72,15,16,1,1,205,1,2,208,224,0.351,0.929
"25050","Santa Cruz","Warnes","U.E. Ignacio Warnes",54,1,2,1,104,13,20,0,0,195,0,7,202,230,0.533,0.878
"25051","Santa Cruz","Warnes","U.E. Ignacio Warnes",88,0,0,0,78,11,12,0,0,189,1,9,199,225,0.413,0.884
"25052","Santa Cruz","Warnes","U.E. Ignacio Warnes",91,2,0,2,61,20,9,2,0,187,3,5,195,219,0.326,0.89
"25053","Santa Cruz","Warnes","U.E. Ignacio Warnes",76,1,1,2,76,16,19,4,1,196,2,5,203,227,0.388,0.894
"25054","Santa Cruz","Warnes","U.E. Ignacio Warnes",85,0,0,0,74,23,15,2,1,200,1,6,207,224,0.37,0.924
"25055","Santa Cruz","Warnes","U.E. Ignacio Warnes",93,0,1,2,58,10,15,1,0,180,3,9,192,225,0.322,0.853
"25056","Santa Cruz","Warnes","U.E. Ignacio Warnes",97,1,0,3,65,11,14,0,0,191,1,9,201,227,0.34,0.885
"25057","Santa Cruz","Warnes","U.E. Ignacio Warnes",120,0,0,0,34,16,7,3,0,180,1,9,190,219,0.189,0.868
"25058","Santa Cruz","Warnes","U.E. Ignacio Warnes",97,0,1,1,61,12,23,1,0,196,1,5,202,221,0.311,0.914
"25059","Santa Cruz","Warnes","U.E. Ignacio Warnes",54,0,0,1,94,15,22,2,1,189,5,4,198,221,0.497,0.896
"25060","Santa Cruz","Warnes","U.E. Ignacio Warnes",77,0,0,0,62,29,24,1,2,195,3,5,203,227,0.318,0.894
"25061","Santa Cruz","Warnes","U.E. Ignacio Warnes",105,0,0,2,64,26,12,4,1,214,2,2,218,230,0.299,0.948
"25062","Santa Cruz","Warnes","U.E. Ignacio Warnes",122,0,3,0,41,13,4,0,2,185,0,6,191,217,0.222,0.88
"25063","Santa Cruz","Warnes","U.E. Ignacio Warnes",89,0,0,2,63,18,14,1,0,187,4,8,199,221,0.337,0.9
"25064","Santa Cruz","Warnes","U.E. Ignacio Warnes",112,1,0,0,53,19,8,0,0,193,0,6,199,219,0.275,0.909
"25065","Santa Cruz","Warnes","U.E. Ignacio Warnes",85,0,5,0,29,26,11,15,0,171,25,3,199,220,0.17,0.905
"25066","Santa Cruz","Warnes","U.E. Ignacio Warnes",105,0,1,0,52,9,19,1,0,187,2,7,196,225,0.278,0.871
"25067","Santa Cruz","Warnes","U.E. Ignacio Warnes",64,0,0,0,98,10,18,5,0,195,2,4,201,225,0.503,0.893
"25068","Santa Cruz","Warnes","U.E. Ignacio Warnes",108,0,0,1,53,17,6,4,0,189,2,1,192,219,0.28,0.877
"25069","Santa Cruz","Warnes","U.E. Ignacio Warnes",97,0,1,2,60,21,21,1,2,205,2,4,211,226,0.293,0.934
"25070","Santa Cruz","Warnes","U.E. Ignacio Warnes",112,0,0,0,56,15,14,1,0,198,1,8,207,225,0.283,0.92
"25071","Santa Cruz","Warnes","U.E. Ignacio Warnes",99,0,0,1,55,13,15,1,1,185,0,8,193,220,0.297,0.877
"25072","Santa Cruz","Warnes","U.E. Ignacio Warnes",108,0,0,1,54,18,10,1,0,192,1,5,198,227,0.281,0.872
"25073","Santa Cruz","Warnes","U.E. Ignacio Warnes",83,1,0,0,65,10,24,1,1,185,1,8,194,226,0.351,0.858
"25074","Santa Cruz","Warnes","U.E. Ignacio Warnes",128,1,0,0,33,16,10,1,0,189,0,6,195,218,0.175,0.894
"25075","Santa Cruz","Warnes","U.E. Ignacio Warnes",91,0,0,0,65,16,17,0,0,189,0,6,195,222,0.344,0.878
"25076","Santa Cruz","Warnes","U.E. Ignacio Warnes",86,1,1,2,65,11,13,1,1,181,4,5,190,222,0.359,0.856
"25077","Santa Cruz","Warnes","Esc. Col. Constantino Cuellar",100,0,0,0,57,26,16,1,1,201,2,4,207,229,0.284,0.904
"25078","Santa Cruz","Warnes","Esc. Col. Constantino Cuellar",118,0,1,0,45,18,11,0,0,193,4,5,202,225,0.233,0.898
"25079","Santa Cruz","Warnes","Esc. Col. Constantino Cuellar",107,1,0,0,50,25,14,3,0,200,1,9,210,225,0.25,0.933
"25080","Santa Cruz","Warnes","Esc. Col. Constantino Cuellar",98,0,1,0,69,21,10,0,0,199,1,3,203,230,0.347,0.883
"25081","Santa Cruz","Warnes","Esc. Col. Constantino Cuellar",60,0,0,1,89,14,34,0,0,198,3,4,205,231,0.449,0.887
"25082","Santa Cruz","Warnes","Esc. Col. Constantino Cuellar",90,0,1,0,59,28,14,1,0,193,2,6,201,227,0.306,0.885
"25083","Santa Cruz","Warnes","Esc. Col. Constantino Cuellar",77,0,1,1,78,16,17,2,1,193,2,5,200,222,0.404,0.901
"25084","Santa Cruz","Warnes","Esc. Col. Constantino Cuellar",100,0,0,1,69,14,13,2,1,200,1,9,210,235,0.345,0.894
"25085","Santa Cruz","Warnes","Esc. Col. Constantino Cuellar",123,0,0,0,53,17,6,4,1,204,0,5,209,229,0.26,0.913
"25086","Santa Cruz","Warnes","Esc. Col. Constantino Cuellar",88,0,1,0,81,12,23,1,1,207,2,4,213,231,0.391,0.922
"25087","Santa Cruz","Warnes","Esc. Col. Constantino Cuellar",98,1,0,2,60,23,16,2,1,203,1,4,208,230,0.296,0.904
"25088","Santa Cruz","Warnes","Esc. Col. Constantino Cuellar",90,0,0,1,71,17,16,2,0,197,2,7,206,228,0.36,0.904
"25089","Santa Cruz","Warnes","Esc. Col. Constantino Cuellar",98,0,0,1,48,31,17,2,1,198,2,6,206,229,0.242,0.9
"25090","Santa Cruz","Warnes","Esc. Col. Constantino Cuellar",102,0,1,1,50,25,14,1,2,196,3,4,203,225,0.255,0.902
"25091","Santa Cruz","Warnes","Esc. Col. Constantino Cuellar",86,1,0,0,69,14,19,0,1,190,5,9,204,232,0.363,0.879
"25092","Santa Cruz","Warnes","Esc. Col. Constantino Cuellar",109,0,0,1,50,26,14,1,0,201,3,4,208,231,0.249,0.9
"25093","Santa Cruz","Warnes","Esc. Col. Constantino Cuellar",106,1,0,0,48,29,16,2,1,203,1,3,207,229,0.236,0.904
"25094","Santa Cruz","Warnes","Esc. Col. Constantino Cuellar",105,1,1,1,57,16,13,2,2,198,2,4,204,235,0.288,0.868
"25095","Santa Cruz","Warnes","Esc. Col. Constantino Cuellar",127,1,0,0,46,13,16,1,0,204,0,1,205,229,0.225,0.895
"25096","Santa Cruz","Warnes","Esc. Col. Constantino Cuellar",89,0,0,1,66,26,12,1,0,195,1,5,201,232,0.338,0.866
"25097","Santa Cruz","Warnes","Esc. El Jipa",56,0,2,2,90,25,31,0,0,206,0,13,219,237,0.437,0.924
"25098","Santa Cruz","Warnes","Esc. El Jipa",52,1,1,1,118,11,27,1,0,212,3,6,221,235,0.557,0.94
"25099","Santa Cruz","Warnes","Esc. El Jipa",57,0,1,0,91,28,22,4,1,204,3,11,218,234,0.446,0.932
"25100","Santa Cruz","Warnes","Esc. El Jipa",67,1,2,1,89,18,29,1,1,209,2,11,222,237,0.426,0.937
"25101","Santa Cruz","Warnes","Esc. El Jipa",75,0,4,0,96,19,12,1,1,208,0,11,219,236,0.462,0.928
"25102","Santa Cruz","Warnes","U.E. Jose Manuel Vaca",83,1,1,0,83,19,24,1,0,212,1,6,219,237,0.392,0.924
"25103","Santa Cruz","Warnes","U.E. Jose Manuel Vaca",80,0,1,0,75,14,36,0,0,206,1,4,211,236,0.364,0.894
"25104","Santa Cruz","Warnes","U.E. Jose Manuel Vaca",85,0,1,1,46,22,25,0,1,181,2,2,185,199,0.254,0.93
"25105","Santa Cruz","Warnes","U.E. Antonio Anzuati",37,0,0,1,113,13,28,0,1,193,1,25,219,237,0.585,0.924
"25106","Santa Cruz","Warnes","U.E. Antonio Anzuati",34,1,2,2,116,19,38,1,0,213,3,8,224,239,0.545,0.937
"25107","Santa Cruz","Warnes","U.E. Antonio Anzuati",54,0,0,1,127,16,16,0,0,214,4,7,225,237,0.593,0.949
"25108","Santa Cruz","Warnes","U.E. Paititi",46,0,0,0,110,23,24,1,0,204,2,9,215,238,0.539,0.903
"25109","Santa Cruz","Warnes","U.E. Paititi",51,0,0,1,119,24,19,0,1,215,1,8,224,237,0.553,0.945
"25110","Santa Cruz","Warnes","U.E. Paititi",64,0,0,1,103,17,22,2,0,209,18,12,239,239,0.493,1
"25111","Santa Cruz","Warnes","U.E. Paititi",56,2,0,0,106,20,18,3,1,206,1,5,212,224,0.515,0.946
"25112","Santa Cruz","Warnes","U.E. Wajojo",64,1,2,4,91,31,23,1,2,219,1,7,227,239,0.416,0.95
"25113","Santa Cruz","Warnes","U.E. Wajojo",49,2,2,1,99,24,13,1,0,191,5,24,220,233,0.518,0.944
"25114","Santa Cruz","Warnes","U.E. Wajojo",77,0,1,2,80,30,17,0,0,207,4,6,217,234,0.386,0.927
"25115","Santa Cruz","Warnes","U.E. Wajojo",48,0,0,1,73,30,7,0,0,159,2,5,166,176,0.459,0.943
"25116","Santa Cruz","Warnes","U.E. Emilio Finot",101,0,1,0,63,22,27,0,0,214,5,5,224,239,0.294,0.937
"25117","Santa Cruz","Warnes","U.E. Emilio Finot",87,1,1,0,88,25,20,0,1,223,2,6,231,239,0.395,0.967
"25118","Santa Cruz","Warnes","U.E. Emilio Finot",95,0,0,2,78,17,26,0,0,218,0,3,221,239,0.358,0.925
"25119","Santa Cruz","Warnes","U.E. Emilio Finot",119,0,0,0,61,10,30,1,0,221,2,4,227,238,0.276,0.954
"25120","Santa Cruz","Warnes","Esc. Valle Sanchez",135,1,2,1,40,11,10,0,0,200,0,6,206,232,0.2,0.888
"25121","Santa Cruz","Warnes","Esc. Valle Sanchez",141,0,0,0,35,15,13,2,1,207,1,2,210,232,0.169,0.905
"25122","Santa Cruz","Warnes","Esc. Valle Sanchez",124,0,0,3,50,10,11,1,1,200,0,3,203,223,0.25,0.91
"25123","Santa Cruz","Warnes","Esc. Valle Sanchez",108,1,0,0,52,12,13,1,0,187,2,6,195,231,0.278,0.844
"25124","Santa Cruz","Warnes","Esc. Valle Sanchez",135,0,0,1,44,14,10,0,0,204,1,9,214,229,0.216,0.934
"25125","Santa Cruz","Warnes","Esc. Valle Sanchez",134,0,1,0,38,15,11,0,1,200,2,5,207,227,0.19,0.912
"25126","Santa Cruz","Warnes","Esc. Valle Sanchez",135,0,1,0,37,9,14,0,0,196,1,4,201,224,0.189,0.897
"25127","Santa Cruz","Warnes","Esc. Valle Sanchez",127,0,0,1,41,12,9,1,2,193,0,5,198,228,0.212,0.868
"25128","Santa Cruz","Warnes","Esc. Valle Sanchez",114,1,0,0,49,20,9,0,1,194,1,9,204,232,0.253,0.879
"25129","Santa Cruz","Warnes","Esc. Valle Sanchez",140,2,0,2,28,18,4,0,0,194,1,6,201,227,0.144,0.885
"25130","Santa Cruz","Warnes","Esc. Valle Sanchez",119,0,0,0,38,27,9,1,0,194,1,8,203,232,0.196,0.875
"25131","Santa Cruz","Warnes","Esc. Valle Sanchez",142,0,1,0,26,13,13,0,0,195,2,7,204,227,0.133,0.899
"25132","Santa Cruz","Warnes","Esc. Valle Sanchez",126,1,0,0,52,11,8,0,2,200,1,9,210,233,0.26,0.901
"25133","Santa Cruz","Warnes","Esc. Valle Sanchez",133,1,0,1,27,20,8,0,1,191,0,8,199,228,0.141,0.873
"25134","Santa Cruz","Warnes","Esc. Valle Sanchez",145,1,0,0,22,15,10,1,0,194,0,9,203,222,0.113,0.914
"25135","Santa Cruz","Warnes","Esc. Valle Sanchez",140,1,0,0,35,19,10,1,0,206,1,4,211,231,0.17,0.913
"25136","Santa Cruz","Warnes","Esc. Valle Sanchez",132,1,0,0,37,13,10,0,0,193,1,8,202,229,0.192,0.882
"25137","Santa Cruz","Warnes","Esc. Valle Sanchez",134,0,0,0,36,13,9,3,1,196,0,11,207,235,0.184,0.881
"25138","Santa Cruz","Warnes","U.E. Akualand",144,0,1,1,30,23,11,4,0,214,1,6,221,233,0.14,0.948
"25139","Santa Cruz","Warnes","U.E. Akualand",162,0,2,0,39,9,12,0,1,225,0,2,227,238,0.173,0.954
"25140","Santa Cruz","Warnes","U.E. Akualand",156,0,0,0,37,18,9,0,1,221,0,2,223,235,0.167,0.949
"25141","Santa Cruz","Warnes","U.E. Akualand",102,0,1,1,31,8,8,1,0,152,0,7,159,170,0.204,0.935
"25142","Santa Cruz","Warnes","Esc. Terracor",114,0,1,0,60,22,16,0,1,214,0,1,215,229,0.28,0.939
"25143","Santa Cruz","Warnes","Esc. Terracor",100,0,1,0,63,25,10,0,0,199,2,10,211,234,0.317,0.902
"25144","Santa Cruz","Warnes","Esc. Terracor",109,0,0,0,58,19,11,0,1,198,1,9,208,230,0.293,0.904
"25145","Santa Cruz","Warnes","Esc. Terracor",110,0,0,1,60,12,13,3,2,201,2,4,207,225,0.299,0.92
"25146","Santa Cruz","Warnes","Esc. Terracor",99,0,0,1,49,20,18,3,1,191,1,12,204,231,0.257,0.883
"25147","Santa Cruz","Warnes","Esc. Terracor",92,0,0,3,65,22,16,2,0,200,2,6,208,228,0.325,0.912
"25148","Santa Cruz","Warnes","Esc. Terracor",81,1,2,0,80,18,20,2,1,205,1,5,211,235,0.39,0.898
"25149","Santa Cruz","Warnes","Esc. Terracor",98,0,0,1,46,27,19,2,0,193,0,11,204,229,0.238,0.891
"25150","Santa Cruz","Warnes","Esc. Terracor",95,0,0,0,67,24,14,0,2,202,1,4,207,234,0.332,0.885
"25151","Santa Cruz","Warnes","Esc. Terracor",106,0,0,1,59,21,12,0,0,199,1,9,209,236,0.296,0.886
"25152","Santa Cruz","Warnes","Esc. Terracor",105,0,2,0,55,17,12,0,0,191,2,5,198,227,0.288,0.872
"25153","Santa Cruz","Warnes","Esc. Terracor",103,1,2,1,38,24,12,2,1,184,4,12,200,231,0.207,0.866
"25154","Santa Cruz","Warnes","Esc. Terracor",101,1,0,1,62,23,11,0,0,199,1,6,206,233,0.312,0.884
"25155","Santa Cruz","Warnes","Esc. Unid. Edu. Don Bosco",76,0,1,1,85,21,11,4,2,201,4,7,212,230,0.423,0.922
"25156","Santa Cruz","Warnes","Esc. Unid. Edu. Don Bosco",71,1,0,1,93,26,6,0,2,200,4,3,207,230,0.465,0.9
"25157","Santa Cruz","Warnes","Esc. Unid. Edu. Don Bosco",95,0,1,1,81,23,7,2,1,211,0,2,213,231,0.384,0.922
"25158","Santa Cruz","Warnes","Esc. Unid. Edu. Don Bosco",90,0,0,0,81,24,8,2,0,205,2,8,215,231,0.395,0.931
"25159","Santa Cruz","Warnes","Esc. Mariano Vaca Montero",74,0,0,2,76,21,5,2,1,181,4,8,193,226,0.42,0.854
"25160","Santa Cruz","Warnes","Esc. Mariano Vaca Montero",62,1,0,3,97,23,6,1,0,193,7,9,209,230,0.503,0.909
"25161","Santa Cruz","Warnes","Esc. Mariano Vaca Montero",74,1,0,2,84,20,13,0,0,194,1,9,204,228,0.433,0.895
"25162","Santa Cruz","Warnes","Esc. Mariano Vaca Montero",67,1,0,1,74,34,10,1,3,191,8,11,210,231,0.387,0.909
"25163","Santa Cruz","Warnes","Esc. Mariano Vaca Montero",95,3,0,1,59,13,15,0,0,186,3,12,201,218,0.317,0.922
"25164","Santa Cruz","Warnes","Esc. Angelmira Monte  de Dalence",78,1,1,2,79,29,10,3,0,203,2,8,213,224,0.389,0.951
"25165","Santa Cruz","Warnes","Esc. Angelmira Monte  de Dalence",90,1,0,0,56,43,16,1,0,207,2,4,213,229,0.271,0.93
"25166","Santa Cruz","Warnes","Esc. Seccional La Marina",37,0,0,1,122,14,9,0,0,183,8,7,198,225,0.667,0.88
"25167","Santa Cruz","Warnes","Esc. Seccional La Marina",59,1,0,0,99,16,8,3,0,186,3,6,195,221,0.532,0.882
"25168","Santa Cruz","Warnes","Esc. Seccional Azuzaqui",63,0,0,2,81,33,0,2,0,181,6,6,193,221,0.448,0.873
"25169","Santa Cruz","Warnes","Esc. Seccional Azuzaqui",64,0,0,2,62,31,20,0,1,180,6,10,196,215,0.344,0.912
"25170","Santa Cruz","Warnes","Esc. Las Barreras",60,1,0,0,83,36,16,0,1,197,4,9,210,228,0.421,0.921
"25171","Santa Cruz","Warnes","Esc. Las Barreras",70,0,1,0,75,33,16,3,1,199,2,9,210,233,0.377,0.901
"25172","Santa Cruz","Warnes","Esc. Las Barreras",66,2,0,1,79,35,17,2,0,202,6,5,213,232,0.391,0.918
"25173","Santa Cruz","Warnes","Esc. Las Barreras",85,1,0,0,68,21,13,0,2,190,8,11,209,232,0.358,0.901
"25174","Santa Cruz","Warnes","Esc. Las Barreras",60,0,1,0,87,25,16,2,0,191,3,10,204,228,0.455,0.895
"25175","Santa Cruz","Warnes","Esc. Las Barreras",92,0,0,1,74,22,11,3,0,203,0,7,210,231,0.365,0.909
"25176","Santa Cruz","Warnes","Esc. Las Barreras",78,1,0,1,70,29,12,0,0,191,4,6,201,234,0.366,0.859
"25177","Santa Cruz","Warnes","Esc. Las Barreras",58,1,0,2,78,31,18,3,1,192,1,14,207,231,0.406,0.896
"25178","Santa Cruz","Warnes","Esc. Las Barreras",82,0,0,0,83,22,11,3,0,201,4,11,216,240,0.413,0.9
"25179","Santa Cruz","Warnes","Esc. Turobito",57,0,2,0,76,53,10,2,1,201,3,5,209,228,0.378,0.917
"25180","Santa Cruz","Warnes","Esc. Nucleo Central Clara Chuchio",84,0,1,1,57,31,13,3,1,191,1,9,201,225,0.298,0.893
"25181","Santa Cruz","Warnes","Esc. Nucleo Central Clara Chuchio",88,0,1,2,70,20,10,1,0,192,2,6,200,232,0.365,0.862
"25182","Santa Cruz","Warnes","Esc. Nucleo Central Clara Chuchio",111,1,2,0,52,13,10,3,0,192,2,3,197,221,0.271,0.891
"25183","Santa Cruz","Warnes","Esc. Nucleo Central Clara Chuchio",96,1,1,0,68,19,9,5,0,199,3,9,211,225,0.342,0.938
"25184","Santa Cruz","Warnes","Esc. Adrian Justiniano Roca",74,0,0,1,65,27,9,2,0,178,4,10,192,228,0.365,0.842
"25185","Santa Cruz","Warnes","Esc. Adrian Justiniano Roca",72,1,0,1,70,26,9,1,1,181,7,11,199,224,0.387,0.888
"25186","Santa Cruz","Warnes","Esc. Unid. Edu.   Motacu",85,0,0,2,63,27,8,1,0,186,3,13,202,225,0.339,0.898
"25187","Santa Cruz","Warnes","Esc. Unid. Edu.  Los Chacos",107,1,0,0,47,22,3,3,1,184,2,8,194,223,0.255,0.87
"25188","Santa Cruz","Warnes","Esc. Unid. Edu.  Los Chacos",116,0,0,1,53,29,3,2,0,204,0,5,209,235,0.26,0.889
"25189","Santa Cruz","Warnes","Esc. Unid. Edu. El Tajibo",91,1,1,1,73,21,3,2,0,193,4,10,207,230,0.378,0.9
"25190","Santa Cruz","Warnes","Esc. Unid. Edu. El Tajibo",83,1,1,1,94,13,9,3,3,208,1,5,214,228,0.452,0.939
"25191","Santa Cruz","Warnes","Esc. Unid. Edu. El Tajibo",76,0,0,0,83,20,7,4,0,190,7,8,205,227,0.437,0.903
"25192","Santa Cruz","Warnes","Esc. Unid. Edu. El Tajibo",77,2,0,2,65,28,5,4,2,185,4,4,193,220,0.351,0.877
"25193","Santa Cruz","Warnes","Esc.  Unid. Edu. Felix Paz Vieira",71,0,0,2,89,21,5,1,1,190,4,7,201,229,0.468,0.878
"25194","Santa Cruz","Warnes","Esc. Unid. Edu.  La Reforma",59,0,1,2,104,18,6,4,1,195,4,4,203,232,0.533,0.875
"25195","Santa Cruz","Warnes","Esc. Unid. Edu.  La Reforma",60,0,0,1,88,32,13,1,2,197,3,8,208,234,0.447,0.889
"25196","Santa Cruz","Warnes","Esc. Unid. Edu.  La Reforma",59,0,1,0,85,35,8,0,0,188,8,10,206,229,0.452,0.9
"25197","Santa Cruz","Warnes","Esc. Unid. Edu.  Juan Latino",84,1,0,1,63,25,22,0,0,196,3,11,210,230,0.321,0.913
"25198","Santa Cruz","Warnes","Esc. Unid. Edu.  Juan Latino",64,0,1,1,72,37,13,0,0,188,1,13,202,223,0.383,0.906
"25199","Santa Cruz","Warnes","Esc. Ciudad Satelite Norte",64,0,0,1,95,13,24,2,1,200,0,5,205,229,0.475,0.895
"25200","Santa Cruz","Warnes","Esc. Ciudad Satelite Norte",61,0,0,0,85,13,19,1,1,180,0,6,186,226,0.472,0.823
"25201","Santa Cruz","Warnes","Esc. Ciudad Satelite Norte",65,0,1,1,91,17,18,1,1,195,2,7,204,227,0.467,0.899
"25202","Santa Cruz","Warnes","Esc. Ciudad Satelite Norte",74,1,2,0,85,17,18,0,1,198,3,5,206,230,0.429,0.896
"25203","Santa Cruz","Warnes","Esc. Ciudad Satelite Norte",76,0,0,1,83,8,12,1,0,181,2,9,192,227,0.459,0.846
"25204","Santa Cruz","Warnes","Esc. Ciudad Satelite Norte",70,0,0,1,86,14,19,1,0,191,2,4,197,227,0.45,0.868
"25205","Santa Cruz","Warnes","Esc. Ciudad Satelite Norte",62,0,1,1,93,13,19,1,2,192,1,9,202,230,0.484,0.878
"25206","Santa Cruz","Warnes","Esc. Ciudad Satelite Norte",63,0,0,0,86,14,21,0,2,186,3,7,196,226,0.462,0.867
"25207","Santa Cruz","Warnes","Esc. Ciudad Satelite Norte",69,0,0,0,91,15,14,0,0,189,1,2,192,227,0.481,0.846
"25208","Santa Cruz","Warnes","Esc. Ciudad Satelite Norte",46,2,1,0,124,10,21,1,0,205,1,5,211,230,0.605,0.917
"25209","Santa Cruz","Warnes","Esc. Ciudad Satelite Norte",24,0,1,0,138,9,18,0,3,193,2,8,203,233,0.715,0.871
"25210","Santa Cruz","Warnes","Esc. Ciudad Satelite Norte",61,0,0,0,94,15,23,1,1,195,4,5,204,225,0.482,0.907
"25211","Santa Cruz","Warnes","Esc. Ciudad Satelite Norte",63,0,1,0,90,20,22,2,0,198,2,7,207,231,0.455,0.896
"25212","Santa Cruz","Warnes","Esc. Ciudad Satelite Norte",54,0,2,0,94,12,27,1,0,190,0,9,199,227,0.495,0.877
"25213","Santa Cruz","Warnes","Esc. Ciudad Satelite Norte",51,1,2,0,109,18,20,0,0,201,0,8,209,233,0.542,0.897
"25214","Santa Cruz","Warnes","Esc. Ciudad Satelite Norte",71,0,0,0,93,15,10,1,0,190,2,11,203,229,0.489,0.886
"25215","Santa Cruz","Warnes","Esc. Ciudad Satelite Norte",64,0,0,0,84,12,19,0,0,179,0,6,185,227,0.469,0.815
"25216","Santa Cruz","Warnes","Esc. Ciudad Satelite Norte",71,0,0,0,92,12,15,1,1,192,1,5,198,227,0.479,0.872
"25217","Santa Cruz","Warnes","Esc. Ciudad Satelite Norte",59,0,1,1,106,9,23,0,1,200,0,6,206,228,0.53,0.904
"25218","Santa Cruz","Warnes","Esc. Ciudad Satelite Norte",78,1,4,0,72,17,12,3,0,187,1,9,197,230,0.385,0.857
"25219","Santa Cruz","Warnes","Esc. Ciudad Satelite Norte",62,0,2,1,99,18,19,0,1,202,2,5,209,228,0.49,0.917
"25220","Santa Cruz","Warnes","Esc. Ciudad Satelite Norte",47,1,0,0,115,10,20,0,3,196,2,4,202,231,0.587,0.874
"25221","Santa Cruz","Warnes","Esc. Ciudad Satelite Norte",21,0,6,0,124,8,29,2,3,193,1,3,197,223,0.642,0.883
"25222","Santa Cruz","Warnes","Esc. Ciudad Satelite Norte",73,0,1,0,78,14,22,1,0,189,2,2,193,223,0.413,0.865
"25223","Santa Cruz","Warnes","Esc. Ciudad Satelite Norte",79,0,0,0,77,21,14,1,1,193,1,10,204,228,0.399,0.895
"25224","Santa Cruz","Warnes","Esc. Ciudad Satelite Norte",61,0,1,1,95,18,14,0,0,190,1,4,195,225,0.5,0.867
"25225","Santa Cruz","Warnes","Esc. Ciudad Satelite Norte",59,0,2,0,93,19,18,3,1,195,1,2,198,228,0.477,0.868
"25226","Santa Cruz","Warnes","Esc. Ciudad Satelite Norte",69,1,0,1,98,12,12,1,1,195,2,4,201,226,0.503,0.889
"25227","Santa Cruz","Warnes","Esc. Ciudad Satelite Norte",69,0,0,1,77,17,20,1,0,185,1,6,192,226,0.416,0.85
"25228","Santa Cruz","Warnes","Esc. Ciudad Satelite Norte",91,0,1,1,77,17,10,0,3,200,0,3,203,224,0.385,0.906
"25229","Santa Cruz","Warnes","Esc. Ciudad Satelite Norte",65,1,1,1,81,17,24,2,1,193,1,4,198,227,0.42,0.872
"25230","Santa Cruz","Warnes","Esc. Ciudad Satelite Norte",41,0,0,2,127,12,19,0,0,201,0,4,205,230,0.632,0.891
"25231","Santa Cruz","Warnes","Esc. Ciudad Satelite Norte",62,0,0,0,97,15,23,0,2,199,0,2,201,228,0.487,0.882
"25232","Santa Cruz","Warnes","Esc. Ciudad Satelite Norte",82,1,1,0,74,25,13,0,1,197,1,8,206,229,0.376,0.9
"25233","Santa Cruz","Warnes","Esc. Ciudad Satelite Norte",77,1,1,0,89,12,9,0,2,191,1,9,201,225,0.466,0.893
"25234","Santa Cruz","Warnes","Esc. Ciudad Satelite Norte",62,1,2,1,75,25,16,0,1,183,3,2,188,223,0.41,0.843
"25235","Santa Cruz","Warnes","Esc. Ciudad Satelite Norte",83,0,0,1,73,12,11,1,4,185,3,10,198,227,0.395,0.872
"25236","Santa Cruz","Warnes","Esc. Ciudad Satelite Norte",73,0,0,0,82,16,20,0,0,191,1,7,199,220,0.429,0.905
"25237","Santa Cruz","Warnes","Esc. Ciudad Satelite Norte",84,0,0,1,70,22,14,0,1,192,1,10,203,227,0.365,0.894
"25238","Santa Cruz","Warnes","Esc. Ciudad Satelite Norte",45,1,5,0,104,14,26,0,0,195,0,11,206,228,0.533,0.904
"25239","Santa Cruz","Warnes","Esc. Ciudad Satelite Norte",87,1,0,1,76,17,22,0,0,204,1,1,206,236,0.373,0.873
"25240","Santa Cruz","Warnes","Esc. Ciudad Satelite Norte",63,0,0,1,75,21,29,3,1,193,0,12,205,225,0.389,0.911
"25241","Santa Cruz","Warnes","Esc. Ciudad Satelite Norte",65,0,1,2,109,7,15,0,0,199,1,4,204,227,0.548,0.899
"25242","Santa Cruz","Warnes","Esc. Ciudad Satelite Norte",55,3,0,0,94,21,25,1,2,201,2,3,206,231,0.468,0.892
"25243","Santa Cruz","Warnes","Esc. Juana Azurduy De Padilla",66,1,0,0,100,19,25,2,0,213,0,5,218,236,0.469,0.924
"25244","Santa Cruz","Warnes","Esc. Juana Azurduy De Padilla",73,2,2,1,96,20,17,0,1,212,0,6,218,234,0.453,0.932
"25245","Santa Cruz","Warnes","Esc. Juana Azurduy De Padilla",68,0,0,0,101,9,24,0,0,202,2,8,212,237,0.5,0.895
"25246","Santa Cruz","Warnes","Esc. Juana Azurduy De Padilla",50,0,1,1,111,13,19,0,2,197,3,7,207,234,0.563,0.885
"25247","Santa Cruz","Warnes","Esc. Juana Azurduy De Padilla",42,0,1,1,131,11,16,0,2,204,3,4,211,235,0.642,0.898
"25248","Santa Cruz","Warnes","Esc. Juana Azurduy De Padilla",34,1,2,0,133,9,21,1,0,201,1,5,207,234,0.662,0.885
"25249","Santa Cruz","Warnes","Esc. Juana Azurduy De Padilla",60,0,1,0,104,19,24,0,0,208,1,2,211,237,0.5,0.89
"25250","Santa Cruz","Warnes","Esc. Juana Azurduy De Padilla",56,1,0,0,111,16,21,0,3,208,1,6,215,238,0.534,0.903
"25251","Santa Cruz","Warnes","Esc. Juana Azurduy De Padilla",51,2,2,2,122,10,22,0,0,211,1,6,218,237,0.578,0.92
"25252","Santa Cruz","Warnes","Esc. Juana Azurduy De Padilla",70,0,0,1,96,16,18,2,0,203,3,4,210,231,0.473,0.909
"25253","Santa Cruz","Warnes","Esc. Juana Azurduy De Padilla",54,0,2,0,102,17,24,1,1,201,4,6,211,233,0.507,0.906
"25254","Santa Cruz","Warnes","Esc. Juana Azurduy De Padilla",48,0,0,1,115,11,20,1,0,196,2,6,204,231,0.587,0.883
"25255","Santa Cruz","Warnes","Esc. Juana Azurduy De Padilla",44,0,2,1,117,11,31,3,5,214,2,3,219,236,0.547,0.928
"25256","Santa Cruz","Warnes","Esc. Juana Azurduy De Padilla",71,1,0,0,101,14,15,1,2,205,0,4,209,236,0.493,0.886
"25257","Santa Cruz","Warnes","Esc. Juana Azurduy De Padilla",64,1,0,1,114,11,18,0,1,210,1,9,220,236,0.543,0.932
"25258","Santa Cruz","Warnes","Esc. Juana Azurduy De Padilla",61,0,1,0,108,18,20,0,1,209,6,10,225,236,0.517,0.953
"25259","Santa Cruz","Warnes","Esc. Juana Azurduy De Padilla",61,0,1,1,93,18,26,1,0,201,1,11,213,238,0.463,0.895
"25260","Santa Cruz","Warnes","Esc. Juana Azurduy De Padilla",31,0,2,1,134,7,22,0,2,199,2,6,207,236,0.673,0.877
"25261","Santa Cruz","Warnes","Esc. Juana Azurduy De Padilla",53,0,0,1,105,19,9,1,1,189,1,13,203,233,0.556,0.871
"25262","Santa Cruz","Warnes","Esc. Juana Azurduy De Padilla",58,1,1,0,85,24,26,1,1,197,1,7,205,235,0.431,0.872
"25263","Santa Cruz","Warnes","Esc. Juana Azurduy De Padilla",57,0,0,0,107,17,26,2,0,209,2,3,214,235,0.512,0.911
"25264","Santa Cruz","Warnes","Esc. Juana Azurduy De Padilla",54,0,1,1,101,23,18,0,0,198,3,4,205,235,0.51,0.872
"25265","Santa Cruz","Warnes","Esc. Juana Azurduy De Padilla",59,1,0,0,103,14,15,0,0,192,1,12,205,231,0.536,0.887
"25266","Santa Cruz","Warnes","Esc. Juana Azurduy De Padilla",60,0,0,2,109,14,17,1,1,204,0,7,211,229,0.534,0.921
"25267","Santa Cruz","Warnes","U.E. San Juan",98,0,2,1,70,15,19,1,2,208,0,11,219,238,0.337,0.92
"25268","Santa Cruz","Warnes","U.E. San Juan",80,0,2,1,93,8,18,1,1,204,3,4,211,237,0.456,0.89
"25269","Santa Cruz","Warnes","U.E. San Juan",89,0,1,0,85,24,15,0,0,214,2,3,219,239,0.397,0.916
"25270","Santa Cruz","Warnes","U.E. San Juan",80,0,1,2,79,17,26,1,0,206,3,6,215,238,0.383,0.903
"25271","Santa Cruz","Warnes","U.E. San Juan",93,0,0,1,71,20,17,1,1,204,1,10,215,236,0.348,0.911
"25272","Santa Cruz","Warnes","U.E. San Juan",72,1,1,2,75,24,23,0,1,199,1,4,204,237,0.377,0.861
"25273","Santa Cruz","Warnes","U.E. San Juan",87,0,0,0,80,17,19,0,2,205,2,2,209,234,0.39,0.893
"25274","Santa Cruz","Warnes","U.E. San Juan",63,0,1,0,77,13,22,0,0,176,1,8,185,193,0.438,0.959
"25275","Santa Cruz","Warnes","U.E. Monte Carmelo",78,0,0,0,74,16,17,0,0,185,0,36,221,239,0.4,0.925
"25276","Santa Cruz","Warnes","U.E. Monte Carmelo",77,0,0,0,100,16,25,0,0,218,2,5,225,239,0.459,0.941
"25277","Santa Cruz","Warnes","U.E. Monte Carmelo",67,0,0,0,102,10,27,0,0,206,0,7,213,235,0.495,0.906
"25278","Santa Cruz","Warnes","U.E. Monte Carmelo",82,0,0,1,88,17,24,0,0,212,2,8,222,238,0.415,0.933
"25279","Santa Cruz","Warnes","U.E. Monte Carmelo",65,0,1,0,92,32,27,1,0,218,2,7,227,249,0.422,0.912
"25280","Santa Cruz","Warnes","U.E. El Manantial",82,0,0,2,93,20,17,1,0,215,1,8,224,236,0.433,0.949
"25281","Santa Cruz","Warnes","U.E. El Manantial",57,0,0,0,106,19,18,2,2,204,1,6,211,236,0.52,0.894
"25282","Santa Cruz","Warnes","U.E. El Manantial",68,1,0,1,90,20,24,0,2,206,3,8,217,238,0.437,0.912
"25283","Santa Cruz","Warnes","U.E. El Manantial",55,0,1,1,107,16,23,1,1,205,3,10,218,237,0.522,0.92
"25284","Santa Cruz","Warnes","U.E. El Manantial",80,0,3,0,82,24,20,2,1,212,2,10,224,235,0.387,0.953
"25285","Santa Cruz","Warnes","U.E. El Manantial",86,0,2,2,69,28,16,3,1,207,2,6,215,236,0.333,0.911
"25286","Santa Cruz","Warnes","U.E. El Manantial",80,4,3,2,85,19,12,0,1,206,1,9,216,234,0.413,0.923
"25287","Santa Cruz","Warnes","U.E. Campo Rosso 4 de Abril",76,0,1,0,88,21,18,0,1,205,0,8,213,238,0.429,0.895
"25288","Santa Cruz","Warnes","U.E. Campo Rosso 4 de Abril",64,1,0,0,101,20,18,3,0,207,1,2,210,236,0.488,0.89
"25289","Santa Cruz","Warnes","U.E. Campo Rosso 4 de Abril",52,0,3,0,107,11,24,2,3,202,1,6,209,236,0.53,0.886
"25290","Santa Cruz","Warnes","U.E. Campo Rosso 4 de Abril",50,0,0,0,81,20,20,1,1,173,2,43,218,238,0.468,0.916
"25291","Santa Cruz","Warnes","U.E. Campo Rosso 4 de Abril",72,1,1,0,91,21,17,0,0,203,2,6,211,234,0.448,0.902
"25292","Santa Cruz","Warnes","U.E. Campo Rosso 4 de Abril",60,1,1,0,92,20,22,1,5,202,5,8,215,234,0.455,0.919
"25293","Santa Cruz","Warnes","U.E. Campo Rosso 4 de Abril",82,0,1,0,86,19,20,1,2,211,0,8,219,240,0.408,0.912
"25294","Santa Cruz","Warnes","U.E. Campo Rosso 4 de Abril",81,0,0,1,77,21,26,0,0,206,0,5,211,233,0.374,0.906
"25295","Santa Cruz","Warnes","U.E. Campo Rosso 4 de Abril",90,0,3,0,63,20,24,0,3,203,1,6,210,234,0.31,0.897
"25296","Santa Cruz","Warnes","U.E. Campo Rosso 4 de Abril",63,1,2,1,90,15,18,2,0,192,0,9,201,220,0.469,0.914
"25297","Santa Cruz","Warnes","26 de Marzo",52,0,1,2,111,15,24,0,1,206,2,12,220,237,0.539,0.928
"25298","Santa Cruz","Warnes","26 de Marzo",64,0,2,1,96,25,18,1,1,208,3,4,215,239,0.462,0.9
"25299","Santa Cruz","Warnes","U.E. Maximo Novillo",53,0,2,0,111,14,28,0,0,208,1,5,214,239,0.534,0.895
"25300","Santa Cruz","Warnes","U.E. Maximo Novillo",74,0,0,0,92,20,24,0,3,213,0,10,223,237,0.432,0.941
"25301","Santa Cruz","Warnes","U.E. Maximo Novillo",62,1,0,0,116,21,17,1,0,218,1,9,228,238,0.532,0.958
"25302","Santa Cruz","Warnes","U.E. Maximo Novillo",36,0,2,0,137,13,17,0,1,206,4,12,222,235,0.665,0.945
"25303","Santa Cruz","Warnes","U.E. Maximo Novillo",68,0,0,0,103,13,22,0,1,207,3,8,218,238,0.498,0.916
"25304","Santa Cruz","Warnes","U.E. Maximo Novillo",50,1,2,1,122,17,18,0,1,212,5,6,223,239,0.575,0.933
"25305","Santa Cruz","Warnes","U.E. Maximo Novillo",58,0,0,0,113,15,16,1,0,203,2,9,214,236,0.557,0.907
"25306","Santa Cruz","Warnes","U.E. Maximo Novillo",51,0,1,1,125,8,20,2,1,209,2,11,222,239,0.598,0.929
"25307","Santa Cruz","Warnes","U.E. Maximo Novillo",63,0,1,0,114,20,14,1,0,213,2,7,222,238,0.535,0.933
"25308","Santa Cruz","Warnes","U.E. Maximo Novillo",67,2,2,2,101,24,14,1,0,213,0,10,223,234,0.474,0.953
"25309","Santa Cruz","Warnes","U.E. Maximo Novillo",69,0,2,1,85,23,24,1,1,206,3,12,221,237,0.413,0.932
"25310","Santa Cruz","Warnes","U.E. Maximo Novillo",46,1,0,0,124,10,23,2,1,207,3,5,215,235,0.599,0.915
"25311","Santa Cruz","Warnes","U.E. Maximo Novillo",51,0,0,3,98,27,25,3,0,207,2,15,224,239,0.473,0.937
"25312","Santa Cruz","Warnes","U.E. Maximo Novillo",76,1,1,1,100,19,13,0,1,212,2,3,217,234,0.472,0.927
"25313","Santa Cruz","Warnes","U.E. Maximo Novillo",76,0,1,2,94,14,26,2,0,215,0,10,225,238,0.437,0.945
"25314","Santa Cruz","Warnes","U.E. Maximo Novillo",48,0,0,0,122,11,18,0,0,199,0,10,209,225,0.613,0.929
"25315","Santa Cruz","Warnes","U.E. Juancito Pinto",46,0,2,2,115,19,28,2,3,217,0,5,222,238,0.53,0.933
"25316","Santa Cruz","Warnes","U.E. Juancito Pinto",56,1,1,1,110,21,20,0,0,210,2,6,218,240,0.524,0.908
"25317","Santa Cruz","Warnes","U.E. Juancito Pinto",55,0,2,1,112,12,21,0,5,208,1,6,215,238,0.538,0.903
"25318","Santa Cruz","Warnes","U.E. Juancito Pinto",57,1,0,0,103,11,25,0,1,198,1,11,210,237,0.52,0.886
"25319","Santa Cruz","Warnes","U.E. Juancito Pinto",62,0,0,0,95,23,28,1,0,209,2,5,216,238,0.455,0.908
"25320","Santa Cruz","Warnes","U.E. Juancito Pinto",51,0,0,1,99,14,15,0,0,180,0,9,189,202,0.55,0.936
"25321","Santa Cruz","Warnes","U.E. Satelite Norte",85,1,0,0,84,10,23,2,0,205,4,8,217,238,0.41,0.912
"25322","Santa Cruz","Warnes","U.E. Satelite Norte",51,0,1,2,100,20,26,1,1,202,4,1,207,234,0.495,0.885
"25323","Santa Cruz","Warnes","U.E. Satelite Norte",55,0,1,0,100,15,23,2,1,197,1,10,208,231,0.508,0.9
"25324","Santa Cruz","Warnes","U.E. Satelite Norte",85,0,2,0,79,16,21,1,0,204,1,7,212,236,0.387,0.898
"25325","Santa Cruz","Warnes","U.E. Satelite Norte",69,1,0,0,96,19,28,1,0,214,3,3,220,237,0.449,0.928
"25326","Santa Cruz","Warnes","U.E. Satelite Norte",87,2,3,0,85,11,16,1,0,205,1,29,235,235,0.415,1
"25327","Santa Cruz","Warnes","U.E. Satelite Norte",76,0,2,1,84,16,18,1,3,201,1,6,208,236,0.418,0.881
"25328","Santa Cruz","Warnes","U.E. Satelite Norte",67,1,0,2,100,29,23,1,1,224,2,3,229,249,0.446,0.92
"25329","Santa Cruz","Warnes","U.E. Nueva Jerusalen-Pentaguazu",61,0,2,2,79,23,18,0,0,185,30,4,219,239,0.427,0.916
"25330","Santa Cruz","Warnes","U.E. Nueva Jerusalen-Pentaguazu",54,0,0,1,107,13,30,0,1,206,4,4,214,238,0.519,0.899
"25331","Santa Cruz","Warnes","U.E. Nueva Jerusalen-Pentaguazu",77,0,0,0,95,18,18,2,1,211,2,4,217,236,0.45,0.919
"25332","Santa Cruz","Warnes","U.E. Nueva Jerusalen-Pentaguazu",70,0,0,0,103,13,23,2,2,213,3,5,221,237,0.484,0.932
"25333","Santa Cruz","Warnes","U.E. Nueva Jerusalen-Pentaguazu",73,1,0,0,93,18,29,1,1,216,1,7,224,239,0.431,0.937
"25334","Santa Cruz","Warnes","U.E. Nueva Jerusalen-Pentaguazu",76,0,0,0,92,21,17,1,0,207,4,7,218,237,0.444,0.92
"25335","Santa Cruz","Warnes","Politecnico Pentaguazu",74,0,0,0,90,23,19,2,0,208,3,11,222,232,0.433,0.957
"25336","Santa Cruz","Warnes","Esc. Fiscal Potrero Largo",71,0,1,0,104,26,10,1,0,213,1,3,217,233,0.488,0.931
"25337","Santa Cruz","Warnes","Esc. Fiscal Potrero Largo",74,0,0,0,71,19,9,1,0,174,3,14,191,230,0.408,0.83
"25338","Santa Cruz","Warnes","Esc. Fiscal Potrero Largo",58,0,2,0,117,13,19,0,2,211,0,4,215,237,0.555,0.907
"25339","Santa Cruz","Warnes","Esc. Fiscal Potrero Largo",46,1,2,0,116,21,15,2,2,205,1,2,208,231,0.566,0.9
"25340","Santa Cruz","Warnes","Esc. Fiscal Potrero Largo",59,1,0,1,107,15,18,1,0,202,4,10,216,231,0.53,0.935
"25341","Santa Cruz","Warnes","Esc. Fiscal Potrero Largo",68,0,0,0,100,18,17,0,0,203,5,7,215,236,0.493,0.911
"25342","Santa Cruz","Warnes","Esc. Fiscal Potrero Largo",59,1,0,0,105,18,17,0,1,201,3,4,208,228,0.522,0.912
"25343","Santa Cruz","Warnes","Esc. Fiscal Potrero Largo",53,2,0,1,120,6,24,0,0,206,2,5,213,233,0.583,0.914
"25344","Santa Cruz","Warnes","Esc. Fiscal Potrero Largo",81,0,0,1,89,24,8,1,0,204,1,8,213,231,0.436,0.922
"25345","Santa Cruz","Warnes","Esc. Fiscal Potrero Largo",62,2,0,0,92,25,26,1,3,211,0,4,215,234,0.436,0.919
"25346","Santa Cruz","Warnes","Esc. Fiscal Potrero Largo",73,0,0,1,84,17,23,0,0,198,1,9,208,232,0.424,0.897
"25347","Santa Cruz","Warnes","Esc. Fiscal Potrero Largo",69,0,0,0,94,19,15,2,0,199,4,5,208,234,0.472,0.889
"25348","Santa Cruz","Warnes","Esc. Fiscal Potrero Largo",67,0,1,0,83,24,24,0,1,200,0,6,206,226,0.415,0.912
"25349","Santa Cruz","Warnes","Esc. Fiscal Potrero Largo",64,0,0,1,88,24,18,0,1,196,1,11,208,229,0.449,0.908
"25350","Santa Cruz","Warnes","Esc. Fiscal Potrero Largo",68,2,1,0,96,21,23,0,0,211,1,3,215,237,0.455,0.907
"25351","Santa Cruz","Warnes","Esc. Fiscal Potrero Largo",51,1,0,2,103,18,17,1,0,193,4,8,205,230,0.534,0.891
"25352","Santa Cruz","Warnes","Esc. Unid. Edu. 21 De Octubre",16,0,1,0,158,9,16,0,1,201,2,7,210,228,0.786,0.921
"25353","Santa Cruz","Warnes","U.E. Buena Fe",42,0,1,0,138,13,17,0,2,213,3,4,220,235,0.648,0.936
"25354","Santa Cruz","Warnes","U.E. Buena Fe",26,1,0,2,156,11,20,0,1,217,1,7,225,238,0.719,0.945
"25355","Santa Cruz","Warnes","U.E. Buena Fe",48,1,0,0,140,8,15,0,0,212,3,4,219,237,0.66,0.924
"25356","Santa Cruz","Warnes","U.E. Buena Fe",37,0,0,0,138,12,23,0,1,211,4,1,216,233,0.654,0.927
"25357","Santa Cruz","Warnes","U.E. Buena Fe",28,0,0,0,151,13,15,0,1,208,3,5,216,235,0.726,0.919
"25358","Santa Cruz","Warnes","U.E. Buena Fe",36,1,0,1,145,9,18,1,0,211,1,7,219,237,0.687,0.924
"25359","Santa Cruz","Warnes","U.E. Buena Fe",39,0,0,0,133,15,19,1,1,208,2,9,219,238,0.639,0.92
"25360","Santa Cruz","Okinawa Uno","Esc. Unidad Educativa Nueva Esperanza",73,0,0,0,80,23,12,0,0,188,9,4,201,227,0.426,0.885
"25361","Santa Cruz","Okinawa Uno","Esc. Unid. Edu. Seccional Puerto Nuevo",91,1,1,3,40,31,5,0,2,174,6,10,190,224,0.23,0.848
"25362","Santa Cruz","Okinawa Uno","Escuela Unid. Edu.Nuevo Horizonte",87,2,1,2,44,34,10,0,0,180,5,5,190,224,0.244,0.848
"25363","Santa Cruz","Okinawa Uno","Escuela Unid. Edu.Nuevo Horizonte",86,3,0,1,55,43,14,7,0,209,1,4,214,224,0.263,0.955
"25364","Santa Cruz","Okinawa Uno","Escuela Unid. Edu.Nuevo Horizonte",89,3,2,1,46,37,13,1,0,192,2,9,203,226,0.24,0.898
"25365","Santa Cruz","Okinawa Uno","Escuela Unid. Edu.Nuevo Horizonte",91,0,0,0,56,27,7,1,1,183,5,14,202,227,0.306,0.89
"25366","Santa Cruz","Okinawa Uno","Escuela Unid. Edu.Nuevo Horizonte",94,0,0,0,40,41,8,4,0,187,4,7,198,218,0.214,0.908
"25367","Santa Cruz","Okinawa Uno","Escuela Colegio Evangelico Metodista",82,1,0,0,46,32,9,0,1,171,6,13,190,216,0.269,0.88
"25368","Santa Cruz","Okinawa Uno","Escuela Colegio Evangelico Metodista",108,1,0,1,48,18,7,1,2,186,5,6,197,226,0.258,0.872
"25369","Santa Cruz","Okinawa Uno","Escuela Colegio Evangelico Metodista",98,0,1,0,56,23,11,1,1,191,3,10,204,232,0.293,0.879
"25370","Santa Cruz","Okinawa Uno","Escuela Colegio Evangelico Metodista",73,4,0,0,71,23,16,1,0,188,3,11,202,229,0.378,0.882
"25371","Santa Cruz","Okinawa Uno","Escuela Colegio Evangelico Metodista",81,1,0,1,76,27,12,2,0,200,3,8,211,236,0.38,0.894
"25372","Santa Cruz","Okinawa Uno","Escuela Colegio Evangelico Metodista",80,0,0,0,72,18,19,0,0,189,3,8,200,232,0.381,0.862
"25373","Santa Cruz","Okinawa Uno","Escuela Colegio Evangelico Metodista",93,0,0,1,50,22,17,2,0,185,1,10,196,223,0.27,0.879
"25374","Santa Cruz","Okinawa Uno","Escuela Colegio Evangelico Metodista",118,1,0,0,36,29,5,2,0,191,1,12,204,228,0.188,0.895
"25375","Santa Cruz","Okinawa Uno","Escuela Colegio Evangelico Metodista",76,1,0,1,68,27,13,2,0,188,1,9,198,231,0.362,0.857
"25376","Santa Cruz","Okinawa Uno","Escuela Colegio Evangelico Metodista",82,0,2,0,56,36,12,1,0,189,3,7,199,229,0.296,0.869
"25377","Santa Cruz","Okinawa Uno","Escuela Colegio Evangelico Metodista",104,1,0,1,48,23,13,0,0,190,4,4,198,223,0.253,0.888
"25378","Santa Cruz","Okinawa Uno","Escuela Colegio Evangelico Metodista",92,1,0,1,49,28,8,1,1,181,1,14,196,224,0.271,0.875
"25379","Santa Cruz","Okinawa Uno","Escuela Colegio Evangelico Metodista",95,4,0,1,70,22,12,3,0,207,0,4,211,228,0.338,0.925
"25380","Santa Cruz","Okinawa Uno","Escuela Colegio Evangelico Metodista",88,0,1,0,61,29,8,0,1,188,5,10,203,230,0.324,0.883
"25381","Santa Cruz","Okinawa Uno","Escuela Colegio Evangelico Metodista",98,1,0,0,49,19,9,3,1,180,2,21,203,226,0.272,0.898
"25382","Santa Cruz","Okinawa Uno","Escuela Colegio Evangelico Metodista",45,0,2,0,35,65,3,3,1,154,37,6,197,219,0.227,0.9
"25383","Santa Cruz","Okinawa Uno","Escuela Colegio Evangelico Metodista",108,1,0,0,42,28,6,0,0,185,2,12,199,217,0.227,0.917
"25384","Santa Cruz","Okinawa Uno","Escuela Colegio Evangelico Metodista",89,0,0,0,60,30,6,0,3,188,2,8,198,229,0.319,0.865
"25385","Santa Cruz","Okinawa Uno","Esc. Unid. Edu. San Miguel",52,2,1,0,75,55,6,0,2,193,1,2,196,223,0.389,0.879
"25386","Santa Cruz","Okinawa Uno","Esc. Unid. Edu. San Miguel",48,2,0,0,74,46,5,0,2,177,3,10,190,225,0.418,0.844
"25387","Santa Cruz","San Ignacio","Esc. Mariscal Sucre",105,0,0,0,24,32,12,5,0,178,0,4,182,220,0.135,0.827
"25388","Santa Cruz","San Ignacio","Esc. Mariscal Sucre",111,1,0,0,31,27,10,1,0,181,2,5,188,224,0.171,0.839
"25389","Santa Cruz","San Ignacio","Esc. Mariscal Sucre",109,2,0,1,26,32,6,2,8,186,2,8,196,228,0.14,0.86
"25390","Santa Cruz","San Ignacio","Esc. Mariscal Sucre",111,0,0,1,25,31,10,3,2,183,2,5,190,236,0.137,0.805
"25391","Santa Cruz","San Ignacio","Esc. Mariscal Sucre",105,2,1,1,26,31,7,2,0,175,4,13,192,227,0.149,0.846
"25392","Santa Cruz","San Ignacio","Esc. Mariscal Sucre",82,0,0,0,41,38,12,6,1,180,2,3,185,228,0.228,0.811
"25393","Santa Cruz","San Ignacio","Esc. Mariscal Sucre",104,1,0,1,33,35,7,2,1,184,5,2,191,221,0.179,0.864
"25394","Santa Cruz","San Ignacio","Esc. Mariscal Sucre",97,0,0,0,27,43,0,10,0,177,5,0,182,224,0.153,0.812
"25395","Santa Cruz","San Ignacio","Esc. Mariscal Sucre",114,0,0,2,29,42,2,5,0,194,2,5,201,233,0.149,0.863
"25396","Santa Cruz","San Ignacio","Esc. Mariscal Sucre",92,0,1,1,47,20,6,2,2,171,4,6,181,220,0.275,0.823
"25397","Santa Cruz","San Ignacio","Esc. Mariscal Sucre",75,2,0,0,33,49,9,4,0,172,4,8,184,232,0.192,0.793
"25398","Santa Cruz","San Ignacio","Esc. Mariscal Sucre",82,1,0,0,35,47,8,7,1,181,7,11,199,229,0.193,0.869
"25399","Santa Cruz","San Ignacio","Esc. Mariscal Sucre",121,0,0,1,16,35,6,5,1,185,3,7,195,223,0.086,0.874
"25400","Santa Cruz","San Ignacio","Esc. Mariscal Sucre",89,0,2,1,35,42,8,5,1,183,3,8,194,227,0.191,0.855
"25401","Santa Cruz","San Ignacio","Esc. Mariscal Sucre",92,1,0,2,36,42,8,4,2,187,6,6,199,228,0.193,0.873
"25402","Santa Cruz","San Ignacio","Esc. Mariscal Sucre",113,1,1,1,30,35,5,8,1,195,2,3,200,228,0.154,0.877
"25403","Santa Cruz","San Ignacio","Esc. Mariscal Sucre",97,0,0,1,36,34,7,5,1,181,4,10,195,228,0.199,0.855
"25404","Santa Cruz","San Ignacio","Esc. Mariscal Sucre",118,0,0,0,27,36,5,6,1,193,2,4,199,231,0.14,0.861
"25405","Santa Cruz","San Ignacio","Esc. Mariscal Sucre",102,0,0,0,36,29,11,4,1,183,2,6,191,227,0.197,0.841
"25406","Santa Cruz","San Ignacio","Esc. Mariscal Sucre",92,0,1,1,30,43,17,4,0,188,3,6,197,232,0.16,0.849
"25407","Santa Cruz","San Ignacio","Esc. Mariscal Sucre",102,0,0,2,27,50,7,4,1,193,9,2,204,229,0.14,0.891
"25408","Santa Cruz","San Ignacio","Esc. Mariscal Sucre",84,1,0,0,27,45,11,4,2,174,4,4,182,229,0.155,0.795
"25409","Santa Cruz","San Ignacio","Esc. Mariscal Sucre",95,0,0,0,37,33,7,4,1,177,7,7,191,232,0.209,0.823
"25410","Santa Cruz","San Ignacio","Esc. Mariscal Sucre",85,0,0,2,32,45,9,4,1,178,9,3,190,233,0.18,0.815
"25411","Santa Cruz","San Ignacio","Esc. Carlos Mayser",108,1,1,1,20,36,13,4,2,186,2,14,202,228,0.108,0.886
"25412","Santa Cruz","San Ignacio","Esc. Carlos Mayser",95,1,0,1,35,46,8,5,0,191,4,5,200,225,0.183,0.889
"25413","Santa Cruz","San Ignacio","Esc. Carlos Mayser",102,2,0,0,28,49,8,3,0,192,1,7,200,223,0.146,0.897
"25414","Santa Cruz","San Ignacio","Esc. Carlos Mayser",106,0,0,1,23,35,7,9,0,181,11,8,200,229,0.127,0.873
"25415","Santa Cruz","San Ignacio","Esc. Carlos Mayser",111,1,1,0,30,31,11,5,1,191,5,8,204,230,0.157,0.887
"25416","Santa Cruz","San Ignacio","Esc. Carlos Mayser",101,0,1,1,26,40,6,2,0,177,7,13,197,225,0.147,0.876
"25417","Santa Cruz","San Ignacio","Esc. Carlos Mayser",96,0,0,1,42,38,6,9,0,192,3,2,197,230,0.219,0.857
"25418","Santa Cruz","San Ignacio","Esc. Carlos Mayser",104,0,0,0,38,32,11,4,2,191,4,7,202,227,0.199,0.89
"25419","Santa Cruz","San Ignacio","Esc. Carlos Mayser",74,2,0,0,42,41,10,4,2,175,7,10,192,216,0.24,0.889
"25420","Santa Cruz","San Ignacio","Esc. Carlos Mayser",104,0,0,1,29,53,2,2,1,192,5,6,203,226,0.151,0.898
"25421","Santa Cruz","San Ignacio","Esc. Carlos Mayser",95,1,1,2,39,40,6,5,1,190,7,5,202,228,0.205,0.886
"25422","Santa Cruz","San Ignacio","Esc. Carlos Mayser",85,1,0,0,40,44,12,5,1,188,3,9,200,226,0.213,0.885
"25423","Santa Cruz","San Ignacio","Esc. Carlos Mayser",99,0,0,2,30,38,10,3,2,184,6,6,196,225,0.163,0.871
"25424","Santa Cruz","San Ignacio","Esc. Carlos Mayser",88,0,1,2,32,37,5,5,0,170,8,15,193,225,0.188,0.858
"25425","Santa Cruz","San Ignacio","Esc. Carlos Mayser",113,0,0,1,32,29,9,6,2,192,5,7,204,231,0.167,0.883
"25426","Santa Cruz","San Ignacio","Esc. Carlos Mayser",90,1,0,0,36,33,13,4,2,179,7,12,198,225,0.201,0.88
"25427","Santa Cruz","San Ignacio","Esc. Carlos Mayser",90,1,0,1,27,49,3,6,0,177,9,11,197,229,0.153,0.86
"25428","Santa Cruz","San Ignacio","Esc. Carlos Mayser",92,2,0,1,43,35,13,5,1,192,1,12,205,228,0.224,0.899
"25429","Santa Cruz","San Ignacio","Esc. Carlos Mayser",113,1,0,1,30,39,4,3,1,192,4,7,203,226,0.156,0.898
"25430","Santa Cruz","San Ignacio","Esc. Lic. Senoritas Monsenor Daniel Rive",109,3,0,0,26,42,2,10,0,192,3,6,201,224,0.135,0.897
"25431","Santa Cruz","San Ignacio","Esc. Lic. Senoritas Monsenor Daniel Rive",107,0,0,1,11,47,10,5,0,181,2,7,190,228,0.061,0.833
"25432","Santa Cruz","San Ignacio","Esc. Lic. Senoritas Monsenor Daniel Rive",103,0,0,0,29,45,14,4,2,197,4,3,204,229,0.147,0.891
"25433","Santa Cruz","San Ignacio","Esc. Lic. Senoritas Monsenor Daniel Rive",111,0,1,1,11,49,6,11,0,190,1,9,200,233,0.058,0.858
"25434","Santa Cruz","San Ignacio","Esc. Lic. Senoritas Monsenor Daniel Rive",105,2,1,0,12,51,9,10,1,191,9,2,202,230,0.063,0.878
"25435","Santa Cruz","San Ignacio","Esc. Lic. Senoritas Monsenor Daniel Rive",102,0,2,2,25,35,6,13,0,185,8,8,201,225,0.135,0.893
"25436","Santa Cruz","San Ignacio","Esc. Lic. Senoritas Monsenor Daniel Rive",104,0,0,1,25,33,13,9,1,186,4,3,193,226,0.134,0.854
"25437","Santa Cruz","San Ignacio","Esc. Lic. Senoritas Monsenor Daniel Rive",127,0,0,1,7,40,5,9,0,189,2,5,196,226,0.037,0.867
"25438","Santa Cruz","San Ignacio","Esc. Lic. Senoritas Monsenor Daniel Rive",116,0,1,0,21,29,11,7,1,186,3,7,196,222,0.113,0.883
"25439","Santa Cruz","San Ignacio","Esc. Lic. Senoritas Monsenor Daniel Rive",115,1,0,1,21,41,10,3,1,193,4,4,201,234,0.109,0.859
"25440","Santa Cruz","San Ignacio","Esc. Lic. Senoritas Monsenor Daniel Rive",123,1,0,1,25,27,5,10,0,192,1,0,193,225,0.13,0.858
"25441","Santa Cruz","San Ignacio","Esc. Lic. Senoritas Monsenor Daniel Rive",98,0,1,0,44,27,9,8,0,187,6,9,202,233,0.235,0.867
"25442","Santa Cruz","San Ignacio","Esc. Lic. Senoritas Monsenor Daniel Rive",113,1,2,0,17,37,3,6,0,179,11,13,203,229,0.095,0.886
"25443","Santa Cruz","San Ignacio","Esc. Lic. Senoritas Monsenor Daniel Rive",104,0,0,1,35,33,5,10,0,188,2,11,201,224,0.186,0.897
"25444","Santa Cruz","San Ignacio","Esc. Lic. Senoritas Monsenor Daniel Rive",100,2,1,0,29,40,4,8,0,184,6,5,195,225,0.158,0.867
"25445","Santa Cruz","San Ignacio","Esc. Lic. Senoritas Monsenor Daniel Rive",87,3,0,0,30,52,4,15,0,191,6,5,202,232,0.157,0.871
"25446","Santa Cruz","San Ignacio","Esc. Lic. Senoritas Monsenor Daniel Rive",100,2,1,1,19,43,12,5,1,184,2,7,193,221,0.103,0.873
"25447","Santa Cruz","San Ignacio","Esc. Lic. Senoritas Monsenor Daniel Rive",112,0,2,3,17,41,8,4,0,187,2,11,200,226,0.091,0.885
"25448","Santa Cruz","San Ignacio","Esc. Lic. Senoritas Monsenor Daniel Rive",79,0,0,2,25,48,17,14,0,185,0,9,194,221,0.135,0.878
"25449","Santa Cruz","San Ignacio","Esc. Lic. Senoritas Monsenor Daniel Rive",110,1,0,1,25,33,12,8,0,190,0,8,198,224,0.132,0.884
"25450","Santa Cruz","San Ignacio","Esc. Lic. Senoritas Monsenor Daniel Rive",126,3,0,1,22,44,4,5,0,205,2,5,212,231,0.107,0.918
"25451","Santa Cruz","San Ignacio","Esc. Lic. Senoritas Monsenor Daniel Rive",106,2,1,1,29,25,7,4,1,176,7,7,190,225,0.165,0.844
"25452","Santa Cruz","San Ignacio","Esc. Lic. Senoritas Monsenor Daniel Rive",97,1,1,0,32,34,10,9,0,184,3,11,198,230,0.174,0.861
"25453","Santa Cruz","San Ignacio","Esc. Lic. Senoritas Monsenor Daniel Rive",101,2,0,2,17,38,12,11,0,183,4,10,197,227,0.093,0.868
"25454","Santa Cruz","San Ignacio","Esc. Lic. Senoritas Monsenor Daniel Rive",96,1,1,2,17,46,3,8,1,175,4,10,189,224,0.097,0.844
"25455","Santa Cruz","San Ignacio","Esc. Lic. Senoritas Monsenor Daniel Rive",85,2,1,1,21,57,6,5,1,179,8,9,196,228,0.117,0.86
"25456","Santa Cruz","San Ignacio","Esc. Lic. Senoritas Monsenor Daniel Rive",115,0,0,1,32,30,11,11,0,200,1,8,209,231,0.16,0.905
"25457","Santa Cruz","San Ignacio","Esc. Don Bosco",95,0,1,0,45,22,14,3,0,180,1,8,189,221,0.25,0.855
"25458","Santa Cruz","San Ignacio","Esc. Don Bosco",92,0,1,2,58,22,21,1,0,197,4,7,208,234,0.294,0.889
"25459","Santa Cruz","San Ignacio","Esc. Don Bosco",100,0,0,0,51,29,9,8,0,197,10,10,217,231,0.259,0.939
"25460","Santa Cruz","San Ignacio","Esc. Don Bosco",83,0,0,0,53,34,17,0,0,187,5,6,198,227,0.283,0.872
"25461","Santa Cruz","San Ignacio","Esc. Don Bosco",78,0,0,1,48,37,13,6,1,184,7,7,198,227,0.261,0.872
"25462","Santa Cruz","San Ignacio","Esc. Don Bosco",70,0,1,1,72,25,17,3,2,191,5,5,201,225,0.377,0.893
"25463","Santa Cruz","San Ignacio","Esc. Don Bosco",100,0,0,0,45,30,20,4,0,199,3,5,207,232,0.226,0.892
"25464","Santa Cruz","San Ignacio","Esc. Don Bosco",75,0,3,1,66,29,16,6,1,197,5,9,211,234,0.335,0.902
"25465","Santa Cruz","San Ignacio","Esc. Don Bosco",95,0,0,1,48,25,19,4,0,192,5,11,208,234,0.25,0.889
"25466","Santa Cruz","San Ignacio","Esc. Don Bosco",72,0,0,3,43,52,15,6,2,193,8,8,209,236,0.223,0.886
"25467","Santa Cruz","San Ignacio","Esc. Don Bosco",99,1,0,1,32,48,13,4,0,198,3,5,206,232,0.162,0.888
"25468","Santa Cruz","San Ignacio","Esc. Don Bosco",87,1,2,1,49,43,9,4,1,197,3,9,209,233,0.249,0.897
"25469","Santa Cruz","San Ignacio","Esc. Don Bosco",102,1,1,2,43,31,13,2,0,195,3,8,206,229,0.221,0.9
"25470","Santa Cruz","San Ignacio","Esc. Don Bosco",105,0,0,0,54,30,14,6,0,209,3,4,216,234,0.258,0.923
"25471","Santa Cruz","San Ignacio","Esc. Don Bosco",80,1,0,2,45,38,10,4,1,181,5,11,197,231,0.249,0.853
"25472","Santa Cruz","San Ignacio","Esc. Don Bosco",67,0,0,0,32,68,0,8,0,175,25,0,200,230,0.183,0.87
"25473","Santa Cruz","San Ignacio","Esc. Don Bosco",74,3,1,0,59,24,8,7,0,176,0,12,188,212,0.335,0.887
"25474","Santa Cruz","San Ignacio","Esc. El Carmen De Ruiz",106,2,1,5,22,24,3,25,2,190,5,11,206,232,0.116,0.888
"25475","Santa Cruz","San Ignacio","Esc. El Carmen De Ruiz",86,2,4,5,16,35,2,25,2,177,18,2,197,225,0.09,0.876
"25476","Santa Cruz","San Ignacio","Esc. Nucleo Central Espiritu",75,1,2,1,20,25,4,27,1,156,8,12,176,223,0.128,0.789
"25477","Santa Cruz","San Ignacio","Esc. Campamento",53,4,3,0,29,64,9,16,0,178,14,7,199,227,0.163,0.877
"25478","Santa Cruz","San Ignacio","Esc. Campamento",43,1,1,1,50,44,3,15,1,159,14,14,187,228,0.314,0.82
"25479","Santa Cruz","San Ignacio","Esc. San Vicente",61,1,1,2,67,28,2,10,1,173,20,5,198,228,0.387,0.868
"25480","Santa Cruz","San Ignacio","Esc. Santa Ana",120,3,0,0,11,15,5,11,1,166,7,6,179,220,0.066,0.814
"25481","Santa Cruz","San Ignacio","Esc. Santa Ana",143,0,1,3,13,12,1,15,2,190,7,6,203,224,0.068,0.906
"25482","Santa Cruz","San Ignacio","Esc. Santa Rosa Roca",57,2,1,0,92,24,13,2,2,193,4,2,199,235,0.477,0.847
"25483","Santa Cruz","San Ignacio","Esc. Santa Rosa Roca",34,1,2,1,105,17,3,7,0,170,10,11,191,226,0.618,0.845
"25484","Santa Cruz","San Ignacio","Esc. Santa Rosa Roca",51,4,1,0,79,16,7,2,0,160,8,4,172,234,0.494,0.735
"25485","Santa Cruz","San Ignacio","Esc. Santa Rosa Roca",38,4,0,1,85,24,17,4,1,174,9,7,190,228,0.489,0.833
"25486","Santa Cruz","San Ignacio","Esc. Santa Rosa Roca",42,1,1,0,92,28,14,9,0,187,9,10,206,232,0.492,0.888
"25487","Santa Cruz","San Ignacio","Esc. Santa Rosa Roca",38,2,1,1,96,34,4,7,0,183,13,8,204,231,0.525,0.883
"25488","Santa Cruz","San Ignacio","Esc. Santa Rosa Roca",42,0,1,0,87,37,10,1,0,178,8,6,192,232,0.489,0.828
"25489","Santa Cruz","San Ignacio","Esc. Santa Rosa Roca",33,1,1,3,103,21,4,9,0,175,10,12,197,231,0.589,0.853
"25490","Santa Cruz","San Ignacio","Esc. San Martin",5,0,0,0,187,4,16,1,1,214,1,3,218,236,0.874,0.924
"25491","Santa Cruz","San Ignacio","Esc. San Martin",1,0,1,0,188,3,17,0,1,211,3,1,215,233,0.891,0.923
"25492","Santa Cruz","San Ignacio","Esc. San Martin",9,0,0,0,174,2,15,2,1,203,3,3,209,230,0.857,0.909
"25493","Santa Cruz","San Ignacio","Esc. San Martin",6,0,0,0,188,2,9,0,0,205,2,1,208,234,0.917,0.889
"25494","Santa Cruz","San Ignacio","Esc. San Martin",6,0,0,0,183,2,10,0,1,202,2,0,204,225,0.906,0.907
"25495","Santa Cruz","San Ignacio","Esc. U.E. La Estrella",9,0,0,0,183,6,10,2,1,211,9,6,226,233,0.867,0.97
"25496","Santa Cruz","San Ignacio","Esc. U.E. La Estrella",8,1,1,1,166,11,4,4,2,198,5,18,221,236,0.838,0.936
"25497","Santa Cruz","San Ignacio","Esc. U.E. La Estrella",1,1,1,0,129,17,2,0,0,151,9,3,163,178,0.854,0.916
"25498","Santa Cruz","San Ignacio","15 de Agosto",6,0,1,0,174,0,6,0,0,187,3,1,191,204,0.93,0.936
"25499","Santa Cruz","San Ignacio","U.E. Tierra Firme",7,0,1,1,189,1,6,1,0,206,2,4,212,236,0.917,0.898
"25500","Santa Cruz","San Ignacio","U.E. Celedonio Cortezon",108,0,0,3,9,25,1,62,0,208,5,16,229,235,0.043,0.974
"25501","Santa Cruz","San Ignacio","U.E. Tarcila Justiniano",86,4,2,2,20,23,5,21,0,163,11,12,186,193,0.123,0.964
"25502","Santa Cruz","San Ignacio","U.E. San Javierito",23,3,1,1,41,97,5,14,3,188,4,32,224,236,0.218,0.949
"25503","Santa Cruz","San Ignacio","U.E. San Javierito",28,5,3,1,35,64,9,20,4,169,11,29,209,221,0.207,0.946
"25504","Santa Cruz","San Ignacio","U.E. San Rafaelito de Suponema",117,1,1,0,3,22,1,6,0,151,1,10,162,170,0.02,0.953
"25505","Santa Cruz","San Ignacio","U.E. San Lorencito de La Frontera",73,2,5,2,32,39,0,2,0,155,3,8,166,186,0.206,0.892
"25506","Santa Cruz","San Ignacio","U. E. Tupac Katari",10,0,1,0,203,2,6,0,1,223,14,1,238,238,0.91,1
"25507","Santa Cruz","San Ignacio","U.E.Tierra Hermosa",0,0,0,0,186,0,3,3,0,192,2,3,197,203,0.969,0.97
"25508","Santa Cruz","San Miguel","Esc. Belisario Santisteban",75,0,0,1,103,15,3,1,1,199,2,13,214,232,0.518,0.922
"25509","Santa Cruz","San Miguel","Esc. Belisario Santisteban",80,1,1,1,83,8,3,2,0,179,1,17,197,230,0.464,0.857
"25510","Santa Cruz","San Miguel","Esc. Belisario Santisteban",82,0,0,0,88,16,1,1,1,189,0,12,201,233,0.466,0.863
"25511","Santa Cruz","San Miguel","Esc. Belisario Santisteban",51,0,2,2,113,5,3,4,0,180,9,7,196,231,0.628,0.848
"25512","Santa Cruz","San Miguel","Esc. Belisario Santisteban",66,2,1,0,105,21,2,1,0,198,2,8,208,230,0.53,0.904
"25513","Santa Cruz","San Miguel","Esc. Belisario Santisteban",47,2,0,0,102,13,3,4,0,171,4,18,193,227,0.596,0.85
"25514","Santa Cruz","San Miguel","Esc. Belisario Santisteban",43,3,1,0,124,11,4,0,0,186,6,16,208,231,0.667,0.9
"25515","Santa Cruz","San Miguel","Esc. Belisario Santisteban",71,2,3,2,89,11,2,3,0,183,3,11,197,234,0.486,0.842
"25516","Santa Cruz","San Miguel","Esc. Belisario Santisteban",78,0,2,0,85,10,5,1,1,182,9,13,204,227,0.467,0.899
"25517","Santa Cruz","San Miguel","Esc. Belisario Santisteban",53,0,2,1,121,11,0,1,0,189,1,9,199,236,0.64,0.843
"25518","Santa Cruz","San Miguel","Esc. Jose J.Dorado",84,1,1,1,88,11,2,1,2,191,2,10,203,237,0.461,0.857
"25519","Santa Cruz","San Miguel","Esc. Jose J.Dorado",92,0,0,1,73,12,5,0,0,183,4,12,199,226,0.399,0.881
"25520","Santa Cruz","San Miguel","Esc. Jose J.Dorado",126,1,1,0,43,11,3,1,0,186,0,8,194,217,0.231,0.894
"25521","Santa Cruz","San Miguel","Esc. Jose J.Dorado",120,2,0,2,59,12,4,0,0,199,0,7,206,229,0.296,0.9
"25522","Santa Cruz","San Miguel","Esc. Jose J.Dorado",97,1,0,0,71,7,6,2,0,184,2,11,197,229,0.386,0.86
"25523","Santa Cruz","San Miguel","Esc. Jose J.Dorado",84,2,1,2,93,12,1,1,1,197,1,4,202,229,0.472,0.882
"25524","Santa Cruz","San Miguel","Esc. Jose J.Dorado",85,0,0,0,93,14,2,1,1,196,0,10,206,228,0.474,0.904
"25525","Santa Cruz","San Miguel","Esc. Jose J.Dorado",67,0,1,1,104,14,3,0,0,190,2,5,197,217,0.547,0.908
"25526","Santa Cruz","San Miguel","Esc. Jose J.Dorado",64,0,2,0,108,20,4,2,0,200,4,6,210,228,0.54,0.921
"25527","Santa Cruz","San Miguel","Esc. Jose J.Dorado",69,1,1,1,92,10,6,1,1,182,0,7,189,225,0.505,0.84
"25528","Santa Cruz","San Miguel","Esc. Jose J.Dorado",93,0,0,1,71,11,2,1,0,179,5,9,193,221,0.397,0.873
"25529","Santa Cruz","San Miguel","Esc. Jose J.Dorado",97,0,0,0,65,9,4,1,0,176,1,12,189,223,0.369,0.848
"25530","Santa Cruz","San Miguel","Esc. Jose J.Dorado",81,1,0,2,80,14,3,3,2,186,6,7,199,225,0.43,0.884
"25531","Santa Cruz","San Miguel","Esc. Monseñor Bonifacio",63,2,0,1,79,20,4,1,4,174,30,6,210,236,0.454,0.89
"25532","Santa Cruz","San Miguel","Esc. Monseñor Bonifacio",32,0,0,0,97,20,4,2,1,156,33,8,197,229,0.622,0.86
"25533","Santa Cruz","San Miguel","U.E. Sapoco",46,0,0,2,148,5,10,1,0,212,2,13,227,235,0.698,0.966
"25534","Santa Cruz","San Rafael","Esc. Godofredo Trenker",90,0,0,0,63,22,4,2,1,182,3,7,192,233,0.346,0.824
"25535","Santa Cruz","San Rafael","Esc. Godofredo Trenker",78,0,1,4,43,43,6,3,1,179,6,5,190,234,0.24,0.812
"25536","Santa Cruz","San Rafael","Esc. Godofredo Trenker",99,1,1,0,53,26,3,0,0,183,2,8,193,232,0.29,0.832
"25537","Santa Cruz","San Rafael","Esc. Godofredo Trenker",129,1,0,0,40,14,1,1,1,187,3,8,198,233,0.214,0.85
"25538","Santa Cruz","San Rafael","Esc. Godofredo Trenker",90,0,0,1,52,28,5,6,0,182,8,5,195,228,0.286,0.855
"25539","Santa Cruz","San Rafael","Esc. Godofredo Trenker",113,0,1,0,39,28,2,5,0,188,2,6,196,229,0.207,0.856
"25540","Santa Cruz","San Rafael","Esc. Godofredo Trenker",81,2,0,0,66,31,8,2,1,191,3,6,200,233,0.346,0.858
"25541","Santa Cruz","San Rafael","Esc. Godofredo Trenker",114,1,2,0,30,38,4,3,0,192,2,14,208,235,0.156,0.885
"25542","Santa Cruz","San Rafael","Esc. Godofredo Trenker",90,0,0,0,39,34,7,5,1,176,4,9,189,230,0.222,0.822
"25543","Santa Cruz","San Rafael","Esc. Godofredo Trenker",112,0,0,0,57,22,3,2,1,197,3,3,203,233,0.289,0.871
"25544","Santa Cruz","San Rafael","Esc. El Tuna",92,0,0,2,55,4,0,4,1,158,5,12,175,214,0.348,0.818
"25545","Santa Cruz","San Rafael","Esc. Miraflores II",52,1,1,1,121,9,11,4,2,202,3,7,212,235,0.599,0.902
"25546","Santa Cruz","San Rafael","Esc. Miraflores II",44,0,0,0,129,5,17,1,2,198,0,8,206,238,0.652,0.866
"25547","Santa Cruz","Buena Vista","Esc. Mariano Saucedo Sevilla",60,0,0,4,71,23,22,1,0,181,8,12,201,230,0.392,0.874
"25548","Santa Cruz","Buena Vista","Esc. Mariano Saucedo Sevilla",74,0,0,1,69,25,13,0,0,182,5,8,195,228,0.379,0.855
"25549","Santa Cruz","Buena Vista","Esc. Mariano Saucedo Sevilla",53,1,0,0,80,38,11,1,1,185,4,9,198,225,0.432,0.88
"25550","Santa Cruz","Buena Vista","Esc. Mariano Saucedo Sevilla",68,0,1,0,63,40,9,4,0,185,3,11,199,228,0.341,0.873
"25551","Santa Cruz","Buena Vista","Esc. Mariano Saucedo Sevilla",52,0,0,0,75,31,14,2,1,175,2,7,184,228,0.429,0.807
"25552","Santa Cruz","Buena Vista","Esc. Mariano Saucedo Sevilla",52,0,1,1,77,29,18,2,0,180,2,11,193,228,0.428,0.846
"25553","Santa Cruz","Buena Vista","Esc. Mariano Saucedo Sevilla",61,0,0,0,59,31,27,1,0,179,1,10,190,222,0.33,0.856
"25554","Santa Cruz","Buena Vista","Esc. Mariano Saucedo Sevilla",60,0,1,0,76,29,14,1,0,181,3,5,189,227,0.42,0.833
"25555","Santa Cruz","Buena Vista","Esc. Mariano Saucedo Sevilla",58,1,0,0,85,26,15,2,0,187,3,9,199,231,0.455,0.861
"25556","Santa Cruz","Buena Vista","Esc. Mariano Saucedo Sevilla",77,0,0,1,58,35,13,2,0,186,4,4,194,225,0.312,0.862
"25557","Santa Cruz","Buena Vista","Esc. Mariano Saucedo Sevilla",72,1,0,0,70,32,15,1,0,191,1,4,196,219,0.366,0.895
"25558","Santa Cruz","Buena Vista","Esc. Ovidio Suarez",46,0,0,1,71,36,9,4,0,167,0,13,180,219,0.425,0.822
"25559","Santa Cruz","Buena Vista","Esc. Ovidio Suarez",64,0,1,0,72,32,13,0,0,182,0,5,187,214,0.396,0.874
"25560","Santa Cruz","Buena Vista","Esc. Ovidio Suarez",35,0,0,0,90,36,11,1,1,174,2,10,186,223,0.517,0.834
"25561","Santa Cruz","Buena Vista","Esc. Ovidio Suarez",62,2,0,0,77,36,7,1,1,186,3,6,195,224,0.414,0.871
"25562","Santa Cruz","Buena Vista","Esc. Ovidio Suarez",54,0,1,0,101,24,9,2,1,192,7,4,203,224,0.526,0.906
"25563","Santa Cruz","Buena Vista","Esc. Ovidio Suarez",43,0,3,1,98,25,18,0,0,188,2,2,192,222,0.521,0.865
"25564","Santa Cruz","Buena Vista","Esc. Ovidio Suarez",57,1,0,0,80,22,9,1,0,170,5,8,183,219,0.471,0.836
"25565","Santa Cruz","Buena Vista","Esc. Ovidio Suarez",36,0,0,0,88,27,14,0,0,165,5,12,182,215,0.533,0.847
"25566","Santa Cruz","Buena Vista","Esc. Ovidio Suarez",61,0,0,1,71,26,8,7,0,174,5,6,185,221,0.408,0.837
"25567","Santa Cruz","Buena Vista","Esc. Ovidio Suarez",58,1,0,0,71,30,11,2,0,173,2,3,178,218,0.41,0.817
"25568","Santa Cruz","Buena Vista","Esc. Eduardo Abaroa",16,0,1,2,149,9,10,0,0,187,1,4,192,223,0.797,0.861
"25569","Santa Cruz","Buena Vista","Esc. Eduardo Abaroa",20,3,0,0,142,13,15,1,0,194,6,10,210,226,0.732,0.929
"25570","Santa Cruz","Buena Vista","Esc. Eduardo Abaroa",19,2,1,1,140,5,18,1,0,187,5,6,198,228,0.749,0.868
"25571","Santa Cruz","Buena Vista","Esc. Eduardo Abaroa",36,0,2,0,141,15,12,0,2,208,2,1,211,222,0.678,0.95
"25572","Santa Cruz","Buena Vista","Esc. U.E. San Isidro",95,0,0,1,17,48,1,6,0,168,7,9,184,221,0.101,0.833
"25573","Santa Cruz","Buena Vista","Esc. U.E. Lucio  Perez",73,2,0,1,32,71,5,3,1,188,6,7,201,222,0.17,0.905
"25574","Santa Cruz","Buena Vista","Esc. U.E. Santo Esposorio",78,2,1,1,30,58,7,1,0,178,2,3,183,216,0.169,0.847
"25575","Santa Cruz","Buena Vista","Esc. Adhemar Ortiz",24,1,0,1,147,24,6,0,0,203,1,4,208,232,0.724,0.897
"25576","Santa Cruz","Buena Vista","Esc. U.E. Caranda",38,1,0,2,97,37,12,2,1,190,3,4,197,220,0.511,0.895
"25577","Santa Cruz","Buena Vista","Esc. U.E. Caranda",41,2,1,2,96,42,10,0,1,195,6,2,203,220,0.492,0.923
"25578","Santa Cruz","Buena Vista","Esc. U.E. Caranda",23,1,3,0,90,33,10,2,0,162,3,9,174,192,0.556,0.906
"25579","Santa Cruz","Buena Vista","Esc. U.E. Pedro Domingo Murillo",3,0,1,1,194,2,8,0,0,209,4,3,216,231,0.928,0.935
"25580","Santa Cruz","Buena Vista","Esc. U.E. Pedro Domingo Murillo",6,0,1,1,177,5,7,0,0,197,3,1,201,224,0.898,0.897
"25581","Santa Cruz","Buena Vista","U.E. 6 de Agosto",87,1,1,3,39,46,12,4,1,194,1,14,209,232,0.201,0.901
"25582","Santa Cruz","Buena Vista","U.E. 6 de Agosto",65,2,0,2,24,45,10,2,2,152,5,9,166,175,0.158,0.949
"25583","Santa Cruz","San Carlos","Esc. Central San Carlos",89,0,2,0,46,30,6,6,0,179,1,8,188,221,0.257,0.851
"25584","Santa Cruz","San Carlos","Esc. Central San Carlos",86,0,0,0,46,28,14,3,0,177,4,15,196,225,0.26,0.871
"25585","Santa Cruz","San Carlos","Esc. Central San Carlos",90,0,1,1,60,25,7,4,0,188,4,12,204,227,0.319,0.899
"25586","Santa Cruz","San Carlos","Esc. Central San Carlos",61,0,1,0,91,23,4,3,1,184,5,10,199,224,0.495,0.888
"25587","Santa Cruz","San Carlos","Esc. Central San Carlos",87,0,0,0,66,26,12,1,1,193,4,2,199,226,0.342,0.881
"25588","Santa Cruz","San Carlos","Esc. Central San Carlos",71,0,2,0,74,17,13,3,1,181,1,11,193,220,0.409,0.877
"25589","Santa Cruz","San Carlos","Esc. Central San Carlos",88,0,0,0,55,21,16,2,0,182,2,11,195,225,0.302,0.867
"25590","Santa Cruz","San Carlos","Esc. Central San Carlos",54,0,0,0,99,21,19,3,0,196,0,4,200,228,0.505,0.877
"25591","Santa Cruz","San Carlos","Esc. Central San Carlos",101,0,0,1,29,41,7,2,0,181,5,10,196,220,0.16,0.891
"25592","Santa Cruz","San Carlos","Esc. Central San Carlos",113,2,0,0,44,27,8,0,0,194,4,9,207,229,0.227,0.904
"25593","Santa Cruz","San Carlos","Esc. Central San Carlos",62,0,1,0,91,28,10,1,0,193,3,8,204,230,0.472,0.887
"25594","Santa Cruz","San Carlos","Esc. Central San Carlos",63,1,0,0,65,27,17,2,0,175,4,6,185,216,0.371,0.856
"25595","Santa Cruz","San Carlos","Esc. Central San Carlos",80,0,0,0,66,33,11,4,0,194,3,5,202,220,0.34,0.918
"25596","Santa Cruz","San Carlos","Esc. Central San Carlos",102,1,0,1,34,25,15,2,0,180,5,3,188,216,0.189,0.87
"25597","Santa Cruz","San Carlos","Esc. Central San Carlos",66,0,0,0,54,23,7,3,0,153,5,26,184,224,0.353,0.821
"25598","Santa Cruz","San Carlos","Esc. Central San Carlos",72,0,1,0,64,13,9,1,0,160,1,3,164,179,0.4,0.916
"25599","Santa Cruz","San Carlos","Esc. U.E. Popular Don Bosco",77,1,1,1,68,40,3,3,1,195,4,8,207,230,0.349,0.9
"25600","Santa Cruz","San Carlos","Esc. U.E. Popular Don Bosco",68,1,0,2,68,38,4,3,0,184,4,8,196,226,0.37,0.867
"25601","Santa Cruz","San Carlos","Esc. U.E. Popular Don Bosco",75,1,1,1,62,32,5,2,1,180,5,12,197,225,0.344,0.876
"25602","Santa Cruz","San Carlos","Esc. U.E. Popular Don Bosco",74,0,1,1,57,41,6,4,0,184,5,11,200,223,0.31,0.897
"25603","Santa Cruz","San Carlos","Esc. U.E. Popular Don Bosco",80,1,0,2,60,22,5,3,0,173,4,16,193,222,0.347,0.869
"25604","Santa Cruz","San Carlos","Esc. Nucleo Central",4,1,1,0,164,8,9,1,1,189,3,4,196,220,0.868,0.891
"25605","Santa Cruz","San Carlos","Esc. Nucleo Central",13,0,0,0,150,12,20,1,0,196,2,3,201,222,0.765,0.905
"25606","Santa Cruz","San Carlos","Esc. Nucleo Central",10,1,0,1,156,6,14,3,0,191,2,3,196,223,0.817,0.879
"25607","Santa Cruz","San Carlos","Esc. Nucleo Central",9,1,2,1,123,10,22,1,0,169,2,9,180,198,0.728,0.909
"25608","Santa Cruz","San Carlos","Esc. Fiscal De Ninos Santa Fe",45,1,2,0,111,16,18,0,1,194,4,11,209,228,0.572,0.917
"25609","Santa Cruz","San Carlos","Esc. Fiscal De Ninos Santa Fe",74,1,0,1,70,10,25,1,0,182,3,11,196,231,0.385,0.848
"25610","Santa Cruz","San Carlos","Esc. Fiscal De Ninos Santa Fe",49,1,1,0,87,20,16,0,1,175,4,15,194,225,0.497,0.862
"25611","Santa Cruz","San Carlos","Esc. Fiscal De Ninos Santa Fe",28,0,1,0,121,15,28,0,0,193,3,11,207,230,0.627,0.9
"25612","Santa Cruz","San Carlos","Esc. Fiscal De Ninos Santa Fe",44,0,0,0,116,13,18,0,1,192,3,8,203,228,0.604,0.89
"25613","Santa Cruz","San Carlos","Esc. Fiscal De Ninos Santa Fe",21,0,2,0,124,15,19,0,0,181,2,8,191,227,0.685,0.841
"25614","Santa Cruz","San Carlos","Esc. Fiscal De Ninos Santa Fe",22,1,2,1,135,4,27,0,2,194,1,6,201,225,0.696,0.893
"25615","Santa Cruz","San Carlos","Esc. Fiscal De Ninos Santa Fe",51,1,0,0,88,18,23,1,1,183,1,9,193,224,0.481,0.862
"25616","Santa Cruz","San Carlos","Esc. Fiscal De Ninos Santa Fe",35,2,1,0,115,20,14,0,0,187,5,7,199,230,0.615,0.865
"25617","Santa Cruz","San Carlos","Esc. Fiscal De Ninos Santa Fe",48,0,3,0,93,17,22,0,0,183,2,6,191,224,0.508,0.853
"25618","Santa Cruz","San Carlos","Esc. Fiscal De Ninos Santa Fe",53,1,1,0,90,19,16,1,1,182,3,9,194,225,0.495,0.862
"25619","Santa Cruz","San Carlos","Esc. Fiscal De Ninos Santa Fe",32,0,0,1,122,20,23,0,0,198,1,5,204,225,0.616,0.907
"25620","Santa Cruz","San Carlos","Esc. Fiscal De Ninos Santa Fe",61,1,0,0,92,16,23,0,0,193,1,9,203,226,0.477,0.898
"25621","Santa Cruz","San Carlos","Esc. Fiscal De Ninos Santa Fe",36,1,1,0,121,8,20,1,0,188,3,5,196,234,0.644,0.838
"25622","Santa Cruz","San Carlos","Esc. Fiscal De Ninos Santa Fe",30,0,2,0,143,12,20,0,0,207,0,3,210,231,0.691,0.909
"25623","Santa Cruz","San Carlos","Esc. Fiscal De Ninos Santa Fe",45,1,0,0,98,22,26,1,0,193,2,4,199,232,0.508,0.858
"25624","Santa Cruz","San Carlos","Esc. Fiscal De Ninos Santa Fe",39,1,0,1,92,10,25,0,0,168,0,6,174,222,0.548,0.784
"25625","Santa Cruz","San Carlos","Esc. Fiscal De Ninos Santa Fe",33,0,3,0,106,11,29,2,0,184,6,11,201,224,0.576,0.897
"25626","Santa Cruz","San Carlos","Esc. Fiscal De Ninos Santa Fe",32,1,0,1,105,14,36,0,0,189,1,7,197,227,0.556,0.868
"25627","Santa Cruz","San Carlos","Esc. Fiscal De Ninos Santa Fe",45,0,0,0,97,23,26,0,0,191,2,5,198,226,0.508,0.876
"25628","Santa Cruz","San Carlos","Esc. Fiscal De Ninos Santa Fe",44,0,1,0,114,14,14,1,0,188,3,9,200,224,0.606,0.893
"25629","Santa Cruz","San Carlos","Esc. Fiscal De Ninos Santa Fe",51,1,0,0,100,21,20,0,0,193,5,13,211,229,0.518,0.921
"25630","Santa Cruz","San Carlos","Esc. Fiscal De Ninos Santa Fe",47,0,0,0,97,16,25,1,0,186,2,11,199,229,0.522,0.869
"25631","Santa Cruz","San Carlos","Esc. Fiscal De Ninos Santa Fe",55,2,2,0,80,31,16,0,1,187,3,4,194,219,0.428,0.886
"25632","Santa Cruz","San Carlos","Esc. Fiscal De Ninos Santa Fe",53,0,1,0,88,14,33,0,0,189,2,8,199,226,0.466,0.881
"25633","Santa Cruz","San Carlos","Esc. Fiscal De Ninos Santa Fe",53,1,1,0,109,9,25,0,1,199,3,8,210,231,0.548,0.909
"25634","Santa Cruz","San Carlos","Esc. Fiscal De Ninos Santa Fe",42,0,1,1,88,18,18,0,2,170,3,14,187,228,0.518,0.82
"25635","Santa Cruz","San Carlos","Esc. Fiscal De Ninos Santa Fe",39,0,1,1,122,10,16,1,1,191,2,4,197,228,0.639,0.864
"25636","Santa Cruz","San Carlos","Esc. Fiscal De Ninos Santa Fe",37,0,1,0,133,18,21,0,0,210,0,6,216,240,0.633,0.9
"25637","Santa Cruz","Yapacaní","Esc. U.E. Nucleo Central",16,0,3,1,141,5,18,1,0,185,3,13,201,223,0.762,0.901
"25638","Santa Cruz","Yapacaní","Esc. U.E. Nucleo Central",13,1,2,0,144,4,21,3,2,190,7,4,201,229,0.758,0.878
"25639","Santa Cruz","Yapacaní","Esc. U.E. Nucleo Central",18,2,3,0,147,12,21,1,1,205,3,6,214,230,0.717,0.93
"25640","Santa Cruz","Yapacaní","Esc. U.E. Cascabel",10,2,2,1,153,1,19,0,1,189,3,2,194,220,0.81,0.882
"25641","Santa Cruz","Yapacaní","Esc. U.E. Cascabel",9,0,0,0,156,11,16,0,0,192,2,6,200,226,0.812,0.885
"25642","Santa Cruz","Yapacaní","Esc. Cesar Banzer Aliaga",32,0,1,0,115,8,36,0,2,194,4,4,202,220,0.593,0.918
"25643","Santa Cruz","Yapacaní","Esc. Cesar Banzer Aliaga",39,0,4,0,113,6,24,0,1,187,8,5,200,223,0.604,0.897
"25644","Santa Cruz","Yapacaní","Esc. Cesar Banzer Aliaga",33,0,2,1,99,15,31,0,0,181,3,5,189,221,0.547,0.855
"25645","Santa Cruz","Yapacaní","Esc. Cesar Banzer Aliaga",45,2,2,1,109,8,26,0,1,194,1,11,206,224,0.562,0.92
"25646","Santa Cruz","Yapacaní","Esc. Cesar Banzer Aliaga",27,1,3,0,114,8,27,0,2,182,2,8,192,223,0.626,0.861
"25647","Santa Cruz","Yapacaní","Esc. Cesar Banzer Aliaga",31,1,3,0,116,8,32,1,2,194,6,5,205,224,0.598,0.915
"25648","Santa Cruz","Yapacaní","Esc. Cesar Banzer Aliaga",15,1,4,0,120,13,28,0,0,181,2,7,190,223,0.663,0.852
"25649","Santa Cruz","Yapacaní","Esc. Cesar Banzer Aliaga",25,0,3,1,107,11,34,1,1,183,2,6,191,224,0.585,0.853
"25650","Santa Cruz","Yapacaní","Esc. Cesar Banzer Aliaga",8,0,1,0,144,6,33,3,1,196,2,3,201,225,0.735,0.893
"25651","Santa Cruz","Yapacaní","Esc. Cesar Banzer Aliaga",34,2,1,1,86,7,25,2,2,160,3,36,199,223,0.537,0.892
"25652","Santa Cruz","Yapacaní","Esc. Cesar Banzer Aliaga",40,1,2,2,88,14,29,2,2,180,1,13,194,221,0.489,0.878
"25653","Santa Cruz","Yapacaní","Esc. Cesar Banzer Aliaga",23,0,1,0,136,6,29,0,0,195,5,6,206,223,0.697,0.924
"25654","Santa Cruz","Yapacaní","Esc. Cesar Banzer Aliaga",24,2,2,0,112,7,40,1,2,190,2,1,193,223,0.589,0.865
"25655","Santa Cruz","Yapacaní","Esc. Cesar Banzer Aliaga",39,0,0,0,112,7,32,0,0,190,3,10,203,225,0.589,0.902
"25656","Santa Cruz","Yapacaní","Esc. Cesar Banzer Aliaga",35,2,7,0,117,5,27,0,1,194,3,5,202,230,0.603,0.878
"25657","Santa Cruz","Yapacaní","Esc. Cesar Banzer Aliaga",34,0,4,0,112,7,26,0,1,184,3,9,196,225,0.609,0.871
"25658","Santa Cruz","Yapacaní","Esc. Cesar Banzer Aliaga",34,0,0,1,106,8,35,0,0,184,4,3,191,224,0.576,0.853
"25659","Santa Cruz","Yapacaní","Esc. Cesar Banzer Aliaga",31,1,2,0,117,3,35,2,0,191,1,6,198,220,0.613,0.9
"25660","Santa Cruz","Yapacaní","Esc. Cesar Banzer Aliaga",34,1,1,1,120,4,32,0,1,194,4,3,201,223,0.619,0.901
"25661","Santa Cruz","Yapacaní","Esc. Cesar Banzer Aliaga",36,1,2,0,126,3,23,1,1,193,1,3,197,223,0.653,0.883
"25662","Santa Cruz","Yapacaní","Esc. Cesar Banzer Aliaga",33,2,1,0,117,10,27,1,2,193,5,12,210,228,0.606,0.921
"25663","Santa Cruz","Yapacaní","Esc. Cesar Banzer Aliaga",41,0,4,1,112,5,27,1,1,192,4,2,198,223,0.583,0.888
"25664","Santa Cruz","Yapacaní","Esc. Cesar Banzer Aliaga",33,3,3,0,112,9,33,0,1,194,1,7,202,224,0.577,0.902
"25665","Santa Cruz","Yapacaní","Esc. Cesar Banzer Aliaga",17,0,0,0,122,12,34,0,0,185,2,6,193,225,0.659,0.858
"25666","Santa Cruz","Yapacaní","Esc. Cesar Banzer Aliaga",29,0,0,1,115,10,28,0,1,184,4,1,189,228,0.625,0.829
"25667","Santa Cruz","Yapacaní","Esc. Cesar Banzer Aliaga",39,0,1,1,121,8,27,0,0,197,2,4,203,230,0.614,0.883
"25668","Santa Cruz","Yapacaní","Esc. Cesar Banzer Aliaga",18,1,0,3,126,8,35,1,3,195,5,6,206,231,0.646,0.892
"25669","Santa Cruz","Yapacaní","Esc. Cesar Banzer Aliaga",25,1,2,1,108,6,39,2,0,184,4,7,195,220,0.587,0.886
"25670","Santa Cruz","Yapacaní","Esc. Cesar Banzer Aliaga",40,0,1,0,120,13,20,0,0,194,2,5,201,231,0.619,0.87
"25671","Santa Cruz","Yapacaní","Esc. Cesar Banzer Aliaga",40,0,1,0,113,5,33,1,0,193,2,5,200,227,0.585,0.881
"25672","Santa Cruz","Yapacaní","Esc. Cesar Banzer Aliaga",40,0,1,1,94,5,49,0,0,190,2,4,196,225,0.495,0.871
"25673","Santa Cruz","Yapacaní","Esc. Cesar Banzer Aliaga",37,0,0,0,120,16,22,0,0,195,3,3,201,224,0.615,0.897
"25674","Santa Cruz","Yapacaní","Esc. Cesar Banzer Aliaga",23,0,0,1,121,10,36,0,0,191,4,6,201,227,0.634,0.885
"25675","Santa Cruz","Yapacaní","Esc. Cesar Banzer Aliaga",36,0,1,0,107,12,24,0,1,181,1,10,192,219,0.591,0.877
"25676","Santa Cruz","Yapacaní","Esc. Cesar Banzer Aliaga",28,1,4,0,108,5,40,0,0,186,3,6,195,223,0.581,0.874
"25677","Santa Cruz","Yapacaní","Esc. Cesar Banzer Aliaga",21,0,0,0,124,8,31,1,0,185,5,10,200,228,0.67,0.877
"25678","Santa Cruz","Yapacaní","Esc. German Busch",35,0,3,0,112,5,40,1,0,196,1,5,202,233,0.571,0.867
"25679","Santa Cruz","Yapacaní","Esc. German Busch",15,0,10,0,96,48,12,2,0,183,17,3,203,227,0.525,0.894
"25680","Santa Cruz","Yapacaní","Esc. German Busch",42,1,1,0,95,22,36,0,0,197,3,12,212,236,0.482,0.898
"25681","Santa Cruz","Yapacaní","Esc. German Busch",24,1,2,0,126,5,34,0,1,193,2,3,198,226,0.653,0.876
"25682","Santa Cruz","Yapacaní","Esc. German Busch",21,0,0,0,104,14,44,2,5,190,3,7,200,221,0.547,0.905
"25683","Santa Cruz","Yapacaní","Esc. German Busch",21,0,2,1,108,15,41,2,0,190,2,10,202,230,0.568,0.878
"25684","Santa Cruz","Yapacaní","Esc. German Busch",18,0,0,1,134,4,36,1,0,194,1,6,201,233,0.691,0.863
"25685","Santa Cruz","Yapacaní","Esc. German Busch",33,1,0,0,124,14,28,0,1,201,2,6,209,231,0.617,0.905
"25686","Santa Cruz","Yapacaní","Esc. German Busch",19,0,4,0,107,13,50,0,0,193,0,9,202,232,0.554,0.871
"25687","Santa Cruz","Yapacaní","Esc. German Busch",37,0,2,1,97,11,45,1,0,194,0,5,199,238,0.5,0.836
"25688","Santa Cruz","Yapacaní","Esc. German Busch",31,1,1,0,124,8,27,1,0,193,4,5,202,230,0.642,0.878
"25689","Santa Cruz","Yapacaní","Esc. German Busch",40,1,1,0,104,11,28,0,1,186,3,7,196,226,0.559,0.867
"25690","Santa Cruz","Yapacaní","Esc. German Busch",35,0,2,0,110,9,36,0,0,192,3,6,201,228,0.573,0.882
"25691","Santa Cruz","Yapacaní","Esc. German Busch",37,1,1,0,108,7,43,0,1,198,3,4,205,230,0.545,0.891
"25692","Santa Cruz","Yapacaní","Esc. German Busch",29,2,3,0,119,5,26,0,0,184,5,11,200,232,0.647,0.862
"25693","Santa Cruz","Yapacaní","Esc. German Busch",38,0,1,1,103,11,35,1,1,191,3,12,206,231,0.539,0.892
"25694","Santa Cruz","Yapacaní","Esc. German Busch",43,1,1,0,110,8,36,1,0,200,4,13,217,235,0.55,0.923
"25695","Santa Cruz","Yapacaní","Esc. German Busch",30,0,1,0,118,10,33,1,0,193,3,7,203,232,0.611,0.875
"25696","Santa Cruz","Yapacaní","Esc. German Busch",30,0,0,0,113,7,45,0,0,195,3,2,200,229,0.579,0.873
"25697","Santa Cruz","Yapacaní","Esc. German Busch",24,1,0,1,125,4,42,0,2,199,1,8,208,232,0.628,0.897
"25698","Santa Cruz","Yapacaní","Esc. German Busch",31,0,2,0,119,6,40,0,0,198,5,5,208,232,0.601,0.897
"25699","Santa Cruz","Yapacaní","Esc. German Busch",24,0,1,0,130,11,26,1,0,193,4,5,202,229,0.674,0.882
"25700","Santa Cruz","Yapacaní","Esc. German Busch",38,0,0,0,117,9,35,1,0,200,2,8,210,232,0.585,0.905
"25701","Santa Cruz","Yapacaní","Esc. German Busch",41,2,3,0,103,12,35,0,2,198,2,5,205,232,0.52,0.884
"25702","Santa Cruz","Yapacaní","Esc. German Busch",29,0,1,1,103,19,39,0,0,192,4,4,200,228,0.536,0.877
"25703","Santa Cruz","Yapacaní","Esc. German Busch",31,0,0,0,108,15,38,0,0,192,5,3,200,225,0.562,0.889
"25704","Santa Cruz","Yapacaní","Esc. German Busch",42,0,5,0,99,4,33,1,0,184,2,7,193,224,0.538,0.862
"25705","Santa Cruz","Yapacaní","Esc. Nuevo Simon Bollivar",26,0,1,1,121,8,31,0,4,192,3,6,201,229,0.63,0.878
"25706","Santa Cruz","Yapacaní","Esc. Nuevo Simon Bollivar",38,0,0,0,105,13,35,0,1,192,3,5,200,232,0.547,0.862
"25707","Santa Cruz","Yapacaní","Esc. Nuevo Simon Bollivar",37,0,1,0,101,13,37,0,1,190,6,3,199,225,0.532,0.884
"25708","Santa Cruz","Yapacaní","Esc. Nuevo Simon Bollivar",26,1,1,0,118,8,36,0,1,191,3,6,200,228,0.618,0.877
"25709","Santa Cruz","Yapacaní","Esc. Nuevo Simon Bollivar",20,0,2,0,102,11,46,1,1,183,3,9,195,223,0.557,0.874
"25710","Santa Cruz","Yapacaní","Esc. Nuevo Simon Bollivar",19,0,0,0,142,5,31,0,3,200,1,6,207,229,0.71,0.904
"25711","Santa Cruz","Yapacaní","Esc. Nuevo Simon Bollivar",42,0,1,0,110,5,31,0,2,191,3,4,198,224,0.576,0.884
"25712","Santa Cruz","Yapacaní","Esc. Nuevo Simon Bollivar",15,0,2,0,126,13,34,0,0,190,4,4,198,229,0.663,0.865
"25713","Santa Cruz","Yapacaní","Esc. Nuevo Simon Bollivar",40,1,4,1,118,9,28,0,1,202,3,4,209,229,0.584,0.913
"25714","Santa Cruz","Yapacaní","Esc. Nuevo Simon Bollivar",33,1,1,0,120,6,38,0,1,200,3,3,206,227,0.6,0.907
"25715","Santa Cruz","Yapacaní","Esc. Nuevo Simon Bollivar",38,0,4,0,114,10,34,0,0,200,0,5,205,230,0.57,0.891
"25716","Santa Cruz","Yapacaní","Esc. Nuevo Simon Bollivar",20,1,2,0,131,8,29,0,0,191,4,3,198,232,0.686,0.853
"25717","Santa Cruz","Yapacaní","Esc. Nuevo Simon Bollivar",40,1,3,0,111,5,34,0,0,194,3,6,203,229,0.572,0.886
"25718","Santa Cruz","Yapacaní","Esc. Nuevo Simon Bollivar",23,1,1,0,118,14,41,0,1,199,4,2,205,230,0.593,0.891
"25719","Santa Cruz","Yapacaní","Esc. Nuevo Simon Bollivar",24,3,5,0,109,9,36,1,0,187,5,12,204,231,0.583,0.883
"25720","Santa Cruz","Yapacaní","Esc. Nuevo Simon Bollivar",33,2,1,0,122,5,28,0,0,191,2,7,200,231,0.639,0.866
"25721","Santa Cruz","Yapacaní","Esc. Nuevo Simon Bollivar",26,0,2,0,121,7,33,0,2,191,3,6,200,234,0.634,0.855
"25722","Santa Cruz","Yapacaní","Esc. Nuevo Simon Bollivar",23,1,1,0,121,10,38,1,2,197,4,3,204,226,0.614,0.903
"25723","Santa Cruz","Yapacaní","Esc. Nuevo Simon Bollivar",30,1,1,0,109,10,44,0,0,195,1,11,207,228,0.559,0.908
"25724","Santa Cruz","Yapacaní","Esc. Nuevo Simon Bollivar",39,0,2,0,97,15,35,1,1,190,2,8,200,226,0.511,0.885
"25725","Santa Cruz","Yapacaní","Esc. Nuevo Simon Bollivar",40,1,6,0,114,10,32,0,0,203,6,2,211,228,0.562,0.925
"25726","Santa Cruz","Yapacaní","Esc. Nuevo Simon Bollivar",21,0,2,0,126,16,32,0,0,197,2,7,206,228,0.64,0.904
"25727","Santa Cruz","Yapacaní","Esc. Nuevo Simon Bollivar",36,0,0,0,118,7,35,1,2,199,8,4,211,231,0.593,0.913
"25728","Santa Cruz","Yapacaní","Esc. Nacional Bolivia",25,0,2,0,116,3,52,0,0,198,2,10,210,237,0.586,0.886
"25729","Santa Cruz","Yapacaní","Esc. Nacional Bolivia",16,0,3,0,149,8,34,0,1,211,0,6,217,239,0.706,0.908
"25730","Santa Cruz","Yapacaní","Esc. Nacional Bolivia",21,0,0,0,128,5,40,0,0,194,1,5,200,236,0.66,0.847
"25731","Santa Cruz","Yapacaní","Esc. Nacional Bolivia",23,0,0,0,144,6,40,0,0,213,2,5,220,237,0.676,0.928
"25732","Santa Cruz","Yapacaní","Esc. Nacional Bolivia",23,2,2,0,121,11,40,0,1,200,3,4,207,234,0.605,0.885
"25733","Santa Cruz","Yapacaní","Esc. Nacional Bolivia",23,0,2,1,128,2,47,0,0,203,2,5,210,236,0.631,0.89
"25734","Santa Cruz","Yapacaní","Esc. Nacional Bolivia",24,0,3,0,123,4,40,0,1,195,0,6,201,231,0.631,0.87
"25735","Santa Cruz","Yapacaní","Esc. Nacional Bolivia",23,0,4,1,132,6,38,0,2,206,2,8,216,238,0.641,0.908
"25736","Santa Cruz","Yapacaní","U.E. Juana Azurduy",12,2,1,0,143,2,32,1,0,193,4,12,209,239,0.741,0.874
"25737","Santa Cruz","Yapacaní","U.E. Juana Azurduy",17,0,3,1,149,5,26,1,1,203,5,3,211,246,0.734,0.858
"25738","Santa Cruz","Yapacaní","U.E. 25 de Mayo",26,0,1,0,97,8,45,1,1,179,2,9,190,203,0.542,0.936
"25739","Santa Cruz","Yapacaní","U.E. 12 de Octubre",18,1,2,1,101,6,43,0,1,173,2,5,180,195,0.584,0.923
"25740","Santa Cruz","Yapacaní","Esc. Mariscal Sucre",23,1,0,0,129,13,23,1,0,190,7,19,216,231,0.679,0.935
"25741","Santa Cruz","Yapacaní","Esc. Mariscal Sucre",22,0,2,0,144,4,26,1,1,200,5,6,211,227,0.72,0.93
"25742","Santa Cruz","Yapacaní","Esc. Mariscal Sucre",32,1,3,0,132,13,19,0,0,200,2,4,206,225,0.66,0.916
"25743","Santa Cruz","Yapacaní","Esc. Mariscal Sucre",15,1,0,0,114,9,24,0,1,164,1,31,196,216,0.695,0.907
"25744","Santa Cruz","Yapacaní","Esc. Mariscal Sucre",24,0,0,2,115,6,29,0,0,176,3,39,218,229,0.653,0.952
"25745","Santa Cruz","Yapacaní","U.E.Franz Tamayo",6,1,1,0,181,3,21,0,0,213,5,7,225,227,0.85,0.991
"25746","Santa Cruz","Yapacaní","Esc. U.E. Nucleo Central los Pozos",4,0,2,3,154,6,30,2,0,201,7,11,219,230,0.766,0.952
"25747","Santa Cruz","Yapacaní","Esc. Don Bosco Fe y Alegria",27,0,5,0,122,5,18,0,1,178,11,10,199,225,0.685,0.884
"25748","Santa Cruz","Yapacaní","Esc. Don Bosco Fe y Alegria",17,0,2,1,147,6,22,0,0,195,0,4,199,228,0.754,0.873
"25749","Santa Cruz","Yapacaní","Esc. Don Bosco Fe y Alegria",9,1,4,0,158,4,15,0,0,191,5,3,199,223,0.827,0.892
"25750","Santa Cruz","Yapacaní","Esc. Don Bosco Fe y Alegria",19,1,0,0,134,8,25,1,0,188,3,8,199,223,0.713,0.892
"25751","Santa Cruz","Yapacaní","Esc. Don Bosco Fe y Alegria",19,0,4,0,158,9,13,2,0,205,2,2,209,232,0.771,0.901
"25752","Santa Cruz","Yapacaní","Esc. Don Bosco Fe y Alegria",19,0,5,0,131,5,19,0,0,179,5,10,194,219,0.732,0.886
"25753","Santa Cruz","Yapacaní","Esc. Don Bosco Fe y Alegria",20,0,2,0,134,10,20,0,0,186,1,1,188,225,0.72,0.836
"25754","Santa Cruz","Yapacaní","Esc. Don Bosco Fe y Alegria",8,0,4,0,174,4,18,0,0,208,2,2,212,229,0.837,0.926
"25755","Santa Cruz","Yapacaní","Esc. Don Bosco Fe y Alegria",23,1,3,0,132,3,19,3,0,184,3,4,191,220,0.717,0.868
"25756","Santa Cruz","Yapacaní","Esc. Don Bosco Fe y Alegria",28,3,2,0,130,7,22,1,0,193,2,5,200,226,0.674,0.885
"25757","Santa Cruz","Yapacaní","Esc. Don Bosco Fe y Alegria",11,0,1,0,127,5,15,0,1,160,1,3,164,191,0.794,0.859
"25758","Santa Cruz","Yapacaní","Esc. U.E. Nucleo Central el Condor",1,0,5,0,175,0,13,0,0,194,2,4,200,221,0.902,0.905
"25759","Santa Cruz","Yapacaní","Esc. U.E. German Busch (P. Grether)",9,1,1,0,131,21,19,2,1,185,6,10,201,228,0.708,0.882
"25760","Santa Cruz","Yapacaní","Esc. U.E. Puerto Avaroa",9,0,0,1,148,10,17,1,0,186,4,10,200,224,0.796,0.893
"25761","Santa Cruz","Yapacaní","Esc. U.E. Puerto Avaroa",14,2,1,3,135,17,15,1,0,188,5,7,200,230,0.718,0.87
"25762","Santa Cruz","Yapacaní","Esc. Noel Kenp Mercado",6,0,2,2,174,1,18,1,1,205,4,5,214,234,0.849,0.915
"25763","Santa Cruz","Yapacaní","Esc. Noel Kenp Mercado",2,0,0,0,185,4,11,1,0,203,2,2,207,232,0.911,0.892
"25764","Santa Cruz","Yapacaní","Esc. Noel Kenp Mercado",9,1,0,0,189,2,8,0,0,209,2,6,217,234,0.904,0.927
"25765","Santa Cruz","Yapacaní","Esc. Noel Kenp Mercado",2,0,2,0,181,2,14,0,0,201,4,8,213,230,0.9,0.926
"25766","Santa Cruz","Yapacaní","Esc. Noel Kenp Mercado",4,0,2,0,183,2,12,0,0,203,4,4,211,231,0.901,0.913
"25767","Santa Cruz","Yapacaní","Esc. Noel Kenp Mercado",3,0,2,0,187,1,10,0,0,203,2,3,208,225,0.921,0.924
"25768","Santa Cruz","Yapacaní","Esc. El Pallar",9,1,0,1,139,11,17,1,2,181,11,8,200,250,0.768,0.8
"25769","Santa Cruz","Yapacaní","U.E. San Rafael",11,0,1,0,181,1,18,0,1,213,4,5,222,243,0.85,0.914
"25770","Santa Cruz","Yapacaní","U.E. Nuevo Horizonte",2,3,4,1,178,6,19,0,0,213,6,3,222,235,0.836,0.945
"25771","Santa Cruz","Yapacaní","U.E. Nuevo Horizonte",7,0,4,1,172,3,18,0,0,205,4,7,216,234,0.839,0.923
"25772","Santa Cruz","Yapacaní","U.E. Nuevo Horizonte",9,1,8,1,163,3,22,1,0,208,5,4,217,234,0.784,0.927
"25773","Santa Cruz","San Juan","Nucleo Central La Enconada",29,1,2,1,125,8,22,1,1,190,9,3,202,226,0.658,0.894
"25774","Santa Cruz","San Juan","Nucleo Central La Enconada",22,2,0,3,139,11,22,0,0,199,3,9,211,230,0.698,0.917
"25775","Santa Cruz","San Juan","Nucleo Central La Enconada",22,1,4,1,142,7,19,0,1,197,5,3,205,229,0.721,0.895
"25776","Santa Cruz","San Juan","Esc. Popular Don Bosco",48,1,0,0,82,18,15,1,1,166,1,7,174,215,0.494,0.809
"25777","Santa Cruz","San Juan","Esc. Popular Don Bosco",60,0,2,0,64,27,21,1,1,176,5,6,187,218,0.364,0.858
"25778","Santa Cruz","San Juan","Esc. Popular Don Bosco",50,1,4,0,81,22,31,0,3,192,3,11,206,226,0.422,0.912
"25779","Santa Cruz","San Juan","Esc. Popular Don Bosco",57,0,0,0,80,20,21,2,0,180,6,4,190,224,0.444,0.848
"25780","Santa Cruz","San Juan","Esc. Popular Don Bosco",65,0,0,0,85,23,14,1,0,188,1,13,202,225,0.452,0.898
"25781","Santa Cruz","San Juan","Esc. Popular Don Bosco",65,0,2,0,56,31,17,0,1,172,2,4,178,200,0.326,0.89
"25782","Santa Cruz","San Juan","Esc. Popular Don Bosco",65,0,0,0,59,24,23,2,0,173,6,3,182,212,0.341,0.858
"25783","Santa Cruz","San Juan","Esc. Popular Don Bosco",64,1,0,0,71,16,20,1,0,173,2,6,181,214,0.41,0.846
"25784","Santa Cruz","San Juan","Esc. Popular Don Bosco",85,0,0,1,62,14,9,0,2,173,4,0,177,199,0.358,0.889
"25785","Santa Cruz","San Juan","Esc. Popular Don Bosco",47,3,1,1,99,24,14,0,1,190,4,5,199,222,0.521,0.896
"25786","Santa Cruz","San Juan","Esc. Popular Don Bosco",55,2,1,0,79,25,27,0,4,193,2,4,199,230,0.409,0.865
"25787","Santa Cruz","San Juan","Esc. Popular Don Bosco",73,1,0,0,66,17,20,1,0,178,3,7,188,213,0.371,0.883
"25788","Santa Cruz","San Juan","Esc. Popular Don Bosco",70,2,1,0,66,29,12,1,1,182,1,2,185,209,0.363,0.885
"25789","Santa Cruz","San Juan","Esc. Popular Don Bosco",64,2,1,1,65,19,14,1,0,167,6,19,192,221,0.389,0.869
"25790","Santa Cruz","San Juan","Esc. Popular Don Bosco",61,0,0,2,58,16,22,0,0,159,5,6,170,190,0.365,0.895
"25791","Santa Cruz","San Juan","U.E. Raul Menacho",25,1,1,3,123,18,16,0,1,188,9,11,208,228,0.654,0.912
"25792","Santa Cruz","San Juan","U.E. Ayacucho",21,6,4,3,125,7,21,1,0,188,4,5,197,225,0.665,0.876
"25793","Santa Cruz","San José","Esc. Leonor Rivera",95,3,0,2,77,15,8,1,0,201,1,2,204,233,0.383,0.876
"25794","Santa Cruz","San José","Esc. Leonor Rivera",104,0,0,0,60,13,7,4,0,188,2,2,192,227,0.319,0.846
"25795","Santa Cruz","San José","Esc. Leonor Rivera",85,0,0,0,66,26,13,3,0,193,1,5,199,226,0.342,0.881
"25796","Santa Cruz","San José","Esc. Leonor Rivera",89,0,0,2,69,21,10,2,0,193,1,4,198,228,0.358,0.868
"25797","Santa Cruz","San José","Esc. Leonor Rivera",97,0,0,0,59,19,7,2,0,184,2,9,195,232,0.321,0.841
"25798","Santa Cruz","San José","Esc. Leonor Rivera",74,0,1,1,63,20,4,3,0,166,1,10,177,220,0.38,0.805
"25799","Santa Cruz","San José","Esc. Leonor Rivera",102,1,0,3,60,16,11,2,0,195,4,5,204,231,0.308,0.883
"25800","Santa Cruz","San José","Esc. Leonor Rivera",103,0,0,1,44,21,13,1,1,184,1,4,189,227,0.239,0.833
"25801","Santa Cruz","San José","Esc. Leonor Rivera",122,2,0,1,43,18,4,4,0,194,1,3,198,226,0.222,0.876
"25802","Santa Cruz","San José","Esc. Leonor Rivera",91,0,0,2,61,20,3,5,0,182,1,4,187,222,0.335,0.842
"25803","Santa Cruz","San José","Esc. Leonor Rivera",98,0,2,0,43,33,8,3,0,187,3,2,192,225,0.23,0.853
"25804","Santa Cruz","San José","Esc. Leonor Rivera",81,0,0,1,56,29,8,4,0,179,5,8,192,220,0.313,0.873
"25805","Santa Cruz","San José","Esc. Leonor Rivera",90,0,0,2,60,28,3,2,0,185,2,7,194,226,0.324,0.858
"25806","Santa Cruz","San José","Esc. Leonor Rivera",95,0,0,0,42,22,8,2,2,171,2,9,182,211,0.246,0.863
"25807","Santa Cruz","San José","Esc. German Busch",85,0,0,0,61,22,11,5,0,184,2,10,196,230,0.332,0.852
"25808","Santa Cruz","San José","Esc. German Busch",83,1,0,1,62,40,3,1,0,191,1,9,201,233,0.325,0.863
"25809","Santa Cruz","San José","Esc. German Busch",77,1,0,1,73,16,8,1,0,177,3,5,185,235,0.412,0.787
"25810","Santa Cruz","San José","Esc. German Busch",105,2,0,1,45,21,10,1,1,186,0,9,195,235,0.242,0.83
"25811","Santa Cruz","San José","Esc. German Busch",79,0,0,0,87,13,9,3,0,191,2,7,200,226,0.455,0.885
"25812","Santa Cruz","San José","Esc. German Busch",86,0,0,1,64,21,10,1,0,183,4,35,222,222,0.35,1
"25813","Santa Cruz","San José","Esc. German Busch",52,0,0,0,92,15,9,2,0,170,3,15,188,236,0.541,0.797
"25814","Santa Cruz","San José","Esc. German Busch",116,0,0,0,37,29,2,6,0,190,2,5,197,223,0.195,0.883
"25815","Santa Cruz","San José","Esc. German Busch",91,1,1,2,63,12,3,1,1,175,0,6,181,223,0.36,0.812
"25816","Santa Cruz","San José","Esc. German Busch",96,0,0,2,48,37,5,3,0,191,3,3,197,229,0.251,0.86
"25817","Santa Cruz","San José","Esc. German Busch",122,0,0,0,29,28,5,4,1,189,0,1,190,226,0.153,0.841
"25818","Santa Cruz","San José","Esc. German Busch",95,0,0,0,59,24,10,2,0,190,2,5,197,232,0.311,0.849
"25819","Santa Cruz","San José","Esc. German Busch",90,3,0,1,49,35,2,1,0,181,4,9,194,231,0.271,0.84
"25820","Santa Cruz","San José","Esc. German Busch",92,0,1,2,57,33,6,0,2,193,2,7,202,229,0.295,0.882
"25821","Santa Cruz","San José","Esc. German Busch",93,1,0,2,53,26,2,3,0,180,6,6,192,225,0.294,0.853
"25822","Santa Cruz","San José","Esc. German Busch",101,0,0,0,66,22,6,2,0,197,2,4,203,235,0.335,0.864
"25823","Santa Cruz","San José","Esc. Unzaga De La Vega",107,0,0,0,43,19,5,2,0,176,1,13,190,228,0.244,0.833
"25824","Santa Cruz","San José","Esc. Unzaga De La Vega",121,0,0,0,42,18,7,2,1,191,0,2,193,235,0.22,0.821
"25825","Santa Cruz","San José","Esc. Unzaga De La Vega",100,0,0,1,42,42,8,4,0,197,0,2,199,229,0.213,0.869
"25826","Santa Cruz","San José","Esc. Unzaga De La Vega",79,0,0,1,83,19,3,0,2,187,2,3,192,227,0.444,0.846
"25827","Santa Cruz","San José","Esc. Unzaga De La Vega",84,2,1,0,62,28,3,1,1,182,5,4,191,225,0.341,0.849
"25828","Santa Cruz","San José","Esc. Unzaga De La Vega",96,1,0,0,60,24,3,3,2,189,1,10,200,228,0.317,0.877
"25829","Santa Cruz","San José","Esc. Unzaga De La Vega",89,0,0,0,53,23,9,2,0,176,2,6,184,224,0.301,0.821
"25830","Santa Cruz","San José","Esc. Unzaga De La Vega",94,0,0,0,49,27,6,5,1,182,3,7,192,218,0.269,0.881
"25831","Santa Cruz","San José","Esc. Unzaga De La Vega",94,1,0,2,51,25,7,2,0,182,3,4,189,225,0.28,0.84
"25832","Santa Cruz","San José","Esc. Unzaga De La Vega",116,0,0,0,47,29,3,2,0,197,3,8,208,232,0.239,0.897
"25833","Santa Cruz","San José","Esc. Unzaga De La Vega",94,0,1,1,43,36,7,4,2,188,28,4,220,224,0.229,0.982
"25834","Santa Cruz","San José","Esc. Unzaga De La Vega",122,1,0,0,50,23,11,2,0,209,2,1,212,231,0.239,0.918
"25835","Santa Cruz","San José","Esc. Unzaga De La Vega",101,0,0,0,42,34,5,3,0,185,2,10,197,225,0.227,0.876
"25836","Santa Cruz","San José","Esc. Unzaga De La Vega",96,2,0,0,50,29,7,2,1,187,2,6,195,228,0.267,0.855
"25837","Santa Cruz","San José","Esc. Unzaga De La Vega",124,0,0,0,24,34,5,3,0,190,0,8,198,228,0.126,0.868
"25838","Santa Cruz","San José","Esc. Unzaga De La Vega",96,1,0,0,45,29,8,0,0,179,1,6,186,225,0.251,0.827
"25839","Santa Cruz","San José","Esc. Municipal",84,0,0,3,57,31,6,5,0,186,2,18,206,228,0.306,0.904
"25840","Santa Cruz","San José","Esc. San Juan",73,1,0,0,75,18,10,0,0,177,1,7,185,226,0.424,0.819
"25841","Santa Cruz","San José","Esc. Educacional Taperas",88,0,0,0,78,12,5,5,0,188,2,5,195,219,0.415,0.89
"25842","Santa Cruz","San José","Esc. Educacional Taperas",76,1,1,0,89,17,10,4,0,198,1,4,203,229,0.449,0.886
"25843","Santa Cruz","San José","Esc. Educacional Taperas",61,0,0,0,84,23,7,5,0,180,2,7,189,216,0.467,0.875
"25844","Santa Cruz","San José","U.E. Buena Vista",86,1,4,0,46,24,3,9,0,173,5,11,189,210,0.266,0.9
"25845","Santa Cruz","Pailón","Esc. Fe Alegria",88,2,0,1,66,11,16,2,2,188,3,5,196,222,0.351,0.883
"25846","Santa Cruz","Pailón","Esc. Fe Alegria",80,0,0,1,65,19,13,3,2,183,1,4,188,228,0.355,0.825
"25847","Santa Cruz","Pailón","Esc. Fe Alegria",108,0,0,1,55,18,15,2,1,200,2,5,207,232,0.275,0.892
"25848","Santa Cruz","Pailón","Esc. Fe Alegria",68,0,0,0,82,17,7,4,0,178,2,4,184,219,0.461,0.84
"25849","Santa Cruz","Pailón","Esc. Fe Alegria",74,1,0,0,65,16,9,5,0,170,1,6,177,217,0.382,0.816
"25850","Santa Cruz","Pailón","Esc. Fe Alegria",98,0,0,0,57,15,15,0,0,185,5,3,193,224,0.308,0.862
"25851","Santa Cruz","Pailón","Esc. Fe Alegria",84,0,0,2,72,14,9,4,0,185,0,6,191,218,0.389,0.876
"25852","Santa Cruz","Pailón","Esc. Fe Alegria",68,0,0,3,84,10,9,2,0,176,7,6,189,227,0.477,0.833
"25853","Santa Cruz","Pailón","Esc. Fe Alegria",46,1,0,0,87,16,13,0,0,163,1,12,176,223,0.534,0.789
"25854","Santa Cruz","Pailón","Esc. Fe Alegria",88,0,1,1,43,12,20,2,0,167,2,7,176,222,0.257,0.793
"25855","Santa Cruz","Pailón","Esc. Fe Alegria",92,1,0,0,52,14,12,0,0,171,3,8,182,224,0.304,0.812
"25856","Santa Cruz","Pailón","Esc. Fe Alegria",75,1,0,0,64,21,17,2,0,180,2,8,190,218,0.356,0.872
"25857","Santa Cruz","Pailón","Esc. Fe Alegria",88,0,0,1,58,14,16,3,0,180,3,6,189,222,0.322,0.851
"25858","Santa Cruz","Pailón","Esc. Fe Alegria",83,1,1,2,66,7,21,0,0,181,4,3,188,226,0.365,0.832
"25859","Santa Cruz","Pailón","Esc. Fe Alegria",125,0,1,0,37,17,6,4,1,191,0,9,200,222,0.194,0.901
"25860","Santa Cruz","Pailón","Esc. Fe Alegria",78,1,2,0,56,17,19,3,0,176,2,8,186,223,0.318,0.834
"25861","Santa Cruz","Pailón","Esc. Fe Alegria",66,0,0,3,94,12,17,0,1,193,1,4,198,230,0.487,0.861
"25862","Santa Cruz","Pailón","Esc. Fe Alegria",66,1,0,1,78,14,13,3,1,177,0,7,184,223,0.441,0.825
"25863","Santa Cruz","Pailón","Esc. Fe Alegria",133,0,0,1,35,13,7,5,0,194,1,3,198,218,0.18,0.908
"25864","Santa Cruz","Pailón","Esc. Fe Alegria",118,0,0,0,49,19,8,3,0,197,2,1,200,222,0.249,0.901
"25865","Santa Cruz","Pailón","Esc. Fe Alegria",105,0,0,1,62,11,10,5,0,194,4,5,203,232,0.32,0.875
"25866","Santa Cruz","Pailón","Esc. Fe Alegria",82,2,0,0,60,15,14,2,0,175,2,6,183,224,0.343,0.817
"25867","Santa Cruz","Pailón","Esc. Fe Alegria",87,1,0,0,68,19,9,4,0,188,5,4,197,225,0.362,0.876
"25868","Santa Cruz","Pailón","Esc. Fe Alegria",106,0,1,0,52,18,14,1,0,192,2,6,200,217,0.271,0.922
"25869","Santa Cruz","Pailón","Esc. Fe Alegria",122,0,0,1,41,10,8,1,0,183,2,7,192,229,0.224,0.838
"25870","Santa Cruz","Pailón","Esc. Fe Alegria",75,0,1,2,60,24,20,4,0,186,2,3,191,227,0.323,0.841
"25871","Santa Cruz","Pailón","Esc. Fe Alegria",73,1,1,1,82,13,11,3,0,185,1,4,190,225,0.443,0.844
"25872","Santa Cruz","Pailón","Esc. Fe Alegria",88,0,0,1,57,15,15,1,0,177,4,14,195,229,0.322,0.852
"25873","Santa Cruz","Pailón","Esc. Fe Alegria",92,1,1,2,51,21,9,6,1,184,1,4,189,221,0.277,0.855
"25874","Santa Cruz","Pailón","Esc. Fe Alegria",78,0,0,1,65,15,9,1,2,171,0,10,181,216,0.38,0.838
"25875","Santa Cruz","Pailón","Esc. Fe Alegria",100,0,0,1,46,11,9,5,1,173,2,8,183,220,0.266,0.832
"25876","Santa Cruz","Pailón","Esc. Fe Alegria",96,1,0,0,46,31,11,4,0,189,0,10,199,229,0.243,0.869
"25877","Santa Cruz","Pailón","Esc. Fe Alegria",88,1,1,0,69,16,6,4,0,185,4,3,192,223,0.373,0.861
"25878","Santa Cruz","Pailón","Esc. Fe Alegria",94,1,0,1,69,14,10,0,0,189,2,4,195,227,0.365,0.859
"25879","Santa Cruz","Pailón","Esc. Fe Alegria",63,0,2,0,99,9,13,1,0,187,2,9,198,232,0.529,0.853
"25880","Santa Cruz","Pailón","Esc. Fe Alegria",80,3,0,0,79,20,11,0,0,193,0,4,197,231,0.409,0.853
"25881","Santa Cruz","Pailón","U. E. Prof. Carlos Gomez Cornejo",107,0,0,1,69,19,20,3,1,220,2,4,226,238,0.314,0.95
"25882","Santa Cruz","Pailón","U. E. Prof. Carlos Gomez Cornejo",86,1,1,0,89,7,22,5,1,212,3,8,223,236,0.42,0.945
"25883","Santa Cruz","Pailón","U. E. Prof. Carlos Gomez Cornejo",105,0,1,0,63,10,21,2,1,203,2,4,209,231,0.31,0.905
"25884","Santa Cruz","Pailón","U. E. Prof. Carlos Gomez Cornejo",106,0,1,0,61,22,25,1,1,217,0,3,220,234,0.281,0.94
"25885","Santa Cruz","Pailón","U. E. Prof. Carlos Gomez Cornejo",76,0,0,1,88,18,18,3,2,206,5,9,220,236,0.427,0.932
"25886","Santa Cruz","Pailón","U. E. Nacional 13 de Mayo",61,2,1,0,98,28,22,4,1,217,6,7,230,239,0.452,0.962
"25887","Santa Cruz","Pailón","U. E. Nacional 13 de Mayo",53,2,1,0,101,25,23,1,0,206,1,10,217,236,0.49,0.919
"25888","Santa Cruz","Pailón","Esc. Seccional Cañada Larga",77,0,0,1,70,23,18,6,0,195,7,2,204,230,0.359,0.887
"25889","Santa Cruz","Pailón","Esc. Seccional Cañada Larga",71,1,1,1,61,40,18,10,1,204,3,7,214,238,0.299,0.899
"25890","Santa Cruz","Pailón","Esc. 3 de Mayo",40,2,0,1,87,30,19,4,0,183,5,9,197,226,0.475,0.872
"25891","Santa Cruz","Pailón","Esc. 3 de Mayo",47,2,0,0,83,26,20,2,2,182,6,10,198,232,0.456,0.853
"25892","Santa Cruz","Pailón","Esc. 3 de Mayo",32,0,0,0,89,12,23,1,1,158,3,3,164,226,0.563,0.726
"25893","Santa Cruz","Pailón","Esc. 3 de Mayo",58,1,0,2,79,17,14,4,0,175,4,4,183,230,0.451,0.796
"25894","Santa Cruz","Pailón","Esc. 3 de Mayo",45,0,1,0,80,30,21,1,0,178,3,7,188,226,0.449,0.832
"25895","Santa Cruz","Pailón","Esc. 3 de Mayo",45,2,0,4,88,21,17,3,0,180,5,12,197,235,0.489,0.838
"25896","Santa Cruz","Pailón","Esc. 3 de Mayo",44,1,2,0,61,25,21,5,0,159,0,12,171,201,0.384,0.851
"25897","Santa Cruz","Pailón","Esc. Emilio Suncer Salinas",52,1,1,1,85,15,15,0,0,170,4,6,180,224,0.5,0.804
"25898","Santa Cruz","Pailón","Esc. Emilio Suncer Salinas",58,2,0,5,74,17,25,3,0,184,3,0,187,225,0.402,0.831
"25899","Santa Cruz","Pailón","Esc. Municipal Rosal Centro",82,1,1,2,51,12,23,4,1,177,26,7,210,223,0.288,0.942
"25900","Santa Cruz","Pailón","Esc. Municipal Rosal Centro",120,0,1,0,26,3,36,0,1,187,9,4,200,219,0.139,0.913
"25901","Santa Cruz","Pailón","Esc. Municipal Rosal Centro",89,3,0,0,48,5,42,3,0,190,11,3,204,216,0.253,0.944
"25902","Santa Cruz","Pailón","Esc. Municipal Rosal Centro",55,1,4,2,76,14,30,3,1,186,16,7,209,226,0.409,0.925
"25903","Santa Cruz","Pailón","Escuela Tunas Nuevo",23,0,0,1,147,3,12,0,0,186,3,0,189,221,0.79,0.855
"25904","Santa Cruz","Pailón","Escuela Tunas Nuevo",25,0,2,0,116,4,15,1,0,163,5,3,171,220,0.712,0.777
"25905","Santa Cruz","Pailón","Escuela Tunas Nuevo",29,0,0,0,116,10,14,0,1,170,3,4,177,227,0.682,0.78
"25906","Santa Cruz","Pailón","U. E. Sinaí",54,1,0,2,74,22,27,4,0,184,7,16,207,207,0.402,1
"25907","Santa Cruz","Pailón","U.E. Ing. Jorge Mauricio Rojas P.",78,1,1,1,60,28,23,1,0,193,2,10,205,233,0.311,0.88
"25908","Santa Cruz","Roboré","Esc. Guido Oswaldo Suanzo",99,0,0,0,44,18,15,6,0,182,4,8,194,222,0.242,0.874
"25909","Santa Cruz","Roboré","Esc. Guido Oswaldo Suanzo",101,1,1,1,47,29,5,5,0,190,0,4,194,229,0.247,0.847
"25910","Santa Cruz","Roboré","Esc. Guido Oswaldo Suanzo",111,1,0,1,40,25,8,5,0,191,2,4,197,227,0.209,0.868
"25911","Santa Cruz","Roboré","Esc. Guido Oswaldo Suanzo",97,0,0,1,37,28,7,2,0,172,4,7,183,218,0.215,0.839
"25912","Santa Cruz","Roboré","Esc. Guido Oswaldo Suanzo",90,0,0,1,41,25,4,2,0,163,2,18,183,218,0.252,0.839
"25913","Santa Cruz","Roboré","Esc. Guido Oswaldo Suanzo",100,0,0,1,33,29,13,9,0,185,5,7,197,225,0.178,0.876
"25914","Santa Cruz","Roboré","Esc. Sagrada Familia",108,0,0,1,44,19,13,1,1,187,3,4,194,219,0.235,0.886
"25915","Santa Cruz","Roboré","Esc. Sagrada Familia",120,0,0,0,49,13,10,1,0,193,1,4,198,228,0.254,0.868
"25916","Santa Cruz","Roboré","Esc. Sagrada Familia",107,2,0,0,60,10,10,3,0,192,0,6,198,235,0.312,0.843
"25917","Santa Cruz","Roboré","Esc. Sagrada Familia",131,1,0,0,36,19,8,3,1,199,1,2,202,228,0.181,0.886
"25918","Santa Cruz","Roboré","Esc. Sagrada Familia",134,0,1,0,34,21,3,2,0,195,1,4,200,229,0.174,0.873
"25919","Santa Cruz","Roboré","Esc. Sagrada Familia",91,0,0,0,68,19,11,1,0,190,1,6,197,229,0.358,0.86
"25920","Santa Cruz","Roboré","Esc. Sagrada Familia",109,1,0,0,32,12,6,1,0,161,4,15,180,223,0.199,0.807
"25921","Santa Cruz","Roboré","Esc. Sagrada Familia",102,0,1,0,34,20,9,1,0,167,4,8,179,224,0.204,0.799
"25922","Santa Cruz","Roboré","Esc. Sagrada Familia",89,0,0,0,63,18,7,0,2,179,0,5,184,228,0.352,0.807
"25923","Santa Cruz","Roboré","Esc. Sagrada Familia",118,0,1,1,40,16,11,1,0,188,1,3,192,223,0.213,0.861
"25924","Santa Cruz","Roboré","Esc. Sagrada Familia",109,2,1,0,47,16,11,3,0,189,0,9,198,225,0.249,0.88
"25925","Santa Cruz","Roboré","Esc. Sagrada Familia",101,0,0,1,46,12,14,0,1,175,0,5,180,230,0.263,0.783
"25926","Santa Cruz","Roboré","Esc. Marista",92,1,0,0,54,15,11,4,1,178,3,6,187,230,0.303,0.813
"25927","Santa Cruz","Roboré","Esc. Marista",92,2,1,1,46,29,6,2,0,179,3,9,191,224,0.257,0.853
"25928","Santa Cruz","Roboré","Esc. Marista",99,1,0,2,28,31,7,7,0,175,3,16,194,230,0.16,0.843
"25929","Santa Cruz","Roboré","Esc. Marista",118,0,3,1,41,16,4,0,0,183,1,7,191,229,0.224,0.834
"25930","Santa Cruz","Roboré","Esc. Marista",102,0,1,1,39,25,8,3,0,179,1,13,193,223,0.218,0.865
"25931","Santa Cruz","Roboré","Esc. Marista",105,0,0,1,41,20,13,1,0,181,3,8,192,222,0.227,0.865
"25932","Santa Cruz","Roboré","Esc. Marista",85,1,1,0,43,38,11,4,0,183,2,9,194,229,0.235,0.847
"25933","Santa Cruz","Roboré","Esc. Marista",107,1,1,0,26,32,11,5,1,184,6,9,199,222,0.141,0.896
"25934","Santa Cruz","Roboré","Esc. Marista",122,1,0,1,36,24,3,6,0,193,0,3,196,227,0.187,0.863
"25935","Santa Cruz","Roboré","Esc. Don Bosco",91,1,1,1,42,30,22,2,0,190,1,5,196,227,0.221,0.863
"25936","Santa Cruz","Roboré","Esc. Don Bosco",96,0,1,2,60,23,0,2,0,184,2,2,188,227,0.326,0.828
"25937","Santa Cruz","Roboré","Esc. Don Bosco",89,1,0,0,42,28,13,5,0,178,1,7,186,228,0.236,0.816
"25938","Santa Cruz","Roboré","Esc. Don Bosco",103,1,0,1,39,24,16,3,0,187,1,6,194,226,0.209,0.858
"25939","Santa Cruz","Roboré","Esc. Don Bosco",82,1,0,0,64,18,15,0,1,181,2,3,186,227,0.354,0.819
"25940","Santa Cruz","Roboré","Esc. Don Bosco",91,1,1,1,50,32,11,1,0,188,0,3,191,228,0.266,0.838
"25941","Santa Cruz","Roboré","Esc. Don Bosco",94,1,1,1,50,24,21,3,0,195,2,9,206,230,0.256,0.896
"25942","Santa Cruz","Roboré","Esc. Don Bosco",108,0,0,0,33,29,9,3,0,182,2,6,190,232,0.181,0.819
"25943","Santa Cruz","Roboré","Esc. Don Bosco",103,2,0,0,37,23,16,7,0,188,5,5,198,233,0.197,0.85
"25944","Santa Cruz","Roboré","Esc. Don Bosco",90,0,0,1,52,27,14,6,1,191,2,7,200,242,0.272,0.826
"25945","Santa Cruz","Roboré","Esc. Seccional Chochis",87,1,0,4,31,38,8,7,0,176,4,5,185,220,0.176,0.841
"25946","Santa Cruz","Roboré","Esc. Seccional Chochis",111,0,0,2,26,36,3,3,0,181,3,10,194,224,0.144,0.866
"25947","Santa Cruz","Roboré","Esc. Napoleon Montero Montero",89,0,4,0,61,10,5,7,1,177,0,1,178,228,0.345,0.781
"25948","Santa Cruz","Roboré","Esc. Napoleon Montero Montero",96,1,0,1,52,17,2,1,1,171,5,6,182,224,0.304,0.812
"25949","Santa Cruz","Roboré","Esc. Napoleon Montero Montero",92,0,2,0,56,13,6,1,0,170,2,8,180,223,0.329,0.807
"25950","Santa Cruz","Roboré","Esc. Napoleon Montero Montero",125,0,0,1,32,25,0,4,1,188,1,4,193,223,0.17,0.865
"25951","Santa Cruz","Roboré","Esc. Seccional Aguas Calientes",38,2,1,2,100,24,16,5,0,188,4,8,200,227,0.532,0.881
"25952","Santa Cruz","Roboré","Esc. Seccional Aguas Calientes",46,2,0,1,83,34,18,5,1,190,3,5,198,229,0.437,0.865
"25953","Santa Cruz","Roboré","Esc. Los Sotos",37,2,1,0,116,21,12,3,0,192,4,5,201,224,0.604,0.897
"25954","Santa Cruz","Portachuelo","Esc. Angel Maria Limpias",126,0,1,2,37,25,9,1,0,201,1,7,209,229,0.184,0.913
"25955","Santa Cruz","Portachuelo","Esc. Angel Maria Limpias",120,0,0,0,27,23,10,2,0,182,1,9,192,223,0.148,0.861
"25956","Santa Cruz","Portachuelo","Esc. Angel Maria Limpias",111,0,0,0,42,21,7,3,0,184,4,5,193,228,0.228,0.846
"25957","Santa Cruz","Portachuelo","Esc. Angel Maria Limpias",134,0,0,0,34,19,7,2,0,196,0,9,205,227,0.173,0.903
"25958","Santa Cruz","Portachuelo","Esc. Angel Maria Limpias",136,0,0,1,35,21,9,3,0,205,2,2,209,229,0.171,0.913
"25959","Santa Cruz","Portachuelo","Esc. Angel Maria Limpias",117,0,0,4,49,22,3,2,2,199,1,3,203,222,0.246,0.914
"25960","Santa Cruz","Portachuelo","Esc. Angel Maria Limpias",131,0,0,1,39,16,4,4,0,195,2,9,206,230,0.2,0.896
"25961","Santa Cruz","Portachuelo","Esc. Angel Maria Limpias",126,0,1,0,40,22,5,1,1,196,3,9,208,227,0.204,0.916
"25962","Santa Cruz","Portachuelo","Esc. Angel Maria Limpias",130,0,1,0,41,27,3,4,0,206,4,5,215,233,0.199,0.923
"25963","Santa Cruz","Portachuelo","Esc. Angel Maria Limpias",125,0,0,0,41,19,7,3,0,195,8,8,211,229,0.21,0.921
"25964","Santa Cruz","Portachuelo","Esc. Angel Maria Limpias",87,0,0,1,55,23,12,2,1,181,2,4,187,206,0.304,0.908
"25965","Santa Cruz","Portachuelo","Esc. La Aplicacion",124,0,0,1,32,25,7,2,1,192,4,8,204,219,0.167,0.932
"25966","Santa Cruz","Portachuelo","Esc. La Aplicacion",142,1,0,1,25,25,2,2,2,200,1,5,206,223,0.125,0.924
"25967","Santa Cruz","Portachuelo","Esc. La Aplicacion",107,2,0,1,22,25,5,4,0,166,4,41,211,235,0.133,0.898
"25968","Santa Cruz","Portachuelo","Esc. La Aplicacion",109,0,0,0,36,30,5,2,0,182,1,14,197,222,0.198,0.887
"25969","Santa Cruz","Portachuelo","Esc. La Aplicacion",126,1,0,1,27,34,4,4,0,197,5,7,209,230,0.137,0.909
"25970","Santa Cruz","Portachuelo","Esc. La Aplicacion",113,0,0,0,31,31,6,0,2,183,2,11,196,226,0.169,0.867
"25971","Santa Cruz","Portachuelo","Esc. La Aplicacion",131,1,3,3,26,28,5,1,0,198,1,5,204,227,0.131,0.899
"25972","Santa Cruz","Portachuelo","Esc. La Aplicacion",137,0,1,0,17,29,7,1,1,193,1,33,227,227,0.088,1
"25973","Santa Cruz","Portachuelo","Esc. La Aplicacion",123,1,0,3,28,29,6,4,1,195,3,7,205,225,0.144,0.911
"25974","Santa Cruz","Portachuelo","Esc. La Aplicacion",131,0,0,0,26,35,2,2,2,198,3,2,203,227,0.131,0.894
"25975","Santa Cruz","Portachuelo","Esc. La Aplicacion",129,0,0,1,21,34,4,4,1,194,3,7,204,227,0.108,0.899
"25976","Santa Cruz","Portachuelo","Esc. La Aplicacion",145,1,0,0,26,26,1,2,0,201,4,9,214,229,0.129,0.934
"25977","Santa Cruz","Portachuelo","Esc. La Aplicacion",122,0,1,2,23,26,5,1,0,180,4,14,198,219,0.128,0.904
"25978","Santa Cruz","Portachuelo","Esc. La Aplicacion",132,1,1,1,25,26,5,2,1,194,4,8,206,226,0.129,0.912
"25979","Santa Cruz","Portachuelo","Esc. La Aplicacion",113,0,0,2,30,44,4,4,0,197,6,8,211,228,0.152,0.925
"25980","Santa Cruz","Portachuelo","Esc. La Aplicacion",122,0,1,0,23,35,8,1,0,190,1,14,205,227,0.121,0.903
"25981","Santa Cruz","Portachuelo","Esc. La Aplicacion",133,1,0,0,20,29,2,2,1,188,5,9,202,226,0.106,0.894
"25982","Santa Cruz","Portachuelo","Esc. Julio Landivar",139,0,0,3,24,15,4,2,2,189,0,8,197,221,0.127,0.891
"25983","Santa Cruz","Portachuelo","Esc. Julio Landivar",102,0,1,0,48,28,6,3,0,188,2,13,203,223,0.255,0.91
"25984","Santa Cruz","Portachuelo","Esc. Julio Landivar",128,0,0,0,27,28,6,2,0,191,2,3,196,219,0.141,0.895
"25985","Santa Cruz","Portachuelo","Esc. Julio Landivar",120,0,0,0,32,19,8,1,0,180,2,11,193,217,0.178,0.889
"25986","Santa Cruz","Portachuelo","Esc. Julio Landivar",140,0,0,0,24,25,3,3,0,195,0,11,206,224,0.123,0.92
"25987","Santa Cruz","Portachuelo","Esc. Julio Landivar",140,0,0,0,29,21,4,4,0,198,1,8,207,223,0.146,0.928
"25988","Santa Cruz","Portachuelo","Esc. Julio Landivar",119,0,0,1,27,28,1,1,0,177,4,15,196,227,0.153,0.863
"25989","Santa Cruz","Portachuelo","Esc. Julio Landivar",129,0,0,1,22,29,5,1,1,188,4,6,198,217,0.117,0.912
"25990","Santa Cruz","Portachuelo","Esc. Martina Dorado",138,0,0,0,29,25,7,3,0,202,3,4,209,229,0.144,0.913
"25991","Santa Cruz","Portachuelo","Esc. Martina Dorado",109,1,0,0,40,27,9,4,2,192,2,5,199,227,0.208,0.877
"25992","Santa Cruz","Portachuelo","Esc. Martina Dorado",108,0,0,2,36,26,12,2,0,186,3,3,192,219,0.194,0.877
"25993","Santa Cruz","Portachuelo","Esc. Martina Dorado",123,0,1,1,36,25,8,1,1,196,4,12,212,225,0.184,0.942
"25994","Santa Cruz","Portachuelo","Esc. Martina Dorado",128,1,1,2,33,18,6,8,1,198,4,10,212,226,0.167,0.938
"25995","Santa Cruz","Portachuelo","Esc. Martina Dorado",121,0,1,0,36,30,4,5,1,198,3,1,202,227,0.182,0.89
"25996","Santa Cruz","Portachuelo","Esc. Martina Dorado",130,1,1,1,29,33,7,7,0,209,3,5,217,231,0.139,0.939
"25997","Santa Cruz","Portachuelo","Esc. Martina Dorado",132,0,1,0,32,19,6,4,1,195,2,10,207,221,0.164,0.937
"25998","Santa Cruz","Portachuelo","Esc. Martina Dorado",122,0,1,3,29,21,5,2,1,184,5,8,197,224,0.158,0.879
"25999","Santa Cruz","Portachuelo","Esc. Martina Dorado",124,0,0,2,19,33,6,4,0,188,1,11,200,226,0.101,0.885
"26000","Santa Cruz","Portachuelo","Esc. Martina Dorado",123,1,2,1,38,24,5,5,0,199,0,5,204,226,0.191,0.903
"26001","Santa Cruz","Portachuelo","Esc. Martina Dorado",116,0,0,0,42,28,5,3,0,194,4,10,208,224,0.216,0.929
"26002","Santa Cruz","Portachuelo","Esc. Martina Dorado",123,1,0,2,30,26,9,2,0,193,2,4,199,221,0.155,0.9
"26003","Santa Cruz","Portachuelo","Esc. Martina Dorado",118,1,0,2,41,21,1,6,1,191,3,5,199,222,0.215,0.896
"26004","Santa Cruz","Portachuelo","Esc. San Ignacio",88,0,0,3,44,31,5,2,0,173,6,18,197,227,0.254,0.868
"26005","Santa Cruz","Portachuelo","Esc. San Ignacio",61,1,1,1,68,47,10,3,0,192,5,8,205,230,0.354,0.891
"26006","Santa Cruz","Portachuelo","Esc. Nucleo Central",71,0,0,1,69,35,14,2,0,192,5,11,208,230,0.359,0.904
"26007","Santa Cruz","Portachuelo","Esc. Nucleo Central",83,1,1,3,44,27,9,4,1,173,12,3,188,215,0.254,0.874
"26008","Santa Cruz","Portachuelo","Esc. Nucleo Central",83,1,1,1,50,36,7,2,0,181,4,9,194,219,0.276,0.886
"26009","Santa Cruz","Santa Rosa","Esc. Pasto Mercado Quiroga",58,2,0,1,79,24,16,0,1,181,4,11,196,219,0.436,0.895
"26010","Santa Cruz","Santa Rosa","Esc. Pasto Mercado Quiroga",41,2,0,1,96,21,12,2,0,175,4,3,182,212,0.549,0.858
"26011","Santa Cruz","Santa Rosa","Esc. Alfredo Vasquez",107,0,0,1,30,26,5,7,0,176,6,8,190,225,0.17,0.844
"26012","Santa Cruz","Santa Rosa","Esc. Alfredo Vasquez",138,0,0,1,21,23,1,10,0,194,7,7,208,230,0.108,0.904
"26013","Santa Cruz","Santa Rosa","Esc. Alfredo Vasquez",117,0,0,0,38,21,9,10,0,195,5,6,206,230,0.195,0.896
"26014","Santa Cruz","Santa Rosa","Esc. Santa Rosa",83,0,0,1,70,16,7,3,0,180,4,10,194,227,0.389,0.855
"26015","Santa Cruz","Santa Rosa","Esc. Santa Rosa",92,0,0,4,57,13,13,2,0,181,5,9,195,225,0.315,0.867
"26016","Santa Cruz","Santa Rosa","Esc. Santa Rosa",57,0,0,4,102,13,6,2,2,186,2,10,198,230,0.548,0.861
"26017","Santa Cruz","Santa Rosa","Esc. Santa Rosa",89,0,1,2,64,14,6,8,0,184,5,6,195,227,0.348,0.859
"26018","Santa Cruz","Santa Rosa","Esc. Santa Rosa",76,0,0,2,69,27,11,3,0,188,3,6,197,226,0.367,0.872
"26019","Santa Cruz","Santa Rosa","Esc. Santa Rosa",90,0,0,1,62,32,11,1,1,198,2,2,202,228,0.313,0.886
"26020","Santa Cruz","Santa Rosa","Esc. Santa Rosa",97,2,1,2,55,15,10,3,0,185,8,9,202,224,0.297,0.902
"26021","Santa Cruz","Santa Rosa","Esc. Santa Rosa",61,0,1,0,84,26,17,2,0,191,4,7,202,229,0.44,0.882
"26022","Santa Cruz","Santa Rosa","Esc. Santa Rosa",121,2,0,2,38,18,7,4,0,192,2,11,205,230,0.198,0.891
"26023","Santa Cruz","Santa Rosa","Esc. Santa Rosa",103,0,1,1,62,15,10,1,1,194,2,7,203,228,0.32,0.89
"26024","Santa Cruz","Santa Rosa","Esc. Santa Rosa",82,0,1,2,49,31,11,3,0,179,5,20,204,231,0.274,0.883
"26025","Santa Cruz","Santa Rosa","Esc. Santa Rosa",69,1,0,1,87,17,11,1,0,187,3,6,196,229,0.465,0.856
"26026","Santa Cruz","Santa Rosa","Esc. Santa Rosa",98,0,0,0,63,20,4,1,1,187,0,7,194,221,0.337,0.878
"26027","Santa Cruz","Santa Rosa","Esc. Santa Rosa",104,0,0,0,32,19,12,3,1,171,2,13,186,221,0.187,0.842
"26028","Santa Cruz","Santa Rosa","Esc. Santa Rosa",105,0,0,0,36,32,7,3,0,183,2,11,196,228,0.197,0.86
"26029","Santa Cruz","Santa Rosa","Esc. Santa Rosa",92,0,1,1,39,14,9,2,2,160,5,8,173,225,0.244,0.769
"26030","Santa Cruz","Santa Rosa","Esc. 4 de Marzo",5,0,2,0,159,1,15,1,1,184,4,7,195,220,0.864,0.886
"26031","Santa Cruz","Santa Rosa","Esc. Galilea",17,0,0,0,131,11,12,1,0,172,7,2,181,224,0.762,0.808
"26032","Santa Cruz","Santa Rosa","Esc. Rincon De Palometa",80,2,0,1,60,30,5,6,1,185,4,5,194,221,0.324,0.878
"26033","Santa Cruz","Santa Rosa","Esc. Rincon De Palometa",82,1,0,0,49,31,2,17,1,183,10,9,202,223,0.268,0.906
"26034","Santa Cruz","Santa Rosa","Esc.  Mixto Los Andes",5,1,1,0,152,4,15,1,2,181,3,4,188,222,0.84,0.847
"26035","Santa Cruz","Santa Rosa","Esc.  Mixto Los Andes",10,1,0,1,138,1,22,0,0,173,8,13,194,225,0.798,0.862
"26036","Santa Cruz","Santa Rosa","Esc.  Mixto Los Andes",8,1,2,1,148,2,25,0,0,187,5,5,197,230,0.791,0.857
"26037","Santa Cruz","Santa Rosa","Esc.  Mixto Los Andes",10,1,0,0,140,2,14,0,1,168,2,26,196,228,0.833,0.86
"26038","Santa Cruz","Santa Rosa","Esc.  Mixto Los Andes",13,2,0,1,165,3,18,0,1,203,4,2,209,231,0.813,0.905
"26039","Santa Cruz","Santa Rosa","Esc.  Alfredo Vaca Flor",5,0,0,1,166,6,16,1,1,196,3,4,203,230,0.847,0.883
"26040","Santa Cruz","Santa Rosa","Esc.  Alfredo Vaca Flor",5,0,2,1,139,1,11,0,0,159,6,5,170,199,0.874,0.854
"26041","Santa Cruz","Santa Rosa","Esc. La Conquista",12,1,1,0,156,1,16,2,2,191,3,4,198,233,0.817,0.85
"26042","Santa Cruz","Santa Rosa","Esc. San Luis",22,2,0,0,156,4,9,0,0,193,4,4,201,229,0.808,0.878
"26043","Santa Cruz","Santa Rosa","U.E. Río Nuevo",9,0,1,0,185,3,4,0,0,202,2,2,206,210,0.916,0.981
"26044","Santa Cruz","Santa Rosa","U.E. 24 de Junio",8,0,0,0,203,4,10,1,0,226,4,4,234,238,0.898,0.983
"26045","Santa Cruz","Santa Rosa","U.E. 24 de Junio",11,1,0,2,191,1,0,4,1,211,8,3,222,240,0.905,0.925
"26046","Santa Cruz","Colpa Bélgica","Esc. Republica Del Brasil",103,1,0,0,46,31,8,0,0,189,4,3,196,221,0.243,0.887
"26047","Santa Cruz","Colpa Bélgica","Esc. Republica Del Brasil",116,0,0,0,45,30,2,2,0,195,3,4,202,228,0.231,0.886
"26048","Santa Cruz","Colpa Bélgica","Esc. Republica Del Brasil",118,0,0,0,38,19,7,0,2,184,2,2,188,219,0.207,0.858
"26049","Santa Cruz","Colpa Bélgica","Esc. Republica Del Brasil",112,0,0,2,45,24,2,1,0,186,4,10,200,222,0.242,0.901
"26050","Santa Cruz","Colpa Bélgica","Esc. Republica Del Brasil",125,0,0,1,29,33,5,1,0,194,6,6,206,230,0.149,0.896
"26051","Santa Cruz","Colpa Bélgica","U.E. Hans Bottler Bowles",100,1,1,0,45,38,6,1,1,193,0,6,199,231,0.233,0.861
"26052","Santa Cruz","Colpa Bélgica","U.E. Hans Bottler Bowles",103,0,3,1,44,29,7,1,2,190,1,5,196,226,0.232,0.867
"26053","Santa Cruz","Colpa Bélgica","U.E. Hans Bottler Bowles",79,0,0,0,80,34,7,0,0,200,2,7,209,233,0.4,0.897
"26054","Santa Cruz","Colpa Bélgica","U.E. Hans Bottler Bowles",94,1,0,0,61,25,11,0,1,193,4,4,201,228,0.316,0.882
"26055","Santa Cruz","Colpa Bélgica","U.E. Hans Bottler Bowles",87,0,1,0,65,26,6,0,1,186,1,2,189,230,0.349,0.822
"26056","Santa Cruz","Colpa Bélgica","U.E. Hans Bottler Bowles",108,1,0,0,48,24,4,0,1,186,1,7,194,229,0.258,0.847
"26057","Santa Cruz","Colpa Bélgica","U.E. Hans Bottler Bowles",100,0,3,0,53,16,9,1,0,182,8,12,202,229,0.291,0.882
"26058","Santa Cruz","Colpa Bélgica","U.E. Hans Bottler Bowles",77,0,0,1,70,30,10,2,0,190,4,5,199,227,0.368,0.877
"26059","Santa Cruz","Colpa Bélgica","U.E. Hans Bottler Bowles",109,0,0,1,47,30,8,2,0,197,4,5,206,227,0.239,0.907
"26060","Santa Cruz","Colpa Bélgica","U.E. Hans Bottler Bowles",130,0,0,0,35,21,3,0,0,189,1,9,199,227,0.185,0.877
"26061","Santa Cruz","Colpa Bélgica","U.E. Hans Bottler Bowles",88,1,0,1,61,27,7,1,2,188,1,5,194,227,0.324,0.855
"26062","Santa Cruz","Colpa Bélgica","U.E. Hans Bottler Bowles",95,0,0,0,51,29,9,0,1,185,3,8,196,226,0.276,0.867
"26063","Santa Cruz","Colpa Bélgica","U.E. Hans Bottler Bowles",101,2,1,0,57,20,7,2,0,190,4,4,198,225,0.3,0.88
"26064","Santa Cruz","Colpa Bélgica","U.E. Orlando Rivero Vargas",63,3,0,3,61,33,6,2,0,171,3,8,182,190,0.357,0.958
"26065","Santa Cruz","Lagunillas","Esc. Lagunillas",66,2,1,2,70,15,5,3,1,165,7,7,179,220,0.424,0.814
"26066","Santa Cruz","Lagunillas","Esc. Lagunillas",33,3,0,1,120,15,6,1,0,179,3,6,188,228,0.67,0.825
"26067","Santa Cruz","Lagunillas","Esc. Lagunillas",61,1,0,1,90,23,2,3,0,181,5,6,192,226,0.497,0.85
"26068","Santa Cruz","Lagunillas","Esc. Lagunillas",57,1,1,1,86,19,5,0,2,172,5,12,189,229,0.5,0.825
"26069","Santa Cruz","Lagunillas","Esc. Lagunillas",65,0,1,0,67,20,6,1,0,160,8,15,183,224,0.419,0.817
"26070","Santa Cruz","Lagunillas","Esc. Lagunillas",64,3,0,0,72,13,12,1,1,166,7,25,198,226,0.434,0.876
"26071","Santa Cruz","Lagunillas","Esc. Prof. Delfin Arteaga Ipati",60,1,0,1,103,11,6,0,0,182,9,7,198,225,0.566,0.88
"26072","Santa Cruz","Lagunillas","Esc. Prof. Delfin Arteaga Ipati",83,2,0,0,63,17,2,1,1,169,6,10,185,215,0.373,0.86
"26073","Santa Cruz","Lagunillas","Esc. Prof. Delfin Arteaga Ipati",59,2,0,0,98,21,3,1,0,184,5,10,199,229,0.533,0.869
"26074","Santa Cruz","Lagunillas","Esc. Seccional Aguada Grande",33,0,1,2,146,18,5,0,1,206,6,5,217,238,0.709,0.912
"26075","Santa Cruz","Charagua","Escuela Central Fe y Alegria",87,1,0,1,58,24,14,1,1,187,7,3,197,231,0.31,0.853
"26076","Santa Cruz","Charagua","Escuela Central Fe y Alegria",71,0,0,2,87,18,10,1,2,191,3,9,203,231,0.455,0.879
"26077","Santa Cruz","Charagua","Escuela Central Fe y Alegria",56,1,1,0,77,17,18,1,1,172,4,8,184,226,0.448,0.814
"26078","Santa Cruz","Charagua","Escuela Central Fe y Alegria",87,1,0,1,70,16,10,2,0,187,7,5,199,232,0.374,0.858
"26079","Santa Cruz","Charagua","Escuela Central Fe y Alegria",67,0,1,2,79,19,11,1,0,180,2,12,194,227,0.439,0.855
"26080","Santa Cruz","Charagua","Escuela Central Fe y Alegria",88,0,0,0,63,17,19,0,0,187,4,7,198,225,0.337,0.88
"26081","Santa Cruz","Charagua","Escuela Central Fe y Alegria",72,0,0,1,67,18,10,3,0,171,4,12,187,231,0.392,0.81
"26082","Santa Cruz","Charagua","Escuela Central Fe y Alegria",39,1,0,0,93,22,7,3,0,165,7,6,178,226,0.564,0.788
"26083","Santa Cruz","Charagua","Escuela Central Fe y Alegria",68,0,1,0,95,17,8,0,0,189,3,9,201,234,0.503,0.859
"26084","Santa Cruz","Charagua","Escuela Central Fe y Alegria",74,0,1,0,71,24,5,1,1,177,6,12,195,230,0.401,0.848
"26085","Santa Cruz","Charagua","Escuela Central Fe y Alegria",79,2,0,0,62,19,4,1,1,168,6,13,187,220,0.369,0.85
"26086","Santa Cruz","Charagua","Escuela Central Fe y Alegria",83,0,2,2,52,18,17,1,0,175,3,17,195,224,0.297,0.871
"26087","Santa Cruz","Charagua","Escuela Central Fe y Alegria",63,1,2,0,73,25,15,3,0,182,7,12,201,228,0.401,0.882
"26088","Santa Cruz","Charagua","Esc. Estacion Charagua",62,0,0,2,79,25,22,1,0,191,9,7,207,230,0.414,0.9
"26089","Santa Cruz","Charagua","Esc. Estacion Charagua",42,1,1,0,117,16,13,1,0,191,10,7,208,228,0.613,0.912
"26090","Santa Cruz","Charagua","Esc. Estacion Charagua",64,1,1,0,101,18,11,1,0,197,3,6,206,232,0.513,0.888
"26091","Santa Cruz","Charagua","Esc. Estacion Charagua",58,2,1,1,98,18,21,0,0,199,9,4,212,235,0.492,0.902
"26092","Santa Cruz","Charagua","Esc. Estacion Charagua",64,1,0,0,100,15,12,0,1,193,4,10,207,225,0.518,0.92
"26093","Santa Cruz","Charagua","Esc. Secc. Central Masavi",21,4,1,4,115,16,8,0,0,169,17,17,203,230,0.68,0.883
"26094","Santa Cruz","Charagua","Esc. Secc. Central Masavi",22,2,1,1,144,17,12,2,1,202,6,4,212,238,0.713,0.891
"26095","Santa Cruz","Charagua","Esc. Secc. El Espino",11,2,2,1,182,6,3,0,0,207,5,12,224,235,0.879,0.953
"26096","Santa Cruz","Charagua","Esc. Secc. El Espino",22,1,2,3,139,6,6,0,2,181,14,6,201,231,0.768,0.87
"26097","Santa Cruz","Charagua","Esc. Secc. Taputa",6,1,0,0,157,4,13,0,0,181,8,9,198,235,0.867,0.843
"26098","Santa Cruz","Charagua","Esc. Enrique Quintela",42,0,0,2,109,13,18,3,1,188,6,5,199,223,0.58,0.892
"26099","Santa Cruz","Charagua","Esc. Enrique Quintela",48,0,0,0,107,9,22,7,1,194,4,6,204,227,0.552,0.899
"26100","Santa Cruz","Charagua","Esc. Enrique Quintela",39,2,3,0,92,13,31,6,0,186,6,8,200,222,0.495,0.901
"26101","Santa Cruz","Charagua","Esc. Nucleo Escolar La Brecha",28,1,1,0,120,7,9,0,0,166,12,12,190,233,0.723,0.815
"26102","Santa Cruz","Charagua","Esc. Nucleo Escolar La Brecha",23,4,0,1,131,3,6,5,1,174,9,10,193,233,0.753,0.828
"26103","Santa Cruz","Charagua","Esc. Nucleo Escolar La Brecha",35,0,0,0,128,10,8,1,0,182,7,10,199,236,0.703,0.843
"26104","Santa Cruz","Charagua","Esc. Central Iyobi",56,2,0,1,94,9,9,3,1,175,3,8,186,234,0.537,0.795
"26105","Santa Cruz","Charagua","Esc. Central Iyobi",24,4,0,1,136,12,5,3,1,186,1,3,190,235,0.731,0.809
"26106","Santa Cruz","Charagua","Esc. Central Iyobi",35,3,2,1,129,6,7,1,4,188,9,8,205,237,0.686,0.865
"26107","Santa Cruz","Charagua","Esc. Secc. Huarirenda Nueva",41,2,3,3,106,24,11,4,2,196,11,6,213,251,0.541,0.849
"26108","Santa Cruz","Charagua","Esc. Secc. Rancho Nuevo",66,1,0,2,82,8,5,1,1,166,4,5,175,231,0.494,0.758
"26109","Santa Cruz","Charagua","Esc. Secc. de Kaipepe",23,2,1,3,112,24,31,1,1,198,4,7,209,231,0.566,0.905
"26110","Santa Cruz","Charagua","Esc. Seccional San F. de Parapeti",29,2,0,0,107,8,6,2,1,155,5,4,164,189,0.69,0.868
"26111","Santa Cruz","Charagua","Esc. Secc. Tacobo",21,3,3,1,97,16,35,1,1,178,11,11,200,224,0.545,0.893
"26112","Santa Cruz","Charagua","Esc. Pueblo Nuevo Parapeti",36,2,1,1,96,17,13,3,1,170,28,4,202,222,0.565,0.91
"26113","Santa Cruz","Charagua","U.E. Pedro Ramos",18,1,0,1,109,16,8,1,2,156,13,5,174,182,0.699,0.956
"26114","Santa Cruz","Charagua","U.E. Yapiroa",68,0,0,3,113,13,9,1,1,208,7,10,225,235,0.543,0.957
"26115","Santa Cruz","Cabezas","Esc. Serafin Rodriguez",72,1,2,2,81,15,16,1,1,191,2,8,201,232,0.424,0.866
"26116","Santa Cruz","Cabezas","Esc. Serafin Rodriguez",57,1,1,1,93,17,9,0,0,179,3,9,191,232,0.52,0.823
"26117","Santa Cruz","Cabezas","Esc. Serafin Rodriguez",45,0,1,0,99,19,12,1,0,177,3,10,190,234,0.559,0.812
"26118","Santa Cruz","Cabezas","Esc. Serafin Rodriguez",61,0,0,1,89,11,12,1,0,175,4,4,183,229,0.509,0.799
"26119","Santa Cruz","Cabezas","Esc. Serafin Rodriguez",65,2,7,1,76,17,11,0,1,180,2,7,189,233,0.422,0.811
"26120","Santa Cruz","Cabezas","Esc. Serafin Rodriguez",75,0,2,0,66,23,15,1,0,182,4,9,195,230,0.363,0.848
"26121","Santa Cruz","Cabezas","Esc. Serafin Rodriguez",74,0,0,0,84,17,11,1,1,188,2,6,196,231,0.447,0.848
"26122","Santa Cruz","Cabezas","Esc. Serafin Rodriguez",59,3,1,0,93,18,8,0,0,182,5,6,193,232,0.511,0.832
"26123","Santa Cruz","Cabezas","Esc. Serafin Rodriguez",61,0,2,1,79,18,19,3,2,185,2,8,195,233,0.427,0.837
"26124","Santa Cruz","Cabezas","Esc. Serafin Rodriguez",55,0,0,0,90,16,16,0,0,177,8,6,191,229,0.508,0.834
"26125","Santa Cruz","Cabezas","Esc. Seccional Pueblo Viejo",46,1,2,2,84,31,17,1,0,184,9,9,202,229,0.457,0.882
"26126","Santa Cruz","Cabezas","Esc. 12 de Abril",45,0,1,1,94,26,13,2,0,182,12,8,202,228,0.516,0.886
"26127","Santa Cruz","Cabezas","Esc. 12 de Abril",43,0,1,0,98,30,18,1,1,192,11,4,207,231,0.51,0.896
"26128","Santa Cruz","Cabezas","Esc. 12 de Abril",34,1,1,2,114,24,9,3,1,189,6,6,201,229,0.603,0.878
"26129","Santa Cruz","Cabezas","Esc. 12 de Abril",30,1,1,0,107,31,12,0,0,182,10,11,203,228,0.588,0.89
"26130","Santa Cruz","Cabezas","Esc. 12 de Abril",52,1,1,0,84,17,24,3,1,183,9,13,205,226,0.459,0.907
"26131","Santa Cruz","Cabezas","Esc. 12 de Abril",40,3,0,0,115,19,10,1,2,190,3,12,205,232,0.605,0.884
"26132","Santa Cruz","Cabezas","Esc. 12 de Abril",37,1,1,1,98,27,13,0,1,179,3,17,199,228,0.547,0.873
"26133","Santa Cruz","Cabezas","Esc. 12 de Abril",32,2,0,1,99,34,10,4,1,183,8,23,214,232,0.541,0.922
"26134","Santa Cruz","Cabezas","Esc. 12 de Abril",32,1,3,0,82,35,25,0,1,179,11,18,208,229,0.458,0.908
"26135","Santa Cruz","Cabezas","Esc. Rio Seco Florida",50,1,0,0,82,31,12,2,3,181,5,6,192,229,0.453,0.838
"26136","Santa Cruz","Cabezas","Esc. Rio Seco Florida",55,0,0,0,76,32,9,2,0,174,2,11,187,223,0.437,0.839
"26137","Santa Cruz","Cabezas","Esc. Eduardo Abaroa",26,1,0,0,99,12,26,0,1,165,6,12,183,203,0.6,0.901
"26138","Santa Cruz","Cabezas","Esc. Zanja Honda",65,1,0,4,98,9,13,1,1,192,5,7,204,232,0.51,0.879
"26139","Santa Cruz","Cabezas","Esc. Zanja Honda",65,0,0,1,96,16,9,3,0,190,2,9,201,230,0.505,0.874
"26140","Santa Cruz","Cabezas","Esc. Zanja Honda",48,4,0,0,108,17,11,0,0,188,6,10,204,228,0.574,0.895
"26141","Santa Cruz","Cabezas","Esc. Zanja Honda",55,1,0,1,119,12,12,1,0,201,1,8,210,231,0.592,0.909
"26142","Santa Cruz","Cabezas","Esc. Zanja Honda",41,0,0,3,117,11,20,3,0,195,6,8,209,231,0.6,0.905
"26143","Santa Cruz","Cabezas","Esc. Zanja Honda",42,0,0,3,117,10,13,0,1,186,8,11,205,230,0.629,0.891
"26144","Santa Cruz","Cabezas","Esc. Zanja Honda",72,0,5,1,86,17,14,0,0,195,4,8,207,230,0.441,0.9
"26145","Santa Cruz","Cabezas","Esc. Pto. Camacho",79,1,1,3,56,40,13,2,0,195,5,6,206,229,0.287,0.9
"26146","Santa Cruz","Cabezas","Esc. Pto. Camacho",50,0,1,2,79,46,17,1,1,197,8,3,208,229,0.401,0.908
"26147","Santa Cruz","Cabezas","Esc. Pto. Camacho",59,3,0,0,76,28,17,2,0,185,11,9,205,233,0.411,0.88
"26148","Santa Cruz","Cabezas","Esc. Pto. Camacho",53,3,3,0,69,41,20,3,0,192,11,4,207,228,0.359,0.908
"26149","Santa Cruz","Cabezas","Esc. Pto. Camacho",55,0,9,1,83,26,10,3,2,189,5,7,201,225,0.439,0.893
"26150","Santa Cruz","Cabezas","Esc. Pto. Camacho",51,2,1,0,91,24,9,2,1,181,12,14,207,234,0.503,0.885
"26151","Santa Cruz","Cabezas","Esc. Pto. Camacho",58,2,2,0,76,36,16,4,2,196,6,9,211,235,0.388,0.898
"26152","Santa Cruz","Cabezas","Esc. Pto. Camacho",42,1,1,3,91,29,16,0,0,183,6,14,203,231,0.497,0.879
"26153","Santa Cruz","Cabezas","Esc. Pto. Camacho",55,3,0,0,84,25,15,0,1,183,5,11,199,226,0.459,0.881
"26154","Santa Cruz","Cabezas","Esc. Pto. Camacho",64,0,0,1,73,41,21,0,0,200,3,10,213,232,0.365,0.918
"26155","Santa Cruz","Cabezas","Esc. Pto. Camacho",61,1,0,2,84,33,13,1,1,196,2,9,207,231,0.429,0.896
"26156","Santa Cruz","Cabezas","Esc. Santa Rosa",29,1,1,0,89,21,21,1,1,164,2,7,173,193,0.543,0.896
"26157","Santa Cruz","Cabezas","Esc. Pampa Del Coscal",24,2,0,2,146,12,12,0,2,200,5,16,221,233,0.73,0.948
"26158","Santa Cruz","Cabezas","Esc. Yatirenda",28,1,1,9,99,39,21,2,0,200,6,6,212,230,0.495,0.922
"26159","Santa Cruz","Cabezas","Esc. Secc. San Francisco De Asis",28,0,0,1,121,15,18,0,0,183,7,8,198,239,0.661,0.828
"26160","Santa Cruz","Cabezas","Esc. Secc. San Francisco De Asis",27,2,0,2,119,17,19,0,0,186,5,7,198,232,0.64,0.853
"26161","Santa Cruz","Cabezas","U. E. Loma Blanca",31,3,1,3,106,17,29,1,2,193,17,8,218,221,0.549,0.986
"26162","Santa Cruz","Cuevo","Esc. Ub. Angel Sandoval",35,1,2,1,103,20,2,1,1,166,6,6,178,228,0.62,0.781
"26163","Santa Cruz","Cuevo","Esc. Ub. Angel Sandoval",38,0,2,0,83,30,6,3,0,162,5,1,168,228,0.512,0.737
"26164","Santa Cruz","Cuevo","Esc. Ub. Angel Sandoval",67,2,0,0,77,13,6,2,1,168,2,11,181,223,0.458,0.812
"26165","Santa Cruz","Cuevo","Esc. Ub. Angel Sandoval",67,0,0,0,70,22,0,0,2,161,3,4,168,222,0.435,0.757
"26166","Santa Cruz","Cuevo","Esc. Ub. Angel Sandoval",41,0,1,0,78,29,4,1,0,154,3,0,157,220,0.506,0.714
"26167","Santa Cruz","Cuevo","Esc. Ub. Angel Sandoval",50,0,2,2,83,25,9,1,1,173,1,4,178,224,0.48,0.795
"26168","Santa Cruz","Cuevo","Esc. Ub. Angel Sandoval",68,0,1,0,60,31,4,2,1,167,7,9,183,222,0.359,0.824
"26169","Santa Cruz","Cuevo","Esc. Ub. Angel Sandoval",68,2,2,2,58,29,7,0,1,169,4,4,177,226,0.343,0.783
"26170","Santa Cruz","Gutiérrez","Esc. Marcelino Revollo",14,1,0,1,122,24,37,2,1,202,5,6,213,228,0.604,0.934
"26171","Santa Cruz","Gutiérrez","Esc. Marcelino Revollo",9,0,0,0,112,13,40,0,0,174,4,12,190,226,0.644,0.841
"26172","Santa Cruz","Gutiérrez","Esc. Central Ipatimiri",8,4,1,0,127,5,40,0,0,185,5,4,194,222,0.686,0.874
"26173","Santa Cruz","Gutiérrez","Esc. Secc. Guasanti",6,2,1,0,154,8,31,2,0,204,3,9,216,246,0.755,0.878
"26174","Santa Cruz","Gutiérrez","Esc. Emilio Finot",72,2,1,1,66,17,4,0,0,163,9,14,186,227,0.405,0.819
"26175","Santa Cruz","Gutiérrez","Esc. Emilio Finot",64,1,0,1,64,25,4,5,0,164,7,19,190,223,0.39,0.852
"26176","Santa Cruz","Gutiérrez","Esc. Emilio Finot",66,0,0,0,79,23,6,1,0,175,5,11,191,221,0.451,0.864
"26177","Santa Cruz","Gutiérrez","Esc. Emilio Finot",67,0,0,0,63,31,4,7,1,173,7,6,186,226,0.364,0.823
"26178","Santa Cruz","Gutiérrez","Esc. Palmarito",5,1,0,0,173,3,5,0,0,187,5,4,196,237,0.925,0.827
"26179","Santa Cruz","Gutiérrez","Esc. Mariscal Sucre",46,2,2,1,90,33,9,4,2,189,11,4,204,232,0.476,0.879
"26180","Santa Cruz","Gutiérrez","Esc. Miguel Landivar",18,2,0,0,113,28,17,1,1,180,6,11,197,225,0.628,0.876
"26181","Santa Cruz","Gutiérrez","Esc. Tatarenda Vieja",25,2,1,0,115,17,17,0,1,178,5,6,189,218,0.646,0.867
"26182","Santa Cruz","Gutiérrez","Esc. Ibamirapinta",8,1,0,1,112,13,36,1,3,175,24,3,202,230,0.64,0.878
"26183","Santa Cruz","Gutiérrez","Esc. Ibamirapinta",10,5,0,0,123,11,16,2,2,169,24,7,200,229,0.728,0.873
"26184","Santa Cruz","Gutiérrez","Esc. Seccional Capirenda",4,1,1,2,160,5,8,1,0,182,11,7,200,234,0.879,0.855
"26185","Santa Cruz","Gutiérrez","Esc. Seccional Itembeguazu",2,0,0,0,178,7,10,0,0,197,11,4,212,251,0.904,0.845
"26186","Santa Cruz","Gutiérrez","U.E. Isidro Chandey",1,8,1,5,133,7,24,24,0,203,9,25,237,238,0.655,0.996
"26187","Santa Cruz","Gutiérrez","U.E. Feliciano Ferreira",5,1,0,0,126,4,20,4,0,160,10,7,177,196,0.787,0.903
"26188","Santa Cruz","Camiri","Aulas U.A.G.R.M.",111,0,0,1,42,19,17,0,0,190,6,5,201,225,0.221,0.893
"26189","Santa Cruz","Camiri","Aulas U.A.G.R.M.",104,0,1,0,53,15,11,1,3,188,8,9,205,230,0.282,0.891
"26190","Santa Cruz","Camiri","Aulas U.A.G.R.M.",106,0,2,0,40,18,7,2,3,178,4,14,196,229,0.225,0.856
"26191","Santa Cruz","Camiri","Aulas U.A.G.R.M.",95,0,0,0,57,16,9,3,3,183,3,7,193,229,0.311,0.843
"26192","Santa Cruz","Camiri","Aulas U.A.G.R.M.",96,0,1,0,61,15,18,1,0,192,6,6,204,230,0.318,0.887
"26193","Santa Cruz","Camiri","Aulas U.A.G.R.M.",118,0,1,0,44,18,9,1,2,193,3,5,201,230,0.228,0.874
"26194","Santa Cruz","Camiri","Aulas U.A.G.R.M.",111,0,0,3,45,16,15,1,2,193,2,8,203,228,0.233,0.89
"26195","Santa Cruz","Camiri","Aulas U.A.G.R.M.",122,0,1,0,37,15,19,2,1,197,2,5,204,231,0.188,0.883
"26196","Santa Cruz","Camiri","Aulas U.A.G.R.M.",103,0,1,1,55,10,14,2,2,188,4,13,205,236,0.293,0.869
"26197","Santa Cruz","Camiri","Aulas U.A.G.R.M.",98,0,0,0,43,15,16,0,1,173,2,18,193,228,0.249,0.846
"26198","Santa Cruz","Camiri","Aulas U.A.G.R.M.",121,1,0,1,43,13,12,0,1,192,4,5,201,229,0.224,0.878
"26199","Santa Cruz","Camiri","Aulas U.A.G.R.M.",107,0,1,2,54,12,12,0,1,189,5,7,201,232,0.286,0.866
"26200","Santa Cruz","Camiri","Aulas U.A.G.R.M.",104,1,0,2,57,10,9,1,2,186,1,5,192,230,0.306,0.835
"26201","Santa Cruz","Camiri","Aulas U.A.G.R.M.",96,0,0,0,67,14,10,0,2,189,3,5,197,227,0.354,0.868
"26202","Santa Cruz","Camiri","Aulas U.A.G.R.M.",110,0,1,0,42,23,10,2,0,188,1,10,199,229,0.223,0.869
"26203","Santa Cruz","Camiri","Aulas U.A.G.R.M.",99,1,1,1,48,22,11,2,1,186,5,10,201,236,0.258,0.852
"26204","Santa Cruz","Camiri","Aulas U.A.G.R.M.",99,0,0,2,63,22,11,2,1,200,2,3,205,233,0.315,0.88
"26205","Santa Cruz","Camiri","Esc. Abel Iturralde",119,1,2,0,25,16,9,4,0,176,1,5,182,220,0.142,0.827
"26206","Santa Cruz","Camiri","Esc. Abel Iturralde",108,0,3,1,55,12,3,4,2,188,2,4,194,227,0.293,0.855
"26207","Santa Cruz","Camiri","Esc. Abel Iturralde",113,0,1,3,28,23,6,1,0,175,5,3,183,217,0.16,0.843
"26208","Santa Cruz","Camiri","Esc. Abel Iturralde",105,0,1,1,54,14,6,1,0,182,2,7,191,224,0.297,0.853
"26209","Santa Cruz","Camiri","Esc. Abel Iturralde",96,0,0,0,47,23,9,1,4,180,5,1,186,218,0.261,0.853
"26210","Santa Cruz","Camiri","Esc. Abel Iturralde",111,2,1,1,33,16,11,3,2,180,0,6,186,223,0.183,0.834
"26211","Santa Cruz","Camiri","Esc. Abel Iturralde",113,0,0,0,44,15,6,3,1,182,2,7,191,228,0.242,0.838
"26212","Santa Cruz","Camiri","Esc. Abel Iturralde",125,0,0,0,49,19,5,1,1,200,3,5,208,241,0.245,0.863
"26213","Santa Cruz","Camiri","Esc. Cristiana Evangelica",110,0,0,0,50,21,5,0,0,186,3,1,190,219,0.269,0.868
"26214","Santa Cruz","Camiri","Esc. Cristiana Evangelica",114,1,1,0,51,20,7,1,0,195,2,4,201,219,0.262,0.918
"26215","Santa Cruz","Camiri","Esc. Cristiana Evangelica",108,1,1,2,28,22,7,2,1,172,0,4,176,214,0.163,0.822
"26216","Santa Cruz","Camiri","Esc. Cristiana Evangelica",124,0,1,0,39,18,5,0,0,187,3,5,195,220,0.209,0.886
"26217","Santa Cruz","Camiri","Esc. Niño Jesus",128,0,0,1,41,21,7,0,1,199,2,3,204,224,0.206,0.911
"26218","Santa Cruz","Camiri","Esc. Niño Jesus",111,1,1,0,42,13,12,6,0,186,0,9,195,224,0.226,0.871
"26219","Santa Cruz","Camiri","Esc. Niño Jesus",122,0,0,0,37,21,5,1,0,186,1,6,193,224,0.199,0.862
"26220","Santa Cruz","Camiri","Esc. Niño Jesus",122,0,0,3,42,22,8,1,3,201,2,4,207,227,0.209,0.912
"26221","Santa Cruz","Camiri","Esc. Niño Jesus",110,0,1,2,43,18,7,1,1,183,1,10,194,238,0.235,0.815
"26222","Santa Cruz","Camiri","Esc. Jose Castrillo",98,1,1,2,53,6,16,2,0,179,5,7,191,228,0.296,0.838
"26223","Santa Cruz","Camiri","Esc. Jose Castrillo",73,1,2,1,80,19,10,1,1,188,5,6,199,231,0.426,0.861
"26224","Santa Cruz","Camiri","Esc. Jose Castrillo",95,0,0,2,60,21,9,1,1,189,4,8,201,228,0.317,0.882
"26225","Santa Cruz","Camiri","Esc. Jose Castrillo",97,1,0,0,66,7,11,1,1,184,2,8,194,223,0.359,0.87
"26226","Santa Cruz","Camiri","Esc. Jose Castrillo",83,0,1,2,65,18,11,2,0,182,4,17,203,229,0.357,0.886
"26227","Santa Cruz","Camiri","Esc. Jose Castrillo",82,0,0,0,72,20,8,4,2,188,2,9,199,231,0.383,0.861
"26228","Santa Cruz","Camiri","Esc. Jose Castrillo",98,1,0,1,55,17,14,1,1,188,4,8,200,229,0.293,0.873
"26229","Santa Cruz","Camiri","Esc. Jose Castrillo",95,0,0,0,65,13,8,0,2,183,4,9,196,228,0.355,0.86
"26230","Santa Cruz","Camiri","Esc. 24 de Septiembre",111,0,0,0,48,13,8,0,3,183,3,9,195,221,0.262,0.882
"26231","Santa Cruz","Camiri","Esc. 24 de Septiembre",97,0,0,1,44,21,10,3,0,176,2,7,185,213,0.25,0.869
"26232","Santa Cruz","Camiri","Esc. 24 de Septiembre",117,2,1,2,46,11,13,0,0,192,4,4,200,226,0.24,0.885
"26233","Santa Cruz","Camiri","Esc. 24 de Septiembre",102,0,3,0,46,18,8,1,2,180,3,3,186,222,0.256,0.838
"26234","Santa Cruz","Camiri","Esc. 24 de Septiembre",121,0,1,0,46,14,3,1,0,186,1,7,194,222,0.247,0.874
"26235","Santa Cruz","Camiri","Esc. 24 de Septiembre",106,0,1,0,57,10,7,1,2,184,7,5,196,226,0.31,0.867
"26236","Santa Cruz","Camiri","Esc. 24 de Septiembre",114,0,0,1,29,15,7,2,1,169,3,4,176,216,0.172,0.815
"26237","Santa Cruz","Camiri","Esc. 24 de Septiembre",107,1,0,0,40,18,6,1,2,175,2,4,181,220,0.229,0.823
"26238","Santa Cruz","Camiri","Esc. 24 de Septiembre",99,0,1,0,48,21,4,1,0,174,2,9,185,222,0.276,0.833
"26239","Santa Cruz","Camiri","Esc. 24 de Septiembre",106,0,1,2,45,9,7,0,1,171,4,6,181,216,0.263,0.838
"26240","Santa Cruz","Camiri","Esc. 12 de Julio",117,0,0,0,45,11,11,0,0,184,1,10,195,225,0.245,0.867
"26241","Santa Cruz","Camiri","Esc. 12 de Julio",113,0,1,3,42,6,13,1,0,179,2,6,187,221,0.235,0.846
"26242","Santa Cruz","Camiri","Esc. 12 de Julio",93,0,1,0,60,18,6,3,0,181,2,7,190,224,0.331,0.848
"26243","Santa Cruz","Camiri","Esc. 12 de Julio",113,0,0,0,43,21,13,4,0,194,1,5,200,224,0.222,0.893
"26244","Santa Cruz","Camiri","Esc. 12 de Julio",116,1,0,1,39,18,14,3,2,194,7,6,207,229,0.201,0.904
"26245","Santa Cruz","Camiri","Esc. 12 de Julio",104,0,2,0,56,15,7,1,0,185,2,10,197,235,0.303,0.838
"26246","Santa Cruz","Camiri","Esc. 12 de Julio",96,0,0,0,57,6,19,2,2,182,4,15,201,229,0.313,0.878
"26247","Santa Cruz","Camiri","Esc. 12 de Julio",88,0,1,2,54,25,9,4,0,183,3,5,191,227,0.295,0.841
"26248","Santa Cruz","Camiri","Esc. 12 de Julio",116,1,1,1,42,13,15,2,0,191,2,8,201,231,0.22,0.87
"26249","Santa Cruz","Camiri","Esc. 12 de Julio",102,2,0,0,46,21,19,1,1,192,2,8,202,231,0.24,0.874
"26250","Santa Cruz","Camiri","Esc. 12 de Julio",90,0,0,0,58,17,8,1,1,175,5,11,191,221,0.331,0.864
"26251","Santa Cruz","Camiri","Esc. 12 de Julio",96,1,1,0,46,23,8,3,1,179,2,11,192,228,0.257,0.842
"26252","Santa Cruz","Camiri","Esc. 12 de Julio",86,0,0,0,50,15,9,0,0,160,4,10,174,201,0.312,0.866
"26253","Santa Cruz","Camiri","Esc. 16 de Marzo",90,0,0,0,58,16,14,3,3,184,3,3,190,219,0.315,0.868
"26254","Santa Cruz","Camiri","Esc. 16 de Marzo",90,0,0,0,60,21,4,2,2,179,3,12,194,221,0.335,0.878
"26255","Santa Cruz","Camiri","Esc. 16 de Marzo",111,1,2,0,38,17,11,3,2,185,7,7,199,229,0.205,0.869
"26256","Santa Cruz","Camiri","Esc. 16 de Marzo",85,2,1,0,63,17,8,3,2,181,6,5,192,229,0.348,0.838
"26257","Santa Cruz","Camiri","Esc. 16 de Marzo",79,0,2,0,68,21,13,3,2,188,3,8,199,228,0.362,0.873
"26258","Santa Cruz","Camiri","Esc. 16 de Marzo",97,2,0,2,48,20,8,9,1,187,4,13,204,226,0.257,0.903
"26259","Santa Cruz","Camiri","Esc. 16 de Marzo",92,0,0,2,51,23,6,3,3,180,5,10,195,223,0.283,0.874
"26260","Santa Cruz","Camiri","Esc. Aponte J. Manuel O.H. Del Chaco",101,1,0,1,43,23,7,4,0,180,2,10,192,224,0.239,0.857
"26261","Santa Cruz","Camiri","Esc. Aponte J. Manuel O.H. Del Chaco",108,0,2,1,43,16,4,5,0,179,4,5,188,220,0.24,0.855
"26262","Santa Cruz","Camiri","Esc. Aponte J. Manuel O.H. Del Chaco",132,0,0,0,31,8,7,4,0,182,3,9,194,218,0.17,0.89
"26263","Santa Cruz","Camiri","Esc. Aponte J. Manuel O.H. Del Chaco",112,0,0,0,43,16,6,4,1,182,3,5,190,221,0.236,0.86
"26264","Santa Cruz","Camiri","Esc. Aponte J. Manuel O.H. Del Chaco",94,0,1,1,57,15,6,5,1,180,0,6,186,217,0.317,0.857
"26265","Santa Cruz","Camiri","Esc. Aponte J. Manuel O.H. Del Chaco",103,1,0,1,43,16,6,2,2,174,3,5,182,213,0.247,0.854
"26266","Santa Cruz","Camiri","Esc. Aponte J. Manuel O.H. Del Chaco",112,0,1,0,51,8,5,2,1,180,2,4,186,218,0.283,0.853
"26267","Santa Cruz","Camiri","Esc. Gabriel Rene Moreno",95,0,0,1,60,16,8,0,1,181,3,5,189,220,0.331,0.859
"26268","Santa Cruz","Camiri","Esc. Gabriel Rene Moreno",89,1,0,2,50,23,12,1,0,178,3,8,189,218,0.281,0.867
"26269","Santa Cruz","Camiri","Esc. Gabriel Rene Moreno",94,1,1,1,45,13,19,0,1,175,4,11,190,226,0.257,0.841
"26270","Santa Cruz","Camiri","Esc. Gabriel Rene Moreno",127,1,0,0,37,8,6,0,0,179,2,7,188,220,0.207,0.855
"26271","Santa Cruz","Camiri","Esc. Gabriel Rene Moreno",73,0,2,1,64,20,11,3,0,174,9,2,185,221,0.368,0.837
"26272","Santa Cruz","Camiri","Esc. Gabriel Rene Moreno",97,0,0,2,51,23,12,5,2,192,1,7,200,223,0.266,0.897
"26273","Santa Cruz","Camiri","Esc. Gabriel Rene Moreno",97,1,1,1,50,15,8,0,1,174,0,7,181,223,0.287,0.812
"26274","Santa Cruz","Camiri","Esc. Gabriel Rene Moreno",93,1,0,1,52,20,11,1,1,180,3,5,188,220,0.289,0.855
"26275","Santa Cruz","Camiri","Esc. Gabriel Rene Moreno",101,0,0,3,50,18,10,0,1,183,5,12,200,225,0.273,0.889
"26276","Santa Cruz","Camiri","Col. Hugo Arteaga",102,0,0,0,48,21,9,3,0,183,3,6,192,217,0.262,0.885
"26277","Santa Cruz","Camiri","Col. Hugo Arteaga",88,1,0,0,59,16,8,3,1,176,4,9,189,224,0.335,0.844
"26278","Santa Cruz","Camiri","Col. Hugo Arteaga",109,1,0,0,45,12,6,0,0,173,4,6,183,221,0.26,0.828
"26279","Santa Cruz","Camiri","Col. Hugo Arteaga",114,0,1,0,44,9,7,1,0,176,0,5,181,231,0.25,0.784
"26280","Santa Cruz","Camiri","Col. Hugo Arteaga",94,0,0,0,57,7,13,2,1,174,2,4,180,217,0.328,0.829
"26281","Santa Cruz","Camiri","Esc. Seccional El Rodeo",6,2,1,1,165,3,7,2,3,190,15,8,213,231,0.868,0.922
"26282","Santa Cruz","Camiri","Esc. Seccional Pipi",21,0,0,2,134,9,3,1,0,170,9,11,190,213,0.788,0.892
"26283","Santa Cruz","Camiri","Esc. Central de Itanambikua",33,1,1,0,108,13,19,2,2,179,11,13,203,225,0.603,0.902
"26284","Santa Cruz","Camiri","Esc. Central de Itanambikua",18,0,1,2,120,20,12,2,1,176,11,15,202,228,0.682,0.886
"26285","Santa Cruz","Camiri","Esc. Central de Itanambikua",25,1,2,0,125,27,14,2,0,196,13,9,218,245,0.638,0.89
"26286","Santa Cruz","Camiri","Esc. Central Urbana",65,0,0,1,73,14,7,2,2,164,6,6,176,227,0.445,0.775
"26287","Santa Cruz","Camiri","Esc. Central Urbana",66,1,1,0,68,17,7,2,0,162,0,8,170,229,0.42,0.742
"26288","Santa Cruz","Camiri","Esc. Central Urbana",68,0,1,1,79,23,10,1,0,183,3,3,189,229,0.432,0.825
"26289","Santa Cruz","Camiri","Esc. Central Urbana",60,0,1,1,63,22,11,3,0,161,3,3,167,205,0.391,0.815
"26290","Santa Cruz","Camiri","Esc. Secc. Curundaity",17,0,0,0,148,9,5,2,0,181,13,11,205,229,0.818,0.895
"26291","Santa Cruz","Camiri","Esc. Secc. Puente Viejo",41,1,3,0,77,20,14,3,2,161,7,14,182,235,0.478,0.774
"26292","Santa Cruz","Boyuibe","Esc. Central Rafael Pabon",68,0,0,0,66,15,2,6,0,157,3,9,169,223,0.42,0.758
"26293","Santa Cruz","Boyuibe","Esc. Central Rafael Pabon",64,0,0,0,74,10,9,17,0,174,1,11,186,226,0.425,0.823
"26294","Santa Cruz","Boyuibe","Esc. Central Rafael Pabon",56,2,0,0,90,13,7,18,1,187,2,6,195,229,0.481,0.852
"26295","Santa Cruz","Boyuibe","Esc. Central Rafael Pabon",56,0,0,0,92,7,7,20,0,182,5,4,191,230,0.505,0.83
"26296","Santa Cruz","Boyuibe","Esc. Central Rafael Pabon",77,0,1,1,61,15,8,12,0,175,2,9,186,227,0.349,0.819
"26297","Santa Cruz","Boyuibe","Esc. Central Rafael Pabon",51,0,0,1,67,13,8,16,1,157,8,3,168,226,0.427,0.743
"26298","Santa Cruz","Boyuibe","Esc. Central Rafael Pabon",58,0,0,0,76,20,13,12,0,179,4,7,190,231,0.425,0.823
"26299","Santa Cruz","Boyuibe","Esc. Central Rafael Pabon",54,0,0,0,81,15,10,18,1,179,2,5,186,227,0.453,0.819
"26300","Santa Cruz","Boyuibe","Esc. Central Rafael Pabon",52,0,1,1,78,20,7,14,0,173,0,10,183,219,0.451,0.836
"26301","Santa Cruz","Boyuibe","Esc. Central Rafael Pabon",50,1,0,0,92,7,9,11,1,171,4,9,184,225,0.538,0.818
"26302","Santa Cruz","Boyuibe","Esc. Central Rafael Pabon",44,0,1,0,89,25,5,13,1,178,3,6,187,242,0.5,0.773
"26303","Santa Cruz","Vallegrande","Esc. Juana Carmen Roman",90,1,0,2,56,34,14,2,0,199,3,7,209,227,0.281,0.921
"26304","Santa Cruz","Vallegrande","Esc. Juana Carmen Roman",82,1,0,1,53,30,10,0,0,177,4,9,190,220,0.299,0.864
"26305","Santa Cruz","Vallegrande","Esc. Juana Carmen Roman",72,3,0,2,52,36,14,1,1,181,6,12,199,227,0.287,0.877
"26306","Santa Cruz","Vallegrande","Esc. Juana Carmen Roman",75,3,0,1,59,26,14,0,1,179,3,12,194,223,0.33,0.87
"26307","Santa Cruz","Vallegrande","Esc. Juana Carmen Roman",81,0,0,1,47,29,16,2,2,178,8,10,196,214,0.264,0.916
"26308","Santa Cruz","Vallegrande","Esc. Juana Carmen Roman",81,0,1,0,51,35,8,0,2,178,5,6,189,220,0.287,0.859
"26309","Santa Cruz","Vallegrande","Esc. Juana Carmen Roman",71,1,1,1,48,37,17,2,1,179,10,7,196,219,0.268,0.895
"26310","Santa Cruz","Vallegrande","Esc. Juana Carmen Roman",84,1,2,1,55,29,9,2,1,184,2,9,195,223,0.299,0.874
"26311","Santa Cruz","Vallegrande","Kinder Santa Maria",110,0,2,1,51,21,3,3,0,191,1,8,200,225,0.267,0.889
"26312","Santa Cruz","Vallegrande","Kinder Santa Maria",102,1,0,1,48,31,12,1,1,197,5,3,205,225,0.244,0.911
"26313","Santa Cruz","Vallegrande","Kinder Santa Maria",95,0,0,0,50,22,12,2,0,181,6,11,198,227,0.276,0.872
"26314","Santa Cruz","Vallegrande","Kinder Santa Maria",90,1,0,0,50,35,10,1,0,187,2,9,198,226,0.267,0.876
"26315","Santa Cruz","Vallegrande","Kinder Santa Maria",101,1,0,1,42,30,8,2,1,186,4,10,200,226,0.226,0.885
"26316","Santa Cruz","Vallegrande","Kinder Santa Maria",79,0,0,1,62,37,9,0,1,189,2,9,200,225,0.328,0.889
"26317","Santa Cruz","Vallegrande","Kinder Santa Maria",77,0,0,0,52,40,4,0,1,174,3,12,189,219,0.299,0.863
"26318","Santa Cruz","Vallegrande","Kinder Santa Maria",96,1,0,0,46,30,4,3,2,182,6,10,198,224,0.253,0.884
"26319","Santa Cruz","Vallegrande","Kinder Santa Maria",82,0,0,0,67,35,4,1,0,189,5,8,202,225,0.354,0.898
"26320","Santa Cruz","Vallegrande","Esc. Obispo Manuel Jose Peña",83,2,0,0,48,33,9,2,4,181,1,10,192,220,0.265,0.873
"26321","Santa Cruz","Vallegrande","Esc. Obispo Manuel Jose Peña",102,1,1,0,45,26,11,0,0,186,5,5,196,218,0.242,0.899
"26322","Santa Cruz","Vallegrande","Esc. Obispo Manuel Jose Peña",97,0,1,1,52,24,11,0,1,187,1,9,197,222,0.278,0.887
"26323","Santa Cruz","Vallegrande","Esc. Obispo Manuel Jose Peña",78,4,1,0,42,28,15,4,3,175,12,10,197,230,0.24,0.857
"26324","Santa Cruz","Vallegrande","Esc. Obispo Manuel Jose Peña",73,1,0,0,54,38,8,3,0,177,4,12,193,225,0.305,0.858
"26325","Santa Cruz","Vallegrande","Esc. Obispo Manuel Jose Peña",85,0,2,3,56,23,8,0,1,178,6,11,195,219,0.315,0.89
"26326","Santa Cruz","Vallegrande","Esc. Obispo Manuel Jose Peña",87,1,1,1,47,34,12,1,1,185,3,10,198,221,0.254,0.896
"26327","Santa Cruz","Vallegrande","Esc. Obispo Manuel Jose Peña",103,0,0,0,30,24,7,3,0,167,4,13,184,214,0.18,0.86
"26328","Santa Cruz","Vallegrande","Esc. Obispo Manuel Jose Peña",73,1,1,0,50,33,10,1,1,170,0,16,186,215,0.294,0.865
"26329","Santa Cruz","Vallegrande","Esc. Obispo Manuel Jose Peña",81,0,0,0,51,28,9,5,0,174,3,7,184,213,0.293,0.864
"26330","Santa Cruz","Vallegrande","U.E. Fagima Eid de Villagómez",85,1,0,1,52,26,9,0,0,174,5,10,189,220,0.299,0.859
"26331","Santa Cruz","Vallegrande","U.E. Fagima Eid de Villagómez",82,1,0,1,58,28,5,0,0,175,5,13,193,221,0.331,0.873
"26332","Santa Cruz","Vallegrande","U.E. Fagima Eid de Villagómez",83,3,0,1,45,38,9,0,0,179,4,9,192,213,0.251,0.901
"26333","Santa Cruz","Vallegrande","U.E. Fagima Eid de Villagómez",73,3,2,2,52,34,9,0,0,175,8,13,196,227,0.297,0.863
"26334","Santa Cruz","Vallegrande","U.E. Fagima Eid de Villagómez",68,0,0,1,42,52,13,1,1,178,11,10,199,223,0.236,0.892
"26335","Santa Cruz","Vallegrande","U.E. Fagima Eid de Villagómez",91,0,1,0,49,29,15,1,0,186,4,8,198,224,0.263,0.884
"26336","Santa Cruz","Vallegrande","U.E. Fagima Eid de Villagómez",82,0,0,1,47,35,5,0,0,170,4,12,186,213,0.276,0.873
"26337","Santa Cruz","Vallegrande","U.E. Fagima Eid de Villagómez",76,0,1,1,54,32,12,2,1,179,2,14,195,222,0.302,0.878
"26338","Santa Cruz","Vallegrande","U.E. Fagima Eid de Villagómez",78,0,1,1,47,37,8,1,1,174,8,11,193,222,0.27,0.869
"26339","Santa Cruz","Vallegrande","U.E. Fagima Eid de Villagómez",90,1,0,0,34,40,8,2,0,175,5,13,193,225,0.194,0.858
"26340","Santa Cruz","Vallegrande","U.E. Fagima Eid de Villagómez",64,0,0,0,57,30,13,0,2,166,8,16,190,222,0.343,0.856
"26341","Santa Cruz","Vallegrande","U.E. Fagima Eid de Villagómez",98,0,0,0,44,30,7,1,0,180,3,12,195,223,0.244,0.874
"26342","Santa Cruz","Vallegrande","Esc. Central Guadalupe",53,4,1,1,75,44,5,3,1,187,4,6,197,216,0.401,0.912
"26343","Santa Cruz","Vallegrande","Esc. Central Guadalupe",70,2,0,1,64,40,6,3,0,186,2,5,193,215,0.344,0.898
"26344","Santa Cruz","Vallegrande","Esc. Nucleo San Juan",48,1,0,0,55,44,3,1,2,154,7,2,163,179,0.357,0.911
"26345","Santa Cruz","Trigal","Esc. San Jose Aguirre Acha",74,1,0,4,66,23,3,3,0,174,8,7,189,213,0.379,0.887
"26346","Santa Cruz","Trigal","Esc. San Jose Aguirre Acha",76,0,0,0,88,17,3,1,0,185,4,8,197,224,0.476,0.879
"26347","Santa Cruz","Trigal","Esc. San Jose Aguirre Acha",71,0,1,1,64,11,0,4,2,154,2,3,159,177,0.416,0.898
"26348","Santa Cruz","Trigal","Esc. Tte.Roman Alderette",45,1,0,1,56,46,2,1,0,152,4,4,160,180,0.368,0.889
"26349","Santa Cruz","Trigal","Esc. Lagunillas",67,0,1,2,74,25,6,2,0,177,7,10,194,219,0.418,0.886
"26350","Santa Cruz","Moromoro","Esc. Moromoro",74,1,2,2,62,37,9,0,1,188,7,9,204,217,0.33,0.94
"26351","Santa Cruz","Moromoro","Esc. Moromoro",58,1,1,3,28,53,6,2,3,155,13,19,187,217,0.181,0.862
"26352","Santa Cruz","Moromoro","Esc. Moromoro",67,1,3,0,47,41,8,3,1,171,13,19,203,223,0.275,0.91
"26353","Santa Cruz","Moromoro","Esc. La Laja",53,1,4,1,39,44,5,5,3,155,10,13,178,190,0.252,0.937
"26354","Santa Cruz","Moromoro","Esc. U.E. El Veladero",39,4,1,4,65,41,14,5,1,174,14,13,201,216,0.374,0.931
"26355","Santa Cruz","Postrervalle","Esc. Nucleo Postervalle",66,3,0,2,34,56,13,0,2,176,16,4,196,225,0.193,0.871
"26356","Santa Cruz","Postrervalle","Esc. Nucleo Postervalle",70,2,0,2,32,50,9,2,0,167,8,7,182,219,0.192,0.831
"26357","Santa Cruz","Postrervalle","Esc. Nucleo Postervalle",48,1,1,1,34,55,10,2,0,152,10,16,178,217,0.224,0.82
"26358","Santa Cruz","Pucará","Esc. Edey Corban Sehaller",73,0,1,0,85,21,0,0,0,180,2,6,188,214,0.472,0.879
"26359","Santa Cruz","Pucará","Esc. Edey Corban Sehaller",39,2,0,1,117,25,0,0,1,185,5,3,193,219,0.632,0.881
"26360","Santa Cruz","Pucará","Esc. Edey Corban Sehaller",37,0,1,0,113,41,1,3,1,197,7,7,211,231,0.574,0.913
"26361","Santa Cruz","Pucará","Esc. La Higuera",43,1,0,1,65,36,19,4,3,172,6,12,190,218,0.378,0.872
"26362","Santa Cruz","Samaipata","Esc. Napoleon Gomez",101,1,1,2,60,19,3,4,0,191,9,5,205,222,0.314,0.923
"26363","Santa Cruz","Samaipata","Esc. Napoleon Gomez",94,2,2,2,53,28,8,1,0,190,2,6,198,220,0.279,0.9
"26364","Santa Cruz","Samaipata","Esc. Napoleon Gomez",84,3,0,2,72,14,9,1,2,187,8,12,207,221,0.385,0.937
"26365","Santa Cruz","Samaipata","Esc. Napoleon Gomez",98,1,0,1,73,9,7,0,0,189,4,4,197,216,0.386,0.912
"26366","Santa Cruz","Samaipata","Esc. Napoleon Gomez",94,0,0,3,54,19,6,0,1,177,4,12,193,213,0.305,0.906
"26367","Santa Cruz","Samaipata","Esc. Napoleon Gomez",86,1,1,1,61,19,3,0,0,172,7,14,193,221,0.355,0.873
"26368","Santa Cruz","Samaipata","Esc. Napoleon Gomez",102,1,1,1,56,18,5,3,1,188,8,8,204,218,0.298,0.936
"26369","Santa Cruz","Samaipata","Esc. Napoleon Gomez",98,0,1,2,70,11,4,1,0,187,10,10,207,219,0.374,0.945
"26370","Santa Cruz","Samaipata","Esc. Napoleon Gomez",78,2,0,1,69,24,8,1,1,184,6,10,200,218,0.375,0.917
"26371","Santa Cruz","Samaipata","Esc. Napoleon Gomez",94,1,2,0,73,16,4,1,0,191,4,12,207,221,0.382,0.937
"26372","Santa Cruz","Samaipata","Esc. Gral. Agustin Saavedra",95,2,2,1,59,18,9,1,0,187,4,10,201,221,0.316,0.91
"26373","Santa Cruz","Samaipata","Esc. Gral. Agustin Saavedra",90,1,0,1,62,15,6,0,0,175,3,11,189,220,0.354,0.859
"26374","Santa Cruz","Samaipata","Esc. Gral. Agustin Saavedra",58,0,1,0,96,16,10,0,2,183,5,13,201,219,0.525,0.918
"26375","Santa Cruz","Samaipata","Esc. Gral. Agustin Saavedra",93,3,0,0,66,20,6,0,1,189,7,6,202,218,0.349,0.927
"26376","Santa Cruz","Samaipata","Esc. Gral. Agustin Saavedra",75,0,0,0,73,20,12,1,2,183,5,12,200,225,0.399,0.889
"26377","Santa Cruz","Samaipata","Esc. Gral. Agustin Saavedra",93,0,0,0,63,25,10,0,0,191,3,7,201,221,0.33,0.91
"26378","Santa Cruz","Samaipata","Esc. Gral. Agustin Saavedra",99,0,1,0,66,18,8,1,0,193,0,9,202,227,0.342,0.89
"26379","Santa Cruz","Samaipata","Esc. Gral. Agustin Saavedra",78,0,1,2,79,16,12,1,2,191,1,7,199,227,0.414,0.877
"26380","Santa Cruz","Samaipata","Esc. Gral. Agustin Saavedra",87,0,1,0,67,17,11,0,1,184,4,8,196,222,0.364,0.883
"26381","Santa Cruz","Samaipata","Esc. Timoteo Rondales",73,1,1,3,52,35,6,2,1,174,8,11,193,211,0.299,0.915
"26382","Santa Cruz","Samaipata","Esc. Timoteo Rondales",53,1,1,4,63,28,12,2,0,164,10,9,183,205,0.384,0.893
"26383","Santa Cruz","Samaipata","Esc. Santiago del Valle",93,0,0,0,40,28,5,6,0,172,4,9,185,209,0.233,0.885
"26384","Santa Cruz","Samaipata","Esc. Nucleo San Juan del Rosario",60,4,2,2,37,33,5,9,1,153,15,9,177,208,0.242,0.851
"26385","Santa Cruz","Samaipata","Esc. Central Bella Victoria",66,1,0,1,97,15,8,2,0,190,7,12,209,223,0.511,0.937
"26386","Santa Cruz","Samaipata","Esc. Central Bella Victoria",79,0,0,4,80,19,10,1,9,202,9,8,219,223,0.396,0.982
"26387","Santa Cruz","Samaipata","Esc. Central Bella Victoria",69,0,0,1,86,19,13,4,1,193,4,9,206,218,0.446,0.945
"26388","Santa Cruz","Samaipata","Esc. Central Bella Victoria",76,1,0,0,84,18,13,0,0,192,6,14,212,228,0.438,0.93
"26389","Santa Cruz","Samaipata","Esc. Central Bella Victoria",79,1,0,2,73,22,10,1,2,190,7,16,213,227,0.384,0.938
"26390","Santa Cruz","Samaipata","Esc. Unidad Educativa 27 De Mayo",50,1,1,3,80,17,21,2,1,176,2,6,184,196,0.455,0.939
"26391","Santa Cruz","Pampa Grande","Esc. Pedro Aristides",108,2,1,1,55,14,8,0,0,189,5,7,201,219,0.291,0.918
"26392","Santa Cruz","Pampa Grande","Esc. Pedro Aristides",106,1,2,2,38,22,13,0,0,184,5,8,197,218,0.207,0.904
"26393","Santa Cruz","Pampa Grande","Esc. Pedro Aristides",93,0,1,1,46,22,8,1,0,172,4,6,182,204,0.267,0.892
"26394","Santa Cruz","Pampa Grande","Esc. San Ignacio De Loyola",97,0,1,1,50,24,12,0,0,185,4,11,200,223,0.27,0.897
"26395","Santa Cruz","Pampa Grande","Esc. San Ignacio De Loyola",97,1,0,3,46,28,10,1,1,187,5,6,198,216,0.246,0.917
"26396","Santa Cruz","Pampa Grande","Esc. U.E. Eduardo Avaroa",37,1,0,2,133,8,7,1,0,189,7,8,204,226,0.704,0.903
"26397","Santa Cruz","Pampa Grande","Esc. U.E. Eduardo Avaroa",73,3,2,1,73,16,19,0,0,187,5,18,210,230,0.39,0.913
"26398","Santa Cruz","Pampa Grande","Esc. U.E. Eduardo Avaroa",45,1,1,1,135,8,7,1,1,200,6,17,223,235,0.675,0.949
"26399","Santa Cruz","Pampa Grande","Esc. U.E. Eduardo Avaroa",39,2,1,0,142,13,7,1,0,205,5,8,218,230,0.693,0.948
"26400","Santa Cruz","Pampa Grande","Esc. U.E. Eduardo Avaroa",62,3,0,2,88,16,7,2,1,181,14,8,203,228,0.486,0.89
"26401","Santa Cruz","Pampa Grande","Esc. U.E. Eduardo Avaroa",62,2,1,0,95,8,7,0,1,176,11,15,202,230,0.54,0.878
"26402","Santa Cruz","Pampa Grande","Esc. U.E. Eduardo Avaroa",57,0,1,1,113,11,10,1,0,194,5,29,228,228,0.582,1
"26403","Santa Cruz","Pampa Grande","Esc. U.E. Eduardo Avaroa",41,3,0,1,124,10,17,0,0,196,2,11,209,229,0.633,0.913
"26404","Santa Cruz","Pampa Grande","Esc. U.E. Eduardo Avaroa",32,0,2,1,135,6,8,0,2,186,6,27,219,232,0.726,0.944
"26405","Santa Cruz","Pampa Grande","Esc. U.E. Eduardo Avaroa",72,1,1,1,89,18,10,1,0,193,3,9,205,225,0.461,0.911
"26406","Santa Cruz","Pampa Grande","Esc. U.E. Eduardo Avaroa",61,1,1,1,116,7,6,1,1,195,6,9,210,231,0.595,0.909
"26407","Santa Cruz","Pampa Grande","Esc. U.E. Eduardo Avaroa",63,0,0,1,110,12,6,0,1,193,9,19,221,221,0.57,1
"26408","Santa Cruz","Pampa Grande","Esc. U.E. Eduardo Avaroa",50,1,2,0,102,15,14,0,1,185,14,6,205,226,0.551,0.907
"26409","Santa Cruz","Pampa Grande","Esc. U.E. Eduardo Avaroa",52,2,0,1,116,10,10,0,0,191,4,5,200,228,0.607,0.877
"26410","Santa Cruz","Pampa Grande","Esc. U.E. Eduardo Avaroa",54,0,0,0,97,10,8,0,0,169,6,34,209,228,0.574,0.917
"26411","Santa Cruz","Pampa Grande","Esc. U.E. Eduardo Avaroa",52,0,0,0,119,9,17,0,0,197,10,6,213,226,0.604,0.942
"26412","Santa Cruz","Pampa Grande","Esc. Palmasola (El Carmen)",24,6,0,0,102,20,5,1,0,158,10,11,179,191,0.646,0.937
"26413","Santa Cruz","Pampa Grande","Esc. Nucleo Santa Rosa",48,1,1,0,101,23,1,2,0,177,3,7,187,196,0.571,0.954
"26414","Santa Cruz","Mairana","Esc. Rene Barrientos Ortuño",63,1,0,1,103,5,12,2,0,187,1,10,198,231,0.551,0.857
"26415","Santa Cruz","Mairana","Esc. Rene Barrientos Ortuño",63,0,1,0,95,17,11,0,3,190,5,10,205,232,0.5,0.884
"26416","Santa Cruz","Mairana","Esc. Rene Barrientos Ortuño",65,0,2,0,88,11,7,3,0,176,6,18,200,227,0.5,0.881
"26417","Santa Cruz","Mairana","Esc. Rene Barrientos Ortuño",29,1,0,2,127,8,21,3,1,192,6,11,209,226,0.661,0.925
"26418","Santa Cruz","Mairana","Esc. Rene Barrientos Ortuño",36,1,2,0,138,7,11,0,1,196,1,12,209,231,0.704,0.905
"26419","Santa Cruz","Mairana","Esc. Rene Barrientos Ortuño",68,2,0,1,91,14,8,1,0,185,9,12,206,229,0.492,0.9
"26420","Santa Cruz","Mairana","Esc. Rene Barrientos Ortuño",55,2,0,0,120,12,8,2,0,199,6,6,211,228,0.603,0.925
"26421","Santa Cruz","Mairana","Esc. Rene Barrientos Ortuño",75,1,0,2,91,9,10,2,1,191,4,9,204,224,0.476,0.911
"26422","Santa Cruz","Mairana","Esc. Rene Barrientos Ortuño",69,1,1,1,97,10,10,1,0,190,5,14,209,229,0.511,0.913
"26423","Santa Cruz","Mairana","Esc. Rene Barrientos Ortuño",70,0,0,0,79,14,12,2,0,177,10,14,201,226,0.446,0.889
"26424","Santa Cruz","Mairana","Esc. Rene Barrientos Ortuño",60,2,0,0,104,5,20,2,0,193,3,10,206,228,0.539,0.904
"26425","Santa Cruz","Mairana","Esc. Rene Barrientos Ortuño",42,0,0,1,110,15,16,1,0,185,4,17,206,230,0.595,0.896
"26426","Santa Cruz","Mairana","Esc. Rene Barrientos Ortuño",40,1,2,1,128,10,14,1,1,198,5,5,208,231,0.646,0.9
"26427","Santa Cruz","Mairana","Esc. Rene Barrientos Ortuño",77,0,0,0,86,14,11,2,0,190,3,12,205,222,0.453,0.923
"26428","Santa Cruz","Mairana","Esc. Rene Barrientos Ortuño",89,1,0,0,70,15,13,2,0,190,6,13,209,223,0.368,0.937
"26429","Santa Cruz","Mairana","Esc. Rene Barrientos Ortuño",72,1,0,1,96,11,13,2,0,196,7,12,215,232,0.49,0.927
"26430","Santa Cruz","Mairana","Esc. Rene Barrientos Ortuño",68,0,0,0,89,15,17,0,0,189,3,9,201,219,0.471,0.918
"26431","Santa Cruz","Mairana","Esc. Rene Barrientos Ortuño",107,1,0,0,67,14,8,1,0,198,2,6,206,227,0.338,0.907
"26432","Santa Cruz","Mairana","Esc. Rene Barrientos Ortuño",49,0,0,2,120,6,11,1,2,191,1,11,203,224,0.628,0.906
"26433","Santa Cruz","Mairana","Esc. Rene Barrientos Ortuño",69,0,1,2,76,17,13,1,1,180,1,13,194,222,0.422,0.874
"26434","Santa Cruz","Mairana","Esc. Rene Barrientos Ortuño",53,1,1,1,104,11,19,0,0,190,3,10,203,228,0.547,0.89
"26435","Santa Cruz","Mairana","Esc. Rene Barrientos Ortuño",69,0,0,0,85,20,5,2,0,181,6,12,199,221,0.47,0.9
"26436","Santa Cruz","Mairana","Esc. Rene Barrientos Ortuño",83,1,0,1,79,13,11,1,1,190,5,8,203,221,0.416,0.919
"26437","Santa Cruz","Mairana","Esc. Rene Barrientos Ortuño",70,0,0,2,95,17,11,1,0,196,1,5,202,228,0.485,0.886
"26438","Santa Cruz","Mairana","Esc. Rene Barrientos Ortuño",56,0,1,0,116,5,4,2,1,185,5,16,206,228,0.627,0.904
"26439","Santa Cruz","Mairana","Esc. Rene Barrientos Ortuño",46,2,0,1,130,5,16,1,1,202,6,6,214,226,0.644,0.947
"26440","Santa Cruz","Mairana","Esc. Rene Barrientos Ortuño",54,0,1,0,124,12,8,1,1,201,6,6,213,231,0.617,0.922
"26441","Santa Cruz","Mairana","Esc. Rene Barrientos Ortuño",70,1,0,0,87,14,10,4,1,187,4,9,200,229,0.465,0.873
"26442","Santa Cruz","Mairana","Esc. Angel Saavedra Chavez",62,0,3,1,79,11,2,0,0,158,4,12,174,186,0.5,0.935
"26443","Santa Cruz","Mairana","Esc. Ananias Melendres",44,2,0,0,119,9,16,1,4,195,1,8,204,229,0.61,0.891
"26444","Santa Cruz","Mairana","Esc. Ananias Melendres",37,1,1,0,122,7,16,0,1,185,8,22,215,231,0.659,0.931
"26445","Santa Cruz","Mairana","Esc. Ananias Melendres",53,1,2,0,91,11,25,1,3,187,9,12,208,219,0.487,0.95
"26446","Santa Cruz","Quirusillas","Esc. Nestor Paz Zamora",90,0,0,3,64,19,4,2,0,182,8,9,199,227,0.352,0.877
"26447","Santa Cruz","Quirusillas","Esc. Nestor Paz Zamora",65,0,0,2,81,23,5,1,2,179,3,13,195,221,0.453,0.882
"26448","Santa Cruz","Quirusillas","Esc. Nestor Paz Zamora",76,1,0,1,69,36,2,1,1,187,4,4,195,220,0.369,0.886
"26449","Santa Cruz","Quirusillas","Esc. Nestor Paz Zamora",69,1,2,0,63,26,6,1,1,169,7,8,184,219,0.373,0.84
"26450","Santa Cruz","Montero","Col. Rene Moreno",139,0,0,0,31,12,8,1,0,191,2,10,203,226,0.162,0.898
"26451","Santa Cruz","Montero","Col. Rene Moreno",135,0,0,0,19,9,7,0,0,170,1,33,204,219,0.112,0.932
"26452","Santa Cruz","Montero","Col. Rene Moreno",138,1,2,0,27,15,10,2,0,195,0,3,198,223,0.138,0.888
"26453","Santa Cruz","Montero","Col. Rene Moreno",140,0,0,1,23,17,8,3,1,193,2,4,199,225,0.119,0.884
"26454","Santa Cruz","Montero","Col. Rene Moreno",141,0,0,2,28,13,9,0,0,193,1,7,201,215,0.145,0.935
"26455","Santa Cruz","Montero","Col. Rene Moreno",159,0,0,1,11,19,4,0,1,195,0,1,196,214,0.056,0.916
"26456","Santa Cruz","Montero","Col. Rene Moreno",134,0,1,2,27,11,10,0,0,185,0,5,190,217,0.146,0.876
"26457","Santa Cruz","Montero","Col. Rene Moreno",159,0,0,1,16,12,7,1,0,196,0,3,199,217,0.082,0.917
"26458","Santa Cruz","Montero","Col. Rene Moreno",133,0,0,2,29,16,14,1,0,195,1,2,198,224,0.149,0.884
"26459","Santa Cruz","Montero","Col. Rene Moreno",160,0,1,1,24,15,3,0,0,204,1,1,206,230,0.118,0.896
"26460","Santa Cruz","Montero","Col. Rene Moreno",148,0,0,1,28,14,4,0,0,195,0,5,200,221,0.144,0.905
"26461","Santa Cruz","Montero","Col. Rene Moreno",131,1,0,3,34,17,7,2,0,195,2,4,201,215,0.174,0.935
"26462","Santa Cruz","Montero","Col. Rene Moreno",137,0,0,1,26,19,3,1,2,189,0,5,194,221,0.138,0.878
"26463","Santa Cruz","Montero","Col. Guillermo Kruegler",122,0,0,1,23,24,4,0,0,174,1,7,182,215,0.132,0.847
"26464","Santa Cruz","Montero","Col. Guillermo Kruegler",134,1,0,0,26,27,5,1,0,194,2,7,203,225,0.134,0.902
"26465","Santa Cruz","Montero","Col. Guillermo Kruegler",106,0,0,1,48,20,13,1,0,189,0,7,196,230,0.254,0.852
"26466","Santa Cruz","Montero","Col. Guillermo Kruegler",113,0,0,2,38,14,15,1,1,184,0,1,185,213,0.207,0.869
"26467","Santa Cruz","Montero","Col. Guillermo Kruegler",116,0,1,1,35,17,9,1,1,181,2,5,188,223,0.193,0.843
"26468","Santa Cruz","Montero","Col. Guillermo Kruegler",135,0,0,0,24,28,4,1,0,192,1,2,195,217,0.125,0.899
"26469","Santa Cruz","Montero","Col. Guillermo Kruegler",122,0,0,1,30,25,5,2,0,185,2,2,189,226,0.162,0.836
"26470","Santa Cruz","Montero","Col. Guillermo Kruegler",98,0,1,0,57,17,10,4,0,187,2,6,195,218,0.305,0.894
"26471","Santa Cruz","Montero","Col. Guillermo Kruegler",118,1,0,3,26,27,10,2,1,188,1,12,201,220,0.138,0.914
"26472","Santa Cruz","Montero","Col. Guillermo Kruegler",121,0,1,1,34,17,4,0,1,179,2,8,189,222,0.19,0.851
"26473","Santa Cruz","Montero","Col. Guillermo Kruegler",119,0,0,2,41,20,4,1,0,187,2,5,194,226,0.219,0.858
"26474","Santa Cruz","Montero","Col. Guillermo Kruegler",123,1,1,0,39,23,4,2,0,193,2,4,199,224,0.202,0.888
"26475","Santa Cruz","Montero","Col. Guillermo Kruegler",105,0,1,1,35,43,6,0,0,191,2,4,197,220,0.183,0.895
"26476","Santa Cruz","Montero","Col. Guillermo Kruegler",125,0,0,1,29,23,3,0,0,181,2,6,189,222,0.16,0.851
"26477","Santa Cruz","Montero","Col. Guillermo Kruegler",109,0,0,0,40,21,8,2,1,181,1,5,187,215,0.221,0.87
"26478","Santa Cruz","Montero","Col. Guillermo Kruegler",117,0,0,0,50,17,16,0,1,201,2,9,212,237,0.249,0.895
"26479","Santa Cruz","Montero","Col. Daniel Rivero",44,1,1,0,106,11,27,0,1,191,2,5,198,222,0.555,0.892
"26480","Santa Cruz","Montero","Col. Daniel Rivero",47,0,1,0,101,5,35,0,3,192,3,6,201,223,0.526,0.901
"26481","Santa Cruz","Montero","Col. Daniel Rivero",52,0,2,1,97,10,23,0,1,186,2,11,199,223,0.522,0.892
"26482","Santa Cruz","Montero","Col. Daniel Rivero",48,0,0,1,103,8,32,0,2,194,5,3,202,231,0.531,0.874
"26483","Santa Cruz","Montero","Col. Daniel Rivero",50,0,2,1,115,10,19,0,1,198,1,6,205,235,0.581,0.872
"26484","Santa Cruz","Montero","Col. Daniel Rivero",33,0,0,0,116,10,19,1,3,182,1,7,190,228,0.637,0.833
"26485","Santa Cruz","Montero","Col. Daniel Rivero",40,1,0,0,117,5,23,5,2,193,4,9,206,231,0.606,0.892
"26486","Santa Cruz","Montero","Col. Daniel Rivero",36,0,0,0,115,6,38,0,1,196,3,6,205,233,0.587,0.88
"26487","Santa Cruz","Montero","Col. Daniel Rivero",58,1,2,0,101,3,27,0,3,195,3,1,199,227,0.518,0.877
"26488","Santa Cruz","Montero","Col. Daniel Rivero",36,1,1,1,113,11,29,0,0,192,3,5,200,223,0.589,0.897
"26489","Santa Cruz","Montero","Col. Daniel Rivero",50,1,0,1,91,16,36,1,1,197,2,2,201,225,0.462,0.893
"26490","Santa Cruz","Montero","Col. Daniel Rivero",42,1,1,0,102,11,24,0,2,183,1,8,192,225,0.557,0.853
"26491","Santa Cruz","Montero","Col. Daniel Rivero",46,0,2,1,113,6,25,0,1,194,0,5,199,226,0.582,0.881
"26492","Santa Cruz","Montero","Col. Daniel Rivero",50,0,2,1,93,13,22,1,1,183,2,8,193,221,0.508,0.873
"26493","Santa Cruz","Montero","Col. Daniel Rivero",50,0,1,1,101,10,29,2,0,194,3,3,200,225,0.521,0.889
"26494","Santa Cruz","Montero","Col. Daniel Rivero",37,0,1,0,130,8,20,0,1,197,2,4,203,227,0.66,0.894
"26495","Santa Cruz","Montero","Col. Daniel Rivero",52,0,0,0,104,15,13,2,0,186,1,7,194,226,0.559,0.858
"26496","Santa Cruz","Montero","Col. Daniel Rivero",53,1,0,1,91,14,16,0,1,177,2,9,188,223,0.514,0.843
"26497","Santa Cruz","Montero","Col. Daniel Rivero",46,0,0,0,109,3,24,1,1,184,2,1,187,222,0.592,0.842
"26498","Santa Cruz","Montero","Col. Daniel Rivero",49,2,0,1,115,6,21,0,0,194,1,5,200,230,0.593,0.87
"26499","Santa Cruz","Montero","Col. Daniel Rivero",53,1,0,0,99,7,29,1,0,190,0,6,196,223,0.521,0.879
"26500","Santa Cruz","Montero","Col. Daniel Rivero",31,2,2,0,121,6,29,0,1,192,0,5,197,220,0.63,0.895
"26501","Santa Cruz","Montero","Col. Daniel Rivero",50,0,0,0,97,6,30,0,1,184,2,5,191,222,0.527,0.86
"26502","Santa Cruz","Montero","Col. Daniel Rivero",36,0,0,1,118,11,22,0,0,188,2,4,194,228,0.628,0.851
"26503","Santa Cruz","Montero","Col. Daniel Rivero",39,1,1,0,104,13,21,2,1,182,2,7,191,225,0.571,0.849
"26504","Santa Cruz","Montero","Col. Daniel Rivero",43,1,1,1,100,17,26,3,0,192,2,5,199,222,0.521,0.896
"26505","Santa Cruz","Montero","Col. Daniel Rivero",51,0,2,2,116,15,15,0,0,201,2,5,208,235,0.577,0.885
"26506","Santa Cruz","Montero","Col. Daniel Rivero",55,0,1,0,87,21,28,0,1,193,0,9,202,226,0.451,0.894
"26507","Santa Cruz","Montero","Col. Daniel Rivero",40,0,1,0,117,8,21,0,4,191,3,9,203,226,0.613,0.898
"26508","Santa Cruz","Montero","Col. Daniel Rivero",48,0,0,1,118,7,31,1,1,207,1,4,212,231,0.57,0.918
"26509","Santa Cruz","Montero","Col. Daniel Rivero",32,0,0,0,93,7,24,2,0,158,0,8,166,186,0.589,0.892
"26510","Santa Cruz","Montero","Col. Fe y Alegria",133,0,0,0,31,20,4,1,0,189,3,4,196,221,0.164,0.887
"26511","Santa Cruz","Montero","Col. Fe y Alegria",134,0,0,2,23,30,6,0,0,195,3,1,199,220,0.118,0.905
"26512","Santa Cruz","Montero","Col. Fe y Alegria",134,0,0,0,35,24,12,0,1,206,2,5,213,228,0.17,0.934
"26513","Santa Cruz","Montero","Col. Fe y Alegria",134,2,0,0,32,17,9,0,1,195,1,8,204,222,0.164,0.919
"26514","Santa Cruz","Montero","Col. Fe y Alegria",129,0,0,0,18,24,10,2,0,183,2,6,191,217,0.098,0.88
"26515","Santa Cruz","Montero","Col. Fe y Alegria",118,0,1,1,47,21,9,1,0,198,0,2,200,223,0.237,0.897
"26516","Santa Cruz","Montero","Col. Fe y Alegria",147,0,0,1,20,16,5,1,3,193,0,4,197,221,0.104,0.891
"26517","Santa Cruz","Montero","Col. Fe y Alegria",123,1,0,1,32,17,13,2,1,190,1,6,197,222,0.168,0.887
"26518","Santa Cruz","Montero","Col. Fe y Alegria",128,0,0,2,37,24,7,4,1,203,0,1,204,225,0.182,0.907
"26519","Santa Cruz","Montero","Col. Fe y Alegria",140,0,0,2,27,19,9,3,0,200,1,1,202,220,0.135,0.918
"26520","Santa Cruz","Montero","Col. Fe y Alegria",145,0,0,0,23,18,8,2,0,196,2,4,202,220,0.117,0.918
"26521","Santa Cruz","Montero","Col. Fe y Alegria",150,1,0,1,27,15,3,0,0,197,1,1,199,223,0.137,0.892
"26522","Santa Cruz","Montero","Col. Fe y Alegria",134,0,0,1,28,13,6,3,1,186,3,6,195,221,0.151,0.882
"26523","Santa Cruz","Montero","Col. Fe y Alegria",114,0,1,0,43,21,11,3,0,193,2,0,195,221,0.223,0.882
"26524","Santa Cruz","Montero","Col. Fe y Alegria",142,0,0,0,23,15,11,5,0,196,1,5,202,219,0.117,0.922
"26525","Santa Cruz","Montero","Col. Fe y Alegria",137,0,1,1,23,26,5,2,2,197,0,4,201,218,0.117,0.922
"26526","Santa Cruz","Montero","Col. Fe y Alegria",131,0,0,2,34,20,7,1,1,196,1,4,201,223,0.173,0.901
"26527","Santa Cruz","Montero","Col. Marcos Chavez",102,0,0,1,62,17,10,1,2,195,0,9,204,225,0.318,0.907
"26528","Santa Cruz","Montero","Col. Marcos Chavez",101,1,1,1,50,19,10,3,1,187,1,8,196,226,0.267,0.867
"26529","Santa Cruz","Montero","Col. Marcos Chavez",90,0,1,1,85,17,7,2,0,203,2,6,211,228,0.419,0.925
"26530","Santa Cruz","Montero","Col. Marcos Chavez",93,0,2,0,62,28,15,3,0,203,2,9,214,228,0.305,0.939
"26531","Santa Cruz","Montero","Col. Marcos Chavez",102,0,0,2,62,15,20,1,0,202,4,1,207,227,0.307,0.912
"26532","Santa Cruz","Montero","Col. Marcos Chavez",110,1,1,0,50,14,14,3,2,195,3,4,202,227,0.256,0.89
"26533","Santa Cruz","Montero","Col. Marcos Chavez",107,0,1,0,51,24,13,0,0,196,1,5,202,226,0.26,0.894
"26534","Santa Cruz","Montero","Col. Marcos Chavez",107,0,0,0,49,26,11,0,0,193,1,6,200,223,0.254,0.897
"26535","Santa Cruz","Montero","Col. Marcos Chavez",97,0,0,0,58,24,7,1,0,187,3,6,196,224,0.31,0.875
"26536","Santa Cruz","Montero","Col. Marcos Chavez",98,1,0,0,64,19,18,2,1,203,2,4,209,233,0.315,0.897
"26537","Santa Cruz","Montero","Col. Marcos Chavez",100,0,2,0,44,29,10,3,0,188,4,0,192,228,0.234,0.842
"26538","Santa Cruz","Montero","Col. Marcos Chavez",96,0,3,1,61,28,14,0,0,203,4,6,213,234,0.3,0.91
"26539","Santa Cruz","Montero","Col. Eduardo Abaroa",104,0,1,2,56,15,12,1,2,193,1,7,201,226,0.29,0.889
"26540","Santa Cruz","Montero","Col. Eduardo Abaroa",109,0,0,2,52,11,11,1,2,188,2,3,193,217,0.277,0.889
"26541","Santa Cruz","Montero","Col. Eduardo Abaroa",88,0,0,0,67,10,17,6,1,189,2,1,192,210,0.354,0.914
"26542","Santa Cruz","Montero","Col. Eduardo Abaroa",79,1,0,0,78,9,19,1,0,187,3,4,194,224,0.417,0.866
"26543","Santa Cruz","Montero","Col. Eduardo Abaroa",109,2,0,0,50,18,15,3,0,197,3,8,208,229,0.254,0.908
"26544","Santa Cruz","Montero","Col. Eduardo Abaroa",92,0,0,1,56,16,19,0,0,184,2,4,190,214,0.304,0.888
"26545","Santa Cruz","Montero","Col. Eduardo Abaroa",118,0,0,2,55,19,10,0,0,204,1,5,210,230,0.27,0.913
"26546","Santa Cruz","Montero","Col. Eduardo Abaroa",96,0,0,2,65,17,8,0,2,190,3,6,199,220,0.342,0.905
"26547","Santa Cruz","Montero","Col. Eduardo Abaroa",85,0,0,4,61,15,20,3,0,188,1,2,191,221,0.324,0.864
"26548","Santa Cruz","Montero","Col. Eduardo Abaroa",99,0,0,0,58,17,7,1,0,182,3,4,189,222,0.319,0.851
"26549","Santa Cruz","Montero","Col. Eduardo Abaroa",104,0,0,1,50,26,10,1,1,193,0,9,202,221,0.259,0.914
"26550","Santa Cruz","Montero","Col. Marceliano Montero",132,0,1,0,45,15,1,1,0,195,0,3,198,221,0.231,0.896
"26551","Santa Cruz","Montero","Col. Marceliano Montero",133,0,0,0,33,8,7,0,1,182,1,3,186,213,0.181,0.873
"26552","Santa Cruz","Montero","Col. Marceliano Montero",138,1,0,0,29,11,9,0,1,189,2,5,196,216,0.153,0.907
"26553","Santa Cruz","Montero","Col. Marceliano Montero",131,0,0,1,28,15,12,3,1,191,2,1,194,225,0.147,0.862
"26554","Santa Cruz","Montero","Col. Marceliano Montero",121,1,1,0,30,31,12,1,0,197,2,6,205,229,0.152,0.895
"26555","Santa Cruz","Montero","Col. Marceliano Montero",150,0,0,2,12,25,1,1,0,191,2,1,194,224,0.063,0.866
"26556","Santa Cruz","Montero","Col. Marceliano Montero",130,1,1,0,34,10,15,3,0,194,2,5,201,226,0.175,0.889
"26557","Santa Cruz","Montero","Col. Marceliano Montero",139,0,0,2,25,16,9,1,0,192,2,4,198,227,0.13,0.872
"26558","Santa Cruz","Montero","Col. Marceliano Montero",129,1,1,0,21,27,6,1,0,186,0,8,194,222,0.113,0.874
"26559","Santa Cruz","Montero","Col. Marceliano Montero",139,0,0,0,31,10,6,1,1,188,0,8,196,224,0.165,0.875
"26560","Santa Cruz","Montero","Col. Marceliano Montero",118,1,0,1,27,21,12,2,0,182,2,9,193,220,0.148,0.877
"26561","Santa Cruz","Montero","Col. Marceliano Montero",142,0,0,1,26,14,12,3,1,199,3,4,206,229,0.131,0.9
"26562","Santa Cruz","Montero","Col. Marceliano Montero",121,2,0,0,43,16,5,1,3,191,1,10,202,223,0.225,0.906
"26563","Santa Cruz","Montero","U.E. Marceliano Montero",134,0,0,0,31,21,5,1,0,192,0,4,196,219,0.161,0.895
"26564","Santa Cruz","Montero","U.E. Marceliano Montero",124,0,0,1,31,18,9,4,1,188,0,2,190,221,0.165,0.86
"26565","Santa Cruz","Montero","U.E. Marceliano Montero",122,1,0,1,29,15,12,0,0,180,3,7,190,221,0.161,0.86
"26566","Santa Cruz","Montero","U.E. Marceliano Montero",131,0,0,1,25,15,5,4,0,181,1,9,191,222,0.138,0.86
"26567","Santa Cruz","Montero","U.E. Marceliano Montero",124,2,0,1,32,22,12,0,0,193,0,4,197,222,0.166,0.887
"26568","Santa Cruz","Montero","U.E. Marceliano Montero",126,0,0,0,33,12,4,3,0,178,2,7,187,215,0.185,0.87
"26569","Santa Cruz","Montero","U.E. Marceliano Montero",133,0,1,0,25,10,9,1,0,179,1,5,185,218,0.14,0.849
"26570","Santa Cruz","Montero","Col. Victor Salvatierra",111,0,0,0,58,13,9,1,2,194,1,2,197,226,0.299,0.872
"26571","Santa Cruz","Montero","Col. Victor Salvatierra",130,0,1,0,35,11,16,2,2,197,0,2,199,223,0.178,0.892
"26572","Santa Cruz","Montero","Col. Victor Salvatierra",125,0,0,0,39,17,14,0,1,196,0,6,202,227,0.199,0.89
"26573","Santa Cruz","Montero","Col. Victor Salvatierra",130,0,1,0,41,19,8,0,1,200,0,4,204,222,0.205,0.919
"26574","Santa Cruz","Montero","Col. Victor Salvatierra",124,0,0,1,37,13,12,2,0,189,0,8,197,220,0.196,0.895
"26575","Santa Cruz","Montero","Col. Victor Salvatierra",115,0,0,1,42,21,14,0,0,193,1,33,227,227,0.218,1
"26576","Santa Cruz","Montero","Col. Victor Salvatierra",138,1,0,0,25,23,10,0,0,197,1,5,203,221,0.127,0.919
"26577","Santa Cruz","Montero","Col. Victor Salvatierra",124,0,0,0,29,6,15,2,0,176,1,9,186,221,0.165,0.842
"26578","Santa Cruz","Montero","Col. Victor Salvatierra",131,0,0,0,31,18,10,4,0,194,1,4,199,221,0.16,0.9
"26579","Santa Cruz","Montero","Col. Victor Salvatierra",109,0,0,0,49,12,17,1,0,188,0,9,197,218,0.261,0.904
"26580","Santa Cruz","Montero","Col. Simon Bolivar",127,0,0,0,35,24,7,1,0,194,1,5,200,219,0.18,0.913
"26581","Santa Cruz","Montero","Col. Simon Bolivar",108,1,0,1,39,23,12,4,0,188,4,7,199,225,0.207,0.884
"26582","Santa Cruz","Montero","Col. Simon Bolivar",105,0,0,1,39,31,12,1,0,189,3,7,199,223,0.206,0.892
"26583","Santa Cruz","Montero","Col. Simon Bolivar",132,0,0,1,30,29,10,0,0,202,0,4,206,225,0.149,0.916
"26584","Santa Cruz","Montero","Col. Simon Bolivar",124,0,0,0,33,24,7,2,0,190,4,2,196,224,0.174,0.875
"26585","Santa Cruz","Montero","Col. Simon Bolivar",123,0,0,0,43,23,4,0,1,194,2,6,202,226,0.222,0.894
"26586","Santa Cruz","Montero","Col. Simon Bolivar",110,0,0,4,30,28,6,0,0,178,3,12,193,220,0.169,0.877
"26587","Santa Cruz","Montero","Col. Simon Bolivar",106,0,0,0,41,36,11,4,0,198,1,2,201,226,0.207,0.889
"26588","Santa Cruz","Montero","Col. Jose Cronembol",118,0,0,0,47,21,8,1,2,197,0,5,202,233,0.239,0.867
"26589","Santa Cruz","Montero","Col. Jose Cronembol",136,1,0,1,24,20,10,3,0,195,3,9,207,231,0.123,0.896
"26590","Santa Cruz","Montero","Col. Jose Cronembol",118,0,0,0,46,20,9,4,1,198,0,5,203,229,0.232,0.886
"26591","Santa Cruz","Montero","Col. Jose Cronembol",122,0,0,2,34,18,9,2,1,188,2,11,201,233,0.181,0.863
"26592","Santa Cruz","Montero","Col. Jose Cronembol",99,2,0,2,43,18,10,1,0,175,1,14,190,229,0.246,0.83
"26593","Santa Cruz","Montero","Col. Jose Cronembol",120,2,0,1,21,32,10,1,0,187,5,9,201,228,0.112,0.882
"26594","Santa Cruz","Montero","Col. Jose Cronembol",128,1,1,0,39,18,7,1,0,195,4,2,201,231,0.2,0.87
"26595","Santa Cruz","Montero","Col. Jose Cronembol",113,1,0,1,45,24,10,1,1,196,2,4,202,228,0.23,0.886
"26596","Santa Cruz","Montero","Col. Jose Cronembol",112,0,1,1,31,30,7,1,1,184,3,8,195,231,0.168,0.844
"26597","Santa Cruz","Montero","Col. Jose Cronembol",112,0,0,0,39,37,10,2,0,200,0,5,205,225,0.195,0.911
"26598","Santa Cruz","Montero","Col. Jose Cronembol",102,1,0,2,39,34,12,0,1,191,0,8,199,234,0.204,0.85
"26599","Santa Cruz","Montero","Col. Jose Cronembol",129,0,0,0,29,23,11,1,0,193,1,5,199,231,0.15,0.861
"26600","Santa Cruz","Montero","Col. Jose Cronembol",103,1,0,1,40,26,6,1,0,178,2,12,192,221,0.225,0.869
"26601","Santa Cruz","Montero","Col. Jose Cronembol",97,0,1,0,31,28,6,4,1,168,3,12,183,204,0.185,0.897
"26602","Santa Cruz","Montero","Col. Rafael Terrazas",134,0,0,0,32,24,11,2,0,203,1,5,209,226,0.158,0.925
"26603","Santa Cruz","Montero","Col. Rafael Terrazas",116,0,0,0,22,27,1,2,0,168,2,9,179,216,0.131,0.829
"26604","Santa Cruz","Montero","Col. Rafael Terrazas",129,0,0,1,19,22,2,2,0,175,2,7,184,212,0.109,0.868
"26605","Santa Cruz","Montero","Col. Rafael Terrazas",138,1,1,0,16,24,4,2,0,186,0,5,191,214,0.086,0.893
"26606","Santa Cruz","Montero","Col. Rafael Terrazas",133,0,0,1,24,24,1,3,0,186,1,4,191,222,0.129,0.86
"26607","Santa Cruz","Montero","Col. Rafael Terrazas",113,0,0,1,17,19,5,1,0,156,1,29,186,218,0.109,0.853
"26608","Santa Cruz","Montero","Col. Rafael Terrazas",106,1,0,0,36,29,4,0,1,177,1,6,184,221,0.203,0.833
"26609","Santa Cruz","Montero","Col. Rafael Terrazas",135,1,0,0,15,28,7,1,0,187,2,3,192,223,0.08,0.861
"26610","Santa Cruz","Montero","Col. Rafael Terrazas",128,0,0,0,20,30,6,2,0,186,1,5,192,219,0.108,0.877
"26611","Santa Cruz","Montero","U.E. Maximiliano Kolbe",105,0,1,0,54,25,6,3,1,195,2,4,201,229,0.277,0.878
"26612","Santa Cruz","Montero","U.E. Maximiliano Kolbe",93,0,0,1,59,29,8,0,1,191,2,8,201,229,0.309,0.878
"26613","Santa Cruz","Montero","U.E. Maximiliano Kolbe",124,1,0,0,41,25,7,1,1,200,3,1,204,225,0.205,0.907
"26614","Santa Cruz","Montero","U.E. Maximiliano Kolbe",87,0,0,3,68,16,11,2,0,187,0,6,193,230,0.364,0.839
"26615","Santa Cruz","Montero","U.E. Maximiliano Kolbe",102,0,0,0,64,18,16,0,1,201,3,7,211,231,0.318,0.913
"26616","Santa Cruz","Montero","U.E. Maximiliano Kolbe",79,1,1,1,87,17,7,1,0,194,2,4,200,232,0.448,0.862
"26617","Santa Cruz","Montero","U.E. Maximiliano Kolbe",86,0,1,0,65,20,19,2,2,195,2,5,202,228,0.333,0.886
"26618","Santa Cruz","Montero","U.E. Maximiliano Kolbe",72,0,1,0,74,22,27,0,0,196,4,5,205,232,0.378,0.884
"26619","Santa Cruz","Montero","U.E. Maximiliano Kolbe",84,1,0,1,64,31,14,2,0,197,5,2,204,227,0.325,0.899
"26620","Santa Cruz","Montero","U.E. Maximiliano Kolbe",112,0,0,0,55,23,13,1,0,204,0,6,210,234,0.27,0.897
"26621","Santa Cruz","Montero","U.E. Maximiliano Kolbe",91,1,0,0,58,17,21,1,0,189,2,4,195,228,0.307,0.855
"26622","Santa Cruz","Montero","U.E. Maximiliano Kolbe",49,0,4,1,103,22,18,0,2,199,3,4,206,230,0.518,0.896
"26623","Santa Cruz","Montero","U.E. Maximiliano Kolbe",109,1,0,1,49,18,9,3,1,191,2,5,198,230,0.257,0.861
"26624","Santa Cruz","Montero","U.E. Maximiliano Kolbe",90,0,0,2,50,31,14,0,0,187,3,7,197,228,0.267,0.864
"26625","Santa Cruz","Montero","U.E. Maximiliano Kolbe",103,1,2,1,51,19,15,2,0,194,1,6,201,232,0.263,0.866
"26626","Santa Cruz","Montero","U.E. Maximiliano Kolbe",111,0,0,1,48,24,5,3,0,192,1,29,222,222,0.25,1
"26627","Santa Cruz","Montero","U.E. Maximiliano Kolbe",113,0,0,3,67,14,7,1,0,205,0,5,210,230,0.327,0.913
"26628","Santa Cruz","Montero","U.E. Maximiliano Kolbe",109,0,0,2,50,25,5,1,1,193,2,3,198,229,0.259,0.865
"26629","Santa Cruz","Montero","U.E. Maximiliano Kolbe",101,0,1,0,64,22,10,1,2,201,2,2,205,228,0.318,0.899
"26630","Santa Cruz","Montero","U.E. Maximiliano Kolbe",99,1,0,0,62,24,13,1,1,201,2,6,209,228,0.308,0.917
"26631","Santa Cruz","Montero","U.E. Maximiliano Kolbe",111,1,0,1,43,23,9,1,0,189,2,7,198,230,0.228,0.861
"26632","Santa Cruz","Montero","U.E. Maximiliano Kolbe",102,1,0,0,52,25,16,2,0,198,2,8,208,233,0.263,0.893
"26633","Santa Cruz","Montero","U.E. Maximiliano Kolbe",73,0,0,0,82,17,11,0,0,183,3,12,198,229,0.448,0.865
"26634","Santa Cruz","Montero","Col. Unidad Educativa La Esperanza",87,0,0,1,74,17,26,3,0,208,2,8,218,238,0.356,0.916
"26635","Santa Cruz","Montero","Col. Unidad Educativa La Esperanza",88,1,1,1,79,10,26,0,0,206,21,2,229,229,0.383,1
"26636","Santa Cruz","Montero","Col. Unidad Educativa La Esperanza",56,0,1,2,98,10,31,1,2,201,2,6,209,232,0.488,0.901
"26637","Santa Cruz","Montero","Col. Unidad Educativa La Esperanza",72,1,0,0,79,13,30,0,1,196,1,5,202,226,0.403,0.894
"26638","Santa Cruz","Montero","Col. Unidad Educativa La Esperanza",80,0,0,1,78,9,19,3,2,192,3,4,199,234,0.406,0.85
"26639","Santa Cruz","Montero","Col. Unidad Educativa La Esperanza",87,0,1,0,68,17,27,0,2,202,1,3,206,228,0.337,0.904
"26640","Santa Cruz","Montero","Col. Unidad Educativa La Esperanza",81,0,0,0,89,11,24,1,2,208,1,4,213,229,0.428,0.93
"26641","Santa Cruz","Montero","Col. Unidad Educativa La Esperanza",91,1,0,2,73,8,22,2,0,199,1,7,207,230,0.367,0.9
"26642","Santa Cruz","Montero","Col. Unidad Educativa La Esperanza",84,1,2,0,75,11,16,2,0,191,0,3,194,229,0.393,0.847
"26643","Santa Cruz","Montero","Col. Unidad Educativa La Esperanza",86,2,0,1,72,9,26,2,0,198,4,7,209,228,0.364,0.917
"26644","Santa Cruz","Montero","Col. Unidad Educativa La Esperanza",97,0,2,0,60,7,24,0,0,190,2,8,200,229,0.316,0.873
"26645","Santa Cruz","Montero","Col. Unidad Educativa La Esperanza",95,0,0,0,76,16,20,0,1,208,1,5,214,233,0.365,0.918
"26646","Santa Cruz","Montero","Col. Unidad Educativa La Esperanza",53,0,1,1,81,7,22,0,1,166,3,5,174,195,0.488,0.892
"26647","Santa Cruz","Montero","Col. Unidad Educativa Villa Virginia",36,0,1,1,116,9,21,1,2,187,8,5,200,229,0.62,0.873
"26648","Santa Cruz","Montero","Col. Unidad Educativa Villa Virginia",29,0,0,0,125,12,22,2,0,190,2,9,201,230,0.658,0.874
"26649","Santa Cruz","Montero","Col. Unidad Educativa Villa Virginia",11,0,2,0,154,7,22,0,2,198,6,4,208,230,0.778,0.904
"26650","Santa Cruz","Montero","Col. Unidad Educativa Villa Virginia",38,0,0,3,117,14,14,3,2,191,5,4,200,232,0.613,0.862
"26651","Santa Cruz","Montero","Col. Unidad Educativa Villa Virginia",31,0,2,0,123,12,24,1,3,196,2,4,202,235,0.628,0.86
"26652","Santa Cruz","Montero","Col. Unidad Educativa Villa Virginia",25,1,1,0,131,7,16,1,1,183,6,3,192,228,0.716,0.842
"26653","Santa Cruz","Montero","Col. Unidad Educativa Villa Virginia",33,1,0,0,115,13,24,1,1,188,0,8,196,228,0.612,0.86
"26654","Santa Cruz","Montero","Col. Unidad Educativa Villa Virginia",37,0,5,0,104,11,12,2,0,171,3,25,199,231,0.608,0.861
"26655","Santa Cruz","Montero","Col. Unidad Educativa Villa Virginia",26,1,2,0,144,9,17,0,1,200,4,3,207,236,0.72,0.877
"26656","Santa Cruz","Montero","Col. Unidad Educativa Villa Virginia",33,1,1,0,134,11,17,1,0,198,5,3,206,231,0.677,0.892
"26657","Santa Cruz","Montero","Col. Unidad Educativa Villa Virginia",37,0,1,0,125,8,24,2,0,197,2,5,204,230,0.635,0.887
"26658","Santa Cruz","Montero","Col. Franz Tamayo",76,0,1,0,87,18,19,1,1,203,2,5,210,232,0.429,0.905
"26659","Santa Cruz","Montero","Col. Franz Tamayo",54,0,1,0,88,20,24,1,0,188,3,9,200,228,0.468,0.877
"26660","Santa Cruz","Montero","Col. Franz Tamayo",56,0,0,0,106,9,24,1,2,198,1,7,206,227,0.535,0.907
"26661","Santa Cruz","Montero","Col. Franz Tamayo",46,2,0,0,98,22,33,2,0,203,0,11,214,235,0.483,0.911
"26662","Santa Cruz","Montero","Col. Franz Tamayo",44,3,1,0,108,19,19,1,2,197,2,5,204,224,0.548,0.911
"26663","Santa Cruz","Montero","Col. Franz Tamayo",32,0,0,0,116,11,37,1,2,199,0,6,205,229,0.583,0.895
"26664","Santa Cruz","Montero","Col. Franz Tamayo",80,0,0,0,68,27,14,2,1,192,6,6,204,228,0.354,0.895
"26665","Santa Cruz","Montero","Col. Franz Tamayo",54,0,0,1,93,18,23,0,0,189,1,8,198,224,0.492,0.884
"26666","Santa Cruz","Montero","Col. Franz Tamayo",51,0,0,0,106,14,26,0,0,197,0,1,198,226,0.538,0.876
"26667","Santa Cruz","Montero","Col. Franz Tamayo",73,3,1,0,67,19,22,2,1,188,7,8,203,224,0.356,0.906
"26668","Santa Cruz","Montero","Col. Franz Tamayo",48,1,0,0,97,20,30,1,1,198,3,2,203,229,0.49,0.886
"26669","Santa Cruz","Montero","Col. Franz Tamayo",59,2,0,2,68,28,20,2,0,181,4,11,196,232,0.376,0.845
"26670","Santa Cruz","Montero","Col. Franz Tamayo",47,2,0,0,91,23,14,1,1,179,2,14,195,227,0.508,0.859
"26671","Santa Cruz","Montero","Col. Franz Tamayo",42,0,0,0,91,27,23,0,0,183,3,7,193,225,0.497,0.858
"26672","Santa Cruz","Montero","Col. Angel Limpias",51,1,2,1,105,12,17,0,2,191,10,5,206,235,0.55,0.877
"26673","Santa Cruz","Montero","Col. Angel Limpias",57,0,1,1,98,24,6,4,0,191,1,7,199,230,0.513,0.865
"26674","Santa Cruz","Montero","Col. Angel Limpias",38,0,1,0,118,10,21,1,1,190,3,8,201,233,0.621,0.863
"26675","Santa Cruz","Montero","Col. Angel Limpias",30,0,1,1,115,11,29,1,0,188,4,17,209,231,0.612,0.905
"26676","Santa Cruz","Montero","Col. Angel Limpias",45,2,0,0,103,19,21,1,0,191,4,9,204,226,0.539,0.903
"26677","Santa Cruz","Montero","Col. Angel Limpias",44,0,2,0,123,12,12,0,0,193,2,8,203,231,0.637,0.879
"26678","Santa Cruz","Montero","Col. Angel Limpias",61,0,0,1,96,14,22,0,1,195,4,10,209,234,0.492,0.893
"26679","Santa Cruz","Montero","Col. Angel Limpias",43,0,1,1,119,10,21,1,3,199,4,3,206,231,0.598,0.892
"26680","Santa Cruz","Montero","Col. Angel Limpias",48,1,1,0,115,21,15,0,0,201,3,7,211,234,0.572,0.902
"26681","Santa Cruz","Montero","Col. Angel Limpias",54,0,0,3,98,17,24,1,0,197,4,7,208,231,0.497,0.9
"26682","Santa Cruz","Montero","Col. Angel Limpias",45,2,0,1,121,8,15,2,0,194,3,4,201,227,0.624,0.885
"26683","Santa Cruz","Montero","Col. Angel Limpias",57,0,1,0,96,17,19,0,1,191,3,10,204,230,0.503,0.887
"26684","Santa Cruz","Montero","Col. Angel Limpias",53,0,1,0,98,14,15,1,0,182,3,9,194,229,0.538,0.847
"26685","Santa Cruz","Montero","Col. Angel Limpias",46,1,0,0,108,13,20,1,0,189,1,7,197,231,0.571,0.853
"26686","Santa Cruz","Montero","Col. U.E. Montecristo",96,0,1,0,62,18,18,1,0,196,3,5,204,230,0.316,0.887
"26687","Santa Cruz","Montero","Col. U.E. Montecristo",66,0,0,1,100,14,15,2,0,198,0,9,207,232,0.505,0.892
"26688","Santa Cruz","Montero","Col. U.E. Montecristo",63,1,0,2,104,11,16,2,2,201,0,8,209,234,0.517,0.893
"26689","Santa Cruz","Montero","Col. U.E. Montecristo",95,1,1,1,65,12,16,1,0,192,3,3,198,231,0.339,0.857
"26690","Santa Cruz","Montero","Col. U.E. Montecristo",76,1,1,0,89,12,12,1,0,192,0,7,199,230,0.464,0.865
"26691","Santa Cruz","Montero","Col. U.E. Montecristo",73,0,0,2,82,23,8,2,0,190,1,8,199,228,0.432,0.873
"26692","Santa Cruz","Montero","Col. U.E. Montecristo",69,3,0,1,71,24,15,0,0,183,2,9,194,221,0.388,0.878
"26693","Santa Cruz","Montero","Col. U.E. Montecristo",81,1,0,0,75,24,13,3,0,197,2,6,205,234,0.381,0.876
"26694","Santa Cruz","Montero","Col. U.E. Montecristo",87,1,0,1,72,16,9,1,1,188,3,9,200,231,0.383,0.866
"26695","Santa Cruz","Montero","Col. U.E. Montecristo",70,2,0,0,79,16,16,1,1,185,2,8,195,227,0.427,0.859
"26696","Santa Cruz","Montero","Col. U.E. Elvira Frias",25,4,1,0,125,11,28,0,0,194,1,6,201,229,0.644,0.878
"26697","Santa Cruz","Montero","Col. U.E. Elvira Frias",24,0,2,0,133,9,25,0,3,196,3,7,206,230,0.679,0.896
"26698","Santa Cruz","Montero","Col. U.E. Elvira Frias",36,0,0,1,124,11,19,1,0,192,1,8,201,226,0.646,0.889
"26699","Santa Cruz","Montero","Col. U.E. Elvira Frias",34,1,0,0,122,6,22,0,0,185,4,13,202,226,0.659,0.894
"26700","Santa Cruz","Montero","Col. U.E. Elvira Frias",28,1,0,0,143,8,24,0,0,204,2,8,214,233,0.701,0.918
"26701","Santa Cruz","Montero","Col. U.E. Elvira Frias",28,0,1,0,135,10,19,0,0,193,4,6,203,221,0.699,0.919
"26702","Santa Cruz","Montero","Col. U.E. Elvira Frias",23,2,1,0,130,4,28,1,3,192,3,6,201,227,0.677,0.885
"26703","Santa Cruz","Montero","Col. U.E. Elvira Frias",37,1,0,0,118,9,32,0,0,197,1,8,206,230,0.599,0.896
"26704","Santa Cruz","Montero","Col. U.E. Elvira Frias",37,0,0,0,113,11,31,0,1,193,2,5,200,229,0.585,0.873
"26705","Santa Cruz","Montero","Col. U.E. Elvira Frias",28,0,0,0,117,8,26,1,0,180,1,14,195,230,0.65,0.848
"26706","Santa Cruz","Montero","Col. U.E. Elvira Frias",32,1,0,0,115,6,42,1,1,198,0,4,202,222,0.581,0.91
"26707","Santa Cruz","Montero","Col. U.E. Elvira Frias",31,1,0,0,115,8,22,0,1,178,5,10,193,223,0.646,0.865
"26708","Santa Cruz","Montero","Col. U.E. Elvira Frias",33,3,1,0,121,15,27,2,0,202,0,0,202,227,0.599,0.89
"26709","Santa Cruz","Montero","Col. U.E. Elvira Frias",40,0,2,0,114,6,31,1,1,195,1,4,200,227,0.585,0.881
"26710","Santa Cruz","Montero","Col. U.E. Elvira Frias",22,0,0,1,139,12,23,0,0,197,0,7,204,228,0.706,0.895
"26711","Santa Cruz","Montero","Col. U.E. Elvira Frias",33,0,0,3,120,8,32,0,0,196,1,6,203,224,0.612,0.906
"26712","Santa Cruz","Montero","Col. U.E. Elvira Frias",44,1,0,1,97,8,31,1,0,183,2,13,198,222,0.53,0.892
"26713","Santa Cruz","Montero","Col. U.E. Elvira Frias",32,1,1,1,121,9,16,0,1,182,1,15,198,221,0.665,0.896
"26714","Santa Cruz","Montero","Col. U.E. Elvira Frias",35,0,2,0,111,19,22,0,2,191,2,12,205,233,0.581,0.88
"26715","Santa Cruz","Montero","Col. U.E. Elvira Frias",50,0,4,1,94,16,17,2,0,184,2,11,197,224,0.511,0.879
"26716","Santa Cruz","Montero","Col. U.E. Elvira Frias",38,1,0,2,121,5,23,2,0,192,2,10,204,230,0.63,0.887
"26717","Santa Cruz","Montero","Col. U.E. Elvira Frias",26,0,0,0,123,9,28,1,0,187,3,5,195,220,0.658,0.886
"26718","Santa Cruz","Montero","Col. U.E. Elvira Frias",36,2,1,0,120,9,33,0,1,202,3,5,210,231,0.594,0.909
"26719","Santa Cruz","Montero","Col. U.E. Elvira Frias",40,3,0,0,107,9,25,1,2,187,3,1,191,220,0.572,0.868
"26720","Santa Cruz","Montero","Col. U.E. Elvira Frias",29,0,0,0,114,9,34,1,0,187,4,5,196,229,0.61,0.856
"26721","Santa Cruz","Montero","Col. U.E. Elvira Frias",38,1,0,0,113,8,27,1,0,188,2,9,199,225,0.601,0.884
"26722","Santa Cruz","Montero","Col. U.E. Elvira Frias",57,0,0,1,103,10,13,0,1,185,2,4,191,221,0.557,0.864
"26723","Santa Cruz","Montero","Col. U.E. Elvira Frias",40,0,2,0,115,5,19,1,2,184,2,9,195,224,0.625,0.871
"26724","Santa Cruz","Montero","Col. U.E. Elvira Frias",23,0,2,0,129,4,36,0,1,195,1,6,202,232,0.662,0.871
"26725","Santa Cruz","Montero","Col. San Jose Obrero",50,0,0,0,112,15,27,1,1,206,4,3,213,232,0.544,0.918
"26726","Santa Cruz","Montero","Col. San Jose Obrero",45,1,1,0,105,14,21,0,2,189,1,14,204,231,0.556,0.883
"26727","Santa Cruz","Montero","Col. San Jose Obrero",51,2,2,0,111,15,21,1,0,203,1,7,211,230,0.547,0.917
"26728","Santa Cruz","Montero","Col. San Jose Obrero",66,0,1,2,107,7,24,2,0,209,3,2,214,231,0.512,0.926
"26729","Santa Cruz","Montero","Col. San Jose Obrero",38,1,0,0,116,15,26,1,1,198,4,3,205,229,0.586,0.895
"26730","Santa Cruz","Montero","Col. San Jose Obrero",48,0,0,0,105,8,28,2,1,192,6,3,201,226,0.547,0.889
"26731","Santa Cruz","Montero","Col. San Jose Obrero",39,0,4,0,99,12,24,1,0,179,6,7,192,223,0.553,0.861
"26732","Santa Cruz","Montero","Col. San Jose Obrero",38,3,0,0,120,5,22,1,0,189,1,6,196,226,0.635,0.867
"26733","Santa Cruz","Montero","Col. San Jose Obrero",39,1,1,0,130,7,27,0,2,207,0,8,215,233,0.628,0.923
"26734","Santa Cruz","Montero","Col. San Jose Obrero",34,0,1,0,111,8,32,1,0,187,1,10,198,232,0.594,0.853
"26735","Santa Cruz","Montero","Col. San Jose Obrero",38,1,0,2,117,7,25,0,3,193,2,6,201,227,0.606,0.885
"26736","Santa Cruz","Montero","Col. San Jose Obrero",63,1,0,1,97,6,22,0,0,190,3,11,204,233,0.511,0.876
"26737","Santa Cruz","Montero","Col. San Jose Obrero",51,1,0,0,106,7,25,1,2,193,3,5,201,220,0.549,0.914
"26738","Santa Cruz","Montero","Col. San Jose Obrero",43,0,3,2,115,19,18,1,0,201,2,2,205,230,0.572,0.891
"26739","Santa Cruz","Montero","Col. San Jose Obrero",42,1,0,0,111,8,24,3,1,190,1,5,196,223,0.584,0.879
"26740","Santa Cruz","Montero","Col. San Jose Obrero",55,1,0,2,121,6,13,0,1,199,1,6,206,228,0.608,0.904
"26741","Santa Cruz","Montero","Col. San Jose Obrero",37,1,1,0,113,10,33,3,0,198,3,5,206,224,0.571,0.92
"26742","Santa Cruz","Montero","Col. San Jose Obrero",43,0,0,1,113,7,24,0,1,189,2,4,195,226,0.598,0.863
"26743","Santa Cruz","Montero","Col. San Jose Obrero",44,0,1,1,96,9,31,2,1,185,1,15,201,228,0.519,0.882
"26744","Santa Cruz","Montero","Col. San Jose Obrero",47,2,0,2,109,7,28,1,0,196,3,9,208,228,0.556,0.912
"26745","Santa Cruz","Montero","Col. San Jose Obrero",25,0,1,0,97,13,24,0,0,160,3,5,168,199,0.606,0.844
"26746","Santa Cruz","Montero","U.E. Nuevo Milenio",17,2,0,0,111,13,35,1,0,179,0,3,182,238,0.62,0.765
"26747","Santa Cruz","Montero","U.E. Nuevo Milenio",23,0,0,0,128,9,25,0,0,185,2,2,189,237,0.692,0.797
"26748","Santa Cruz","Montero","U.E. Nuevo Milenio",31,0,1,0,119,9,24,0,2,186,1,2,189,239,0.64,0.791
"26749","Santa Cruz","Montero","U.E. 12 de Abril",74,0,0,2,85,31,15,3,0,210,0,5,215,235,0.405,0.915
"26750","Santa Cruz","Montero","U.E. 12 de Abril",61,0,0,0,104,28,13,2,1,209,1,7,217,235,0.498,0.923
"26751","Santa Cruz","Montero","U.E. 12 de Abril",91,2,0,0,74,32,6,3,3,211,0,6,217,237,0.351,0.916
"26752","Santa Cruz","Montero","U.E. San Silvestre",40,2,2,1,115,15,29,2,1,207,1,10,218,239,0.556,0.912
"26753","Santa Cruz","Montero","U.E. San Silvestre",36,2,0,0,121,9,42,0,0,210,6,6,222,238,0.576,0.933
"26754","Santa Cruz","Montero","U.E. San Silvestre",46,2,0,2,114,13,29,0,0,206,2,10,218,235,0.553,0.928
"26755","Santa Cruz","Montero","U.E. San Silvestre",42,0,1,1,113,12,37,1,2,209,1,6,216,237,0.541,0.911
"26756","Santa Cruz","Montero","U.E. San Silvestre",33,0,0,0,125,13,26,3,0,200,5,8,213,238,0.625,0.895
"26757","Santa Cruz","Montero","U.E. Juancito Pinto",39,1,0,0,132,18,22,0,0,212,3,5,220,237,0.623,0.928
"26758","Santa Cruz","Montero","U.E. Juancito Pinto",14,2,0,1,172,7,14,0,0,210,2,8,220,237,0.819,0.928
"26759","Santa Cruz","Montero","U.E. Juancito Pinto",16,1,1,0,151,7,18,0,2,196,2,8,206,237,0.77,0.869
"26760","Santa Cruz","Montero","U.E. Juancito Pinto",24,0,0,1,135,10,23,0,2,195,2,12,209,233,0.692,0.897
"26761","Santa Cruz","Montero","U.E. Juancito Pinto",21,0,0,0,164,7,8,1,2,203,2,8,213,236,0.808,0.903
"26762","Santa Cruz","Montero","U.E. Juancito Pinto",21,1,2,0,155,9,18,0,0,206,1,9,216,233,0.752,0.927
"26763","Santa Cruz","Montero","U.E. Juancito Pinto",42,0,3,1,124,15,15,0,0,200,5,9,214,237,0.62,0.903
"26764","Santa Cruz","Montero","U.E. Juancito Pinto",28,1,1,1,152,16,22,1,2,224,4,4,232,257,0.679,0.903
"26765","Santa Cruz","Montero","U.E. San Ramon de La Vibora",46,0,0,1,138,10,13,1,0,209,3,6,218,235,0.66,0.928
"26766","Santa Cruz","Montero","U.E. San Ramon de La Vibora",46,1,0,0,140,10,16,0,0,213,2,7,222,239,0.657,0.929
"26767","Santa Cruz","Montero","U.E. San Ramon de La Vibora",46,2,2,0,81,10,12,1,0,154,4,5,163,175,0.526,0.931
"26768","Santa Cruz","Montero","Col. Juan Zabala",75,0,0,1,72,19,16,0,0,183,2,3,188,220,0.393,0.855
"26769","Santa Cruz","Montero","Col. Juan Zabala",84,0,0,1,51,36,20,4,0,196,3,3,202,224,0.26,0.902
"26770","Santa Cruz","Montero","Col. Juan Zabala",92,0,1,0,55,35,12,1,0,196,1,5,202,222,0.281,0.91
"26771","Santa Cruz","Montero","Col. Juan Zabala",93,0,1,0,71,27,7,1,1,201,2,10,213,233,0.353,0.914
"26772","Santa Cruz","Montero","Col. Juan Zabala",56,0,0,2,88,27,21,1,0,195,0,5,200,230,0.451,0.87
"26773","Santa Cruz","Montero","Col. Juan Zabala",65,0,0,0,71,19,22,2,1,180,2,11,193,225,0.394,0.858
"26774","Santa Cruz","Montero","Col. Juan Zabala",80,0,1,1,65,19,15,3,0,184,1,5,190,219,0.353,0.868
"26775","Santa Cruz","Montero","Col. Juan Zabala",91,1,1,0,66,15,11,6,0,191,0,7,198,226,0.346,0.876
"26776","Santa Cruz","Montero","Col. Juan Zabala",63,2,0,0,91,22,15,2,0,195,1,9,205,226,0.467,0.907
"26777","Santa Cruz","Montero","Col. Juan Zabala",79,0,1,1,63,27,14,3,1,189,0,12,201,230,0.333,0.874
"26778","Santa Cruz","Montero","Col. Juan Zabala",74,1,1,0,61,18,22,2,0,179,1,15,195,227,0.341,0.859
"26779","Santa Cruz","Montero","Col. Juan Zabala",95,0,1,2,47,26,15,4,0,190,1,10,201,228,0.247,0.882
"26780","Santa Cruz","Montero","Col. Juan Zabala",53,0,2,2,100,11,23,5,2,198,1,3,202,223,0.505,0.906
"26781","Santa Cruz","Montero","Col. Juan Zabala",92,0,0,1,53,32,12,2,0,192,0,8,200,227,0.276,0.881
"26782","Santa Cruz","Montero","Col. Juan Zabala",99,0,0,0,67,27,3,0,0,196,2,7,205,229,0.342,0.895
"26783","Santa Cruz","Montero","Col. Juan Zabala",83,0,2,1,62,32,12,1,0,193,1,6,200,230,0.321,0.87
"26784","Santa Cruz","Montero","Col. Juan Zabala",101,2,1,0,31,50,4,0,1,190,3,11,204,226,0.163,0.903
"26785","Santa Cruz","Montero","Col. Juan Zabala",98,1,0,3,49,29,9,2,1,192,3,5,200,227,0.255,0.881
"26786","Santa Cruz","Montero","Col. Juan Zabala",62,0,0,0,87,21,11,1,1,183,1,11,195,228,0.475,0.855
"26787","Santa Cruz","Montero","Col. Juan Zabala",85,0,2,1,54,17,18,2,0,179,3,7,189,226,0.302,0.836
"26788","Santa Cruz","Montero","Col. Juan Zabala",97,0,0,0,57,17,15,4,0,190,0,12,202,231,0.3,0.874
"26789","Santa Cruz","Montero","Col. Juan Zabala",111,0,0,1,51,18,10,0,1,192,2,9,203,227,0.266,0.894
"26790","Santa Cruz","Montero","Col. Juan Zabala",106,0,0,1,52,27,3,3,0,192,1,13,206,229,0.271,0.9
"26791","Santa Cruz","Montero","Col. Juan Zabala",86,0,1,0,66,14,21,3,1,192,1,4,197,228,0.344,0.864
"26792","Santa Cruz","Montero","Col. Juan Zabala",86,1,0,1,55,33,11,1,0,188,2,5,195,226,0.293,0.863
"26793","Santa Cruz","Montero","Col. Juan Zabala",72,1,0,0,81,18,20,0,1,193,3,8,204,227,0.42,0.899
"26794","Santa Cruz","Montero","Col. Juan Zabala",73,1,1,0,59,17,10,4,1,166,3,7,176,199,0.355,0.884
"26795","Santa Cruz","Montero","Col. Nacional Guabira",73,2,0,1,72,27,8,1,1,185,5,6,196,227,0.389,0.863
"26796","Santa Cruz","Montero","Col. Nacional Guabira",98,0,0,1,44,32,7,3,1,186,1,8,195,227,0.237,0.859
"26797","Santa Cruz","Montero","Col. Nacional Guabira",70,1,0,1,86,21,17,2,1,199,3,13,215,231,0.432,0.931
"26798","Santa Cruz","Montero","Col. Nacional Guabira",67,1,0,1,70,28,14,3,0,184,3,10,197,224,0.38,0.879
"26799","Santa Cruz","Montero","Col. Nacional Guabira",60,1,0,2,78,27,18,3,0,189,4,4,197,221,0.413,0.891
"26800","Santa Cruz","Montero","Col. Nacional Guabira",75,0,2,1,84,27,8,1,0,198,1,4,203,228,0.424,0.89
"26801","Santa Cruz","Montero","Col. Nacional Guabira",87,1,0,0,74,27,17,1,0,207,2,3,212,232,0.357,0.914
"26802","Santa Cruz","Montero","Col. Nacional Guabira",56,1,1,1,94,26,14,0,0,193,3,11,207,229,0.487,0.904
"26803","Santa Cruz","Montero","Col. Nacional Guabira",88,1,0,3,46,43,14,2,0,197,1,10,208,235,0.234,0.885
"26804","Santa Cruz","Montero","Col. Nacional Guabira",102,1,0,2,63,25,14,4,2,213,0,6,219,232,0.296,0.944
"26805","Santa Cruz","Montero","Col. Nacional Guabira",77,0,0,1,65,27,20,1,0,191,2,12,205,233,0.34,0.88
"26806","Santa Cruz","Montero","Col. Nacional Guabira",71,0,0,0,87,21,1,12,0,192,3,13,208,232,0.453,0.897
"26807","Santa Cruz","Montero","Col. Nacional Guabira",89,1,0,2,56,40,10,0,0,198,4,5,207,233,0.283,0.888
"26808","Santa Cruz","Montero","Col. Nacional Guabira",87,2,1,1,57,35,14,4,0,201,2,7,210,229,0.284,0.917
"26809","Santa Cruz","Montero","Col. Nacional Guabira",84,2,0,1,61,27,6,4,0,185,3,7,195,228,0.33,0.855
"26810","Santa Cruz","Montero","Col. Nacional Guabira",61,2,0,0,77,29,10,3,1,183,2,9,194,225,0.421,0.862
"26811","Santa Cruz","Montero","Esc. U.E. Mariluz Estremadoiro",72,0,0,0,96,15,3,5,0,191,5,8,204,228,0.503,0.895
"26812","Santa Cruz","General Saavedra","Col. Principe De Paz",54,0,1,1,74,34,6,5,0,175,8,9,192,219,0.423,0.877
"26813","Santa Cruz","General Saavedra","Col. Principe De Paz",75,0,0,0,49,21,5,5,0,155,4,39,198,223,0.316,0.888
"26814","Santa Cruz","General Saavedra","Col. Principe De Paz",71,1,0,1,67,29,8,3,1,181,6,17,204,222,0.37,0.919
"26815","Santa Cruz","General Saavedra","Col. Principe De Paz",84,1,1,1,49,31,5,6,1,179,6,6,191,224,0.274,0.853
"26816","Santa Cruz","General Saavedra","Col. Principe De Paz",83,0,0,1,53,33,10,13,0,193,5,5,203,228,0.275,0.89
"26817","Santa Cruz","General Saavedra","Col. Principe De Paz",60,1,0,1,63,21,6,11,0,163,5,27,195,226,0.387,0.863
"26818","Santa Cruz","General Saavedra","Col. Principe De Paz",71,0,0,0,63,32,8,8,0,182,3,10,195,229,0.346,0.852
"26819","Santa Cruz","General Saavedra","Col. Principe De Paz",92,1,2,0,60,19,7,5,0,186,3,3,192,226,0.323,0.85
"26820","Santa Cruz","General Saavedra","Col. Principe De Paz",73,0,0,0,65,26,11,8,0,183,7,3,193,224,0.355,0.862
"26821","Santa Cruz","General Saavedra","Col. Principe De Paz",69,2,1,1,70,25,7,13,0,188,5,10,203,224,0.372,0.906
"26822","Santa Cruz","General Saavedra","Col. Principe De Paz",56,0,0,2,66,21,15,12,0,172,12,10,194,223,0.384,0.87
"26823","Santa Cruz","General Saavedra","Col. Principe De Paz",110,1,0,2,35,34,5,6,0,193,5,5,203,219,0.181,0.927
"26824","Santa Cruz","General Saavedra","Col. Principe De Paz",62,1,1,1,75,24,8,21,1,194,9,8,211,232,0.387,0.909
"26825","Santa Cruz","General Saavedra","Col. Principe De Paz",82,0,0,1,58,39,8,5,1,194,1,10,205,221,0.299,0.928
"26826","Santa Cruz","General Saavedra","Col. Principe De Paz",70,0,1,0,69,31,5,6,0,182,4,11,197,221,0.379,0.891
"26827","Santa Cruz","General Saavedra","Col. Principe De Paz",104,1,0,2,51,18,7,9,0,192,2,7,201,222,0.266,0.905
"26828","Santa Cruz","General Saavedra","Col. Principe De Paz",85,0,0,1,78,19,4,4,0,191,5,5,201,224,0.408,0.897
"26829","Santa Cruz","General Saavedra","Col. Principe De Paz",63,0,0,1,90,26,9,11,0,200,4,3,207,224,0.45,0.924
"26830","Santa Cruz","General Saavedra","Esc. 1 de Septiembre",12,0,0,1,125,41,6,5,1,191,6,10,207,230,0.654,0.9
"26831","Santa Cruz","General Saavedra","Esc. 1 de Septiembre",31,0,0,1,123,24,13,4,1,197,8,4,209,230,0.624,0.909
"26832","Santa Cruz","General Saavedra","Esc. U.E. Chane Bedoya",28,2,1,0,123,21,7,3,0,185,5,5,195,224,0.665,0.871
"26833","Santa Cruz","General Saavedra","Esc. U.E. Gualberto Villarroel",10,1,1,0,128,15,12,2,0,169,9,9,187,227,0.757,0.824
"26834","Santa Cruz","General Saavedra","Esc. U.E. Gualberto Villarroel",15,2,1,4,141,12,9,1,0,185,11,6,202,228,0.762,0.886
"26835","Santa Cruz","General Saavedra","Esc. Nucleo Central Nueva Esperanza",41,0,4,2,92,42,7,1,1,190,8,5,203,233,0.484,0.871
"26836","Santa Cruz","General Saavedra","Esc. Nucleo Central Nueva Esperanza",28,0,5,2,123,24,13,3,0,198,3,12,213,231,0.621,0.922
"26837","Santa Cruz","General Saavedra","Esc. Nucleo Central Nueva Esperanza",51,1,8,2,94,25,13,2,0,196,7,10,213,228,0.48,0.934
"26838","Santa Cruz","General Saavedra","Esc. Nucleo Central Nueva Esperanza",55,2,5,3,78,32,11,3,0,189,6,10,205,228,0.413,0.899
"26839","Santa Cruz","General Saavedra","Esc. Nucleo Central Nueva Esperanza",45,1,2,0,107,28,16,1,0,200,8,7,215,240,0.535,0.896
"26840","Santa Cruz","General Saavedra","Esc. Nucleo  Mariscal Sucre",28,0,0,0,135,14,14,1,1,193,2,8,203,226,0.699,0.898
"26841","Santa Cruz","General Saavedra","Esc. Nucleo  Mariscal Sucre",30,0,0,0,133,17,12,2,0,194,3,8,205,229,0.686,0.895
"26842","Santa Cruz","General Saavedra","Esc. Nucleo  Mariscal Sucre",27,0,0,0,123,11,23,2,0,186,5,6,197,226,0.661,0.872
"26843","Santa Cruz","General Saavedra","Esc. Nucleo  Mariscal Sucre",23,0,1,2,132,15,14,4,0,191,5,10,206,222,0.691,0.928
"26844","Santa Cruz","General Saavedra","Esc. U.E. Santiago Cornen",56,1,0,3,76,21,9,2,2,170,5,5,180,216,0.447,0.833
"26845","Santa Cruz","General Saavedra","Esc. U.E. Santiago Cornen",40,2,0,2,92,23,11,0,1,171,1,6,178,204,0.538,0.873
"26846","Santa Cruz","General Saavedra","U.E. Marcelo Quiroga Santa Cruz",21,1,1,0,108,9,12,0,1,153,1,2,156,168,0.706,0.929
"26847","Santa Cruz","Mineros","Esc. Nucleo Central Minero",91,2,0,0,46,21,19,6,0,185,1,9,195,220,0.249,0.886
"26848","Santa Cruz","Mineros","Esc. Nucleo Central Minero",84,0,0,0,70,16,22,0,2,194,2,5,201,226,0.361,0.889
"26849","Santa Cruz","Mineros","Esc. Nucleo Central Minero",85,0,0,0,64,16,13,6,0,184,6,8,198,225,0.348,0.88
"26850","Santa Cruz","Mineros","Esc. Nucleo Central Minero",82,0,1,0,65,13,18,7,1,187,4,6,197,226,0.348,0.872
"26851","Santa Cruz","Mineros","Esc. Nucleo Central Minero",97,1,2,1,56,16,12,5,0,190,6,5,201,224,0.295,0.897
"26852","Santa Cruz","Mineros","Esc. Nucleo Central Minero",110,2,0,0,49,19,17,2,1,200,1,6,207,226,0.245,0.916
"26853","Santa Cruz","Mineros","Esc. Nucleo Central Minero",77,1,1,0,79,10,17,1,0,186,5,8,199,223,0.425,0.892
"26854","Santa Cruz","Mineros","Esc. Nucleo Central Minero",57,1,0,0,99,8,10,3,0,178,3,7,188,225,0.556,0.836
"26855","Santa Cruz","Mineros","Esc. Nucleo Central Minero",66,0,0,0,68,15,32,1,2,184,2,8,194,229,0.37,0.847
"26856","Santa Cruz","Mineros","Esc. Nucleo Central Minero",89,1,2,0,49,27,16,4,0,188,4,8,200,229,0.261,0.873
"26857","Santa Cruz","Mineros","Esc. Nucleo Central Minero",56,0,0,1,78,24,19,6,1,185,4,8,197,225,0.422,0.876
"26858","Santa Cruz","Mineros","Esc. Nucleo Central Minero",67,0,1,0,89,18,15,4,0,194,1,2,197,221,0.459,0.891
"26859","Santa Cruz","Mineros","Esc. Nucleo Central Minero",69,0,1,0,74,17,13,3,1,178,11,9,198,225,0.416,0.88
"26860","Santa Cruz","Mineros","Esc. Nucleo Central Minero",73,0,0,0,66,26,17,3,0,185,3,4,192,223,0.357,0.861
"26861","Santa Cruz","Mineros","Esc. Nucleo Central Minero",75,0,3,1,78,12,20,2,1,192,4,9,205,230,0.406,0.891
"26862","Santa Cruz","Mineros","Esc. Nucleo Central Minero",71,1,0,0,67,18,24,6,1,188,6,7,201,230,0.356,0.874
"26863","Santa Cruz","Mineros","Esc. Nucleo Central Minero",50,2,0,0,107,16,8,4,0,187,1,6,194,223,0.572,0.87
"26864","Santa Cruz","Mineros","Esc. Nucleo Central Minero",73,0,2,1,72,25,10,6,0,189,6,6,201,228,0.381,0.882
"26865","Santa Cruz","Mineros","Esc. Nucleo Central Minero",77,1,1,0,78,15,8,3,0,183,3,9,195,221,0.426,0.882
"26866","Santa Cruz","Mineros","Esc. Nucleo Central Minero",85,1,1,0,63,22,14,4,0,190,3,9,202,230,0.332,0.878
"26867","Santa Cruz","Mineros","Esc. Nucleo Central Minero",92,1,0,1,48,24,9,7,0,182,5,9,196,223,0.264,0.879
"26868","Santa Cruz","Mineros","Esc. Nucleo Central Minero",81,0,1,0,82,9,23,0,0,196,4,2,202,225,0.418,0.898
"26869","Santa Cruz","Mineros","Esc. Nucleo Central Minero",72,1,1,1,69,19,11,1,0,175,4,11,190,221,0.394,0.86
"26870","Santa Cruz","Mineros","Esc. Nucleo Central Minero",72,0,1,0,81,15,23,2,0,194,0,8,202,228,0.418,0.886
"26871","Santa Cruz","Mineros","Esc. Nucleo Central Minero",112,2,0,0,43,27,12,3,1,200,1,6,207,229,0.215,0.904
"26872","Santa Cruz","Mineros","Esc. Nucleo Central Minero",93,0,1,2,58,15,19,1,0,189,1,8,198,226,0.307,0.876
"26873","Santa Cruz","Mineros","Esc. Nucleo Central Minero",86,2,0,1,47,21,15,3,1,176,3,12,191,219,0.267,0.872
"26874","Santa Cruz","Mineros","Esc. Nucleo Central Minero",82,1,2,0,78,19,7,2,1,192,1,5,198,219,0.406,0.904
"26875","Santa Cruz","Mineros","Esc. Nucleo Central Minero",76,2,0,1,71,22,17,1,0,190,5,9,204,231,0.374,0.883
"26876","Santa Cruz","Mineros","Esc. Nucleo Central Minero",87,2,1,1,53,21,14,1,1,181,2,10,193,225,0.293,0.858
"26877","Santa Cruz","Mineros","Esc. Nucleo Central Minero",101,0,4,1,29,17,11,5,0,168,3,14,185,223,0.173,0.83
"26878","Santa Cruz","Mineros","Esc. Nucleo Central Minero",79,0,1,1,65,13,21,4,1,185,2,5,192,222,0.351,0.865
"26879","Santa Cruz","Mineros","Esc. Nucleo Central Minero",73,0,0,2,74,27,13,1,1,191,2,3,196,227,0.387,0.863
"26880","Santa Cruz","Mineros","Esc. Nucleo Central Minero",62,1,2,1,88,14,17,1,1,187,1,9,197,227,0.471,0.868
"26881","Santa Cruz","Mineros","Esc. Nucleo Central Minero",97,0,2,1,41,21,22,0,0,184,2,8,194,229,0.223,0.847
"26882","Santa Cruz","Mineros","Esc. Nucleo Central Minero",103,1,1,0,47,16,11,4,0,183,4,10,197,225,0.257,0.876
"26883","Santa Cruz","Mineros","Esc. Nucleo Central Minero",86,1,2,0,57,23,11,3,1,184,1,12,197,226,0.31,0.872
"26884","Santa Cruz","Mineros","Esc. Nucleo Central Minero",81,1,0,1,68,23,15,2,0,191,1,7,199,229,0.356,0.869
"26885","Santa Cruz","Mineros","Esc. Nucleo Central Minero",80,2,2,2,54,28,8,5,3,184,5,4,193,223,0.293,0.865
"26886","Santa Cruz","Mineros","Esc. Nucleo Central Minero",77,0,2,0,90,14,9,4,0,196,3,8,207,232,0.459,0.892
"26887","Santa Cruz","Mineros","Esc. Nucleo Central Minero",73,0,1,0,71,21,15,7,0,188,3,5,196,225,0.378,0.871
"26888","Santa Cruz","Mineros","Esc. Nucleo Central Minero",108,1,1,0,29,42,7,6,0,194,3,3,200,225,0.149,0.889
"26889","Santa Cruz","Mineros","Esc. Nucleo Central Minero",74,1,0,2,63,19,16,7,2,184,6,13,203,226,0.342,0.898
"26890","Santa Cruz","Mineros","Esc. Nucleo Central Minero",77,2,3,1,64,16,13,4,1,181,6,10,197,224,0.354,0.879
"26891","Santa Cruz","Mineros","Esc. Nucleo Central Minero",96,0,0,1,46,22,11,6,2,184,2,10,196,224,0.25,0.875
"26892","Santa Cruz","Mineros","Esc. Nucleo Central Minero",73,0,0,3,75,16,17,5,1,190,4,11,205,223,0.395,0.919
"26893","Santa Cruz","Mineros","Esc. Nucleo Central Minero",76,0,0,0,80,19,10,1,1,187,0,10,197,226,0.428,0.872
"26894","Santa Cruz","Mineros","Esc. Nucleo Central Minero",71,2,0,0,71,28,10,7,0,189,4,8,201,225,0.376,0.893
"26895","Santa Cruz","Mineros","U.E. Alice Alvarez De Aredondo I",81,0,1,0,73,25,24,2,0,206,2,6,214,237,0.354,0.903
"26896","Santa Cruz","Mineros","U.E. Alice Alvarez De Aredondo I",69,0,2,0,79,18,26,0,1,195,2,9,206,237,0.405,0.869
"26897","Santa Cruz","Mineros","U.E. Alice Alvarez De Aredondo I",98,2,1,2,56,16,21,6,0,202,3,5,210,238,0.277,0.882
"26898","Santa Cruz","Mineros","U.E. Alice Alvarez De Aredondo I",77,1,0,1,72,32,17,1,1,202,4,5,211,239,0.356,0.883
"26899","Santa Cruz","Mineros","U.E. Alice Alvarez De Aredondo I",78,2,1,1,76,13,19,4,0,194,2,12,208,237,0.392,0.878
"26900","Santa Cruz","Mineros","U.E. Benjamin Banegas Vaca",68,1,0,1,77,27,29,5,0,208,4,9,221,240,0.37,0.921
"26901","Santa Cruz","Mineros","U.E. Benjamin Banegas Vaca",71,1,0,2,85,28,16,1,1,205,0,6,211,237,0.415,0.89
"26902","Santa Cruz","Mineros","U.E. Benjamin Banegas Vaca",76,0,2,1,74,31,18,0,0,202,4,6,212,233,0.366,0.91
"26903","Santa Cruz","Mineros","U.E. Benjamin Banegas Vaca",45,0,13,6,59,41,0,6,0,170,42,6,218,237,0.347,0.92
"26904","Santa Cruz","Mineros","U.E. Benjamin Banegas Vaca",72,1,2,1,63,18,14,3,0,174,3,5,182,200,0.362,0.91
"26905","Santa Cruz","Mineros","Esc. Sub. Central la Porfia",26,0,2,3,118,17,6,3,1,176,7,6,189,218,0.67,0.867
"26906","Santa Cruz","Mineros","Esc. Sub. Central la Porfia",43,2,0,0,105,13,13,3,0,179,6,8,193,224,0.587,0.862
"26907","Santa Cruz","Mineros","Esc. La Patria",47,1,1,1,108,38,5,2,0,203,8,7,218,251,0.532,0.869
"26908","Santa Cruz","Mineros","Esc. Las Palmas",38,0,1,1,124,25,9,4,0,202,2,7,211,224,0.614,0.942
"26909","Santa Cruz","Mineros","Esc. Las Palmas",30,0,0,0,123,26,9,3,0,191,5,6,202,224,0.644,0.902
"26910","Santa Cruz","Mineros","U.E. Alianza El Progreso",27,0,2,1,152,10,15,1,1,209,5,5,219,235,0.727,0.932
"26911","Santa Cruz","Fernández Alonso","Esc. Nucleo Mariscal Sucre",50,1,1,0,97,11,28,1,0,189,1,7,197,225,0.513,0.876
"26912","Santa Cruz","Fernández Alonso","Esc. Nucleo Mariscal Sucre",27,0,0,1,131,8,37,1,1,206,2,5,213,225,0.636,0.947
"26913","Santa Cruz","Fernández Alonso","Esc. Nucleo Mariscal Sucre",33,0,0,0,127,4,30,0,1,195,4,8,207,229,0.651,0.904
"26914","Santa Cruz","Fernández Alonso","Esc. Nucleo Mariscal Sucre",19,0,1,0,152,7,33,0,0,212,1,4,217,232,0.717,0.935
"26915","Santa Cruz","Fernández Alonso","Esc. Nucleo Mariscal Sucre",36,0,0,0,123,12,27,5,2,205,4,4,213,229,0.6,0.93
"26916","Santa Cruz","Fernández Alonso","Esc. Nucleo Mariscal Sucre",50,1,0,0,118,10,23,1,1,204,4,5,213,234,0.578,0.91
"26917","Santa Cruz","Fernández Alonso","Esc. Nucleo Mariscal Sucre",43,0,1,3,103,8,38,1,0,197,1,4,202,228,0.523,0.886
"26918","Santa Cruz","Fernández Alonso","Esc. Nucleo Mariscal Sucre",46,1,0,2,111,10,29,1,0,200,3,8,211,229,0.555,0.921
"26919","Santa Cruz","Fernández Alonso","Esc. Nucleo Mariscal Sucre",39,0,0,0,120,12,34,0,0,205,1,6,212,230,0.585,0.922
"26920","Santa Cruz","Fernández Alonso","Esc. Nucleo Mariscal Sucre",48,1,1,0,109,8,30,0,0,197,2,9,208,229,0.553,0.908
"26921","Santa Cruz","Fernández Alonso","Esc. Eduardo Avaroa",48,0,0,0,103,12,22,2,0,187,5,5,197,224,0.551,0.879
"26922","Santa Cruz","Fernández Alonso","Esc. Eduardo Avaroa",34,0,1,0,112,30,21,1,1,200,7,5,212,228,0.56,0.93
"26923","Santa Cruz","Fernández Alonso","Esc. Eduardo Avaroa",30,0,0,0,96,9,17,1,0,153,3,4,160,176,0.627,0.909
"26924","Santa Cruz","Fernández Alonso","Esc. U.E. Victor Hugo Otalora",25,0,1,0,128,15,16,1,0,186,4,2,192,226,0.688,0.85
"26925","Santa Cruz","Fernández Alonso","Esc. U.E. Victor Hugo Otalora",36,0,1,1,113,16,15,2,0,184,3,7,194,223,0.614,0.87
"26926","Santa Cruz","Fernández Alonso","Esc. U.E. Victor Hugo Otalora",31,2,0,0,110,13,33,5,0,194,2,6,202,226,0.567,0.894
"26927","Santa Cruz","Fernández Alonso","Esc. U.E. Victor Hugo Otalora",40,1,2,0,112,10,24,5,0,194,4,6,204,225,0.577,0.907
"26928","Santa Cruz","Fernández Alonso","Esc. U.E. Victor Hugo Otalora",18,0,0,1,134,18,14,0,0,185,1,16,202,229,0.724,0.882
"26929","Santa Cruz","Fernández Alonso","Esc. U.E. Victor Hugo Otalora",25,0,0,0,123,22,30,0,0,200,1,6,207,226,0.615,0.916
"26930","Santa Cruz","Fernández Alonso","Esc. U.E. Victor Hugo Otalora",36,0,0,0,105,13,30,1,0,185,5,4,194,228,0.568,0.851
"26931","Santa Cruz","Fernández Alonso","Esc. U.E. Victor Hugo Otalora",40,1,0,2,105,16,15,1,0,180,2,17,199,226,0.583,0.881
"26932","Santa Cruz","Fernández Alonso","Esc. U.E. Victor Hugo Otalora",42,2,0,1,114,13,23,3,2,200,3,5,208,229,0.57,0.908
"26933","Santa Cruz","Fernández Alonso","Esc. U.E. Victor Hugo Otalora",49,1,1,0,104,24,10,2,2,193,2,2,197,227,0.539,0.868
"26934","Santa Cruz","Fernández Alonso","Esc. U.E. Victor Hugo Otalora",47,0,0,0,107,15,18,1,1,189,4,7,200,229,0.566,0.873
"26935","Santa Cruz","Fernández Alonso","Esc. U.E. Victor Hugo Otalora",51,0,1,0,106,13,15,2,1,189,0,3,192,225,0.561,0.853
"26936","Santa Cruz","Fernández Alonso","Esc. U.E. Victor Hugo Otalora",36,1,1,0,120,8,22,2,1,191,4,6,201,225,0.628,0.893
"26937","Santa Cruz","Fernández Alonso","Esc. U.E. Victor Hugo Otalora",28,0,2,0,124,9,12,1,0,176,7,4,187,221,0.705,0.846
"26938","Santa Cruz","Fernández Alonso","Esc. U.E. Victor Hugo Otalora",38,1,0,0,100,20,30,2,0,191,1,10,202,230,0.524,0.878
"26939","Santa Cruz","Fernández Alonso","Esc. U.E. Victor Hugo Otalora",49,2,0,1,92,14,17,5,0,180,3,8,191,220,0.511,0.868
"26940","Santa Cruz","Fernández Alonso","Esc. U.E. Victor Hugo Otalora",50,0,0,2,75,11,20,1,1,160,4,6,170,186,0.469,0.914
"26941","Santa Cruz","Fernández Alonso","Esc. Aguaices",37,2,2,0,129,15,11,1,2,199,4,4,207,230,0.648,0.9
"26942","Santa Cruz","San Pedro","Esc. Seccional Litoral",15,2,0,1,147,7,36,3,0,211,1,3,215,230,0.697,0.935
"26943","Santa Cruz","San Pedro","Esc. 9 de Abril",41,3,1,0,123,4,29,0,0,201,3,8,212,232,0.612,0.914
"26944","Santa Cruz","San Pedro","Esc. 9 de Abril",61,0,0,0,100,4,32,0,1,198,4,13,215,231,0.505,0.931
"26945","Santa Cruz","San Pedro","Esc. 9 de Abril",49,0,2,0,111,10,29,0,2,203,4,4,211,233,0.547,0.906
"26946","Santa Cruz","San Pedro","Esc. Padre Remo Prandini Viotti",33,0,1,0,116,21,9,2,0,182,14,6,202,230,0.637,0.878
"26947","Santa Cruz","San Pedro","Esc. Padre Remo Prandini Viotti",45,0,0,0,113,14,17,4,1,194,3,5,202,229,0.582,0.882
"26948","Santa Cruz","San Pedro","Esc. Padre Remo Prandini Viotti",43,1,1,0,113,17,16,3,1,195,2,8,205,231,0.579,0.887
"26949","Santa Cruz","San Pedro","Esc. Padre Remo Prandini Viotti",61,2,1,1,102,12,13,3,1,196,6,3,205,229,0.52,0.895
"26950","Santa Cruz","San Pedro","Esc. Padre Remo Prandini Viotti",62,1,2,1,88,9,13,5,0,181,4,8,193,228,0.486,0.846
"26951","Santa Cruz","San Pedro","Esc. Nucleo Central Murillo",31,2,0,1,106,16,30,4,0,190,10,6,206,221,0.558,0.932
"26952","Santa Cruz","San Pedro","Esc. Fe y Alegria Tito Boltan",67,0,0,1,103,12,20,2,2,207,3,1,211,229,0.498,0.921
"26953","Santa Cruz","San Pedro","Esc. Fe y Alegria Tito Boltan",66,0,1,0,112,12,17,2,0,210,1,1,212,230,0.533,0.922
"26954","Santa Cruz","San Pedro","Esc. Fe y Alegria Tito Boltan",80,3,1,2,94,9,15,0,1,205,1,5,211,231,0.459,0.913
"26955","Santa Cruz","San Pedro","Esc. Fe y Alegria Tito Boltan",74,0,0,0,96,20,16,1,0,207,3,0,210,229,0.464,0.917
"26956","Santa Cruz","San Pedro","Esc. Fe y Alegria Tito Boltan",40,0,1,0,92,6,19,1,2,161,2,1,164,180,0.571,0.911
"26957","Santa Cruz","San Pedro","Esc. Obispo Santisteban",35,1,1,1,144,2,16,0,1,201,4,1,206,233,0.716,0.884
"26958","Santa Cruz","San Pedro","Esc. Obispo Santisteban",32,1,1,2,146,6,18,0,0,206,0,7,213,225,0.709,0.947
"26959","Santa Cruz","San Pedro","Esc. Obispo Santisteban",50,0,0,0,125,3,20,3,0,201,4,8,213,239,0.622,0.891
"26960","Santa Cruz","San Pedro","Esc. Fe y Alegria",50,0,0,1,111,10,26,2,1,201,0,3,204,228,0.552,0.895
"26961","Santa Cruz","San Pedro","Esc. Fe y Alegria",45,1,0,0,91,12,22,4,0,175,3,10,188,227,0.52,0.828
"26962","Santa Cruz","San Pedro","Esc. Fe y Alegria",43,1,0,0,78,13,35,5,0,175,5,10,190,224,0.446,0.848
"26963","Santa Cruz","San Pedro","Esc. Fe y Alegria",35,0,0,0,108,10,30,0,0,183,2,9,194,225,0.59,0.862
"26964","Santa Cruz","San Pedro","Esc. Fe y Alegria",59,0,0,2,73,7,32,1,0,174,5,12,191,223,0.42,0.857
"26965","Santa Cruz","San Pedro","Esc. Fe y Alegria",49,1,0,0,128,13,19,0,0,210,2,5,217,234,0.61,0.927
"26966","Santa Cruz","San Pedro","Esc. Fe y Alegria",58,0,0,1,85,11,32,0,0,187,1,7,195,230,0.455,0.848
"26967","Santa Cruz","San Pedro","Esc. Fe y Alegria",46,2,0,0,85,11,31,4,0,179,3,7,189,226,0.475,0.836
"26968","Santa Cruz","San Pedro","Esc. Fe y Alegria",62,1,1,1,83,13,30,3,0,194,2,5,201,229,0.428,0.878
"26969","Santa Cruz","San Pedro","Esc. Fe y Alegria",69,1,1,1,92,9,24,0,0,197,2,10,209,226,0.467,0.925
"26970","Santa Cruz","San Pedro","Esc. Villa Rosario",9,0,0,2,166,5,6,0,0,188,5,4,197,222,0.883,0.887
"26971","Santa Cruz","San Pedro","Esc. Canandoa",14,1,0,1,150,6,16,0,0,188,2,11,201,225,0.798,0.893
"26972","Santa Cruz","San Pedro","Esc. Canandoa",24,0,3,0,151,1,14,1,0,194,4,8,206,232,0.778,0.888
"26973","Santa Cruz","Concepción","Esc. Guadalupe Fe y Alegria",58,0,0,1,107,13,16,1,1,197,7,12,216,231,0.543,0.935
"26974","Santa Cruz","Concepción","Esc. Guadalupe Fe y Alegria",91,2,1,1,59,26,15,2,0,197,5,13,215,230,0.299,0.935
"26975","Santa Cruz","Concepción","Esc. Guadalupe Fe y Alegria",75,0,0,1,75,27,9,2,0,189,9,12,210,234,0.397,0.897
"26976","Santa Cruz","Concepción","Esc. Guadalupe Fe y Alegria",52,1,0,0,100,11,22,6,3,195,2,5,202,230,0.513,0.878
"26977","Santa Cruz","Concepción","Esc. Guadalupe Fe y Alegria",87,2,1,2,66,18,16,2,0,194,4,7,205,227,0.34,0.903
"26978","Santa Cruz","Concepción","Esc. Guadalupe Fe y Alegria",42,0,1,0,110,20,13,2,1,189,2,7,198,229,0.582,0.865
"26979","Santa Cruz","Concepción","Esc. Guadalupe Fe y Alegria",73,1,1,2,85,19,13,2,0,196,7,9,212,230,0.434,0.922
"26980","Santa Cruz","Concepción","Esc. Guadalupe Fe y Alegria",52,0,1,1,114,26,11,2,0,207,4,4,215,236,0.551,0.911
"26981","Santa Cruz","Concepción","Esc. Guadalupe Fe y Alegria",49,1,0,3,85,20,15,5,0,178,6,14,198,228,0.478,0.868
"26982","Santa Cruz","Concepción","Esc. Guadalupe Fe y Alegria",33,1,0,2,126,29,6,7,0,204,2,2,208,229,0.618,0.908
"26983","Santa Cruz","Concepción","Esc. Guadalupe Fe y Alegria",39,1,1,0,129,13,12,1,1,197,6,5,208,234,0.655,0.889
"26984","Santa Cruz","Concepción","Esc. Guadalupe Fe y Alegria",35,1,0,1,137,7,6,4,0,191,9,8,208,233,0.717,0.893
"26985","Santa Cruz","Concepción","Esc. Guadalupe Fe y Alegria",74,0,0,0,93,16,12,5,1,201,2,5,208,228,0.463,0.912
"26986","Santa Cruz","Concepción","Esc. Guadalupe Fe y Alegria",78,0,0,0,76,24,8,2,0,188,4,6,198,235,0.404,0.843
"26987","Santa Cruz","Concepción","Esc. Guadalupe Fe y Alegria",58,0,1,0,95,28,11,6,0,199,3,5,207,231,0.477,0.896
"26988","Santa Cruz","Concepción","Esc. Guadalupe Fe y Alegria",57,0,0,0,102,11,17,5,1,193,5,7,205,236,0.528,0.869
"26989","Santa Cruz","Concepción","Esc. Guadalupe Fe y Alegria",78,0,0,2,85,23,13,1,0,202,2,3,207,228,0.421,0.908
"26990","Santa Cruz","Concepción","Esc. Guadalupe Fe y Alegria",54,0,0,0,94,23,9,5,0,185,4,10,199,226,0.508,0.881
"26991","Santa Cruz","Concepción","Esc. Guadalupe Fe y Alegria",72,0,0,1,80,24,13,2,1,193,4,14,211,235,0.415,0.898
"26992","Santa Cruz","Concepción","Esc. Guadalupe Fe y Alegria",46,0,2,0,115,19,11,3,0,196,3,6,205,230,0.587,0.891
"26993","Santa Cruz","Concepción","Esc. Guadalupe Fe y Alegria",42,0,1,1,121,15,20,3,0,203,4,6,213,231,0.596,0.922
"26994","Santa Cruz","Concepción","Esc. Guadalupe Fe y Alegria",87,2,1,1,73,16,12,6,0,198,5,10,213,231,0.369,0.922
"26995","Santa Cruz","Concepción","Esc. Guadalupe Fe y Alegria",78,0,0,0,85,29,9,3,0,204,1,11,216,231,0.417,0.935
"26996","Santa Cruz","Concepción","Esc. Guadalupe Fe y Alegria",75,1,0,0,71,19,15,4,0,185,5,7,197,229,0.384,0.86
"26997","Santa Cruz","Concepción","Esc. Guadalupe Fe y Alegria",43,0,0,3,109,18,16,3,0,192,4,9,205,231,0.568,0.887
"26998","Santa Cruz","Concepción","Esc. Guadalupe Fe y Alegria",80,1,0,1,68,19,9,9,3,190,5,8,203,230,0.358,0.883
"26999","Santa Cruz","Concepción","Esc. Guadalupe Fe y Alegria",55,2,1,1,112,20,10,4,2,207,6,7,220,235,0.541,0.936
"27000","Santa Cruz","Concepción","Esc. Guadalupe Fe y Alegria",47,2,1,1,117,16,13,1,0,198,3,1,202,227,0.591,0.89
"27001","Santa Cruz","Concepción","Esc. Guadalupe Fe y Alegria",63,0,0,2,89,16,21,3,2,196,3,7,206,232,0.454,0.888
"27002","Santa Cruz","Concepción","Esc. Guadalupe Fe y Alegria",69,3,3,1,92,20,11,0,0,199,2,5,206,228,0.462,0.904
"27003","Santa Cruz","Concepción","Esc. Guadalupe Fe y Alegria",48,0,0,2,117,16,15,0,4,202,6,3,211,235,0.579,0.898
"27004","Santa Cruz","Concepción","Esc. Guadalupe Fe y Alegria",74,0,0,1,72,26,9,9,0,191,4,7,202,230,0.377,0.878
"27005","Santa Cruz","Concepción","Esc. Guadalupe Fe y Alegria",67,1,0,1,98,16,16,4,1,204,3,6,213,234,0.48,0.91
"27006","Santa Cruz","Concepción","Esc. Guadalupe Fe y Alegria",90,1,0,2,69,15,21,5,0,203,5,3,211,230,0.34,0.917
"27007","Santa Cruz","Concepción","Esc. Guadalupe Fe y Alegria",97,0,0,0,71,17,13,1,0,199,1,5,205,230,0.357,0.891
"27008","Santa Cruz","Concepción","Esc. Guadalupe Fe y Alegria",61,0,0,0,99,20,13,4,0,197,1,9,207,233,0.503,0.888
"27009","Santa Cruz","Concepción","Esc. Guadalupe Fe y Alegria",50,0,3,0,111,20,13,5,1,203,3,11,217,232,0.547,0.935
"27010","Santa Cruz","Concepción","Esc. Guadalupe Fe y Alegria",75,1,0,2,74,20,15,4,1,192,3,8,203,225,0.385,0.902
"27011","Santa Cruz","Concepción","Esc. Guadalupe Fe y Alegria",38,1,0,0,116,24,12,6,1,198,7,6,211,234,0.586,0.902
"27012","Santa Cruz","Concepción","Esc. Guadalupe Fe y Alegria",45,0,0,1,101,20,22,5,0,194,8,6,208,228,0.521,0.912
"27013","Santa Cruz","Concepción","Esc. Guadalupe Fe y Alegria",58,1,0,2,80,23,13,6,2,185,5,10,200,235,0.432,0.851
"27014","Santa Cruz","Concepción","Esc. Guadalupe Fe y Alegria",76,2,0,1,78,19,19,2,0,197,6,8,211,230,0.396,0.917
"27015","Santa Cruz","Concepción","Esc. Guadalupe Fe y Alegria",103,0,0,0,65,14,11,3,1,197,5,3,205,229,0.33,0.895
"27016","Santa Cruz","Concepción","Esc. Guadalupe Fe y Alegria",49,1,0,1,102,17,16,3,1,190,5,4,199,214,0.537,0.93
"27017","Santa Cruz","Concepción","Esc. Seccional Calendaria",11,0,1,0,137,28,5,2,1,185,22,6,213,236,0.741,0.903
"27018","Santa Cruz","Concepción","Esc. Cent. Julio Flores Franco",31,2,0,0,112,15,6,5,0,171,6,36,213,233,0.655,0.914
"27019","Santa Cruz","Concepción","Esc. Seccional Palmarito",46,2,2,0,46,71,19,5,0,191,19,5,215,230,0.241,0.935
"27020","Santa Cruz","Concepción","Esc. Central San Pedro",47,0,0,2,86,14,2,2,0,153,5,7,165,200,0.562,0.825
"27021","Santa Cruz","Concepción","Esc. Tierra Hermoza",2,0,0,1,176,1,13,0,3,196,1,6,203,233,0.898,0.871
"27022","Santa Cruz","Concepción","Esc. Tierra Hermoza",3,0,0,0,184,2,10,0,0,199,1,4,204,221,0.925,0.923
"27023","Santa Cruz","Concepción","Esc. U.E. Altamira",43,2,1,1,128,12,6,2,0,195,13,7,215,237,0.656,0.907
"27024","Santa Cruz","Concepción","Esc. U.E. Altamira",33,0,1,1,118,13,14,6,0,186,10,8,204,220,0.634,0.927
"27025","Santa Cruz","Concepción","Esc. U.E. Guayaba",8,2,1,1,127,8,7,3,1,158,5,5,168,186,0.804,0.903
"27026","Santa Cruz","Concepción","U. E. Eduardo Abaroa",5,1,1,0,217,0,7,0,0,231,0,3,234,239,0.939,0.979
"27027","Santa Cruz","San Javier","Escuela Adolfo Burton",83,2,0,0,71,18,7,21,0,202,4,9,215,235,0.351,0.915
"27028","Santa Cruz","San Javier","Escuela Adolfo Burton",112,0,1,0,52,19,4,18,0,206,3,8,217,237,0.252,0.916
"27029","Santa Cruz","San Javier","Escuela Adolfo Burton",98,0,0,0,51,22,4,9,1,185,5,8,198,230,0.276,0.861
"27030","Santa Cruz","San Javier","Escuela Adolfo Burton",81,1,0,2,84,12,7,12,0,199,5,6,210,234,0.422,0.897
"27031","Santa Cruz","San Javier","Escuela Adolfo Burton",93,1,0,1,54,23,5,15,2,194,8,11,213,233,0.278,0.914
"27032","Santa Cruz","San Javier","Escuela Adolfo Burton",65,2,0,0,71,26,3,22,0,189,4,8,201,231,0.376,0.87
"27033","Santa Cruz","San Javier","Escuela Adolfo Burton",97,2,0,0,62,16,7,8,0,192,3,6,201,231,0.323,0.87
"27034","Santa Cruz","San Javier","Escuela Adolfo Burton",76,1,0,1,72,22,5,18,0,195,9,9,213,231,0.369,0.922
"27035","Santa Cruz","San Javier","Escuela Adolfo Burton",87,2,1,1,65,20,7,8,2,193,3,9,205,233,0.337,0.88
"27036","Santa Cruz","San Javier","Escuela Adolfo Burton",81,0,1,0,76,26,6,6,1,197,5,9,211,233,0.386,0.906
"27037","Santa Cruz","San Javier","Escuela Adolfo Burton",99,0,0,1,58,18,3,23,0,202,4,4,210,230,0.287,0.913
"27038","Santa Cruz","San Javier","Escuela Adolfo Burton",72,1,1,0,69,33,10,11,1,198,4,7,209,227,0.348,0.921
"27039","Santa Cruz","San Javier","Escuela Adolfo Burton",62,0,3,2,66,18,3,28,1,183,8,14,205,233,0.361,0.88
"27040","Santa Cruz","San Javier","Escuela Adolfo Burton",93,0,0,0,53,26,7,13,0,192,2,3,197,235,0.276,0.838
"27041","Santa Cruz","San Javier","Escuela Adolfo Burton",97,0,0,0,58,25,5,12,0,197,6,6,209,229,0.294,0.913
"27042","Santa Cruz","San Javier","Escuela Adolfo Burton",91,0,1,1,35,28,0,30,1,187,7,9,203,225,0.187,0.902
"27043","Santa Cruz","San Javier","Escuela Adolfo Burton",94,1,0,2,56,24,5,19,1,202,2,6,210,238,0.277,0.882
"27044","Santa Cruz","San Javier","Escuela Adolfo Burton",122,0,0,0,42,13,4,19,1,201,6,6,213,232,0.209,0.918
"27045","Santa Cruz","San Javier","Escuela Adolfo Burton",79,0,0,1,49,32,10,18,0,189,5,10,204,229,0.259,0.891
"27046","Santa Cruz","San Javier","Escuela Adolfo Burton",83,1,0,1,70,19,6,21,1,202,2,5,209,231,0.347,0.905
"27047","Santa Cruz","San Javier","Escuela Adolfo Burton",93,0,1,1,59,26,4,15,0,199,4,7,210,236,0.296,0.89
"27048","Santa Cruz","San Javier","Escuela Adolfo Burton",76,1,0,0,75,17,6,25,0,200,3,10,213,235,0.375,0.906
"27049","Santa Cruz","San Javier","Escuela Adolfo Burton",75,0,0,2,51,18,6,22,2,176,11,6,193,224,0.29,0.862
"27050","Santa Cruz","San Javier","Escuela Adolfo Burton",83,4,0,0,50,16,6,31,1,191,5,12,208,233,0.262,0.893
"27051","Santa Cruz","San Javier","Escuela Adolfo Burton",98,0,0,1,32,24,10,39,0,204,2,4,210,233,0.157,0.901
"27052","Santa Cruz","San Javier","Escuela Adolfo Burton",58,2,0,1,70,28,14,29,1,203,5,9,217,233,0.345,0.931
"27053","Santa Cruz","San Javier","Escuela Adolfo Burton",90,1,4,0,39,30,4,24,1,193,3,11,207,234,0.202,0.885
"27054","Santa Cruz","San Javier","Escuela Adolfo Burton",83,2,0,1,69,15,8,12,0,190,4,5,199,232,0.363,0.858
"27055","Santa Cruz","San Javier","Esc. Seccional Coronacion",47,1,1,0,119,22,10,5,3,208,5,2,215,233,0.572,0.923
"27056","Santa Cruz","San Javier","Esc. Seccional Coronacion",35,3,0,2,119,20,17,2,1,199,7,7,213,229,0.598,0.93
"27057","Santa Cruz","San Javier","Esc. U.E. Las Abras",6,0,2,0,172,4,0,9,0,193,3,2,198,235,0.891,0.843
"27058","Santa Cruz","San Ramón","Esc. Central San Ramon",80,0,0,0,61,17,12,2,1,173,3,25,201,225,0.353,0.893
"27059","Santa Cruz","San Ramón","Esc. Central San Ramon",63,0,0,0,79,14,16,7,0,179,7,6,192,231,0.441,0.831
"27060","Santa Cruz","San Ramón","Esc. Central San Ramon",56,0,1,0,85,23,12,5,1,183,4,6,193,233,0.464,0.828
"27061","Santa Cruz","San Ramón","Esc. Central San Ramon",83,0,0,1,56,19,12,6,0,177,9,11,197,229,0.316,0.86
"27062","Santa Cruz","San Ramón","Esc. Central San Ramon",66,2,3,1,85,19,13,8,1,198,5,3,206,235,0.429,0.877
"27063","Santa Cruz","San Ramón","Esc. Central San Ramon",70,0,5,1,69,16,4,5,1,171,6,15,192,224,0.404,0.857
"27064","Santa Cruz","San Ramón","Esc. Central San Ramon",98,0,0,1,38,20,6,11,1,175,4,8,187,223,0.217,0.839
"27065","Santa Cruz","San Ramón","Esc. Central San Ramon",69,0,1,0,66,27,6,7,2,178,4,9,191,225,0.371,0.849
"27066","Santa Cruz","San Ramón","Esc. Central San Ramon",64,0,1,1,79,24,10,5,0,184,7,11,202,235,0.429,0.86
"27067","Santa Cruz","San Ramón","Esc. Central San Ramon",85,1,0,2,60,24,7,12,0,191,1,11,203,231,0.314,0.879
"27068","Santa Cruz","San Ramón","Esc. Central San Ramon",64,2,1,1,85,12,13,5,3,186,7,7,200,232,0.457,0.862
"27069","Santa Cruz","San Ramón","Esc. Central San Ramon",63,0,0,0,78,21,12,2,0,176,3,13,192,227,0.443,0.846
"27070","Santa Cruz","San Ramón","Esc. Central San Ramon",74,0,0,5,50,31,12,9,1,182,3,9,194,226,0.275,0.858
"27071","Santa Cruz","San Ramón","Esc. Central San Ramon",61,2,0,1,82,18,5,7,0,176,6,8,190,232,0.466,0.819
"27072","Santa Cruz","San Ramón","Esc. Central San Ramon",76,0,0,0,81,10,18,4,0,189,5,3,197,225,0.429,0.876
"27073","Santa Cruz","San Ramón","Esc. Central San Ramon",84,0,0,0,65,27,10,14,1,201,3,8,212,230,0.323,0.922
"27074","Santa Cruz","San Ramón","Esc. Central San Ramon",66,0,3,2,91,15,12,5,1,195,1,6,202,228,0.467,0.886
"27075","Santa Cruz","San Ramón","Esc. Central San Ramon",69,2,0,5,77,21,4,9,0,187,7,14,208,235,0.412,0.885
"27076","Santa Cruz","San Ramón","Esc. Central San Ramon",60,1,0,0,79,20,11,7,1,179,3,8,190,227,0.441,0.837
"27077","Santa Cruz","San Ramón","Esc. Central San Ramon",76,1,1,1,85,19,5,4,0,192,6,2,200,226,0.443,0.885
"27078","Santa Cruz","San Ramón","Esc. Santa Rosa De La Mina",48,0,0,0,76,20,13,12,1,170,6,4,180,213,0.447,0.845
"27079","Santa Cruz","San Julian","Esc. Col  Ciro Mealla",20,0,0,1,129,3,42,1,2,198,2,5,205,223,0.652,0.919
"27080","Santa Cruz","San Julian","Esc. Col  Ciro Mealla",33,2,0,0,121,13,30,0,1,200,3,5,208,230,0.605,0.904
"27081","Santa Cruz","San Julian","Esc. Col  Ciro Mealla",21,1,1,0,120,19,28,0,1,191,3,5,199,225,0.628,0.884
"27082","Santa Cruz","San Julian","Esc. Col  Ciro Mealla",21,1,0,0,115,7,25,1,3,173,5,12,190,227,0.665,0.837
"27083","Santa Cruz","San Julian","Esc. Col  Ciro Mealla",10,0,1,1,137,6,38,0,0,193,6,4,203,225,0.71,0.902
"27084","Santa Cruz","San Julian","Esc. Col  Ciro Mealla",17,0,2,0,112,10,24,3,0,168,3,25,196,228,0.667,0.86
"27085","Santa Cruz","San Julian","Esc. Col  Ciro Mealla",14,1,0,0,130,8,36,0,0,189,2,8,199,228,0.688,0.873
"27086","Santa Cruz","San Julian","Esc. Col  Ciro Mealla",34,0,2,1,110,8,26,0,1,182,3,6,191,217,0.604,0.88
"27087","Santa Cruz","San Julian","Esc. Col  Ciro Mealla",16,1,1,1,139,4,27,0,1,190,0,21,211,230,0.732,0.917
"27088","Santa Cruz","San Julian","Esc. Col  Ciro Mealla",15,0,2,0,134,2,27,0,1,181,4,12,197,226,0.74,0.872
"27089","Santa Cruz","San Julian","Esc. Col  Ciro Mealla",19,0,1,1,143,1,25,0,1,191,4,6,201,221,0.749,0.91
"27090","Santa Cruz","San Julian","Esc. Col  Ciro Mealla",25,0,2,0,122,10,25,1,0,185,6,4,195,222,0.659,0.878
"27091","Santa Cruz","San Julian","Esc. Col  Ciro Mealla",25,1,0,1,131,9,24,0,0,191,5,6,202,226,0.686,0.894
"27092","Santa Cruz","San Julian","Esc. Col  Ciro Mealla",18,0,2,0,138,11,30,0,2,201,2,1,204,224,0.687,0.911
"27093","Santa Cruz","San Julian","Esc. Col  Ciro Mealla",35,0,1,1,128,9,29,0,1,204,3,3,210,229,0.627,0.917
"27094","Santa Cruz","San Julian","Esc. Col  Ciro Mealla",20,0,0,0,133,6,32,0,1,192,3,9,204,233,0.693,0.876
"27095","Santa Cruz","San Julian","Esc. Col  Ciro Mealla",19,0,0,1,142,7,19,1,1,190,2,2,194,224,0.747,0.866
"27096","Santa Cruz","San Julian","Esc. Col  Ciro Mealla",18,0,1,0,146,3,30,0,0,198,3,8,209,226,0.737,0.925
"27097","Santa Cruz","San Julian","Esc. Col  Ciro Mealla",21,0,1,0,141,6,19,0,0,188,4,10,202,226,0.75,0.894
"27098","Santa Cruz","San Julian","Esc. Col  Ciro Mealla",26,2,0,0,145,9,22,1,2,207,1,2,210,230,0.7,0.913
"27099","Santa Cruz","San Julian","Esc. Col  Ciro Mealla",18,2,0,1,141,4,22,0,0,188,2,4,194,220,0.75,0.882
"27100","Santa Cruz","San Julian","Esc. Col  Ciro Mealla",15,1,0,1,148,6,26,0,0,197,2,10,209,230,0.751,0.909
"27101","Santa Cruz","San Julian","Esc. Col  Ciro Mealla",15,1,1,0,147,4,17,0,1,186,2,3,191,227,0.79,0.841
"27102","Santa Cruz","San Julian","Esc. Col  Ciro Mealla",16,1,1,0,126,14,20,1,1,180,6,5,191,221,0.7,0.864
"27103","Santa Cruz","San Julian","Esc. Col  Ciro Mealla",13,0,0,0,138,10,25,1,1,188,3,9,200,222,0.734,0.901
"27104","Santa Cruz","San Julian","Esc. Col  Ciro Mealla",28,1,0,0,123,6,21,0,1,180,2,16,198,222,0.683,0.892
"27105","Santa Cruz","San Julian","Esc. Col  Ciro Mealla",20,1,0,0,135,11,32,0,0,199,1,1,201,226,0.678,0.889
"27106","Santa Cruz","San Julian","Esc. Col  Ciro Mealla",18,1,2,1,146,10,23,0,1,202,2,3,207,222,0.723,0.932
"27107","Santa Cruz","San Julian","Esc. Col  Ciro Mealla",34,0,0,1,101,7,34,0,2,179,0,6,185,221,0.564,0.837
"27108","Santa Cruz","San Julian","Esc. Col  Ciro Mealla",15,1,0,0,153,5,26,0,0,200,1,3,204,227,0.765,0.899
"27109","Santa Cruz","San Julian","Esc. Col  Ciro Mealla",18,0,1,1,141,4,35,1,0,201,5,3,209,225,0.701,0.929
"27110","Santa Cruz","San Julian","Esc. Col  Ciro Mealla",18,1,1,0,143,9,24,0,0,196,4,9,209,228,0.73,0.917
"27111","Santa Cruz","San Julian","Esc. Col  Ciro Mealla",23,2,1,0,123,8,34,1,0,192,2,5,199,227,0.641,0.877
"27112","Santa Cruz","San Julian","Esc. Col  Ciro Mealla",32,0,0,0,118,9,29,0,0,188,6,6,200,228,0.628,0.877
"27113","Santa Cruz","San Julian","Esc. Col  Ciro Mealla",22,0,1,0,139,6,23,0,0,191,3,9,203,225,0.728,0.902
"27114","Santa Cruz","San Julian","Esc. Col  Ciro Mealla",25,2,1,1,107,6,33,1,3,179,4,6,189,220,0.598,0.859
"27115","Santa Cruz","San Julian","Esc. Col  Ciro Mealla",16,0,0,0,134,16,18,1,1,186,7,3,196,221,0.72,0.887
"27116","Santa Cruz","San Julian","Esc. Col  Ciro Mealla",31,0,0,0,103,8,32,0,0,174,3,18,195,222,0.592,0.878
"27117","Santa Cruz","San Julian","Esc. Col  Ciro Mealla",21,2,0,0,145,2,22,0,0,192,1,8,201,228,0.755,0.882
"27118","Santa Cruz","San Julian","Esc. Col  Ciro Mealla",17,0,1,0,125,1,38,0,1,183,2,7,192,221,0.683,0.869
"27119","Santa Cruz","San Julian","U.E. Guillermo Jordan",19,0,0,0,140,5,30,0,1,195,3,10,208,234,0.718,0.889
"27120","Santa Cruz","San Julian","U.E. Guillermo Jordan",27,0,0,0,145,5,34,0,0,211,5,2,218,238,0.687,0.916
"27121","Santa Cruz","San Julian","U.E. Guillermo Jordan",28,0,0,0,138,7,21,0,0,194,2,9,205,232,0.711,0.884
"27122","Santa Cruz","San Julian","U.E. Guillermo Jordan",14,0,0,1,144,5,30,0,0,194,3,5,202,238,0.742,0.849
"27123","Santa Cruz","San Julian","U.E. Guillermo Jordan",30,1,0,0,133,6,32,1,1,204,3,7,214,235,0.652,0.911
"27124","Santa Cruz","San Julian","U.E. Guillermo Jordan",20,1,1,0,139,3,42,0,1,207,2,4,213,235,0.671,0.906
"27125","Santa Cruz","San Julian","U.E. Guillermo Jordan",24,1,0,0,155,8,27,0,0,215,1,5,221,236,0.721,0.936
"27126","Santa Cruz","San Julian","U.E. Guillermo Jordan",21,0,0,0,148,7,33,0,0,209,3,5,217,235,0.708,0.923
"27127","Santa Cruz","San Julian","U.E. Guillermo Jordan",15,0,0,0,161,8,28,0,0,212,2,1,215,236,0.759,0.911
"27128","Santa Cruz","San Julian","U.E. Guillermo Jordan",27,1,0,1,126,14,43,2,0,214,2,2,218,240,0.589,0.908
"27129","Santa Cruz","San Julian","U.E. Guillermo Jordan",27,0,0,0,147,3,29,0,1,207,4,5,216,238,0.71,0.908
"27130","Santa Cruz","San Julian","U.E. Guillermo Jordan",10,0,0,0,155,1,48,1,3,218,1,2,221,235,0.711,0.94
"27131","Santa Cruz","San Julian","U.E. Guillermo Jordan",15,0,0,0,137,11,32,1,1,197,2,7,206,231,0.695,0.892
"27132","Santa Cruz","San Julian","U.E. Guillermo Jordan",19,0,0,0,144,5,37,2,1,208,0,5,213,238,0.692,0.895
"27133","Santa Cruz","San Julian","U.E. Guillermo Jordan",30,0,0,0,116,2,31,1,2,182,1,30,213,236,0.637,0.903
"27134","Santa Cruz","San Julian","U.E. Guillermo Jordan",17,0,0,0,138,5,30,1,1,192,3,3,198,223,0.719,0.888
"27135","Santa Cruz","San Julian","Esc. Patuju",14,2,1,1,144,5,33,0,2,202,6,5,213,238,0.713,0.895
"27136","Santa Cruz","San Julian","Esc. Patuju",16,2,0,0,159,7,26,0,1,211,2,4,217,239,0.754,0.908
"27137","Santa Cruz","San Julian","Esc. Patuju",21,0,1,0,144,7,35,0,2,210,1,6,217,237,0.686,0.916
"27138","Santa Cruz","San Julian","Esc. Patuju",11,0,3,0,154,4,31,0,1,204,3,6,213,237,0.755,0.899
"27139","Santa Cruz","San Julian","Esc. Patuju",12,1,0,1,133,8,44,2,2,203,3,7,213,238,0.655,0.895
"27140","Santa Cruz","San Julian","Esc. Patuju",13,0,0,0,143,12,32,2,0,202,2,6,210,234,0.708,0.897
"27141","Santa Cruz","San Julian","Esc. Patuju",8,0,1,0,135,11,42,0,1,198,5,12,215,236,0.682,0.911
"27142","Santa Cruz","San Julian","Esc. El Progreso",28,0,0,0,139,8,34,1,1,211,2,3,216,237,0.659,0.911
"27143","Santa Cruz","San Julian","Esc. El Progreso",21,0,0,0,155,8,0,0,0,184,2,3,189,235,0.842,0.804
"27144","Santa Cruz","San Julian","Esc. El Progreso",20,0,1,1,153,6,25,1,1,208,0,4,212,234,0.736,0.906
"27145","Santa Cruz","San Julian","Esc. El Progreso",27,1,0,0,156,2,27,0,2,215,5,2,222,237,0.726,0.937
"27146","Santa Cruz","San Julian","Esc. El Progreso",25,0,0,0,140,10,35,0,1,211,3,4,218,237,0.664,0.92
"27147","Santa Cruz","San Julian","U.E. Jose David Berrios",8,0,1,0,168,5,38,0,0,220,1,4,225,239,0.764,0.941
"27148","Santa Cruz","San Julian","U.E. Jose David Berrios",6,1,0,0,178,2,48,0,0,235,1,10,246,254,0.757,0.969
"27149","Santa Cruz","San Julian","U.E. San Julian e Berlin",11,0,3,1,173,10,19,0,1,218,6,4,228,239,0.794,0.954
"27150","Santa Cruz","San Julian","U.E. San Julian e Berlin",8,0,0,0,126,3,16,0,2,155,4,1,160,167,0.813,0.958
"27151","Santa Cruz","San Julian","Esc. Max Fernandez Rojas",11,1,1,0,131,3,58,1,0,206,3,4,213,227,0.636,0.938
"27152","Santa Cruz","San Julian","Esc. Max Fernandez Rojas",15,0,0,0,128,6,52,1,1,203,2,10,215,231,0.631,0.931
"27153","Santa Cruz","San Julian","Esc. Max Fernandez Rojas",7,0,0,1,112,3,40,1,0,164,3,3,170,180,0.683,0.944
"27154","Santa Cruz","San Julian","Esc. Gral San Martin",3,1,0,0,181,1,21,1,0,208,2,2,212,228,0.87,0.93
"27155","Santa Cruz","San Julian","Esc. Gral San Martin",7,0,2,1,170,7,11,0,0,198,6,4,208,226,0.859,0.92
"27156","Santa Cruz","San Julian","Esc. La Asunta San Bernardo",31,4,2,1,102,18,22,0,1,181,7,2,190,224,0.564,0.848
"27157","Santa Cruz","San Julian","Esc. La Asunta San Bernardo",25,2,1,2,123,13,26,1,0,193,3,3,199,226,0.637,0.881
"27158","Santa Cruz","San Julian","Esc. La Asunta San Bernardo",28,0,1,1,111,19,24,0,1,185,8,6,199,224,0.6,0.888
"27159","Santa Cruz","San Julian","Esc. La Asunta San Bernardo",29,0,1,0,117,18,34,0,1,200,5,12,217,229,0.585,0.948
"27160","Santa Cruz","San Julian","Esc. La Asunta San Bernardo",30,3,1,0,116,11,27,1,0,189,5,8,202,221,0.614,0.914
"27161","Santa Cruz","San Julian","Esc. La Asunta San Bernardo",41,2,0,2,100,10,28,1,1,185,8,13,206,223,0.541,0.924
"27162","Santa Cruz","San Julian","Esc. 26 de Oct. Fe y Alegria",7,0,0,0,194,1,9,0,1,212,3,0,215,225,0.915,0.956
"27163","Santa Cruz","San Julian","Esc. 26 de Oct. Fe y Alegria",2,0,1,0,192,3,13,1,1,213,0,2,215,226,0.901,0.951
"27164","Santa Cruz","San Julian","Esc. San Salvador Nucleo 38",2,0,1,0,180,2,7,1,0,193,6,7,206,225,0.933,0.916
"27165","Santa Cruz","San Julian","Esc. San Salvador Nucleo 38",4,1,0,0,176,1,14,2,2,200,3,3,206,229,0.88,0.9
"27166","Santa Cruz","San Julian","Escuela Eduardo Avaroa",24,2,0,0,133,10,24,2,0,195,6,5,206,224,0.682,0.92
"27167","Santa Cruz","San Julian","Escuela Eduardo Avaroa",17,1,1,0,134,4,32,1,1,191,4,6,201,224,0.702,0.897
"27168","Santa Cruz","San Julian","Escuela Eduardo Avaroa",14,0,3,1,140,10,24,0,0,192,4,4,200,222,0.729,0.901
"27169","Santa Cruz","San Julian","Escuela Eduardo Avaroa",15,1,1,0,130,3,25,0,2,177,12,15,204,221,0.734,0.923
"27170","Santa Cruz","San Julian","Escuela Eduardo Avaroa",29,0,0,1,144,7,27,1,0,209,3,7,219,237,0.689,0.924
"27171","Santa Cruz","San Julian","Escuela Eduardo Avaroa",23,0,0,0,108,3,23,0,1,158,5,3,166,184,0.684,0.902
"27172","Santa Cruz","San Julian","Esc. Fe y Alegria",65,0,0,1,74,21,12,4,0,177,4,15,196,221,0.418,0.887
"27173","Santa Cruz","San Julian","Esc. Fe y Alegria",78,1,0,1,70,32,8,3,0,193,4,5,202,232,0.363,0.871
"27174","Santa Cruz","San Julian","Esc. Fe y Alegria",71,0,0,0,68,32,15,0,3,189,4,2,195,219,0.36,0.89
"27175","Santa Cruz","San Julian","Esc. Fe y Alegria",70,0,1,1,81,39,12,2,0,206,4,7,217,237,0.393,0.916
"27176","Santa Cruz","San Julian","Esc. Central Franz Tamayo",14,0,0,0,151,1,19,0,0,185,7,3,195,218,0.816,0.894
"27177","Santa Cruz","San Julian","Esc. Central Franz Tamayo",9,0,0,0,159,6,14,3,1,192,6,7,205,227,0.828,0.903
"27178","Santa Cruz","San Julian","Esc. Central Franz Tamayo",13,2,2,0,149,3,19,1,0,189,4,8,201,222,0.788,0.905
"27179","Santa Cruz","San Julian","Esc. Central Franz Tamayo",12,3,0,0,142,9,22,0,1,189,4,4,197,227,0.751,0.868
"27180","Santa Cruz","San Julian","Esc. Limoncito",28,4,2,1,133,8,23,3,0,202,3,8,213,239,0.658,0.891
"27181","Santa Cruz","San Julian","Esc. Nucleo 66 2 De Agosto",19,1,0,1,123,2,32,2,0,180,4,12,196,219,0.683,0.895
"27182","Santa Cruz","San Julian","Esc. Nucleo 66 2 De Agosto",12,1,0,0,140,4,25,1,0,183,9,13,205,231,0.765,0.887
"27183","Santa Cruz","San Julian","Escuela Luz y Verdad",38,3,0,0,137,5,13,1,0,197,6,3,206,225,0.695,0.916
"27184","Santa Cruz","San Julian","Esc. U.E. El Limonal",5,0,2,0,165,3,19,0,0,194,4,3,201,219,0.851,0.918
"27185","Santa Cruz","San Julian","Esc. U.E. Segunda Milla",86,0,2,0,38,10,15,0,0,151,3,5,159,166,0.252,0.958
"27186","Santa Cruz","San Julian","Esc. U.E. 16 de Marzo",4,2,1,1,166,3,34,1,0,212,3,5,220,236,0.783,0.932
"27187","Santa Cruz","San Julian","U.E. 27 de Abril",21,1,0,1,92,23,19,1,1,159,3,4,166,177,0.579,0.938
"27188","Santa Cruz","San Antonio de Lomerio","Esc. Central El Puquio",5,0,0,0,189,2,3,0,0,199,2,0,201,231,0.95,0.87
"27189","Santa Cruz","San Antonio de Lomerio","Esc. Padre Matias Lens",70,1,1,0,60,39,5,1,0,177,9,17,203,230,0.339,0.883
"27190","Santa Cruz","San Antonio de Lomerio","Esc. Padre Matias Lens",111,0,0,0,47,45,5,2,0,210,4,8,222,234,0.224,0.949
"27191","Santa Cruz","San Antonio de Lomerio","Esc. Padre Matias Lens",83,0,0,0,73,43,4,1,2,206,4,5,215,234,0.354,0.919
"27192","Santa Cruz","San Antonio de Lomerio","Esc. Padre Matias Lens",98,2,0,0,52,41,3,3,2,201,4,4,209,235,0.259,0.889
"27193","Santa Cruz","San Antonio de Lomerio","Esc. Padre Matias Lens",81,0,0,2,50,52,5,0,1,191,5,7,203,236,0.262,0.86
"27194","Santa Cruz","San Antonio de Lomerio","Esc. Padre Matias Lens",101,0,0,3,54,37,6,2,1,204,4,3,211,233,0.265,0.906
"27195","Santa Cruz","San Antonio de Lomerio","Esc. Seccional Salinas",47,2,2,2,79,29,7,2,2,172,11,8,191,236,0.459,0.809
"27196","Santa Cruz","San Antonio de Lomerio","Esc. San Lorenzo",2,0,0,0,202,3,1,0,1,209,2,1,212,236,0.967,0.898
"27197","Santa Cruz","San Antonio de Lomerio","Esc. U.E. Padre Pio",32,0,3,0,136,10,8,0,0,189,6,4,199,221,0.72,0.9
"27198","Santa Cruz","San Antonio de Lomerio","Esc. U.E. Monterito",1,0,0,0,220,0,0,0,0,221,2,1,224,236,0.995,0.949
"27199","Santa Cruz","Cuatro Cañadas","Esc. Juan Pablo Segundo",33,2,0,0,128,9,28,0,0,200,3,1,204,230,0.64,0.887
"27200","Santa Cruz","Cuatro Cañadas","Esc. Juan Pablo Segundo",38,1,0,1,131,5,24,0,0,200,1,3,204,225,0.655,0.907
"27201","Santa Cruz","Cuatro Cañadas","Esc. Juan Pablo Segundo",23,1,0,0,120,8,43,0,0,195,3,1,199,231,0.615,0.861
"27202","Santa Cruz","Cuatro Cañadas","Esc. Juan Pablo Segundo",37,1,1,1,127,7,30,0,0,204,1,4,209,230,0.623,0.909
"27203","Santa Cruz","Cuatro Cañadas","Esc. Juan Pablo Segundo",33,1,0,0,101,15,24,0,2,176,6,15,197,230,0.574,0.857
"27204","Santa Cruz","Cuatro Cañadas","Esc. Juan Pablo Segundo",36,0,1,0,127,14,24,0,0,202,3,3,208,234,0.629,0.889
"27205","Santa Cruz","Cuatro Cañadas","Esc. Juan Pablo Segundo",24,1,0,1,128,13,34,1,0,202,4,3,209,234,0.634,0.893
"27206","Santa Cruz","Cuatro Cañadas","Esc. Juan Pablo Segundo",24,0,3,0,142,7,25,0,1,202,1,5,208,230,0.703,0.904
"27207","Santa Cruz","Cuatro Cañadas","Esc. Juan Pablo Segundo",33,1,0,1,112,7,29,0,1,184,1,2,187,221,0.609,0.846
"27208","Santa Cruz","Cuatro Cañadas","Esc. Juan Pablo Segundo",25,1,0,0,132,4,32,0,0,194,1,5,200,227,0.68,0.881
"27209","Santa Cruz","Cuatro Cañadas","Esc. Juan Pablo Segundo",37,1,0,0,127,4,20,0,0,189,3,5,197,226,0.672,0.872
"27210","Santa Cruz","Cuatro Cañadas","Esc. Juan Pablo Segundo",37,0,0,0,111,6,33,0,0,187,2,7,196,229,0.594,0.856
"27211","Santa Cruz","Cuatro Cañadas","Esc. Juan Pablo Segundo",32,0,0,1,95,14,35,2,1,180,1,6,187,222,0.528,0.842
"27212","Santa Cruz","Cuatro Cañadas","Esc. Juan Pablo Segundo",29,3,0,0,136,6,22,0,0,196,3,6,205,231,0.694,0.887
"27213","Santa Cruz","Cuatro Cañadas","Esc. Juan Pablo Segundo",32,1,0,0,122,16,34,1,0,206,3,8,217,233,0.592,0.931
"27214","Santa Cruz","Cuatro Cañadas","Esc. Juan Pablo Segundo",39,0,0,0,121,18,17,1,0,196,3,6,205,229,0.617,0.895
"27215","Santa Cruz","Cuatro Cañadas","Esc. Juan Pablo Segundo",49,1,0,0,121,9,22,2,0,204,2,5,211,231,0.593,0.913
"27216","Santa Cruz","Cuatro Cañadas","Esc. Juan Pablo Segundo",20,0,0,0,126,10,31,0,1,188,5,5,198,230,0.67,0.861
"27217","Santa Cruz","Cuatro Cañadas","Esc. Juan Pablo Segundo",35,2,0,0,110,12,39,1,0,199,4,5,208,225,0.553,0.924
"27218","Santa Cruz","Cuatro Cañadas","Esc. Juan Pablo Segundo",18,0,0,0,130,15,30,2,0,195,3,7,205,231,0.667,0.887
"27219","Santa Cruz","Cuatro Cañadas","Esc. Juan Pablo Segundo",30,0,1,1,111,8,31,1,0,183,2,10,195,226,0.607,0.863
"27220","Santa Cruz","Cuatro Cañadas","Esc. Juan Pablo Segundo",28,0,0,0,125,16,16,1,0,186,5,9,200,228,0.672,0.877
"27221","Santa Cruz","Cuatro Cañadas","Esc. Juan Pablo Segundo",29,2,0,0,121,14,24,2,0,192,3,7,202,228,0.63,0.886
"27222","Santa Cruz","Cuatro Cañadas","Esc. Juan Pablo Segundo",26,1,0,0,131,7,29,1,0,195,0,5,200,230,0.672,0.87
"27223","Santa Cruz","Cuatro Cañadas","Esc. Juan Pablo Segundo",42,1,0,0,110,16,28,0,1,198,4,4,206,226,0.556,0.912
"27224","Santa Cruz","Cuatro Cañadas","Esc. Juan Pablo Segundo",23,1,2,0,127,6,25,1,1,186,2,8,196,231,0.683,0.848
"27225","Santa Cruz","Cuatro Cañadas","Esc. Juan Pablo Segundo",26,0,1,0,133,7,23,0,2,192,1,5,198,228,0.693,0.868
"27226","Santa Cruz","Cuatro Cañadas","Esc. Juan Pablo Segundo",24,0,0,1,128,7,24,0,0,184,5,4,193,230,0.696,0.839
"27227","Santa Cruz","Cuatro Cañadas","Col. Nacional Cuatro Cañandas",20,0,0,1,112,11,35,0,2,181,0,37,218,233,0.619,0.936
"27228","Santa Cruz","Cuatro Cañadas","Col. Nacional Cuatro Cañandas",28,1,0,0,119,11,44,1,0,204,1,6,211,233,0.583,0.906
"27229","Santa Cruz","Cuatro Cañadas","Col. Nacional Cuatro Cañandas",19,1,0,1,105,10,51,0,0,187,1,7,195,225,0.561,0.867
"27230","Santa Cruz","Cuatro Cañadas","Col. Nacional Cuatro Cañandas",25,0,1,0,134,9,38,0,0,207,2,10,219,234,0.647,0.936
"27231","Santa Cruz","Cuatro Cañadas","Col. Nacional Cuatro Cañandas",37,1,0,0,123,8,43,0,2,214,4,4,222,237,0.575,0.937
"27232","Santa Cruz","Cuatro Cañadas","Col. Nacional Cuatro Cañandas",31,0,2,0,121,7,35,0,0,196,4,8,208,233,0.617,0.893
"27233","Santa Cruz","Cuatro Cañadas","Esc. Los Troncos",40,0,0,0,80,27,21,3,0,171,2,5,178,209,0.468,0.852
"27234","Santa Cruz","Cuatro Cañadas","Esc. Jose Luis Castro",32,1,0,0,136,8,23,2,0,202,3,9,214,229,0.673,0.934
"27235","Santa Cruz","Cuatro Cañadas","Esc. Jose Luis Castro",25,0,0,1,143,4,21,0,0,194,1,7,202,229,0.737,0.882
"27236","Santa Cruz","Cuatro Cañadas","Esc. Jose Luis Castro",23,0,1,0,142,9,21,1,0,197,4,6,207,222,0.721,0.932
"27237","Santa Cruz","Cuatro Cañadas","Esc. Jose Luis Castro",26,0,0,0,128,10,27,2,1,194,4,5,203,229,0.66,0.886
"27238","Santa Cruz","Cuatro Cañadas","Esc. Jose Luis Castro",28,1,0,0,135,11,28,1,0,204,3,3,210,230,0.662,0.913
"27239","Santa Cruz","Cuatro Cañadas","Esc. Jose Luis Castro",29,0,0,0,115,12,35,1,0,192,6,9,207,222,0.599,0.932
"27240","Santa Cruz","Cuatro Cañadas","Esc. Monte Rico",8,0,1,0,181,4,14,2,1,211,5,4,220,234,0.858,0.94
"27241","Santa Cruz","Cuatro Cañadas","Esc. 26 de Agosto",33,1,0,1,127,7,26,2,0,197,3,9,209,228,0.645,0.917
"27242","Santa Cruz","Cuatro Cañadas","Esc. 26 de Agosto",32,1,1,0,104,7,34,0,2,181,3,10,194,221,0.575,0.878
"27243","Santa Cruz","Cuatro Cañadas","Esc. 26 de Agosto",49,3,1,1,104,8,36,0,0,202,5,4,211,229,0.515,0.921
"27244","Santa Cruz","Cuatro Cañadas","Esc. 26 de Agosto",30,0,0,1,126,6,27,1,2,193,6,7,206,228,0.653,0.904
"27245","Santa Cruz","Cuatro Cañadas","U.E. Haziel",88,0,0,0,11,0,61,0,0,160,5,3,168,195,0.069,0.862
"27246","Santa Cruz","Cuatro Cañadas","U.E. Haziel",73,0,0,1,16,2,64,1,1,158,4,2,164,217,0.101,0.756
"27247","Santa Cruz","San Matías","Esc. U.E.Tecnica Vocacional",33,0,0,1,87,44,11,5,2,183,1,8,192,229,0.475,0.838
"27248","Santa Cruz","San Matías","Esc. U.E.Tecnica Vocacional",39,0,0,3,96,32,7,6,0,183,4,2,189,230,0.525,0.822
"27249","Santa Cruz","San Matías","Esc. U.E.Tecnica Vocacional",54,0,0,1,78,39,5,3,0,180,5,7,192,233,0.433,0.824
"27250","Santa Cruz","San Matías","Esc. U.E.Tecnica Vocacional",38,1,0,0,80,46,5,6,0,176,4,11,191,231,0.455,0.827
"27251","Santa Cruz","San Matías","Esc. U.E.Tecnica Vocacional",40,2,2,2,80,46,1,3,1,177,2,8,187,230,0.452,0.813
"27252","Santa Cruz","San Matías","Esc. U.E.Tecnica Vocacional",41,0,1,0,93,38,8,4,1,186,4,6,196,234,0.5,0.838
"27253","Santa Cruz","San Matías","Esc. U.E.Tecnica Vocacional",40,0,1,1,91,44,3,5,0,185,3,11,199,231,0.492,0.861
"27254","Santa Cruz","San Matías","Esc. U.E.Tecnica Vocacional",41,0,1,1,92,27,2,4,0,168,3,15,186,228,0.548,0.816
"27255","Santa Cruz","San Matías","Esc. U.E.Tecnica Vocacional",26,0,1,1,84,51,3,5,2,173,6,7,186,226,0.486,0.823
"27256","Santa Cruz","San Matías","Esc. U.E.Tecnica Vocacional",28,0,2,0,97,47,3,5,1,183,6,7,196,226,0.53,0.867
"27257","Santa Cruz","San Matías","Esc. U.E.Tecnica Vocacional",28,0,0,0,83,46,4,8,0,169,6,7,182,226,0.491,0.805
"27258","Santa Cruz","San Matías","Esc. U.E.Tecnica Vocacional",36,0,1,0,80,45,4,4,1,171,3,12,186,231,0.468,0.805
"27259","Santa Cruz","San Matías","Esc. U.E. Emilia Rodat",50,2,0,0,80,26,8,3,0,169,5,18,192,234,0.473,0.821
"27260","Santa Cruz","San Matías","Esc. U.E. Emilia Rodat",39,1,1,1,94,19,12,1,0,168,5,2,175,228,0.56,0.768
"27261","Santa Cruz","San Matías","Esc. U.E. Emilia Rodat",27,1,0,0,89,46,5,4,0,172,4,19,195,227,0.517,0.859
"27262","Santa Cruz","San Matías","Esc. U.E. Emilia Rodat",54,1,0,0,73,37,5,7,0,177,3,10,190,231,0.412,0.823
"27263","Santa Cruz","San Matías","Esc. U.E. Emilia Rodat",40,1,0,2,88,39,8,3,1,182,2,3,187,230,0.484,0.813
"27264","Santa Cruz","San Matías","Esc. U.E. Emilia Rodat",43,0,0,2,69,35,0,3,0,152,28,2,182,231,0.454,0.788
"27265","Santa Cruz","San Matías","Esc. U.E. Emilia Rodat",48,0,1,1,72,26,6,4,2,160,2,11,173,221,0.45,0.783
"27266","Santa Cruz","San Matías","Esc. U.E. Emilia Rodat",44,1,2,2,88,28,9,7,0,181,3,11,195,229,0.486,0.852
"27267","Santa Cruz","San Matías","Esc. U.E. Emilia Rodat",54,1,3,0,75,37,5,6,0,181,8,8,197,230,0.414,0.857
"27268","Santa Cruz","San Matías","Esc. U.E. Emilia Rodat",35,1,0,0,96,31,6,8,1,178,9,9,196,229,0.539,0.856
"27269","Santa Cruz","San Matías","Esc. U.E. Emilia Rodat",64,0,1,0,81,30,5,2,0,183,4,10,197,230,0.443,0.857
"27270","Santa Cruz","San Matías","Esc. U.E. Emilia Rodat",41,1,0,0,91,40,3,6,0,182,7,10,199,228,0.5,0.873
"27271","Santa Cruz","San Matías","Esc. U.E. Emilia Rodat",44,2,0,0,86,34,3,8,0,177,4,10,191,232,0.486,0.823
"27272","Santa Cruz","San Matías","Esc. U.E. Emilia Rodat",35,2,1,1,83,53,9,4,0,188,3,3,194,229,0.441,0.847
"27273","Santa Cruz","San Matías","Esc. U.E. Emilia Rodat",35,0,1,1,76,35,9,1,0,158,0,1,159,189,0.481,0.841
"27274","Santa Cruz","San Matías","Esc. Seccional Candelaria",17,1,1,2,96,35,12,7,2,173,2,2,177,227,0.555,0.78
"27275","Santa Cruz","San Matías","Esc. Las Petas",48,2,4,1,91,26,0,1,1,174,5,6,185,229,0.523,0.808
"27276","Santa Cruz","San Matías","Esc. Las Petas",49,1,1,3,51,38,4,5,1,153,9,12,174,237,0.333,0.734
"27277","Santa Cruz","San Matías","Esc. Benjamin Catacora",69,5,1,4,57,25,14,9,1,185,1,18,204,237,0.308,0.861
"27278","Santa Cruz","San Matías","Esc. Benjamin Catacora",69,2,2,2,64,26,9,9,1,184,9,4,197,232,0.348,0.849
"27279","Santa Cruz","San Matías","Esc. Benjamin Catacora",63,1,4,1,64,29,12,7,0,181,3,16,200,231,0.354,0.866
"27280","Santa Cruz","San Matías","Esc. Santo Corazon",61,3,2,4,42,33,1,7,2,155,13,9,177,235,0.271,0.753
"27281","Santa Cruz","Comarapa","Esc. Gabriel Rene Moreno",47,0,1,0,108,5,32,1,0,194,13,9,216,229,0.557,0.943
"27282","Santa Cruz","Comarapa","Esc. Gabriel Rene Moreno",43,1,0,1,117,10,20,0,0,192,3,11,206,228,0.609,0.904
"27283","Santa Cruz","Comarapa","Esc. Gabriel Rene Moreno",54,0,0,2,107,11,21,0,0,195,7,10,212,226,0.549,0.938
"27284","Santa Cruz","Comarapa","Esc. Gabriel Rene Moreno",52,1,0,1,86,15,31,1,1,188,3,9,200,220,0.457,0.909
"27285","Santa Cruz","Comarapa","Esc. Gabriel Rene Moreno",41,1,2,0,120,11,30,0,1,206,5,5,216,229,0.583,0.943
"27286","Santa Cruz","Comarapa","Esc. Gabriel Rene Moreno",45,1,0,0,104,18,34,0,1,203,5,8,216,232,0.512,0.931
"27287","Santa Cruz","Comarapa","Esc. Gabriel Rene Moreno",37,1,0,0,116,13,27,0,3,197,6,7,210,228,0.589,0.921
"27288","Santa Cruz","Comarapa","Esc. Gabriel Rene Moreno",35,1,0,1,102,12,37,0,0,188,5,11,204,228,0.543,0.895
"27289","Santa Cruz","Comarapa","Esc. Gabriel Rene Moreno",30,1,1,0,117,8,28,0,0,185,6,15,206,230,0.632,0.896
"27290","Santa Cruz","Comarapa","Esc. Gabriel Rene Moreno",30,2,0,0,105,12,44,0,1,194,2,13,209,229,0.541,0.913
"27291","Santa Cruz","Comarapa","Esc. Gabriel Rene Moreno",44,0,0,1,123,8,25,0,0,201,2,9,212,227,0.612,0.934
"27292","Santa Cruz","Comarapa","Esc. Gabriel Rene Moreno",35,1,0,1,114,13,32,0,0,196,5,9,210,230,0.582,0.913
"27293","Santa Cruz","Comarapa","Esc. Gabriel Rene Moreno",37,1,0,0,119,10,26,0,1,194,5,10,209,229,0.613,0.913
"27294","Santa Cruz","Comarapa","Esc. Gabriel Rene Moreno",53,2,0,1,97,11,21,0,2,187,5,8,200,223,0.519,0.897
"27295","Santa Cruz","Comarapa","Esc. Gabriel Rene Moreno",60,1,1,0,91,7,35,1,0,196,18,10,224,225,0.464,0.996
"27296","Santa Cruz","Comarapa","Esc. Gabriel Rene Moreno",58,1,0,0,107,6,17,0,1,190,3,14,207,226,0.563,0.916
"27297","Santa Cruz","Comarapa","Esc. Gabriel Rene Moreno",67,0,0,2,80,15,24,1,0,189,7,8,204,227,0.423,0.899
"27298","Santa Cruz","Comarapa","Esc. Gabriel Rene Moreno",86,0,0,1,73,17,20,0,0,197,4,6,207,231,0.371,0.896
"27299","Santa Cruz","Comarapa","Esc. Gabriel Rene Moreno",61,0,1,0,83,9,23,1,0,178,4,15,197,222,0.466,0.887
"27300","Santa Cruz","Comarapa","Esc. Gabriel Rene Moreno",77,0,0,0,83,16,18,1,1,196,0,12,208,228,0.423,0.912
"27301","Santa Cruz","Comarapa","Esc. Gabriel Rene Moreno",41,1,1,0,105,7,41,0,0,196,5,9,210,227,0.536,0.925
"27302","Santa Cruz","Comarapa","Esc. Gabriel Rene Moreno",49,0,1,0,116,5,23,1,0,195,2,13,210,230,0.595,0.913
"27303","Santa Cruz","Comarapa","Esc. Gabriel Rene Moreno",48,2,0,1,94,10,30,1,1,187,6,15,208,224,0.503,0.929
"27304","Santa Cruz","Comarapa","Esc. Gabriel Rene Moreno",36,0,1,1,86,17,22,0,1,164,2,12,178,193,0.524,0.922
"27305","Santa Cruz","Comarapa","Esc. San Juan del Potrero",45,2,0,1,69,48,6,1,0,172,18,8,198,222,0.401,0.892
"27306","Santa Cruz","Comarapa","Esc. San Juan del Potrero",51,1,1,2,53,41,8,1,0,158,9,1,168,182,0.335,0.923
"27307","Santa Cruz","Comarapa","Esc. San Isidro",55,2,0,0,90,30,7,1,0,185,2,11,198,226,0.486,0.876
"27308","Santa Cruz","Comarapa","Esc. San Isidro",47,0,0,0,100,19,20,0,1,187,7,9,203,228,0.535,0.89
"27309","Santa Cruz","Comarapa","Esc. San Isidro",63,1,0,1,105,17,11,0,0,198,3,9,210,227,0.53,0.925
"27310","Santa Cruz","Comarapa","Esc. San Isidro",48,0,1,0,114,18,18,0,2,201,2,9,212,225,0.567,0.942
"27311","Santa Cruz","Comarapa","Esc. San Isidro",58,0,2,0,92,18,15,2,0,187,6,10,203,227,0.492,0.894
"27312","Santa Cruz","Comarapa","Esc. Escuela San Mateo",2,0,0,1,161,7,42,0,1,214,1,5,220,234,0.752,0.94
"27313","Santa Cruz","Comarapa","Esc. Marcelino Chaipana",41,0,4,0,113,20,16,3,1,198,5,5,208,231,0.571,0.9
"27314","Santa Cruz","Comarapa","Esc. Marcelino Chaipana",52,1,0,1,92,39,10,0,0,195,5,10,210,223,0.472,0.942
"27315","Santa Cruz","Comarapa","Esc. San Jose De La Capilla",40,2,0,1,88,23,21,2,0,177,7,18,202,224,0.497,0.902
"27316","Santa Cruz","Comarapa","Esc. San Jose De La Capilla",40,0,2,1,77,29,23,1,0,173,8,11,192,216,0.445,0.889
"27317","Santa Cruz","Comarapa","Esc. Torrecillas",10,5,1,2,130,11,30,1,2,192,6,13,211,220,0.677,0.959
"27318","Santa Cruz","Comarapa","Esc. Torrecillas",9,2,0,1,137,8,29,0,2,188,12,12,212,229,0.729,0.926
"27319","Santa Cruz","Comarapa","Esc. Torrecillas",4,1,1,1,140,10,22,0,1,180,10,12,202,219,0.778,0.922
"27320","Santa Cruz","Comarapa","Esc. Torrecillas",9,2,1,0,116,5,27,1,1,162,12,12,186,202,0.716,0.921
"27321","Santa Cruz","Comarapa","Esc. U.E. La Palizada",38,1,2,0,129,23,16,1,0,210,2,7,219,234,0.614,0.936
"27322","Santa Cruz","Comarapa","Esc. U.E. La Palizada",30,1,0,3,114,19,17,0,0,184,4,7,195,221,0.62,0.882
"27323","Santa Cruz","Saipina","Esc. Humberto Villarroel",29,1,1,1,123,12,14,0,0,181,4,17,202,218,0.68,0.927
"27324","Santa Cruz","Saipina","Esc. Humberto Villarroel",40,0,0,1,106,21,18,1,0,187,6,11,204,223,0.567,0.915
"27325","Santa Cruz","Saipina","Esc. Humberto Villarroel",29,0,0,1,125,17,19,0,2,193,9,8,210,229,0.648,0.917
"27326","Santa Cruz","Saipina","Esc. Humberto Villarroel",51,2,3,1,96,21,19,1,2,196,3,5,204,226,0.49,0.903
"27327","Santa Cruz","Saipina","Esc. Humberto Villarroel",52,0,0,0,106,13,13,0,0,184,7,9,200,223,0.576,0.897
"27328","Santa Cruz","Saipina","Esc. Humberto Villarroel",31,2,1,0,124,13,18,0,2,191,0,13,204,224,0.649,0.911
"27329","Santa Cruz","Saipina","Esc. Humberto Villarroel",30,0,0,1,117,14,11,0,0,173,6,27,206,224,0.676,0.92
"27330","Santa Cruz","Saipina","Esc. Humberto Villarroel",36,0,0,2,107,26,12,1,1,185,4,14,203,224,0.578,0.906
"27331","Santa Cruz","Saipina","Esc. Humberto Villarroel",50,1,0,1,107,30,9,1,1,200,2,5,207,224,0.535,0.924
"27332","Santa Cruz","Saipina","Esc. Humberto Villarroel",53,0,1,0,96,22,21,1,0,194,7,10,211,225,0.495,0.938
"27333","Santa Cruz","Saipina","Esc. San Rafael",39,0,1,0,118,23,13,0,2,196,2,4,202,220,0.602,0.918
"27334","Santa Cruz","Saipina","Esc. U.E. Santa Catalina Chilon",33,0,0,2,120,10,22,0,2,189,2,15,206,229,0.635,0.9
"27335","Santa Cruz","Saipina","Esc. U.E. Santa Catalina Chilon",34,0,1,0,124,8,15,0,0,182,5,10,197,220,0.681,0.895
"27336","Santa Cruz","Puerto Suarez","Esc. Eliodoro Paz",107,0,1,0,28,13,9,4,1,163,4,7,174,213,0.172,0.817
"27337","Santa Cruz","Puerto Suarez","Esc. Eliodoro Paz",99,1,1,0,47,16,4,4,1,173,1,10,184,224,0.272,0.821
"27338","Santa Cruz","Puerto Suarez","Esc. Eliodoro Paz",91,0,0,1,53,18,7,3,0,173,2,13,188,222,0.306,0.847
"27339","Santa Cruz","Puerto Suarez","Esc. Eliodoro Paz",90,0,0,2,28,23,6,8,1,158,2,7,167,218,0.177,0.766
"27340","Santa Cruz","Puerto Suarez","Esc. Eliodoro Paz",89,0,0,0,37,16,11,8,0,161,4,6,171,220,0.23,0.777
"27341","Santa Cruz","Puerto Suarez","Esc. Josefina Goytia",100,0,1,3,33,17,11,7,1,173,0,11,184,225,0.191,0.818
"27342","Santa Cruz","Puerto Suarez","Esc. Josefina Goytia",94,0,0,1,54,18,9,1,2,179,9,5,193,230,0.302,0.839
"27343","Santa Cruz","Puerto Suarez","Esc. Josefina Goytia",107,0,1,0,33,17,12,6,1,177,1,4,182,223,0.186,0.816
"27344","Santa Cruz","Puerto Suarez","Esc. Josefina Goytia",108,1,1,1,52,12,9,1,0,185,1,3,189,227,0.281,0.833
"27345","Santa Cruz","Puerto Suarez","Esc. Josefina Goytia",88,0,1,0,39,24,12,2,2,168,0,5,173,225,0.232,0.769
"27346","Santa Cruz","Puerto Suarez","Esc. Josefina Goytia",100,0,1,1,41,16,5,3,1,168,2,4,174,222,0.244,0.784
"27347","Santa Cruz","Puerto Suarez","Esc. Josefina Goytia",106,0,0,0,46,22,6,6,3,189,0,3,192,226,0.243,0.85
"27348","Santa Cruz","Puerto Suarez","Esc. Josefina Goytia",99,1,1,0,44,16,6,7,1,175,1,4,180,230,0.251,0.783
"27349","Santa Cruz","Puerto Suarez","Esc. Miguel Suarez Arana",86,1,0,2,48,25,12,2,0,176,1,9,186,223,0.273,0.834
"27350","Santa Cruz","Puerto Suarez","Esc. Miguel Suarez Arana",90,0,0,1,48,18,12,5,2,176,2,9,187,226,0.273,0.827
"27351","Santa Cruz","Puerto Suarez","Esc. Miguel Suarez Arana",100,0,1,1,54,21,9,4,0,190,0,9,199,229,0.284,0.869
"27352","Santa Cruz","Puerto Suarez","Esc. Miguel Suarez Arana",88,1,1,2,43,14,11,7,2,169,3,3,175,227,0.254,0.771
"27353","Santa Cruz","Puerto Suarez","Esc. Miguel Suarez Arana",105,2,1,0,45,14,21,2,1,191,2,7,200,226,0.236,0.885
"27354","Santa Cruz","Puerto Suarez","Esc. Miguel Suarez Arana",114,0,1,0,40,22,5,11,0,193,0,5,198,225,0.207,0.88
"27355","Santa Cruz","Puerto Suarez","Esc. Miguel Suarez Arana",86,2,0,1,75,14,10,4,1,193,0,7,200,234,0.389,0.855
"27356","Santa Cruz","Puerto Suarez","Esc. Miguel Suarez Arana",89,0,0,0,51,28,7,3,1,179,3,7,189,228,0.285,0.829
"27357","Santa Cruz","Puerto Suarez","Esc. Miguel Suarez Arana",98,1,0,1,44,28,6,3,0,181,0,7,188,224,0.243,0.839
"27358","Santa Cruz","Puerto Suarez","Esc. Miguel Suarez Arana",104,0,1,0,51,17,7,5,0,185,5,4,194,227,0.276,0.855
"27359","Santa Cruz","Puerto Suarez","Esc. Miguel Suarez Arana",100,0,1,3,42,21,11,8,0,186,2,6,194,220,0.226,0.882
"27360","Santa Cruz","Puerto Suarez","Esc. Miguel Suarez Arana",99,1,0,3,36,26,7,4,0,176,2,7,185,226,0.205,0.819
"27361","Santa Cruz","Puerto Suarez","Esc. Miguel Suarez Arana",90,1,1,4,54,16,9,8,1,184,2,5,191,227,0.293,0.841
"27362","Santa Cruz","Puerto Suarez","Esc. Coop Educacional Puerto Suarez",95,0,1,2,59,16,10,1,0,184,2,2,188,228,0.321,0.825
"27363","Santa Cruz","Puerto Suarez","Esc. Coop Educacional Puerto Suarez",93,0,0,1,57,19,14,2,0,186,1,5,192,229,0.306,0.838
"27364","Santa Cruz","Puerto Suarez","Esc. Coop Educacional Puerto Suarez",97,2,2,1,66,19,2,2,1,192,2,5,199,231,0.344,0.861
"27365","Santa Cruz","Puerto Suarez","Esc. Coop Educacional Puerto Suarez",96,1,0,0,34,25,6,4,1,167,5,14,186,228,0.204,0.816
"27366","Santa Cruz","Puerto Suarez","Esc. Coop Educacional Puerto Suarez",87,2,0,0,66,12,10,2,0,179,0,13,192,229,0.369,0.838
"27367","Santa Cruz","Puerto Suarez","Esc. Coop Educacional Puerto Suarez",92,0,0,0,59,13,12,3,2,181,1,11,193,229,0.326,0.843
"27368","Santa Cruz","Puerto Suarez","Esc. Coop Educacional Puerto Suarez",91,0,1,1,51,22,5,4,1,176,2,6,184,228,0.29,0.807
"27369","Santa Cruz","Puerto Suarez","Esc. Coop Educacional Puerto Suarez",99,0,0,0,46,19,6,1,1,172,0,9,181,228,0.267,0.794
"27370","Santa Cruz","Puerto Suarez","Esc. Coop Educacional Puerto Suarez",70,0,0,1,50,28,9,4,2,164,1,9,174,225,0.305,0.773
"27371","Santa Cruz","Puerto Suarez","Esc. Coop Educacional Puerto Suarez",97,0,1,2,44,19,8,5,1,177,5,13,195,229,0.249,0.852
"27372","Santa Cruz","Puerto Suarez","Esc. Coop Educacional Puerto Suarez",86,0,0,0,60,24,8,3,0,181,3,10,194,226,0.331,0.858
"27373","Santa Cruz","Puerto Suarez","Esc. Coop Educacional Puerto Suarez",116,0,0,1,38,19,6,1,0,181,3,2,186,227,0.21,0.819
"27374","Santa Cruz","Puerto Suarez","Esc. Coop Educacional Puerto Suarez",84,1,0,1,56,21,16,6,0,185,3,4,192,228,0.303,0.842
"27375","Santa Cruz","Puerto Suarez","Esc. Coop Educacional Puerto Suarez",96,1,0,0,52,26,7,4,0,186,34,9,229,229,0.28,1
"27376","Santa Cruz","Puerto Suarez","Esc. Angelica Rivero",99,2,0,0,70,22,5,6,2,206,1,6,213,232,0.34,0.918
"27377","Santa Cruz","Puerto Suarez","Esc. Angelica Rivero",94,0,0,4,60,30,5,3,0,196,1,7,204,232,0.306,0.879
"27378","Santa Cruz","Puerto Suarez","Esc. Angelica Rivero",126,1,0,0,31,24,6,4,2,194,2,8,204,228,0.16,0.895
"27379","Santa Cruz","Puerto Suarez","Esc. Angelica Rivero",97,0,0,1,52,24,10,11,0,195,3,5,203,227,0.267,0.894
"27380","Santa Cruz","Puerto Suarez","Esc. German Busch Yacuses",60,0,0,1,84,21,10,9,1,186,2,7,195,227,0.452,0.859
"27381","Santa Cruz","Puerto Suarez","Esc. German Busch Yacuses",55,0,0,3,89,19,13,10,0,189,5,5,199,226,0.471,0.881
"27382","Santa Cruz","Puerto Quijarro","Esc. Gisela Brun Sciaroni",91,0,0,0,63,18,11,3,1,187,2,6,195,234,0.337,0.833
"27383","Santa Cruz","Puerto Quijarro","Esc. Gisela Brun Sciaroni",96,1,0,2,44,16,15,6,1,181,5,4,190,226,0.243,0.841
"27384","Santa Cruz","Puerto Quijarro","Esc. Gisela Brun Sciaroni",95,0,0,3,40,0,12,5,2,157,0,7,164,222,0.255,0.739
"27385","Santa Cruz","Puerto Quijarro","Esc. Gisela Brun Sciaroni",73,1,1,4,62,25,11,3,1,181,3,3,187,223,0.343,0.839
"27386","Santa Cruz","Puerto Quijarro","Esc. Gisela Brun Sciaroni",73,0,1,2,61,16,16,5,0,174,3,9,186,226,0.351,0.823
"27387","Santa Cruz","Puerto Quijarro","Esc. Gisela Brun Sciaroni",91,1,0,1,60,21,16,1,0,191,2,6,199,229,0.314,0.869
"27388","Santa Cruz","Puerto Quijarro","Esc. Gisela Brun Sciaroni",88,1,1,4,57,19,16,4,0,190,2,8,200,229,0.3,0.873
"27389","Santa Cruz","Puerto Quijarro","Esc. Gisela Brun Sciaroni",76,3,0,0,77,16,14,2,0,188,4,10,202,229,0.41,0.882
"27390","Santa Cruz","Puerto Quijarro","Esc. Gisela Brun Sciaroni",89,0,1,1,52,21,10,7,2,183,1,13,197,228,0.284,0.864
"27391","Santa Cruz","Puerto Quijarro","Esc. Gisela Brun Sciaroni",88,1,1,3,38,24,13,3,0,171,3,18,192,229,0.222,0.838
"27392","Santa Cruz","Puerto Quijarro","Esc. Gisela Brun Sciaroni",71,0,0,0,51,24,17,0,0,163,3,21,187,228,0.313,0.82
"27393","Santa Cruz","Puerto Quijarro","Esc. Gisela Brun Sciaroni",85,1,1,0,45,36,11,8,0,187,26,8,221,221,0.241,1
"27394","Santa Cruz","Puerto Quijarro","Esc. Gisela Brun Sciaroni",89,0,1,2,61,26,11,6,0,196,0,6,202,229,0.311,0.882
"27395","Santa Cruz","Puerto Quijarro","Esc. Gisela Brun Sciaroni",86,2,1,1,50,20,17,4,2,183,2,10,195,227,0.273,0.859
"27396","Santa Cruz","Puerto Quijarro","Esc. Gisela Brun Sciaroni",88,1,0,3,50,25,13,1,0,181,0,19,200,230,0.276,0.87
"27397","Santa Cruz","Puerto Quijarro","Esc. Gisela Brun Sciaroni",86,1,1,2,52,28,8,2,0,180,2,13,195,228,0.289,0.855
"27398","Santa Cruz","Puerto Quijarro","Esc. Samuel Lopez Mendoza",57,0,2,1,80,11,15,1,0,167,2,12,181,227,0.479,0.797
"27399","Santa Cruz","Puerto Quijarro","Esc. Samuel Lopez Mendoza",79,1,1,0,48,19,14,1,1,164,2,7,173,229,0.293,0.755
"27400","Santa Cruz","Puerto Quijarro","Esc. Samuel Lopez Mendoza",79,0,0,2,63,16,13,4,0,177,1,4,182,225,0.356,0.809
"27401","Santa Cruz","Puerto Quijarro","Esc. Samuel Lopez Mendoza",63,0,3,2,70,17,25,2,0,182,2,4,188,228,0.385,0.825
"27402","Santa Cruz","Puerto Quijarro","Esc. Samuel Lopez Mendoza",79,0,2,4,49,22,7,6,0,169,3,5,177,229,0.29,0.773
"27403","Santa Cruz","Puerto Quijarro","Esc. Samuel Lopez Mendoza",75,2,1,0,62,14,12,3,0,169,2,2,173,226,0.367,0.765
"27404","Santa Cruz","Puerto Quijarro","Esc. Samuel Lopez Mendoza",78,0,1,2,63,25,18,3,0,190,1,3,194,231,0.332,0.84
"27405","Santa Cruz","Puerto Quijarro","Esc. Samuel Lopez Mendoza",44,1,0,2,81,18,10,0,1,157,1,6,164,227,0.516,0.722
"27406","Santa Cruz","Puerto Quijarro","Esc. Samuel Lopez Mendoza",74,0,0,0,71,11,16,4,1,177,2,5,184,228,0.401,0.807
"27407","Santa Cruz","Puerto Quijarro","Esc. Samuel Lopez Mendoza",78,0,0,0,54,17,23,5,0,177,3,8,188,230,0.305,0.817
"27408","Santa Cruz","Puerto Quijarro","Esc. Samuel Lopez Mendoza",83,0,0,2,45,22,13,3,0,168,0,8,176,223,0.268,0.789
"27409","Santa Cruz","Puerto Quijarro","Esc. Samuel Lopez Mendoza",56,0,1,1,85,20,16,3,1,183,3,6,192,231,0.464,0.831
"27410","Santa Cruz","Puerto Quijarro","Esc. Samuel Lopez Mendoza",71,1,2,3,63,21,6,6,0,173,3,6,182,223,0.364,0.816
"27411","Santa Cruz","Puerto Quijarro","Esc. Samuel Lopez Mendoza",83,1,2,1,43,25,11,1,0,167,2,7,176,225,0.257,0.782
"27412","Santa Cruz","Puerto Quijarro","Esc. Samuel Lopez Mendoza",83,3,0,2,62,21,10,6,0,187,1,4,192,232,0.332,0.828
"27413","Santa Cruz","Puerto Quijarro","Esc. Samuel Lopez Mendoza",72,3,1,1,62,21,16,4,2,182,3,13,198,244,0.341,0.811
"27414","Santa Cruz","Puerto Quijarro","Esc. Mixta La Frontera",50,0,0,5,83,3,13,5,1,160,3,17,180,233,0.519,0.773
"27415","Santa Cruz","Puerto Quijarro","Esc. Mixta La Frontera",66,0,1,2,69,10,9,4,1,162,0,10,172,224,0.426,0.768
"27416","Santa Cruz","Puerto Quijarro","Esc. Mixta La Frontera",48,0,0,3,92,10,28,3,2,186,2,4,192,232,0.495,0.828
"27417","Santa Cruz","Puerto Quijarro","Esc. Mixta La Frontera",49,1,3,5,81,8,18,3,1,169,2,5,176,233,0.479,0.755
"27418","Santa Cruz","Puerto Quijarro","Esc. Mixta La Frontera",62,0,1,5,74,6,24,2,3,177,0,4,181,228,0.418,0.794
"27419","Santa Cruz","Puerto Quijarro","Esc. Mixta La Frontera",54,2,0,4,79,14,9,5,2,169,2,5,176,226,0.467,0.779
"27420","Santa Cruz","Puerto Quijarro","Esc. Mixta La Frontera",62,0,0,3,70,8,9,3,0,155,2,23,180,234,0.452,0.769
"27421","Santa Cruz","Puerto Quijarro","Esc. Mixta La Frontera",44,1,0,2,91,4,21,0,0,163,3,6,172,225,0.558,0.764
"27422","Santa Cruz","Puerto Quijarro","Esc. Mixta La Frontera",52,1,1,0,70,7,19,2,2,154,2,12,168,226,0.455,0.743
"27423","Santa Cruz","Puerto Quijarro","Esc. Mixta La Frontera",61,1,0,10,54,10,19,3,1,159,4,10,173,227,0.34,0.762
"27424","Santa Cruz","Puerto Quijarro","Esc. Mixta La Frontera",58,1,1,1,62,11,19,4,0,157,4,12,173,229,0.395,0.755
"27425","Santa Cruz","Puerto Quijarro","Esc. Mixta La Frontera",60,2,0,2,52,12,15,11,0,154,5,7,166,231,0.338,0.719
"27426","Santa Cruz","Puerto Quijarro","Esc. Mixta La Frontera",54,3,0,1,86,13,18,2,0,177,0,5,182,230,0.486,0.791
"27427","Santa Cruz","Puerto Quijarro","Esc. Mixta La Frontera",63,0,1,1,55,10,21,3,0,154,5,11,170,224,0.357,0.759
"27428","Santa Cruz","Puerto Quijarro","Esc. Mixta La Frontera",52,3,3,1,61,14,22,1,1,158,2,10,170,225,0.386,0.756
"27429","Santa Cruz","Puerto Quijarro","Esc. Mixta La Frontera",66,0,1,5,63,9,16,5,1,166,6,12,184,230,0.38,0.8
"27430","Santa Cruz","Puerto Quijarro","Esc. Mixta La Frontera",52,0,1,3,65,13,17,2,1,154,2,7,163,228,0.422,0.715
"27431","Santa Cruz","El Carmen Rivero Tórrez","Esc. Evangelica Rincon del Tigre",46,7,1,5,82,8,9,5,0,163,3,11,177,225,0.503,0.787
"27432","Santa Cruz","El Carmen Rivero Tórrez","Esc. Santa Ana",41,0,3,1,126,16,5,2,0,194,4,3,201,235,0.649,0.855
"27433","Santa Cruz","El Carmen Rivero Tórrez","Esc. Daniel Zambrana",84,1,1,1,67,14,7,10,0,185,7,10,202,231,0.362,0.874
"27434","Santa Cruz","El Carmen Rivero Tórrez","Esc. Daniel Zambrana",63,0,0,0,92,11,6,8,0,180,4,5,189,225,0.511,0.84
"27435","Santa Cruz","El Carmen Rivero Tórrez","Esc. Daniel Zambrana",77,0,2,1,64,23,2,9,0,178,5,4,187,223,0.36,0.839
"27436","Santa Cruz","El Carmen Rivero Tórrez","Esc. Daniel Zambrana",58,1,2,1,87,18,6,1,0,174,7,6,187,226,0.5,0.827
"27437","Santa Cruz","El Carmen Rivero Tórrez","Esc. Daniel Zambrana",91,0,0,0,66,11,7,6,1,182,3,7,192,231,0.363,0.831
"27438","Santa Cruz","El Carmen Rivero Tórrez","Esc. Daniel Zambrana",82,1,0,0,71,14,7,3,0,178,4,9,191,230,0.399,0.83
"27439","Santa Cruz","El Carmen Rivero Tórrez","Esc. Daniel Zambrana",76,0,1,1,84,18,6,3,0,189,4,6,199,229,0.444,0.869
"27440","Santa Cruz","El Carmen Rivero Tórrez","Esc. Daniel Zambrana",71,0,0,1,76,17,7,6,0,178,2,8,188,225,0.427,0.836
"27441","Santa Cruz","El Carmen Rivero Tórrez","Esc. Daniel Zambrana",81,0,0,6,65,14,6,18,0,190,1,7,198,227,0.342,0.872
"27442","Santa Cruz","El Carmen Rivero Tórrez","Esc. Daniel Zambrana",69,0,0,0,79,17,5,6,1,177,2,11,190,223,0.446,0.852
"27443","Santa Cruz","El Carmen Rivero Tórrez","Esc. Daniel Zambrana",66,0,0,2,80,23,2,7,0,180,3,7,190,228,0.444,0.833
"27444","Santa Cruz","Ascención de Guarayos","Esc. Ascencion Central",73,2,4,0,67,31,5,2,0,184,6,4,194,231,0.364,0.84
"27445","Santa Cruz","Ascención de Guarayos","Esc. Ascencion Central",61,1,1,2,53,49,11,2,0,180,3,11,194,225,0.294,0.862
"27446","Santa Cruz","Ascención de Guarayos","Esc. Ascencion Central",74,2,0,0,72,27,14,4,2,195,1,6,202,232,0.369,0.871
"27447","Santa Cruz","Ascención de Guarayos","Esc. Ascencion Central",50,2,1,0,90,24,13,4,1,185,0,8,193,229,0.486,0.843
"27448","Santa Cruz","Ascención de Guarayos","Esc. Ascencion Central",47,1,1,0,91,28,8,3,1,180,4,3,187,230,0.506,0.813
"27449","Santa Cruz","Ascención de Guarayos","Esc. Ascencion Central",37,0,0,0,98,32,8,1,0,176,5,7,188,227,0.557,0.828
"27450","Santa Cruz","Ascención de Guarayos","Esc. Ascencion Central",39,1,1,0,100,30,11,1,0,183,5,9,197,228,0.546,0.864
"27451","Santa Cruz","Ascención de Guarayos","Esc. Ascencion Central",65,0,1,1,80,23,15,4,0,189,1,2,192,225,0.423,0.853
"27452","Santa Cruz","Ascención de Guarayos","Esc. Ascencion Central",53,2,2,1,96,34,7,0,0,195,2,1,198,228,0.492,0.868
"27453","Santa Cruz","Ascención de Guarayos","Esc. Ascencion Central",66,0,0,1,83,25,8,1,0,184,3,6,193,227,0.451,0.85
"27454","Santa Cruz","Ascención de Guarayos","Esc. Ascencion Central",62,0,0,0,75,36,10,3,0,186,3,10,199,230,0.403,0.865
"27455","Santa Cruz","Ascención de Guarayos","Esc. Ascencion Central",47,1,0,1,80,40,12,0,0,181,5,6,192,226,0.442,0.85
"27456","Santa Cruz","Ascención de Guarayos","Esc. Ascencion Central",57,2,2,0,68,33,10,1,0,173,1,19,193,230,0.393,0.839
"27457","Santa Cruz","Ascención de Guarayos","Esc. Ascencion Central",52,1,0,0,89,28,10,1,0,181,5,13,199,229,0.492,0.869
"27458","Santa Cruz","Ascención de Guarayos","Esc. Ascencion Central",75,0,0,2,79,20,9,0,1,186,2,8,196,227,0.425,0.863
"27459","Santa Cruz","Ascención de Guarayos","Esc. Ascencion Central",72,0,0,2,64,22,13,2,2,177,3,3,183,226,0.362,0.81
"27460","Santa Cruz","Ascención de Guarayos","Esc. Ascencion Central",47,0,0,1,93,29,11,6,0,187,6,7,200,233,0.497,0.858
"27461","Santa Cruz","Ascención de Guarayos","Esc. Ascencion Central",69,0,3,0,52,54,7,6,1,192,3,5,200,236,0.271,0.847
"27462","Santa Cruz","Ascención de Guarayos","Esc. Ascencion Central",57,1,0,0,86,36,6,2,2,190,5,6,201,232,0.453,0.866
"27463","Santa Cruz","Ascención de Guarayos","Esc. Esteban Gebard",87,0,0,1,65,36,4,5,0,198,2,7,207,231,0.328,0.896
"27464","Santa Cruz","Ascención de Guarayos","Esc. Esteban Gebard",75,1,0,0,46,34,12,2,0,170,4,13,187,220,0.271,0.85
"27465","Santa Cruz","Ascención de Guarayos","Esc. Esteban Gebard",47,0,0,1,64,63,3,6,0,184,11,3,198,224,0.348,0.884
"27466","Santa Cruz","Ascención de Guarayos","Esc. Esteban Gebard",72,0,2,0,66,36,8,2,0,186,0,9,195,219,0.355,0.89
"27467","Santa Cruz","Ascención de Guarayos","Esc. Esteban Gebard",64,0,0,0,68,38,11,1,1,183,2,7,192,222,0.372,0.865
"27468","Santa Cruz","Ascención de Guarayos","Esc. Esteban Gebard",44,0,2,1,95,24,13,1,1,181,4,4,189,222,0.525,0.851
"27469","Santa Cruz","Ascención de Guarayos","Esc. Esteban Gebard",61,0,0,0,52,38,14,3,0,168,7,10,185,217,0.31,0.853
"27470","Santa Cruz","Ascención de Guarayos","Esc. Esteban Gebard",45,1,0,2,99,18,15,0,0,180,2,10,192,222,0.55,0.865
"27471","Santa Cruz","Ascención de Guarayos","Esc. Esteban Gebard",62,0,0,0,73,31,12,4,0,182,3,7,192,225,0.401,0.853
"27472","Santa Cruz","Ascención de Guarayos","Esc. Esteban Gebard",55,1,1,1,68,38,13,3,0,180,3,11,194,222,0.378,0.874
"27473","Santa Cruz","Ascención de Guarayos","Esc. Esteban Gebard",56,0,0,1,72,45,8,2,0,184,3,7,194,227,0.391,0.855
"27474","Santa Cruz","Ascención de Guarayos","Esc. Esteban Gebard",56,0,1,0,80,30,7,1,1,176,5,7,188,226,0.455,0.832
"27475","Santa Cruz","Ascención de Guarayos","Esc. Esteban Gebard",76,0,0,0,70,32,5,2,1,186,3,11,200,220,0.376,0.909
"27476","Santa Cruz","Ascención de Guarayos","Esc. Esteban Gebard",75,1,2,1,45,39,8,5,1,177,4,11,192,217,0.254,0.885
"27477","Santa Cruz","Ascención de Guarayos","Esc. Esteban Gebard",65,0,1,2,62,39,7,3,0,179,5,9,193,221,0.346,0.873
"27478","Santa Cruz","Ascención de Guarayos","Esc. Esteban Gebard",68,1,0,0,65,34,10,3,1,182,3,14,199,224,0.357,0.888
"27479","Santa Cruz","Ascención de Guarayos","Esc. Esteban Gebard",54,2,1,0,80,38,6,1,0,182,2,8,192,227,0.44,0.846
"27480","Santa Cruz","Ascención de Guarayos","Esc. Esteban Gebard",67,0,0,0,75,28,14,1,2,187,1,7,195,228,0.401,0.855
"27481","Santa Cruz","Ascención de Guarayos","Esc. Esteban Gebard",69,2,0,1,68,30,10,0,0,180,1,12,193,226,0.378,0.854
"27482","Santa Cruz","Ascención de Guarayos","Esc. Esteban Gebard",71,0,1,1,57,37,13,1,1,182,1,17,200,226,0.313,0.885
"27483","Santa Cruz","Ascención de Guarayos","Esc. Esteban Gebard",62,0,0,0,66,29,11,1,0,169,4,12,185,221,0.391,0.837
"27484","Santa Cruz","Ascención de Guarayos","Esc. Esteban Gebard",66,0,1,0,46,59,6,7,1,186,4,4,194,221,0.247,0.878
"27485","Santa Cruz","Ascención de Guarayos","Esc. Esteban Gebard",74,0,0,1,65,27,5,5,0,177,1,6,184,220,0.367,0.836
"27486","Santa Cruz","Ascención de Guarayos","Esc. Esteban Gebard",43,1,0,1,86,35,6,4,0,176,8,6,190,221,0.489,0.86
"27487","Santa Cruz","Ascención de Guarayos","Kinder Mi Dulce Hogar",54,0,0,1,95,30,12,2,0,194,3,12,209,226,0.49,0.925
"27488","Santa Cruz","Ascención de Guarayos","Kinder Mi Dulce Hogar",36,1,1,1,110,28,18,0,0,195,7,10,212,234,0.564,0.906
"27489","Santa Cruz","Ascención de Guarayos","Kinder Mi Dulce Hogar",44,1,0,0,106,36,11,0,1,199,4,11,214,232,0.533,0.922
"27490","Santa Cruz","Ascención de Guarayos","Kinder Mi Dulce Hogar",37,1,0,0,116,41,11,3,1,210,6,1,217,234,0.552,0.927
"27491","Santa Cruz","Ascención de Guarayos","Kinder Mi Dulce Hogar",46,1,1,1,103,23,23,2,0,200,4,7,211,235,0.515,0.898
"27492","Santa Cruz","Ascención de Guarayos","Kinder Mi Dulce Hogar",48,2,1,1,85,29,19,1,0,186,6,18,210,238,0.457,0.882
"27493","Santa Cruz","Ascención de Guarayos","Col. Jose Barrera",72,0,0,0,67,33,15,2,1,190,4,7,201,238,0.353,0.845
"27494","Santa Cruz","Ascención de Guarayos","Col. Jose Barrera",67,0,0,0,82,32,21,2,0,204,4,4,212,237,0.402,0.895
"27495","Santa Cruz","Ascención de Guarayos","Col. Jose Barrera",74,0,0,0,74,37,19,0,0,204,2,9,215,239,0.363,0.9
"27496","Santa Cruz","Ascención de Guarayos","Col. Jose Barrera",72,1,1,1,65,35,11,1,0,187,4,8,199,234,0.348,0.85
"27497","Santa Cruz","Ascención de Guarayos","U.E. 27 de Mayo",49,0,0,0,100,37,22,1,0,209,7,2,218,238,0.478,0.916
"27498","Santa Cruz","Ascención de Guarayos","U.E. 27 de Mayo",45,0,4,1,107,35,14,5,0,211,4,4,219,239,0.507,0.916
"27499","Santa Cruz","Ascención de Guarayos","U.E. San José Obrero",55,1,0,0,95,41,19,0,0,211,6,4,221,236,0.45,0.936
"27500","Santa Cruz","Ascención de Guarayos","Esc. San Pablo",54,0,0,1,80,45,13,0,0,193,12,2,207,235,0.415,0.881
"27501","Santa Cruz","Ascención de Guarayos","Esc. San Pablo",42,0,0,0,111,34,9,2,0,198,6,6,210,231,0.561,0.909
"27502","Santa Cruz","Ascención de Guarayos","Esc. San Pablo",31,2,0,2,100,23,3,0,0,161,3,7,171,181,0.621,0.945
"27503","Santa Cruz","Ascención de Guarayos","Esc. Santa Maria",16,1,1,0,156,6,13,2,0,195,3,4,202,226,0.8,0.894
"27504","Santa Cruz","Ascención de Guarayos","Esc. Santa Maria",23,1,1,0,136,16,21,0,0,198,3,5,206,235,0.687,0.877
"27505","Santa Cruz","Ascención de Guarayos","Esc. 6 de Abril",6,0,1,0,120,11,15,0,0,153,2,16,171,204,0.784,0.838
"27506","Santa Cruz","Ascención de Guarayos","Esc. Colonia 5 de Marzo",10,0,4,0,143,15,16,5,1,194,3,7,204,235,0.737,0.868
"27507","Santa Cruz","Ascención de Guarayos","Esc. 17 de Febrero",17,3,6,1,144,4,16,1,1,193,5,5,203,230,0.746,0.883
"27508","Santa Cruz","Urubicha","Esc. Maria De Los Angeles",55,0,0,0,82,45,2,0,2,186,4,4,194,234,0.441,0.829
"27509","Santa Cruz","Urubicha","Esc. Maria De Los Angeles",51,0,0,0,90,38,1,3,0,183,5,6,194,225,0.492,0.862
"27510","Santa Cruz","Urubicha","Esc. Maria De Los Angeles",31,1,1,0,116,35,4,0,0,188,7,1,196,231,0.617,0.848
"27511","Santa Cruz","Urubicha","Esc. Maria De Los Angeles",44,2,0,0,91,42,11,0,1,191,1,5,197,228,0.476,0.864
"27512","Santa Cruz","Urubicha","Esc. Maria De Los Angeles",37,1,1,0,102,44,3,1,1,190,8,8,206,231,0.537,0.892
"27513","Santa Cruz","Urubicha","Esc. Maria De Los Angeles",40,1,0,0,89,37,4,2,2,175,2,5,182,229,0.509,0.795
"27514","Santa Cruz","Urubicha","Esc. Maria De Los Angeles",26,0,0,0,124,40,7,1,2,200,3,2,205,231,0.62,0.887
"27515","Santa Cruz","Urubicha","Esc. Maria De Los Angeles",27,1,0,0,119,30,1,0,1,179,1,4,184,230,0.665,0.8
"27516","Santa Cruz","Urubicha","Esc. Maria De Los Angeles",33,1,0,0,85,44,4,0,0,167,5,5,177,228,0.509,0.776
"27517","Santa Cruz","Urubicha","Esc. Maria De Los Angeles",26,0,0,0,93,30,3,0,0,152,5,8,165,193,0.612,0.855
"27518","Santa Cruz","Urubicha","Esc. Nucleo Escolar Yaguaru",36,0,2,0,60,61,5,2,0,166,7,22,195,223,0.361,0.874
"27519","Santa Cruz","Urubicha","Esc. Nucleo Escolar Yaguaru",39,0,0,2,57,63,0,2,2,165,4,19,188,227,0.345,0.828
"27520","Santa Cruz","Urubicha","Esc. Nucleo Escolar Yaguaru",63,0,0,1,60,51,5,0,0,180,1,11,192,219,0.333,0.877
"27521","Santa Cruz","Urubicha","Esc. Nucleo Escolar Yaguaru",66,0,1,0,48,64,3,3,0,185,3,12,200,225,0.259,0.889
"27522","Santa Cruz","Urubicha","Esc. Nucleo Escolar Yaguaru",53,1,0,2,45,68,2,2,1,174,6,14,194,225,0.259,0.862
"27523","Santa Cruz","El Puente","Esc. Alfredo Smith",53,1,1,0,80,37,12,2,0,186,4,4,194,230,0.43,0.843
"27524","Santa Cruz","El Puente","Esc. Alfredo Smith",61,0,0,0,87,27,14,4,0,193,4,11,208,232,0.451,0.897
"27525","Santa Cruz","El Puente","Esc. Alfredo Smith",45,0,1,1,88,44,7,2,0,188,2,6,196,228,0.468,0.86
"27526","Santa Cruz","El Puente","Esc. Alfredo Smith",44,1,0,0,93,33,17,1,2,191,1,7,199,229,0.487,0.869
"27527","Santa Cruz","El Puente","Esc. Alfredo Smith",56,1,1,0,89,27,12,3,0,189,3,10,202,230,0.471,0.878
"27528","Santa Cruz","El Puente","Esc. Alfredo Smith",52,1,0,3,74,47,12,1,0,190,3,12,205,230,0.389,0.891
"27529","Santa Cruz","El Puente","Esc. Alfredo Smith",53,0,0,2,77,42,16,2,1,193,10,10,213,237,0.399,0.899
"27530","Santa Cruz","El Puente","Esc. Alfredo Smith",64,0,1,0,88,27,18,2,0,200,1,2,203,228,0.44,0.89
"27531","Santa Cruz","El Puente","Esc. Alfredo Smith",67,2,1,2,61,44,10,3,0,190,5,9,204,227,0.321,0.899
"27532","Santa Cruz","El Puente","Esc. Alfredo Smith",64,0,1,0,51,53,12,4,0,185,12,4,201,230,0.276,0.874
"27533","Santa Cruz","El Puente","Esc. Alfredo Smith",53,1,0,0,102,38,5,5,0,204,5,4,213,236,0.5,0.903
"27534","Santa Cruz","El Puente","Esc. San Jose De Yotau",32,2,0,2,126,11,13,0,3,189,1,12,202,229,0.667,0.882
"27535","Santa Cruz","El Puente","Esc. San Jose De Yotau",44,0,1,0,127,17,12,0,2,203,1,10,214,236,0.626,0.907
"27536","Santa Cruz","El Puente","Esc. San Jose De Yotau",28,1,0,1,130,13,13,0,2,188,6,6,200,227,0.691,0.881
"27537","Santa Cruz","El Puente","Esc. San Jose De Yotau",28,0,1,1,141,12,17,1,0,201,4,4,209,231,0.701,0.905
"27538","Santa Cruz","El Puente","Esc. San Jose De Yotau",34,2,0,0,136,11,8,1,3,195,6,5,206,231,0.697,0.892
"27539","Santa Cruz","El Puente","Esc. San Jose De Yotau",29,0,0,0,122,10,13,0,0,174,4,16,194,228,0.701,0.851
"27540","Santa Cruz","El Puente","Esc. 10 de Noviembre",8,3,2,0,144,6,28,0,1,192,3,3,198,229,0.75,0.865
"27541","Santa Cruz","El Puente","Esc. 10 de Noviembre",14,4,1,0,118,8,49,0,0,194,6,2,202,227,0.608,0.89
"27542","Santa Cruz","El Puente","Esc. Seccional El Carmen",15,4,0,0,116,12,27,5,0,179,9,7,195,226,0.648,0.863
"27543","Santa Cruz","El Puente","Esc. Seccional El Carmen",32,1,0,1,99,11,33,3,0,180,5,4,189,226,0.55,0.836
"27544","Santa Cruz","El Puente","Esc. U.E. Bolivar",6,0,1,0,150,5,29,1,1,193,4,6,203,226,0.777,0.898
"27545","Santa Cruz","El Puente","Esc. Corralon",7,1,0,0,160,0,15,0,1,184,0,6,190,228,0.87,0.833
"27546","Santa Cruz","El Puente","Esc. Pueblos Unidos",5,0,1,0,151,2,10,0,0,169,3,5,177,249,0.893,0.711
"27547","Santa Cruz","El Puente","Esc. Los Chacos",14,0,1,0,81,47,9,0,0,152,8,5,165,178,0.533,0.927
"27548","Santa Cruz","El Puente","Monte Sinai",3,0,2,0,193,4,12,1,0,215,1,0,216,236,0.898,0.915
"27549","Beni","Trinidad","U.E. Liceo Mario Saielly",92,0,0,1,49,43,10,4,1,200,1,2,203,229,0.245,0.886
"27550","Beni","Trinidad","U.E. Liceo Mario Saielly",88,0,0,1,46,25,20,4,0,184,0,5,189,222,0.25,0.851
"27551","Beni","Trinidad","U.E. Liceo Mario Saielly",70,0,0,0,56,33,17,1,0,177,1,9,187,216,0.316,0.866
"27552","Beni","Trinidad","U.E. Liceo Mario Saielly",89,1,0,0,49,26,12,4,2,183,3,5,191,224,0.268,0.853
"27553","Beni","Trinidad","U.E. Liceo Mario Saielly",87,0,0,0,58,22,13,4,1,185,3,2,190,222,0.314,0.856
"27554","Beni","Trinidad","U.E. Liceo Mario Saielly",77,0,1,0,56,30,22,2,1,189,1,6,196,225,0.296,0.871
"27555","Beni","Trinidad","U.E. Liceo Mario Saielly",90,0,1,0,46,40,10,2,3,192,2,3,197,224,0.24,0.879
"27556","Beni","Trinidad","U.E. Liceo Mario Saielly",90,0,1,0,59,28,13,1,3,195,1,2,198,223,0.303,0.888
"27557","Beni","Trinidad","U.E. Liceo Mario Saielly",83,0,1,1,49,33,7,1,3,178,1,4,183,207,0.275,0.884
"27558","Beni","Trinidad","U.E. Nicolas Suarez",102,0,0,1,35,30,6,3,0,177,5,3,185,220,0.198,0.841
"27559","Beni","Trinidad","U.E. Nicolas Suarez",87,2,0,1,50,31,18,7,0,196,0,2,198,224,0.255,0.884
"27560","Beni","Trinidad","U.E. Nicolas Suarez",100,0,1,3,38,27,9,3,1,182,1,3,186,215,0.209,0.865
"27561","Beni","Trinidad","U.E. Nicolas Suarez",101,0,0,0,45,30,12,1,0,189,0,0,189,223,0.238,0.848
"27562","Beni","Trinidad","U.E. Nicolas Suarez",94,1,0,0,49,20,13,0,1,178,0,5,183,214,0.275,0.855
"27563","Beni","Trinidad","U.E. Nicolas Suarez",100,0,1,0,46,31,12,1,1,192,0,4,196,219,0.24,0.895
"27564","Beni","Trinidad","U.E. Nicolas Suarez",70,0,1,0,47,36,12,1,1,168,4,8,180,211,0.28,0.853
"27565","Beni","Trinidad","U.E. Nicolas Suarez",105,0,0,0,43,16,6,4,3,177,2,1,180,219,0.243,0.822
"27566","Beni","Trinidad","U.E. Nicolas Suarez",85,0,0,0,46,41,7,4,2,185,3,4,192,223,0.249,0.861
"27567","Beni","Trinidad","U.E. Nicolas Suarez",105,0,0,0,38,25,4,6,1,179,0,5,184,215,0.212,0.856
"27568","Beni","Trinidad","U.E. Nicolas Suarez",91,0,0,0,47,30,13,6,1,188,2,5,195,227,0.25,0.859
"27569","Beni","Trinidad","U.E. Nuestra Señora de Fátima",88,0,2,0,51,29,9,2,1,182,1,7,190,224,0.28,0.848
"27570","Beni","Trinidad","U.E. Nuestra Señora de Fátima",109,1,0,0,42,30,8,3,0,193,4,10,207,227,0.218,0.912
"27571","Beni","Trinidad","U.E. Nuestra Señora de Fátima",87,1,0,0,41,29,13,3,1,175,6,8,189,218,0.234,0.867
"27572","Beni","Trinidad","U.E. Nuestra Señora de Fátima",66,0,3,0,59,28,18,2,0,176,4,6,186,225,0.335,0.827
"27573","Beni","Trinidad","U.E. Nuestra Señora de Fátima",91,0,1,0,47,27,12,4,1,183,1,7,191,220,0.257,0.868
"27574","Beni","Trinidad","U.E. Nuestra Señora de Fátima",87,0,3,0,52,27,17,3,0,189,0,6,195,222,0.275,0.878
"27575","Beni","Trinidad","U.E. Nuestra Señora de Fátima",96,0,1,0,38,21,7,1,0,164,2,4,170,207,0.232,0.821
"27576","Beni","Trinidad","U.E. Nuestra Señora de Fátima",86,0,0,0,42,32,19,2,2,183,1,9,193,228,0.23,0.846
"27577","Beni","Trinidad","U.E. Nuestra Señora de Fátima",80,0,2,0,68,24,16,0,0,190,2,0,192,223,0.358,0.861
"27578","Beni","Trinidad","U.E. Nuestra Señora de Fátima",93,0,1,0,54,20,15,2,1,186,5,3,194,228,0.29,0.851
"27579","Beni","Trinidad","U.E. Nuestra Señora de Fátima",80,1,3,1,49,29,9,7,0,179,3,8,190,222,0.274,0.856
"27580","Beni","Trinidad","U.E. Nuestra Señora de Fátima",85,0,0,2,51,28,12,4,0,182,3,6,191,220,0.28,0.868
"27581","Beni","Trinidad","U.E. Nuestra Señora de Fátima",85,0,1,0,48,25,18,3,0,180,1,4,185,218,0.267,0.849
"27582","Beni","Trinidad","U.E. Nuestra Señora de Fátima",86,0,1,0,55,33,8,5,0,188,2,3,193,225,0.293,0.858
"27583","Beni","Trinidad","U.E. Nuestra Señora de Fátima",85,0,1,1,47,30,19,4,1,188,0,2,190,223,0.25,0.852
"27584","Beni","Trinidad","U.E. Nuestra Señora de Fátima",88,0,0,0,43,28,4,3,1,167,2,12,181,225,0.257,0.804
"27585","Beni","Trinidad","U.E. Nuestra Señora de Fátima",103,0,1,1,51,18,15,4,1,194,0,1,195,224,0.263,0.871
"27586","Beni","Trinidad","U.E. Nuestra Señora de Fátima",93,0,0,0,58,28,9,5,0,193,0,2,195,227,0.301,0.859
"27587","Beni","Trinidad","U.E. Raül Monje Roca",84,0,1,0,53,44,11,6,1,200,3,1,204,230,0.265,0.887
"27588","Beni","Trinidad","U.E. Raül Monje Roca",82,1,2,2,54,25,11,3,0,180,2,4,186,219,0.3,0.849
"27589","Beni","Trinidad","U.E. Raül Monje Roca",72,0,3,1,56,49,17,2,1,201,1,3,205,228,0.279,0.899
"27590","Beni","Trinidad","U.E. Raül Monje Roca",74,0,0,1,62,35,13,0,3,188,2,4,194,232,0.33,0.836
"27591","Beni","Trinidad","U.E. Raül Monje Roca",70,1,2,1,58,41,13,6,1,193,2,3,198,230,0.301,0.861
"27592","Beni","Trinidad","U.E. Raül Monje Roca",80,0,2,0,44,32,17,3,1,179,2,6,187,217,0.246,0.862
"27593","Beni","Trinidad","U.E. Raül Monje Roca",83,1,0,0,47,35,12,9,3,190,1,6,197,222,0.247,0.887
"27594","Beni","Trinidad","U.E. Raül Monje Roca",78,0,0,0,62,33,9,7,0,189,5,3,197,229,0.328,0.86
"27595","Beni","Trinidad","U.E. Raül Monje Roca",80,0,4,1,52,35,6,1,1,180,2,5,187,213,0.289,0.878
"27596","Beni","Trinidad","U.E. Raül Monje Roca",95,1,2,0,36,33,14,1,1,183,2,3,188,225,0.197,0.836
"27597","Beni","Trinidad","U.E. Raül Monje Roca",72,0,1,2,66,26,13,5,0,185,4,7,196,222,0.357,0.883
"27598","Beni","Trinidad","U.E. Raül Monje Roca",64,0,3,0,64,30,16,4,0,181,2,2,185,207,0.354,0.894
"27599","Beni","Trinidad","U.E. J. Chavez Suarez",59,2,3,0,53,30,39,2,1,189,4,4,197,232,0.28,0.849
"27600","Beni","Trinidad","U.E. J. Chavez Suarez",51,2,1,1,62,26,30,2,0,175,1,6,182,220,0.354,0.827
"27601","Beni","Trinidad","U.E. J. Chavez Suarez",53,0,2,0,63,38,24,2,1,183,1,7,191,229,0.344,0.834
"27602","Beni","Trinidad","U.E. J. Chavez Suarez",47,0,3,2,64,28,31,4,1,180,1,9,190,230,0.356,0.826
"27603","Beni","Trinidad","U.E. J. Chavez Suarez",52,1,2,2,42,42,46,0,0,187,0,3,190,224,0.225,0.848
"27604","Beni","Trinidad","U.E. J. Chavez Suarez",48,1,0,0,83,24,26,0,0,182,2,8,192,222,0.456,0.865
"27605","Beni","Trinidad","U.E. J. Chavez Suarez",62,0,0,0,56,42,30,2,1,193,7,3,203,224,0.29,0.906
"27606","Beni","Trinidad","U.E. J. Chavez Suarez",47,0,2,0,59,32,30,4,2,176,3,5,184,221,0.335,0.833
"27607","Beni","Trinidad","U.E. J. Chavez Suarez",58,1,4,0,59,44,16,2,3,187,1,7,195,228,0.316,0.855
"27608","Beni","Trinidad","U.E. J. Chavez Suarez",53,1,0,1,66,35,31,2,4,193,3,3,199,224,0.342,0.888
"27609","Beni","Trinidad","U.E. J. Chavez Suarez",52,1,2,0,56,44,16,4,2,177,6,4,187,224,0.316,0.835
"27610","Beni","Trinidad","U.E. J. Chavez Suarez",56,1,2,0,77,25,18,1,1,181,0,2,183,221,0.425,0.828
"27611","Beni","Trinidad","U.E. J. Chavez Suarez",49,2,2,1,57,30,39,4,5,189,3,3,195,226,0.302,0.863
"27612","Beni","Trinidad","U.E. J. Chavez Suarez",56,0,2,1,59,22,27,3,1,171,3,11,185,225,0.345,0.822
"27613","Beni","Trinidad","U.E. J. Chavez Suarez",55,1,1,1,58,45,21,2,3,187,1,4,192,227,0.31,0.846
"27614","Beni","Trinidad","U.E. J. Chavez Suarez",48,0,2,0,70,40,25,3,0,188,5,10,203,224,0.372,0.906
"27615","Beni","Trinidad","U.E. J. Chavez Suarez",42,0,0,0,58,40,29,6,1,176,6,6,188,217,0.33,0.866
"27616","Beni","Trinidad","U.E. J. Chavez Suarez",55,0,1,1,62,34,23,1,1,178,2,8,188,220,0.348,0.855
"27617","Beni","Trinidad","U.E. J. Chavez Suarez",57,1,0,3,48,52,23,1,2,187,7,4,198,224,0.257,0.884
"27618","Beni","Trinidad","U.E. J. Chavez Suarez",46,0,4,0,85,17,25,2,1,180,1,6,187,228,0.472,0.82
"27619","Beni","Trinidad","U.E. J. Chavez Suarez",65,0,2,1,50,48,15,1,2,184,3,6,193,226,0.272,0.854
"27620","Beni","Trinidad","U.E. J. Chavez Suarez",62,2,1,0,56,35,17,2,2,177,3,20,200,231,0.316,0.866
"27621","Beni","Trinidad","U.E. J. Chavez Suarez",68,0,3,1,71,35,13,0,0,191,2,5,198,229,0.372,0.865
"27622","Beni","Trinidad","U.E. J. Chavez Suarez",65,0,1,0,50,39,19,0,1,175,4,7,186,221,0.286,0.842
"27623","Beni","Trinidad","U.E. J. Chavez Suarez",58,0,1,1,49,54,22,2,1,188,3,3,194,222,0.261,0.874
"27624","Beni","Trinidad","U.E. J. Chavez Suarez",48,0,0,0,62,50,15,1,2,178,2,2,182,228,0.348,0.798
"27625","Beni","Trinidad","U.E. J. Chavez Suarez",57,1,1,0,58,54,23,2,0,196,3,4,203,224,0.296,0.906
"27626","Beni","Trinidad","U.E. J. Chavez Suarez",46,0,3,2,59,28,20,8,2,168,3,6,177,210,0.351,0.843
"27627","Beni","Trinidad","U.E. 4 De  Febrero",48,0,4,0,76,27,12,5,1,173,3,10,186,219,0.439,0.849
"27628","Beni","Trinidad","U.E. 4 De  Febrero",61,0,0,0,58,34,25,1,1,180,1,7,188,224,0.322,0.839
"27629","Beni","Trinidad","U.E. 4 De  Febrero",59,0,2,0,72,33,17,2,2,187,2,6,195,227,0.385,0.859
"27630","Beni","Trinidad","U.E. 4 De  Febrero",70,1,1,4,66,28,14,2,1,187,4,7,198,227,0.353,0.872
"27631","Beni","Trinidad","U.E. 4 De  Febrero",31,0,4,1,77,20,35,3,0,171,4,2,177,218,0.45,0.812
"27632","Beni","Trinidad","U.E. 4 De  Febrero",56,1,0,1,61,43,9,1,0,172,8,8,188,218,0.355,0.862
"27633","Beni","Trinidad","U.E. 4 De  Febrero",59,0,1,3,65,30,13,3,1,175,3,12,190,219,0.371,0.868
"27634","Beni","Trinidad","U.E. 4 De  Febrero",48,4,1,0,63,31,22,6,3,178,5,10,193,225,0.354,0.858
"27635","Beni","Trinidad","U.E. 4 De  Febrero",46,1,3,2,70,25,20,3,2,172,6,7,185,220,0.407,0.841
"27636","Beni","Trinidad","U.E. 4 De  Febrero",49,1,3,0,73,23,31,4,4,188,1,3,192,225,0.388,0.853
"27637","Beni","Trinidad","U.E. 4 De  Febrero",63,1,0,0,56,40,17,1,2,180,5,9,194,229,0.311,0.847
"27638","Beni","Trinidad","U.E. 4 De  Febrero",39,0,1,1,68,53,15,4,1,182,4,17,203,224,0.374,0.906
"27639","Beni","Trinidad","U.E. 4 De  Febrero",50,0,1,1,52,59,22,4,0,189,5,8,202,228,0.275,0.886
"27640","Beni","Trinidad","U.E. 4 De  Febrero",62,2,3,1,50,35,27,8,1,189,4,5,198,229,0.265,0.865
"27641","Beni","Trinidad","U.E. 4 De  Febrero",60,1,1,1,62,34,14,5,0,178,2,8,188,219,0.348,0.858
"27642","Beni","Trinidad","U.E. 4 De  Febrero",61,0,2,0,52,41,13,4,3,176,5,11,192,228,0.295,0.842
"27643","Beni","Trinidad","U.E. 4 De  Febrero",59,0,1,0,58,44,20,2,0,184,6,6,196,225,0.315,0.871
"27644","Beni","Trinidad","U.E. 4 De  Febrero",49,2,0,1,57,49,12,3,1,174,10,4,188,222,0.328,0.847
"27645","Beni","Trinidad","U.E. 4 De  Febrero",60,0,1,1,46,37,24,8,0,177,3,6,186,222,0.26,0.838
"27646","Beni","Trinidad","U.E. 4 De  Febrero",50,1,1,2,64,38,21,2,2,181,6,6,193,226,0.354,0.854
"27647","Beni","Trinidad","U.E. Corina Hurtado De",66,1,1,0,65,37,19,9,0,198,3,4,205,229,0.328,0.895
"27648","Beni","Trinidad","U.E. Corina Hurtado De",40,1,1,1,76,34,29,2,1,185,4,2,191,220,0.411,0.868
"27649","Beni","Trinidad","U.E. Corina Hurtado De",61,0,1,3,61,41,23,3,2,195,3,9,207,231,0.313,0.896
"27650","Beni","Trinidad","U.E. Corina Hurtado De",48,0,2,1,71,33,23,2,2,182,6,6,194,227,0.39,0.855
"27651","Beni","Trinidad","U.E. Corina Hurtado De",55,0,1,1,55,43,30,3,1,189,3,6,198,225,0.291,0.88
"27652","Beni","Trinidad","U.E. Corina Hurtado De",56,0,2,1,57,42,18,2,0,178,3,3,184,221,0.32,0.833
"27653","Beni","Trinidad","U.E. Corina Hurtado De",29,0,3,1,64,47,28,3,1,176,6,5,187,227,0.364,0.824
"27654","Beni","Trinidad","U.E. Corina Hurtado De",65,1,2,0,52,46,25,4,3,198,3,5,206,225,0.263,0.916
"27655","Beni","Trinidad","U.E. Corina Hurtado De",50,0,0,3,52,63,16,2,0,186,6,8,200,224,0.28,0.893
"27656","Beni","Trinidad","U.E. Corina Hurtado De",43,1,1,0,66,50,28,1,3,193,0,3,196,221,0.342,0.887
"27657","Beni","Trinidad","U.E. Corina Hurtado De",55,0,3,0,58,47,14,6,2,185,2,10,197,223,0.314,0.883
"27658","Beni","Trinidad","U.E. Corina Hurtado De",42,1,1,0,59,47,22,6,1,179,3,8,190,222,0.33,0.856
"27659","Beni","Trinidad","U.E. Corina Hurtado De",57,3,0,1,74,35,17,7,2,196,4,2,202,228,0.378,0.886
"27660","Beni","Trinidad","U.E. Corina Hurtado De",38,0,3,2,79,45,16,8,0,191,3,5,199,222,0.414,0.896
"27661","Beni","Trinidad","U.E. Gonzalo Suarez D.",42,0,1,1,76,34,32,3,0,189,3,7,199,237,0.402,0.84
"27662","Beni","Trinidad","U.E. Gonzalo Suarez D.",42,2,1,0,68,44,30,3,2,192,5,2,199,232,0.354,0.858
"27663","Beni","Trinidad","U.E. Gonzalo Suarez D.",47,0,0,1,72,46,25,3,2,196,3,5,204,234,0.367,0.872
"27664","Beni","Trinidad","U.E. San Vicente",74,1,5,1,39,40,7,5,0,172,5,3,180,218,0.227,0.826
"27665","Beni","Trinidad","U.E. San Vicente",80,0,0,1,46,44,11,2,1,185,0,10,195,228,0.249,0.855
"27666","Beni","Trinidad","U.E. San Vicente",77,1,0,0,59,37,14,3,0,191,2,4,197,223,0.309,0.883
"27667","Beni","Trinidad","U.E. San Vicente",74,0,0,0,63,33,12,5,0,187,3,3,193,221,0.337,0.873
"27668","Beni","Trinidad","U.E. San Vicente",71,0,2,0,69,32,12,2,0,188,4,3,195,227,0.367,0.859
"27669","Beni","Trinidad","U.E. San Vicente",83,1,1,0,55,42,8,4,1,195,1,3,199,228,0.282,0.873
"27670","Beni","Trinidad","U.E. San Vicente",74,0,0,1,49,42,14,1,1,182,4,3,189,220,0.269,0.859
"27671","Beni","Trinidad","U.E. San Vicente",69,1,0,2,57,33,13,1,0,176,3,2,181,221,0.324,0.819
"27672","Beni","Trinidad","U.E. San Vicente",75,1,2,0,47,53,10,4,1,193,1,8,202,227,0.244,0.89
"27673","Beni","Trinidad","U.E. San Vicente",74,2,0,0,58,39,8,5,0,186,2,6,194,227,0.312,0.855
"27674","Beni","Trinidad","U.E. San Vicente",83,0,0,0,56,39,12,0,1,191,4,3,198,227,0.293,0.872
"27675","Beni","Trinidad","U.E. San Vicente",78,0,1,0,47,34,14,3,2,179,4,4,187,222,0.263,0.842
"27676","Beni","Trinidad","U.E. San Vicente",71,0,1,0,53,41,9,3,1,179,2,8,189,220,0.296,0.859
"27677","Beni","Trinidad","U.E. San Vicente",68,0,0,1,76,28,7,3,0,183,5,3,191,225,0.415,0.849
"27678","Beni","Trinidad","U.E. San Vicente",80,0,1,0,39,49,12,5,1,187,4,5,196,224,0.209,0.875
"27679","Beni","Trinidad","U.E. San Vicente",78,0,0,0,52,40,14,5,0,189,1,2,192,225,0.275,0.853
"27680","Beni","Trinidad","U.E. San Vicente",61,1,2,0,70,50,9,9,0,202,3,3,208,223,0.347,0.933
"27681","Beni","Trinidad","U.A.B. (Carrera de Derecho)",81,0,0,0,45,44,12,2,1,185,3,8,196,222,0.243,0.883
"27682","Beni","Trinidad","U.A.B. (Carrera de Derecho)",100,0,0,1,46,25,16,5,0,193,4,4,201,223,0.238,0.901
"27683","Beni","Trinidad","U.A.B. (Carrera de Derecho)",80,3,0,0,58,26,10,3,1,181,1,5,187,227,0.32,0.824
"27684","Beni","Trinidad","U.A.B. (Carrera de Derecho)",76,0,0,0,51,38,14,2,0,181,6,4,191,220,0.282,0.868
"27685","Beni","Trinidad","U.A.B. (Carrera de Derecho)",78,1,1,0,49,36,14,5,1,185,4,3,192,225,0.265,0.853
"27686","Beni","Trinidad","U.A.B. (Carrera de Derecho)",73,0,0,0,55,26,13,4,1,172,3,4,179,213,0.32,0.84
"27687","Beni","Trinidad","U.A.B. (Carrera de Derecho)",81,0,1,1,43,43,16,2,0,187,2,4,193,226,0.23,0.854
"27688","Beni","Trinidad","U.A.B. (Carrera de Derecho)",89,0,1,0,47,36,11,4,0,188,4,4,196,230,0.25,0.852
"27689","Beni","Trinidad","U.A.B. (Carrera de Derecho)",90,0,0,2,54,37,9,1,2,195,3,3,201,223,0.277,0.901
"27690","Beni","Trinidad","U.A.B. (Carrera de Derecho)",87,0,1,0,53,35,12,5,0,193,3,2,198,226,0.275,0.876
"27691","Beni","Trinidad","U.A.B. (Carrera de Derecho)",91,0,2,0,55,36,8,3,1,196,0,1,197,224,0.281,0.879
"27692","Beni","Trinidad","U.A.B. (Carrera de Derecho)",91,1,1,0,44,33,11,5,0,186,5,5,196,225,0.237,0.871
"27693","Beni","Trinidad","U.A.B. (Carrera de Derecho)",66,1,1,1,59,44,10,2,1,185,3,8,196,227,0.319,0.863
"27694","Beni","Trinidad","U.E. Pedro Ignacio Muiba",56,0,0,0,56,41,13,7,2,175,2,5,182,225,0.32,0.809
"27695","Beni","Trinidad","U.E. Pedro Ignacio Muiba",54,0,0,0,59,39,17,5,2,176,2,7,185,220,0.335,0.841
"27696","Beni","Trinidad","U.E. Pedro Ignacio Muiba",58,1,1,1,65,38,23,2,2,191,3,4,198,224,0.34,0.884
"27697","Beni","Trinidad","U.E. Pedro Ignacio Muiba",51,1,1,0,70,35,18,3,2,181,2,6,189,225,0.387,0.84
"27698","Beni","Trinidad","U.E. Pedro Ignacio Muiba",67,1,1,0,49,47,17,1,5,188,5,6,199,226,0.261,0.881
"27699","Beni","Trinidad","U.E. Pedro Ignacio Muiba",60,0,0,2,50,40,18,3,0,173,5,9,187,214,0.289,0.874
"27700","Beni","Trinidad","U.E. Pedro Ignacio Muiba",42,1,2,2,54,59,17,2,0,179,8,11,198,221,0.302,0.896
"27701","Beni","Trinidad","U.E. Pedro Ignacio Muiba",68,2,0,1,45,47,17,7,0,187,6,1,194,223,0.241,0.87
"27702","Beni","Trinidad","U.E. Pedro Ignacio Muiba",68,1,1,1,68,27,15,2,3,186,4,4,194,230,0.366,0.843
"27703","Beni","Trinidad","U.E. Pedro Ignacio Muiba",64,0,1,0,63,37,14,2,0,181,4,6,191,220,0.348,0.868
"27704","Beni","Trinidad","U.E. Pedro Ignacio Muiba",60,1,0,0,54,39,11,11,0,176,4,13,193,225,0.307,0.858
"27705","Beni","Trinidad","U.E. Pedro Ignacio Muiba",53,1,3,1,52,58,14,3,2,187,5,6,198,226,0.278,0.876
"27706","Beni","Trinidad","U.E. Pedro Ignacio Muiba",53,1,0,2,50,46,25,3,3,183,8,0,191,222,0.273,0.86
"27707","Beni","Trinidad","U.E. San Antonio",95,1,1,0,44,36,8,0,0,185,1,6,192,225,0.238,0.853
"27708","Beni","Trinidad","U.E. San Antonio",64,0,1,0,57,46,17,6,1,192,2,6,200,228,0.297,0.877
"27709","Beni","Trinidad","U.E. San Antonio",76,0,0,0,55,40,9,4,0,184,4,9,197,218,0.299,0.904
"27710","Beni","Trinidad","U.E. San Antonio",79,0,0,1,51,32,17,6,0,186,2,5,193,224,0.274,0.862
"27711","Beni","Trinidad","U.E. San Antonio",63,2,1,1,47,44,12,3,0,173,5,7,185,221,0.272,0.837
"27712","Beni","Trinidad","U.E. San Antonio",80,0,1,0,51,36,14,2,1,185,3,6,194,229,0.276,0.847
"27713","Beni","Trinidad","U.E. San Antonio",61,0,0,0,57,37,13,9,0,177,2,8,187,220,0.322,0.85
"27714","Beni","Trinidad","U.E. San Antonio",65,0,0,0,68,27,17,7,0,184,6,3,193,225,0.37,0.858
"27715","Beni","Trinidad","U.E. San Antonio",88,0,0,1,47,47,10,1,0,194,2,4,200,223,0.242,0.897
"27716","Beni","Trinidad","U.E. San Antonio",76,1,1,0,48,49,14,3,1,193,5,6,204,227,0.249,0.899
"27717","Beni","Trinidad","U.E. San Antonio",70,0,0,0,44,48,13,0,1,176,0,7,183,220,0.25,0.832
"27718","Beni","Trinidad","U.E. San Antonio",69,0,1,0,63,45,17,5,0,200,2,3,205,229,0.315,0.895
"27719","Beni","Trinidad","U.E. San Antonio",81,0,2,0,46,44,9,3,0,185,2,6,193,219,0.249,0.881
"27720","Beni","Trinidad","U.E. San Antonio",60,0,0,1,59,41,10,5,0,176,3,20,199,232,0.335,0.858
"27721","Beni","Trinidad","U.E. San Antonio",88,0,0,0,49,41,18,3,0,199,3,3,205,230,0.246,0.891
"27722","Beni","Trinidad","U.E. San Antonio",65,0,1,0,61,38,8,2,2,177,2,4,183,219,0.345,0.836
"27723","Beni","Trinidad","U.E. San Antonio",79,0,1,0,53,51,12,6,0,202,0,6,208,228,0.262,0.912
"27724","Beni","Trinidad","U.E. Mangalito",44,0,0,1,59,48,18,2,2,174,9,7,190,225,0.339,0.844
"27725","Beni","Trinidad","U.E. Mangalito",42,0,2,0,79,41,18,1,2,185,5,4,194,230,0.427,0.843
"27726","Beni","Trinidad","U.E. Mangalito",50,1,1,0,66,44,16,4,1,183,8,4,195,224,0.361,0.871
"27727","Beni","Trinidad","U.E. Mangalito",46,2,1,0,74,42,15,3,0,183,3,8,194,228,0.404,0.851
"27728","Beni","Trinidad","U.E. Mangalito",39,2,0,0,75,41,24,3,3,187,10,3,200,226,0.401,0.885
"27729","Beni","Trinidad","U.E. Mangalito",26,1,1,2,82,40,16,0,1,169,8,2,179,222,0.485,0.806
"27730","Beni","Trinidad","U.E. Mangalito",44,0,2,1,64,44,18,6,0,179,6,4,189,229,0.358,0.825
"27731","Beni","Trinidad","U.E. Mangalito",54,2,0,0,52,47,11,4,0,170,4,18,192,223,0.306,0.861
"27732","Beni","Trinidad","U.E. Mangalito",52,1,0,2,66,39,16,4,0,180,5,4,189,217,0.367,0.871
"27733","Beni","Trinidad","U.E. Orlando Monasterio Claure",66,0,2,0,80,48,13,3,0,212,1,6,219,234,0.377,0.936
"27734","Beni","Trinidad","U.E. Orlando Monasterio Claure",29,1,0,1,76,51,13,2,0,173,0,1,174,181,0.439,0.961
"27735","Beni","Trinidad","U.E. 15 de Agosto",50,0,0,1,65,57,16,2,4,195,5,6,206,235,0.333,0.877
"27736","Beni","Trinidad","U.E. 15 de Agosto",35,1,2,0,71,57,23,2,3,194,5,4,203,236,0.366,0.86
"27737","Beni","Trinidad","U.E. 15 de Agosto",53,1,2,0,67,39,19,4,2,187,8,10,205,231,0.358,0.887
"27738","Beni","Trinidad","U.E. 15 de Agosto",53,0,3,0,75,49,9,3,3,195,9,8,212,236,0.385,0.898
"27739","Beni","Trinidad","U.E. 15 de Agosto",46,1,1,0,70,54,13,5,2,192,6,7,205,234,0.365,0.876
"27740","Beni","Trinidad","U.E. 15 de Agosto",54,0,0,1,74,46,14,4,0,193,13,6,212,232,0.383,0.914
"27741","Beni","Trinidad","U.E. 15 de Agosto",34,1,2,0,72,55,17,3,3,187,11,9,207,232,0.385,0.892
"27742","Beni","Trinidad","U.E. Luis Espinal Cams",40,2,2,0,70,54,23,4,1,196,6,12,214,237,0.357,0.903
"27743","Beni","Trinidad","U.E. Luis Espinal Cams",32,0,1,0,73,47,20,6,2,181,7,14,202,235,0.403,0.86
"27744","Beni","Trinidad","U.E. Luis Espinal Cams",38,0,1,1,68,43,19,3,1,174,11,15,200,234,0.391,0.855
"27745","Beni","Trinidad","U.E. Luis Espinal Cams",34,1,1,0,76,56,20,2,2,192,8,10,210,237,0.396,0.886
"27746","Beni","Trinidad","U.E. Luis Espinal Cams",42,1,1,4,78,43,28,6,0,203,2,8,213,237,0.384,0.899
"27747","Beni","Trinidad","U.E. Luis Espinal Cams",29,3,2,1,82,37,33,4,0,191,9,10,210,235,0.429,0.894
"27748","Beni","Trinidad","U.E. Luis Espinal Cams",25,1,1,2,90,53,16,5,2,195,11,7,213,235,0.462,0.906
"27749","Beni","Trinidad","U.E. Luis Espinal Cams",27,2,2,1,90,42,18,10,1,193,5,6,204,236,0.466,0.864
"27750","Beni","Trinidad","U.E. Luis Espinal Cams",42,0,0,1,66,61,16,6,0,192,8,3,203,233,0.344,0.871
"27751","Beni","Trinidad","U.E. Luis Espinal Cams",39,0,1,1,81,52,21,3,1,199,3,2,204,234,0.407,0.872
"27752","Beni","Trinidad","U.E. J. Lorenzo Campero",103,1,0,1,40,23,12,5,0,185,5,1,191,225,0.216,0.849
"27753","Beni","Trinidad","U.E. J. Lorenzo Campero",80,1,0,1,57,35,14,2,0,190,0,7,197,221,0.3,0.891
"27754","Beni","Trinidad","U.E. J. Lorenzo Campero",85,2,2,0,55,24,18,3,4,193,3,4,200,225,0.285,0.889
"27755","Beni","Trinidad","U.E. J. Lorenzo Campero",89,1,1,1,47,38,12,3,0,192,0,3,195,226,0.245,0.863
"27756","Beni","Trinidad","U.E. J. Lorenzo Campero",91,0,3,0,46,32,8,5,0,185,3,1,189,223,0.249,0.848
"27757","Beni","Trinidad","U.E. J. Lorenzo Campero",85,1,1,1,45,33,12,2,0,180,1,8,189,219,0.25,0.863
"27758","Beni","Trinidad","U.E. J. Lorenzo Campero",97,1,1,0,46,35,9,5,0,194,1,2,197,219,0.237,0.9
"27759","Beni","Trinidad","U.E. La Salle",100,1,4,0,44,21,12,5,0,187,0,0,187,221,0.235,0.846
"27760","Beni","Trinidad","U.E. La Salle",91,0,0,0,42,43,10,3,1,190,0,9,199,225,0.221,0.884
"27761","Beni","Trinidad","U.E. La Salle",92,1,0,1,50,28,12,1,1,186,2,7,195,226,0.269,0.863
"27762","Beni","Trinidad","U.E. La Salle",101,0,1,4,48,24,10,4,0,192,1,8,201,229,0.25,0.878
"27763","Beni","Trinidad","U.E. La Salle",98,0,0,0,59,27,12,1,0,197,0,2,199,229,0.299,0.869
"27764","Beni","Trinidad","U.E. La Salle",89,0,0,0,45,25,19,2,0,180,1,6,187,225,0.25,0.831
"27765","Beni","Trinidad","U.E. La Salle",90,0,0,0,49,27,11,6,3,186,4,5,195,224,0.263,0.871
"27766","Beni","Trinidad","U.E. La Salle",112,1,1,0,39,29,11,2,0,195,1,4,200,227,0.2,0.881
"27767","Beni","Trinidad","U.E. La Salle",86,0,0,0,36,20,6,3,0,151,1,4,156,175,0.238,0.891
"27768","Beni","Trinidad","U.E. Hormando Ortiz Chávez",93,0,1,0,41,40,11,3,0,189,5,4,198,223,0.217,0.888
"27769","Beni","Trinidad","U.E. Hormando Ortiz Chávez",99,0,0,0,46,28,3,2,1,179,0,3,182,223,0.257,0.816
"27770","Beni","Trinidad","U.E. Hormando Ortiz Chávez",109,0,0,1,47,26,10,3,0,196,2,5,203,225,0.24,0.902
"27771","Beni","Trinidad","U.E. Hormando Ortiz Chávez",95,3,0,1,40,37,8,3,0,187,0,3,190,222,0.214,0.856
"27772","Beni","Trinidad","U.E. Hormando Ortiz Chávez",107,0,1,0,47,26,8,1,0,190,1,3,194,225,0.247,0.862
"27773","Beni","Trinidad","U.E. Hormando Ortiz Chávez",102,0,0,1,35,46,11,1,0,196,2,2,200,228,0.179,0.877
"27774","Beni","Trinidad","U.E.  Emilio Campos Pedriel",84,0,0,1,56,35,24,2,1,203,4,3,210,231,0.276,0.909
"27775","Beni","Trinidad","U.E.  Emilio Campos Pedriel",90,0,1,2,40,42,18,0,1,194,4,4,202,233,0.206,0.867
"27776","Beni","Trinidad","U.E.  Emilio Campos Pedriel",78,1,1,3,54,35,19,3,1,195,3,7,205,227,0.277,0.903
"27777","Beni","Trinidad","U.E.  Emilio Campos Pedriel",78,0,1,1,67,27,12,6,0,192,0,5,197,226,0.349,0.872
"27778","Beni","Trinidad","U.E.  Emilio Campos Pedriel",79,1,0,1,58,35,17,3,0,194,4,2,200,223,0.299,0.897
"27779","Beni","Trinidad","U.E.  Emilio Campos Pedriel",76,2,3,1,57,37,22,2,2,202,2,5,209,230,0.282,0.909
"27780","Beni","Trinidad","U.E.  Emilio Campos Pedriel",82,0,2,0,46,57,7,4,0,198,0,8,206,228,0.232,0.904
"27781","Beni","Trinidad","U.E.  Emilio Campos Pedriel",75,0,0,0,63,50,16,2,0,206,3,5,214,228,0.306,0.939
"27782","Beni","Trinidad","U.E.  Emilio Campos Pedriel",77,0,4,1,53,32,20,4,0,191,2,5,198,227,0.277,0.872
"27783","Beni","Trinidad","U.E.  Emilio Campos Pedriel",79,0,1,3,45,41,19,5,0,193,2,8,203,228,0.233,0.89
"27784","Beni","Trinidad","U.E.  Emilio Campos Pedriel",77,0,0,1,54,46,13,3,0,194,1,9,204,226,0.278,0.903
"27785","Beni","Trinidad","U.E.  Emilio Campos Pedriel",79,2,0,0,53,41,14,2,0,191,2,5,198,224,0.277,0.884
"27786","Beni","Trinidad","U.E. J.Azurduy De Padilla",84,0,0,1,59,32,15,5,0,196,2,1,199,226,0.301,0.881
"27787","Beni","Trinidad","U.E. J.Azurduy De Padilla",81,0,1,2,59,32,16,2,0,193,0,8,201,224,0.306,0.897
"27788","Beni","Trinidad","U.E. J.Azurduy De Padilla",78,1,0,0,70,24,12,5,1,191,4,5,200,230,0.366,0.87
"27789","Beni","Trinidad","U.E. J.Azurduy De Padilla",106,0,2,0,47,24,15,3,1,198,1,10,209,225,0.237,0.929
"27790","Beni","Trinidad","U.E. J.Azurduy De Padilla",94,1,0,0,59,28,9,3,0,194,0,2,196,224,0.304,0.875
"27791","Beni","Trinidad","U.E. J.Azurduy De Padilla",76,0,2,2,62,34,19,3,0,198,2,5,205,232,0.313,0.884
"27792","Beni","Trinidad","U.E. J.Azurduy De Padilla",100,0,0,0,52,31,9,3,0,195,4,4,203,229,0.267,0.886
"27793","Beni","Trinidad","U.E. J.Azurduy De Padilla",103,0,2,0,35,40,10,4,0,194,1,5,200,222,0.18,0.901
"27794","Beni","Trinidad","U.E. J.Azurduy De Padilla",96,0,1,1,51,31,19,2,0,201,1,2,204,230,0.254,0.887
"27795","Beni","Trinidad","U.E. San Francisco De Asís",102,0,2,0,44,23,20,2,0,193,3,1,197,223,0.228,0.883
"27796","Beni","Trinidad","U.E. San Francisco De Asís",92,0,1,1,51,29,13,4,0,191,0,2,193,217,0.267,0.889
"27797","Beni","Trinidad","U.E. San Francisco De Asís",96,1,0,0,45,37,10,2,0,191,2,4,197,223,0.236,0.883
"27798","Beni","Trinidad","U.E. San Francisco De Asís",72,0,1,1,46,32,8,3,0,163,0,3,166,191,0.282,0.869
"27799","Beni","Trinidad","U.E.  13 de Abril",61,2,1,0,55,39,16,1,2,177,10,8,195,222,0.311,0.878
"27800","Beni","Trinidad","U.E.  13 de Abril",55,0,2,1,59,46,14,4,0,181,0,8,189,232,0.326,0.815
"27801","Beni","Trinidad","U.E.  13 de Abril",41,0,2,0,66,53,18,6,5,191,9,6,206,234,0.346,0.88
"27802","Beni","Trinidad","U.E.  13 de Abril",44,1,0,4,67,50,19,7,1,193,1,4,198,226,0.347,0.876
"27803","Beni","Trinidad","U.E.  13 de Abril",50,0,0,0,75,40,16,4,1,186,3,10,199,230,0.403,0.865
"27804","Beni","Trinidad","U.E.  13 de Abril",51,0,3,0,64,44,15,2,1,180,6,10,196,231,0.356,0.848
"27805","Beni","Trinidad","U.E.  13 de Abril",54,0,0,2,75,49,15,6,1,202,4,7,213,235,0.371,0.906
"27806","Beni","Trinidad","U.E.  13 de Abril",57,2,2,0,47,50,21,7,0,186,5,7,198,228,0.253,0.868
"27807","Beni","Trinidad","U.E.  13 de Abril",61,0,3,0,73,35,19,1,0,192,5,7,204,231,0.38,0.883
"27808","Beni","Trinidad","U.E.  13 de Abril",51,0,1,0,77,53,15,0,3,200,3,6,209,230,0.385,0.909
"27809","Beni","Trinidad","U.E.  13 de Abril",48,0,2,0,65,37,29,2,2,185,5,11,201,228,0.351,0.882
"27810","Beni","Trinidad","U.E.  13 de Abril",57,3,1,1,73,36,21,2,1,195,4,8,207,235,0.374,0.881
"27811","Beni","Trinidad","U.E.  13 de Abril",42,0,0,1,64,53,30,8,0,198,5,3,206,234,0.323,0.88
"27812","Beni","Trinidad","U.E.  13 de Abril",73,0,0,0,52,49,18,4,0,196,3,7,206,224,0.265,0.92
"27813","Beni","Trinidad","U.E.  13 de Abril",61,0,3,0,67,46,9,1,0,187,4,10,201,233,0.358,0.863
"27814","Beni","Trinidad","U.E.  Nueva Trinidad",61,0,1,0,57,42,20,2,1,184,4,4,192,227,0.31,0.846
"27815","Beni","Trinidad","U.E.  Nueva Trinidad",63,2,4,1,48,59,21,3,2,203,3,5,211,231,0.236,0.913
"27816","Beni","Trinidad","U.E.  Nueva Trinidad",46,0,1,0,59,48,21,5,0,180,3,7,190,228,0.328,0.833
"27817","Beni","Trinidad","U.E.  Nueva Trinidad",46,1,0,0,81,27,26,3,2,186,6,5,197,228,0.435,0.864
"27818","Beni","Trinidad","U.E.  Nueva Trinidad",44,0,2,2,78,50,15,1,0,192,1,5,198,225,0.406,0.88
"27819","Beni","Trinidad","U.E.  Nueva Trinidad",51,0,0,0,76,40,20,2,2,191,3,6,200,227,0.398,0.881
"27820","Beni","Trinidad","U.E.  Nueva Trinidad",46,0,0,0,80,33,16,3,0,178,6,1,185,230,0.449,0.804
"27821","Beni","Trinidad","U.E.  Nueva Trinidad",44,0,0,0,58,52,22,4,0,180,1,4,185,230,0.322,0.804
"27822","Beni","Trinidad","U.E.  Nueva Trinidad",70,0,2,0,61,37,18,2,0,190,5,6,201,233,0.321,0.863
"27823","Beni","Trinidad","U.E.  Nueva Trinidad",39,0,1,1,79,38,22,3,2,185,5,6,196,231,0.427,0.848
"27824","Beni","Trinidad","U.E.  Nueva Trinidad",53,0,4,2,62,35,14,6,1,177,8,7,192,225,0.35,0.853
"27825","Beni","Trinidad","U.E.  Nueva Trinidad",43,2,3,1,74,43,25,1,0,192,1,10,203,232,0.385,0.875
"27826","Beni","Trinidad","U.E.  Nueva Trinidad",45,0,2,1,70,40,22,3,4,187,4,7,198,225,0.374,0.88
"27827","Beni","Trinidad","U.E.  Nueva Trinidad",61,0,0,0,54,52,18,4,2,191,3,5,199,232,0.283,0.858
"27828","Beni","Trinidad","U.E.  Nueva Trinidad",52,1,0,1,66,45,18,3,2,188,1,6,195,231,0.351,0.844
"27829","Beni","Trinidad","U.E.  Nueva Trinidad",50,1,2,0,58,53,18,4,2,188,4,2,194,231,0.309,0.84
"27830","Beni","Trinidad","U.E.  Nueva Trinidad",53,2,1,1,48,65,10,6,1,187,3,4,194,226,0.257,0.858
"27831","Beni","Trinidad","U.E.  Nueva Trinidad",58,1,1,2,48,50,22,3,0,185,1,5,191,229,0.259,0.834
"27832","Beni","Trinidad","U.E.  Nueva Trinidad",45,1,0,0,61,43,19,1,2,172,5,13,190,230,0.355,0.826
"27833","Beni","Trinidad","U.E.  Nueva Trinidad",48,0,1,0,56,44,24,2,1,176,2,19,197,232,0.318,0.849
"27834","Beni","Trinidad","U.E.  Nueva Trinidad",40,0,1,1,51,42,20,0,1,156,2,14,172,207,0.327,0.831
"27835","Beni","Trinidad","U.E. Mary Ribera G.",103,2,0,1,52,41,11,1,0,211,2,2,215,236,0.246,0.911
"27836","Beni","Trinidad","U.E. Mary Ribera G.",94,0,3,0,57,26,14,6,1,201,1,5,207,235,0.284,0.881
"27837","Beni","Trinidad","U.E. Mary Ribera G.",82,0,1,1,49,48,10,5,0,196,4,2,202,229,0.25,0.882
"27838","Beni","Trinidad","U.E. Mary Ribera G.",75,0,0,1,58,38,26,2,0,200,1,7,208,231,0.29,0.9
"27839","Beni","Trinidad","U.E. Mary Ribera G.",72,0,3,0,72,29,18,9,3,206,3,9,218,235,0.35,0.928
"27840","Beni","Trinidad","U.E. Mary Ribera G.",85,2,3,0,61,19,15,3,0,188,4,12,204,226,0.324,0.903
"27841","Beni","Trinidad","U.E. Mary Ribera G.",94,0,2,0,54,29,15,1,0,195,1,3,199,231,0.277,0.861
"27842","Beni","Trinidad","U.E. Mary Ribera G.",64,1,3,0,63,41,15,1,2,190,4,13,207,232,0.332,0.892
"27843","Beni","Trinidad","U.E. Mary Ribera G.",79,1,2,3,53,34,16,2,2,192,4,6,202,231,0.276,0.874
"27844","Beni","Trinidad","U.E. Mary Ribera G.",80,1,3,4,53,39,14,5,0,199,4,6,209,231,0.266,0.905
"27845","Beni","Trinidad","U.E. Mary Ribera G.",65,0,1,1,78,36,13,0,3,197,4,6,207,233,0.396,0.888
"27846","Beni","Trinidad","U.E. Mary Ribera G.",100,2,0,1,34,38,17,5,1,198,2,8,208,226,0.172,0.92
"27847","Beni","Trinidad","U.E. Mary Ribera G.",65,3,2,3,57,42,17,2,3,194,0,8,202,232,0.294,0.871
"27848","Beni","Trinidad","U.E. Mary Ribera G.",61,1,4,1,58,42,7,5,0,179,3,4,186,228,0.324,0.816
"27849","Beni","Trinidad","U.E. Mary Ribera G.",78,0,0,0,59,37,12,4,0,190,2,8,200,231,0.311,0.866
"27850","Beni","Trinidad","U.E. Mary Ribera G.",93,1,2,1,49,27,22,3,2,200,1,5,206,229,0.245,0.9
"27851","Beni","Trinidad","U.E. Mary Ribera G.",64,1,0,0,50,44,20,4,2,185,1,9,195,229,0.27,0.852
"27852","Beni","Trinidad","U.E. Mary Ribera G.",90,0,0,0,63,26,13,1,0,193,3,5,201,229,0.326,0.878
"27853","Beni","Trinidad","U.E. Mary Ribera G.",103,0,0,1,39,29,20,1,1,194,2,8,204,228,0.201,0.895
"27854","Beni","Trinidad","U.E. Mary Ribera G.",89,0,0,1,40,45,16,1,1,193,4,8,205,232,0.207,0.884
"27855","Beni","Trinidad","U.E. Mary Ribera G.",74,0,1,2,70,33,14,2,0,196,5,8,209,230,0.357,0.909
"27856","Beni","Trinidad","U.E. Mary Ribera G.",68,0,1,2,52,51,12,6,0,192,4,7,203,228,0.271,0.89
"27857","Beni","Trinidad","U.E.  Gral. Hugo Banzer Suarez",85,1,0,0,78,29,13,0,0,206,3,1,210,235,0.379,0.894
"27858","Beni","Trinidad","U.E.  Gral. Hugo Banzer Suarez",81,1,0,1,75,24,12,2,0,196,2,5,203,237,0.383,0.857
"27859","Beni","Trinidad","U.E.  Gral. Hugo Banzer Suarez",89,0,0,0,55,30,14,6,3,197,2,1,200,231,0.279,0.866
"27860","Beni","Trinidad","U.E.  Gral. Hugo Banzer Suarez",88,0,0,0,55,18,11,3,0,175,1,5,181,200,0.314,0.905
"27861","Beni","Trinidad","U.E. Los Cedros",79,0,0,0,63,24,9,7,0,182,3,7,192,224,0.346,0.857
"27862","Beni","Trinidad","U.E. Los Cedros",84,1,0,2,66,19,12,8,0,192,2,3,197,221,0.344,0.891
"27863","Beni","Trinidad","U.E. Los Cedros",93,0,0,0,48,24,14,3,0,182,1,9,192,221,0.264,0.869
"27864","Beni","Trinidad","U.E. Los Cedros",95,1,2,0,39,41,10,2,0,190,0,5,195,226,0.205,0.863
"27865","Beni","Trinidad","U.E. Los Cedros",94,0,0,1,41,29,11,3,0,179,6,8,193,226,0.229,0.854
"27866","Beni","Trinidad","U.E. Los Cedros",96,1,0,0,48,35,17,1,0,198,0,5,203,225,0.242,0.902
"27867","Beni","Trinidad","U.E. Villa Vecinal",52,0,0,0,61,52,20,2,0,187,7,5,199,233,0.326,0.854
"27868","Beni","Trinidad","U.E. Villa Vecinal",66,1,1,0,46,45,14,3,1,177,12,9,198,229,0.26,0.865
"27869","Beni","Trinidad","U.E. Villa Vecinal",63,1,3,0,57,46,21,4,0,195,1,5,201,231,0.292,0.87
"27870","Beni","Trinidad","U.E. Villa Vecinal",62,0,1,0,64,51,23,6,0,207,4,5,216,235,0.309,0.919
"27871","Beni","Trinidad","U.E. Villa Vecinal",62,1,1,0,56,50,17,7,1,195,5,3,203,229,0.287,0.886
"27872","Beni","Trinidad","U.E. Villa Vecinal",56,0,0,0,64,40,25,8,3,196,1,6,203,228,0.327,0.89
"27873","Beni","Trinidad","U.E. Villa Vecinal",53,2,4,2,70,55,13,0,0,199,2,5,206,230,0.352,0.896
"27874","Beni","Trinidad","U.E. Villa Vecinal",72,1,1,0,52,44,21,8,2,201,1,6,208,234,0.259,0.889
"27875","Beni","Trinidad","U.E. Villa Vecinal",70,0,1,0,57,43,25,1,2,199,4,4,207,233,0.286,0.888
"27876","Beni","Trinidad","U.E. Villa Vecinal",79,1,2,0,49,48,12,6,0,197,2,6,205,229,0.249,0.895
"27877","Beni","Trinidad","U.E. Villa Vecinal",64,0,1,0,53,46,24,4,4,196,5,9,210,234,0.27,0.897
"27878","Beni","Trinidad","U.E. Villa Vecinal",50,0,0,0,57,56,27,4,0,194,4,3,201,233,0.294,0.863
"27879","Beni","Trinidad","U.E. Villa Vecinal",50,0,0,0,62,59,23,3,0,197,8,3,208,230,0.315,0.904
"27880","Beni","Trinidad","U.E. Villa Vecinal",71,1,0,1,51,54,16,4,1,199,7,8,214,235,0.256,0.911
"27881","Beni","Trinidad","U.E. Villa Vecinal",73,4,1,1,53,43,15,2,2,194,2,7,203,237,0.273,0.857
"27882","Beni","Trinidad","U.E. Villa Vecinal",58,2,1,0,51,38,16,6,1,173,5,19,197,231,0.295,0.853
"27883","Beni","Trinidad","U.E. Villa Vecinal",48,0,5,0,52,56,24,6,1,192,5,6,203,224,0.271,0.906
"27884","Beni","Trinidad","U.E. Villa Vecinal",64,0,1,2,52,59,21,6,1,206,3,6,215,237,0.252,0.907
"27885","Beni","Trinidad","U.E. Joaquín Hurtado Chavez",66,0,0,0,71,42,18,3,0,200,2,3,205,228,0.355,0.899
"27886","Beni","Trinidad","U.E. Joaquín Hurtado Chavez",57,1,0,0,59,56,22,2,1,198,1,9,208,232,0.298,0.897
"27887","Beni","Trinidad","U.E. Joaquín Hurtado Chavez",54,0,0,1,73,44,17,4,2,195,3,5,203,230,0.374,0.883
"27888","Beni","Trinidad","U.E. Joaquín Hurtado Chavez",60,0,1,0,75,45,16,1,0,198,2,3,203,230,0.379,0.883
"27889","Beni","Trinidad","U.E. Joaquín Hurtado Chavez",44,2,1,0,73,56,13,3,0,192,6,6,204,234,0.38,0.872
"27890","Beni","Trinidad","U.E. Joaquín Hurtado Chavez",53,0,1,0,67,41,24,3,0,189,5,8,202,223,0.354,0.906
"27891","Beni","Trinidad","U.E. Joaquín Hurtado Chavez",55,0,0,0,65,45,18,7,1,191,3,8,202,227,0.34,0.89
"27892","Beni","Trinidad","U.E. Joaquín Hurtado Chavez",59,2,2,1,53,55,15,2,1,190,9,6,205,229,0.279,0.895
"27893","Beni","Trinidad","U.E. Joaquín Hurtado Chavez",53,1,2,0,67,36,18,9,0,186,2,6,194,231,0.36,0.84
"27894","Beni","Trinidad","U.E. Joaquín Hurtado Chavez",70,1,0,0,70,28,24,1,0,194,2,7,203,232,0.361,0.875
"27895","Beni","Trinidad","U.E. Joaquín Hurtado Chavez",64,1,0,0,60,56,16,1,0,198,3,2,203,234,0.303,0.868
"27896","Beni","Trinidad","U.E. Joaquín Hurtado Chavez",61,0,1,0,57,55,21,4,1,200,3,9,212,234,0.285,0.906
"27897","Beni","Trinidad","U.E. Joaquín Hurtado Chavez",67,2,3,0,55,50,18,5,3,203,2,2,207,229,0.271,0.904
"27898","Beni","Trinidad","U.E. Joaquín Hurtado Chavez",53,0,1,0,67,51,18,3,1,194,9,6,209,240,0.345,0.871
"27899","Beni","Trinidad","Esc. Loma Suarez",28,0,7,0,80,26,18,2,2,163,5,6,174,229,0.491,0.76
"27900","Beni","Trinidad","Esc. Loma Suarez",29,0,3,0,93,24,18,2,2,171,4,2,177,226,0.544,0.783
"27901","Beni","Trinidad","Esc. Loma Suarez",35,1,3,0,92,38,17,2,0,188,6,4,198,229,0.489,0.865
"27902","Beni","Trinidad","Esc. Mayor Pedro Vaca Diez",36,0,1,0,94,34,2,4,1,172,4,2,178,227,0.547,0.784
"27903","Beni","Trinidad","Esc. Mayor Pedro Vaca Diez",21,1,0,1,84,42,7,2,1,159,3,7,169,207,0.528,0.816
"27904","Beni","Trinidad","Escuela Casarabe",63,1,1,1,63,35,14,5,0,183,6,7,196,229,0.344,0.856
"27905","Beni","Trinidad","Escuela Casarabe",52,0,1,0,73,22,18,7,2,175,4,3,182,228,0.417,0.798
"27906","Beni","Trinidad","Escuela Casarabe",63,0,0,0,58,20,5,7,0,153,9,4,166,191,0.379,0.869
"27907","Beni","Trinidad","Escuela Iviato",52,0,1,0,84,38,11,2,1,189,1,9,199,233,0.444,0.854
"27908","Beni","Trinidad","Esc. Puerto Varador",24,1,3,2,60,44,20,6,5,165,7,16,188,227,0.364,0.828
"27909","Beni","Trinidad","Esc. Puerto Varador",37,0,2,2,73,41,10,7,2,174,20,3,197,235,0.42,0.838
"27910","Beni","Trinidad","Esc. Puerto Varador",21,0,4,0,73,42,10,8,3,161,19,10,190,232,0.453,0.819
"27911","Beni","San Javier","Escuela San Javier",44,1,1,1,83,33,1,18,2,184,6,2,192,225,0.451,0.853
"27912","Beni","San Javier","Escuela San Pedro",39,0,2,2,77,47,2,1,0,170,3,9,182,217,0.453,0.839
"27913","Beni","San Javier","Escuela San Pedro",31,1,0,1,67,74,4,1,3,182,2,6,190,222,0.368,0.856
"27914","Beni","San Javier","Escuela Nueva Israel",19,0,1,2,83,53,13,4,1,176,11,9,196,228,0.472,0.86
"27915","Beni","San Javier","Escuela Nueva Israel",13,2,2,1,83,41,23,1,1,167,10,10,187,226,0.497,0.827
"27916","Beni","San Javier","Escuela Pedro Ignacio Muiba",21,0,2,1,114,24,17,2,0,181,6,2,189,222,0.63,0.851
"27917","Beni","Riberalta","U.E.  Eduardo Abaroa",104,1,0,2,47,15,18,6,1,194,3,6,203,232,0.242,0.875
"27918","Beni","Riberalta","U.E.  Eduardo Abaroa",97,2,1,1,38,22,18,7,0,186,6,3,195,221,0.204,0.882
"27919","Beni","Riberalta","U.E.  Eduardo Abaroa",103,1,0,2,47,26,14,8,0,201,3,5,209,227,0.234,0.921
"27920","Beni","Riberalta","U.E.  Eduardo Abaroa",87,0,0,2,63,17,17,10,1,197,2,4,203,227,0.32,0.894
"27921","Beni","Riberalta","U.E.  Eduardo Abaroa",117,1,0,0,34,15,18,5,0,190,5,7,202,232,0.179,0.871
"27922","Beni","Riberalta","U.E.  Eduardo Abaroa",92,0,0,1,52,19,19,9,0,192,1,8,201,232,0.271,0.866
"27923","Beni","Riberalta","U.E.  Eduardo Abaroa",113,0,0,4,40,20,14,7,2,200,2,4,206,225,0.2,0.916
"27924","Beni","Riberalta","U.E.  Eduardo Abaroa",94,1,1,2,65,13,9,4,1,190,2,5,197,225,0.342,0.876
"27925","Beni","Riberalta","U.E.  Eduardo Abaroa",106,0,1,3,33,14,19,13,0,189,3,8,200,227,0.175,0.881
"27926","Beni","Riberalta","U.E.  Eduardo Abaroa",113,1,1,4,43,18,7,6,1,194,2,6,202,226,0.222,0.894
"27927","Beni","Riberalta","U.E.  Eduardo Abaroa",81,0,3,1,59,19,12,9,2,186,2,7,195,220,0.317,0.886
"27928","Beni","Riberalta","U.E.  Eduardo Abaroa",127,0,0,1,40,17,13,4,3,205,0,6,211,230,0.195,0.917
"27929","Beni","Riberalta","U.E.  Eduardo Abaroa",119,0,0,1,36,12,15,8,0,191,0,6,197,221,0.188,0.891
"27930","Beni","Riberalta","U.E.  Eduardo Abaroa",121,0,0,1,45,10,15,4,2,198,6,3,207,229,0.227,0.904
"27931","Beni","Riberalta","U.E.  1ro. de Diciembre",80,0,5,0,26,29,8,13,0,161,49,3,213,225,0.161,0.947
"27932","Beni","Riberalta","U.E.  1ro. de Diciembre",104,2,0,0,38,28,8,12,0,192,8,3,203,221,0.198,0.919
"27933","Beni","Riberalta","U.E.  1ro. de Diciembre",98,2,2,1,33,19,18,14,2,189,8,11,208,233,0.175,0.893
"27934","Beni","Riberalta","U.E.  1ro. de Diciembre",120,1,1,0,34,19,16,8,0,199,2,6,207,223,0.171,0.928
"27935","Beni","Riberalta","U.E.  1ro. de Diciembre",105,1,1,2,37,20,16,12,0,194,4,8,206,228,0.191,0.904
"27936","Beni","Riberalta","U.E.  1ro. de Diciembre",93,2,1,2,44,22,22,11,0,197,7,7,211,229,0.223,0.921
"27937","Beni","Riberalta","U.E.  1ro. de Diciembre",99,1,1,1,41,30,13,12,0,198,6,6,210,227,0.207,0.925
"27938","Beni","Riberalta","U.E.  1ro. de Diciembre",109,1,3,1,32,13,14,15,0,188,4,11,203,228,0.17,0.89
"27939","Beni","Riberalta","U.E.  1ro. de Diciembre",99,4,1,1,34,34,12,10,2,197,5,12,214,230,0.173,0.93
"27940","Beni","Riberalta","U.E. Los Tajibos",70,1,1,1,52,31,23,3,1,183,11,6,200,231,0.284,0.866
"27941","Beni","Riberalta","U.E. Los Tajibos",70,1,0,3,55,32,26,5,1,193,5,8,206,230,0.285,0.896
"27942","Beni","Riberalta","U.E. Los Tajibos",80,0,2,0,69,24,14,8,1,198,3,8,209,231,0.348,0.905
"27943","Beni","Riberalta","U.E. Los Tajibos",98,0,1,0,49,22,17,6,0,193,2,10,205,220,0.254,0.932
"27944","Beni","Riberalta","U.E. Los Tajibos",78,0,2,1,69,16,20,8,1,195,7,9,211,226,0.354,0.934
"27945","Beni","Riberalta","U.E. Los Tajibos",63,3,2,1,57,33,22,9,0,190,7,10,207,233,0.3,0.888
"27946","Beni","Riberalta","U.E. Los Tajibos",83,0,0,1,63,20,26,7,1,201,6,3,210,228,0.313,0.921
"27947","Beni","Riberalta","U.E. Los Tajibos",85,2,0,1,55,21,15,6,0,185,7,9,201,227,0.297,0.885
"27948","Beni","Riberalta","U.E. Los Tajibos",71,3,1,0,69,28,15,6,2,195,9,8,212,236,0.354,0.898
"27949","Beni","Riberalta","U.E. Los Tajibos",77,0,0,1,51,22,18,8,0,177,8,13,198,227,0.288,0.872
"27950","Beni","Riberalta","U.E. Los Tajibos",74,3,3,1,62,23,22,8,0,196,5,7,208,226,0.316,0.92
"27951","Beni","Riberalta","U.E. Los Tajibos",67,1,2,1,54,28,27,4,0,184,5,19,208,231,0.293,0.9
"27952","Beni","Riberalta","U.E. Los Tajibos",52,3,1,1,58,27,33,7,1,183,9,6,198,221,0.317,0.896
"27953","Beni","Riberalta","U.E. Los Tajibos",79,0,0,1,56,28,17,10,1,192,4,8,204,224,0.292,0.911
"27954","Beni","Riberalta","U.E. Los Tajibos",74,1,2,2,58,25,10,8,1,181,6,10,197,225,0.32,0.876
"27955","Beni","Riberalta","U.E. Los Tajibos",68,0,0,2,68,30,17,8,0,193,6,8,207,229,0.352,0.904
"27956","Beni","Riberalta","U.E. Los Tajibos",90,1,1,0,51,19,11,15,0,188,12,7,207,229,0.271,0.904
"27957","Beni","Riberalta","U.E. Los Tajibos",79,1,1,1,63,22,10,5,1,183,5,5,193,225,0.344,0.858
"27958","Beni","Riberalta","U.E. Los Tajibos",76,0,1,1,53,26,21,11,0,189,4,4,197,230,0.28,0.857
"27959","Beni","Riberalta","U.E. Los Tajibos",67,3,2,0,59,25,17,9,2,184,8,11,203,231,0.321,0.879
"27960","Beni","Riberalta","U.E. Los Tajibos",88,1,2,0,52,27,19,6,0,195,3,8,206,226,0.267,0.912
"27961","Beni","Riberalta","U.E. Los Tajibos",73,0,0,4,64,31,21,10,1,204,7,9,220,231,0.314,0.952
"27962","Beni","Riberalta","U.E. Los Tajibos",69,1,1,1,64,30,13,6,0,185,3,9,197,228,0.346,0.864
"27963","Beni","Riberalta","U.E. San Jose Obrero",100,0,1,1,50,19,12,6,1,190,3,8,201,232,0.263,0.866
"27964","Beni","Riberalta","U.E. San Jose Obrero",105,0,1,1,34,22,19,3,0,185,5,7,197,227,0.184,0.868
"27965","Beni","Riberalta","U.E. San Jose Obrero",84,0,0,0,49,24,25,2,0,184,7,4,195,232,0.266,0.841
"27966","Beni","Riberalta","U.E. San Jose Obrero",108,0,0,0,44,15,17,9,0,193,3,6,202,230,0.228,0.878
"27967","Beni","Riberalta","U.E. San Jose Obrero",99,1,0,1,42,26,9,6,0,184,3,10,197,226,0.228,0.872
"27968","Beni","Riberalta","U.E. San Jose Obrero",97,3,1,0,55,17,22,5,0,200,2,5,207,232,0.275,0.892
"27969","Beni","Riberalta","U.E. San Jose Obrero",115,1,1,0,43,23,9,4,1,197,1,5,203,231,0.218,0.879
"27970","Beni","Riberalta","U.E. San Jose Obrero",99,0,1,0,40,22,14,8,2,186,4,4,194,224,0.215,0.866
"27971","Beni","Riberalta","U.E. San Jose Obrero",103,1,1,0,41,20,14,6,0,186,5,10,201,233,0.22,0.863
"27972","Beni","Riberalta","U.E. San Jose Obrero",97,2,0,0,44,24,13,9,0,189,3,6,198,232,0.233,0.853
"27973","Beni","Riberalta","U.E. Nacional Pedro Kramer",118,0,0,1,23,16,15,5,1,179,0,4,183,223,0.128,0.821
"27974","Beni","Riberalta","U.E. Nacional Pedro Kramer",131,1,0,1,17,17,8,3,0,178,3,5,186,219,0.096,0.849
"27975","Beni","Riberalta","U.E. Nacional Pedro Kramer",118,0,1,3,31,10,12,4,1,180,1,7,188,225,0.172,0.836
"27976","Beni","Riberalta","U.E. Nacional Pedro Kramer",116,1,1,0,30,14,12,7,0,181,0,4,185,228,0.166,0.811
"27977","Beni","Riberalta","U.E. Nacional Pedro Kramer",114,1,0,2,25,15,8,10,0,175,2,5,182,221,0.143,0.824
"27978","Beni","Riberalta","U.E. Nacional Pedro Kramer",117,0,0,1,31,10,8,4,0,171,0,6,177,217,0.181,0.816
"27979","Beni","Riberalta","U.E. Nacional Pedro Kramer",125,1,0,2,34,8,6,7,0,183,1,1,185,218,0.186,0.849
"27980","Beni","Riberalta","U.E.Jhon Fitzgerald Kennedy",118,2,0,1,29,13,4,4,2,173,6,10,189,224,0.168,0.844
"27981","Beni","Riberalta","U.E.Jhon Fitzgerald Kennedy",132,1,0,0,30,17,9,5,0,194,3,0,197,221,0.155,0.891
"27982","Beni","Riberalta","U.E.Jhon Fitzgerald Kennedy",119,0,0,0,37,12,8,4,0,180,7,5,192,219,0.206,0.877
"27983","Beni","Riberalta","U.E.Jhon Fitzgerald Kennedy",131,1,0,3,29,12,10,7,1,194,1,3,198,222,0.149,0.892
"27984","Beni","Riberalta","U.E.Jhon Fitzgerald Kennedy",120,0,0,1,35,9,9,8,0,182,1,4,187,210,0.192,0.89
"27985","Beni","Riberalta","U.E.Jhon Fitzgerald Kennedy",114,2,1,0,39,21,9,3,1,190,2,5,197,216,0.205,0.912
"27986","Beni","Riberalta","U.E.Jhon Fitzgerald Kennedy",131,1,0,4,42,12,6,2,1,199,1,4,204,223,0.211,0.915
"27987","Beni","Riberalta","U.E.Jhon Fitzgerald Kennedy",117,0,0,1,32,9,9,6,1,175,2,6,183,212,0.183,0.863
"27988","Beni","Riberalta","U.E. Nuestra Señora Del Carmen",109,1,0,0,40,12,13,3,0,178,1,0,179,215,0.225,0.833
"27989","Beni","Riberalta","U.E. Nuestra Señora Del Carmen",118,0,1,0,31,16,15,3,0,184,2,4,190,220,0.168,0.864
"27990","Beni","Riberalta","U.E. Nuestra Señora Del Carmen",116,1,1,2,37,15,12,7,2,193,1,2,196,228,0.192,0.86
"27991","Beni","Riberalta","U.E. Nuestra Señora Del Carmen",102,0,1,2,50,11,7,6,1,180,5,1,186,215,0.278,0.865
"27992","Beni","Riberalta","U.E. Nuestra Señora Del Carmen",115,0,2,2,46,10,9,9,1,194,4,6,204,225,0.237,0.907
"27993","Beni","Riberalta","U.E. Nuestra Señora Del Carmen",101,1,1,1,41,9,10,8,0,172,4,5,181,217,0.238,0.834
"27994","Beni","Riberalta","U.E. Nuestra Señora Del Carmen",109,1,0,1,37,10,10,9,0,177,0,2,179,210,0.209,0.852
"27995","Beni","Riberalta","U.E. Nuestra Señora Del Carmen",123,0,0,3,28,9,4,11,0,178,3,6,187,216,0.157,0.866
"27996","Beni","Riberalta","U.E. Nuestra Señora Del Carmen",107,0,1,4,45,9,4,4,1,175,5,5,185,220,0.257,0.841
"27997","Beni","Riberalta","U.E. Felix Sattory Roman",109,1,1,1,35,13,12,7,1,180,1,8,189,221,0.194,0.855
"27998","Beni","Riberalta","U.E. Felix Sattory Roman",120,0,1,0,35,12,7,7,0,182,4,4,190,219,0.192,0.868
"27999","Beni","Riberalta","U.E. Felix Sattory Roman",100,2,1,2,49,13,14,5,0,186,3,6,195,217,0.263,0.899
"28000","Beni","Riberalta","U.E. Felix Sattory Roman",110,0,1,3,31,18,15,4,1,183,1,5,189,219,0.169,0.863
"28001","Beni","Riberalta","U.E. Felix Sattory Roman",114,0,0,0,36,13,14,4,0,181,5,6,192,221,0.199,0.869
"28002","Beni","Riberalta","U.E. Felix Sattory Roman",129,1,1,1,24,10,12,3,0,181,3,7,191,222,0.133,0.86
"28003","Beni","Riberalta","U.E. Felix Sattory Roman",131,1,2,1,39,10,12,5,0,201,2,6,209,229,0.194,0.913
"28004","Beni","Riberalta","U.E. Felix Sattory Roman",122,0,0,2,24,12,8,12,1,181,2,5,188,216,0.133,0.87
"28005","Beni","Riberalta","U.E. Felix Sattory Roman",109,2,2,1,35,11,16,9,0,185,1,5,191,225,0.189,0.849
"28006","Beni","Riberalta","U.E. Felix Sattory Roman",107,3,1,0,46,8,16,9,0,190,5,2,197,225,0.242,0.876
"28007","Beni","Riberalta","U.E. Felix Sattory Roman",117,1,0,0,45,14,7,6,0,190,1,6,197,228,0.237,0.864
"28008","Beni","Riberalta","U.E. Felix Sattory Roman",127,0,1,2,38,9,8,5,1,191,3,10,204,224,0.199,0.911
"28009","Beni","Riberalta","U.E. Felix Sattory Roman",107,1,0,0,47,17,17,4,0,193,0,5,198,224,0.244,0.884
"28010","Beni","Riberalta","U.E. Felix Sattory Roman",121,1,0,0,41,10,9,6,0,188,5,5,198,217,0.218,0.912
"28011","Beni","Riberalta","U.E. Felix Sattory Roman",114,0,1,0,48,17,8,6,0,194,1,3,198,227,0.247,0.872
"28012","Beni","Riberalta","U.E. Felix Sattory Roman",119,2,0,1,38,17,11,6,0,194,2,3,199,225,0.196,0.884
"28013","Beni","Riberalta","U.E. Felix Sattory Roman",110,0,2,0,44,15,12,7,0,190,5,4,199,223,0.232,0.892
"28014","Beni","Riberalta","U.E. Felix Sattory Roman",103,0,0,0,48,22,8,2,0,183,3,7,193,222,0.262,0.869
"28015","Beni","Riberalta","U.E. Felix Sattory Roman",125,2,2,1,35,16,7,1,0,189,2,3,194,224,0.185,0.866
"28016","Beni","Riberalta","Politecnico Benjamin Bowles",90,2,0,2,37,19,16,7,1,174,3,14,191,221,0.213,0.864
"28017","Beni","Riberalta","Politecnico Benjamin Bowles",101,0,1,1,51,18,15,8,0,195,2,10,207,229,0.262,0.904
"28018","Beni","Riberalta","Politecnico Benjamin Bowles",83,3,1,3,53,16,17,4,1,181,6,9,196,218,0.293,0.899
"28019","Beni","Riberalta","Politecnico Benjamin Bowles",89,2,2,2,51,21,10,8,2,187,4,7,198,219,0.273,0.904
"28020","Beni","Riberalta","Politecnico Benjamin Bowles",98,0,0,0,38,14,14,12,0,176,5,5,186,216,0.216,0.861
"28021","Beni","Riberalta","Politecnico Benjamin Bowles",96,2,4,0,50,24,10,9,1,196,7,7,210,227,0.255,0.925
"28022","Beni","Riberalta","Politecnico Benjamin Bowles",90,1,2,0,53,16,16,10,0,188,6,7,201,226,0.282,0.889
"28023","Beni","Riberalta","Politecnico Benjamin Bowles",83,2,2,2,43,17,17,1,4,171,6,8,185,219,0.251,0.845
"28024","Beni","Riberalta","Politecnico Benjamin Bowles",104,0,1,1,38,12,17,8,0,181,5,9,195,220,0.21,0.886
"28025","Beni","Riberalta","Politecnico Benjamin Bowles",92,0,0,1,57,18,0,5,3,176,4,5,185,219,0.324,0.845
"28026","Beni","Riberalta","Politecnico Benjamin Bowles",86,1,0,1,63,21,7,3,0,182,3,2,187,217,0.346,0.862
"28027","Beni","Riberalta","Politecnico Benjamin Bowles",92,0,0,1,44,11,17,8,0,173,5,6,184,218,0.254,0.844
"28028","Beni","Riberalta","Politecnico Benjamin Bowles",93,0,2,2,58,15,13,8,1,192,3,6,201,230,0.302,0.874
"28029","Beni","Riberalta","Politecnico Benjamin Bowles",85,0,0,1,60,10,16,10,0,182,5,5,192,229,0.33,0.838
"28030","Beni","Riberalta","Politecnico Benjamin Bowles",91,0,1,1,32,19,18,10,0,172,6,10,188,217,0.186,0.866
"28031","Beni","Riberalta","U.E. Juana Azurduy De Padilla",112,1,1,2,34,9,16,9,0,184,1,6,191,225,0.185,0.849
"28032","Beni","Riberalta","U.E. Juana Azurduy De Padilla",93,0,1,2,34,14,16,6,2,168,4,8,180,219,0.202,0.822
"28033","Beni","Riberalta","U.E. Juana Azurduy De Padilla",110,1,1,0,28,10,17,7,1,175,2,3,180,217,0.16,0.829
"28034","Beni","Riberalta","U.E. Juana Azurduy De Padilla",112,2,0,0,21,5,11,8,0,159,2,4,165,215,0.132,0.767
"28035","Beni","Riberalta","U.E. Juana Azurduy De Padilla",124,0,1,1,38,9,11,5,0,189,2,4,195,216,0.201,0.903
"28036","Beni","Riberalta","U.E. 6 de Junio",111,1,1,2,37,6,9,1,2,170,2,5,177,212,0.218,0.835
"28037","Beni","Riberalta","U.E. 6 de Junio",82,0,1,0,47,11,14,2,1,158,3,5,166,212,0.297,0.783
"28038","Beni","Riberalta","U.E. 6 de Junio",119,1,0,1,44,7,6,2,0,180,3,3,186,222,0.244,0.838
"28039","Beni","Riberalta","U.E. 6 de Junio",117,0,1,1,31,12,10,6,0,178,1,2,181,222,0.174,0.815
"28040","Beni","Riberalta","U.E. 6 de Junio",94,0,2,0,45,16,5,3,0,165,1,2,168,220,0.273,0.764
"28041","Beni","Riberalta","U.E. 6 de Junio",110,0,0,0,40,6,7,7,1,171,5,2,178,223,0.234,0.798
"28042","Beni","Riberalta","U.E. 6 de Junio",90,1,0,1,49,6,11,3,0,161,4,1,166,223,0.304,0.744
"28043","Beni","Riberalta","U.E. 6 de Junio",106,1,0,1,29,11,9,9,0,166,5,6,177,219,0.175,0.808
"28044","Beni","Riberalta","U.E. 6 de Junio",107,0,0,0,41,8,7,7,0,170,2,7,179,224,0.241,0.799
"28045","Beni","Riberalta","Unidad Educativa Nataniel García Chavez",119,2,0,0,34,17,5,8,0,185,4,5,194,222,0.184,0.874
"28046","Beni","Riberalta","Unidad Educativa Nataniel García Chavez",119,0,1,3,31,20,18,7,0,199,11,9,219,235,0.156,0.932
"28047","Beni","Riberalta","Unidad Educativa Nataniel García Chavez",127,1,1,2,24,23,13,11,0,202,6,6,214,229,0.119,0.934
"28048","Beni","Riberalta","Unidad Educativa Nataniel García Chavez",117,1,1,1,24,20,6,14,0,184,5,5,194,221,0.13,0.878
"28049","Beni","Riberalta","Unidad Educativa Nataniel García Chavez",108,2,1,0,43,25,11,7,1,198,7,5,210,229,0.217,0.917
"28050","Beni","Riberalta","Unidad Educativa Nataniel García Chavez",116,0,0,0,32,15,11,5,2,181,12,8,201,223,0.177,0.901
"28051","Beni","Riberalta","Unidad Educativa Nataniel García Chavez",124,1,1,0,25,10,9,14,0,184,5,8,197,221,0.136,0.891
"28052","Beni","Riberalta","Unidad Educativa Nataniel García Chavez",105,0,2,2,44,24,9,15,0,201,4,7,212,229,0.219,0.926
"28053","Beni","Riberalta","Unidad Educativa Nataniel García Chavez",97,2,0,1,40,16,16,15,0,187,3,4,194,224,0.214,0.866
"28054","Beni","Riberalta","Unidad Educativa Nataniel García Chavez",92,0,1,1,40,18,8,9,1,170,11,12,193,224,0.235,0.862
"28055","Beni","Riberalta","Unidad Educativa Nataniel García Chavez",88,2,2,4,36,21,11,6,0,170,11,4,185,220,0.212,0.841
"28056","Beni","Riberalta","Unidad Educativa Nataniel García Chavez",110,0,1,1,36,18,6,9,0,181,5,5,191,219,0.199,0.872
"28057","Beni","Riberalta","Unidad Educativa Nataniel García Chavez",107,1,1,3,39,22,9,8,0,190,3,3,196,220,0.205,0.891
"28058","Beni","Riberalta","Unidad Educativa Nataniel García Chavez",106,1,0,5,43,16,7,7,1,186,2,3,191,218,0.231,0.876
"28059","Beni","Riberalta","Unidad Educativa Nataniel García Chavez",110,0,1,3,35,15,9,17,0,190,2,10,202,218,0.184,0.927
"28060","Beni","Riberalta","Unidad Educativa Nataniel García Chavez",108,0,1,1,38,14,16,9,0,187,7,1,195,221,0.203,0.882
"28061","Beni","Riberalta","U.E.  Británica",81,2,2,0,47,25,15,7,2,181,4,13,198,225,0.26,0.88
"28062","Beni","Riberalta","U.E.  Británica",96,1,0,1,44,18,13,7,0,180,7,6,193,219,0.244,0.881
"28063","Beni","Riberalta","U.E.  Británica",75,2,1,3,53,19,21,11,1,186,4,7,197,225,0.285,0.876
"28064","Beni","Riberalta","U.E.  Británica",102,2,1,2,48,25,10,7,0,197,4,3,204,225,0.244,0.907
"28065","Beni","Riberalta","U.E.  Británica",75,0,2,1,74,22,13,7,1,195,1,9,205,226,0.379,0.907
"28066","Beni","Riberalta","U.E.  Británica",96,0,5,0,46,30,13,10,0,200,4,5,209,227,0.23,0.921
"28067","Beni","Riberalta","U.E.  Británica",83,1,2,1,71,16,11,11,0,196,6,7,209,231,0.362,0.905
"28068","Beni","Riberalta","U.E.  Británica",83,1,3,0,44,22,15,4,1,173,7,8,188,217,0.254,0.866
"28069","Beni","Riberalta","U.E.  Británica",94,3,0,2,39,18,17,6,0,179,5,12,196,224,0.218,0.875
"28070","Beni","Riberalta","U.E.  Británica",58,1,1,1,63,23,27,2,1,177,2,6,185,221,0.356,0.837
"28071","Beni","Riberalta","U.E.  Británica",80,1,2,0,50,26,15,11,1,186,3,3,192,224,0.269,0.857
"28072","Beni","Riberalta","U.E.  Británica",75,3,2,2,63,23,17,7,0,192,5,7,204,227,0.328,0.899
"28073","Beni","Riberalta","U.E.  Británica",93,1,0,2,51,21,12,6,1,187,9,6,202,226,0.273,0.894
"28074","Beni","Riberalta","U.E.  Británica",74,0,0,2,54,17,22,5,0,174,8,6,188,217,0.31,0.866
"28075","Beni","Riberalta","U.E.  Británica",101,2,5,1,48,17,14,3,0,191,5,6,202,229,0.251,0.882
"28076","Beni","Riberalta","U.E.  Británica",89,0,2,2,57,17,19,3,1,190,4,5,199,227,0.3,0.877
"28077","Beni","Riberalta","U.E.  Británica",82,1,0,1,49,23,16,4,0,176,9,9,194,221,0.278,0.878
"28078","Beni","Riberalta","U.E.  Británica",103,0,1,2,49,16,11,6,0,188,4,9,201,221,0.261,0.91
"28079","Beni","Riberalta","U.E. Petrolera",97,4,3,0,30,22,12,14,1,183,6,11,200,221,0.164,0.905
"28080","Beni","Riberalta","U.E. Petrolera",96,0,0,0,50,15,16,4,1,182,5,5,192,218,0.275,0.881
"28081","Beni","Riberalta","U.E. Petrolera",79,0,0,1,36,31,16,10,0,173,1,13,187,217,0.208,0.862
"28082","Beni","Riberalta","U.E. Petrolera",91,0,1,0,34,23,10,12,1,172,10,8,190,218,0.198,0.872
"28083","Beni","Riberalta","U.E. Petrolera",102,1,3,4,38,21,11,12,0,192,5,6,203,223,0.198,0.91
"28084","Beni","Riberalta","U.E. Petrolera",71,1,0,2,54,27,15,14,1,185,6,6,197,223,0.292,0.883
"28085","Beni","Riberalta","U.E. Petrolera",91,0,0,2,40,30,9,12,1,185,6,4,195,213,0.216,0.915
"28086","Beni","Riberalta","U.E. Petrolera",89,0,0,2,44,18,8,11,1,173,5,4,182,220,0.254,0.827
"28087","Beni","Riberalta","U.E. Petrolera",87,0,2,1,39,27,9,9,0,174,8,5,187,218,0.224,0.858
"28088","Beni","Riberalta","U.E. Petrolera",73,1,2,0,58,22,13,17,1,187,8,8,203,227,0.31,0.894
"28089","Beni","Riberalta","U.E. Petrolera",102,4,0,2,48,11,9,5,0,181,6,5,192,221,0.265,0.869
"28090","Beni","Riberalta","U.E. Petrolera",68,2,2,1,40,29,18,13,0,173,7,6,186,213,0.231,0.873
"28091","Beni","Riberalta","U.E. Petrolera",92,2,2,3,35,26,6,17,0,183,2,11,196,225,0.191,0.871
"28092","Beni","Riberalta","U.E. Petrolera",80,0,0,1,59,17,5,12,1,175,3,7,185,219,0.337,0.845
"28093","Beni","Riberalta","U.E. Petrolera",101,0,2,0,30,24,13,11,0,181,8,10,199,220,0.166,0.905
"28094","Beni","Riberalta","U.E. Petrolera",84,2,1,2,55,17,6,12,1,180,9,7,196,222,0.306,0.883
"28095","Beni","Riberalta","U.E. Petrolera",102,2,1,2,33,19,12,8,0,179,8,5,192,219,0.184,0.877
"28096","Beni","Riberalta","U.E. Petrolera",86,1,0,0,44,26,7,17,0,181,5,4,190,217,0.243,0.876
"28097","Beni","Riberalta","U.E. Petrolera",88,2,0,2,36,18,12,15,0,173,7,8,188,216,0.208,0.87
"28098","Beni","Riberalta","U.E. Petrolera",78,1,1,4,37,25,15,12,1,174,2,4,180,221,0.213,0.814
"28099","Beni","Riberalta","U.E. Petrolera",77,4,0,2,41,24,15,12,0,175,7,7,189,225,0.234,0.84
"28100","Beni","Riberalta","U.E. Petrolera",87,0,0,5,35,19,20,13,1,180,8,9,197,225,0.194,0.876
"28101","Beni","Riberalta","U.E.  San Francisco",107,1,1,1,55,11,17,6,0,199,2,7,208,231,0.276,0.9
"28102","Beni","Riberalta","U.E.  San Francisco",106,0,2,0,48,12,15,5,0,188,2,8,198,229,0.255,0.865
"28103","Beni","Riberalta","U.E.  San Francisco",122,0,0,1,35,17,15,1,0,191,2,4,197,232,0.183,0.849
"28104","Beni","Riberalta","U.E.  Walter Alpire Duran",109,0,1,1,47,25,14,7,0,204,5,7,216,235,0.23,0.919
"28105","Beni","Riberalta","U.E.  Walter Alpire Duran",90,0,0,0,61,24,15,9,1,200,3,3,206,234,0.305,0.88
"28106","Beni","Riberalta","U.E.  Walter Alpire Duran",99,1,1,1,60,17,22,7,0,208,2,6,216,235,0.288,0.919
"28107","Beni","Riberalta","U.E.  Walter Alpire Duran",97,1,2,3,39,17,25,4,2,190,3,5,198,237,0.205,0.835
"28108","Beni","Riberalta","U.E.  Walter Alpire Duran",110,0,1,2,59,22,10,3,0,207,3,6,216,233,0.285,0.927
"28109","Beni","Riberalta","U.E.  Ismael Carrasco Telleria",70,0,3,3,70,20,29,3,1,199,1,4,204,235,0.352,0.868
"28110","Beni","Riberalta","U.E.  Ismael Carrasco Telleria",69,2,1,1,88,16,29,3,0,209,3,9,221,237,0.421,0.932
"28111","Beni","Riberalta","U.E.  Ismael Carrasco Telleria",72,1,4,1,71,16,31,4,1,201,1,7,209,235,0.353,0.889
"28112","Beni","Riberalta","U.E.  Ismael Carrasco Telleria",70,0,4,0,77,11,28,4,1,195,8,8,211,234,0.395,0.902
"28113","Beni","Riberalta","U.E.  Ismael Carrasco Telleria",78,1,3,0,87,19,27,0,2,217,5,4,226,249,0.401,0.908
"28114","Beni","Riberalta","U.E. Federico Demmer",87,0,0,0,53,32,23,3,0,198,4,10,212,235,0.268,0.902
"28115","Beni","Riberalta","U.E. Federico Demmer",94,0,0,2,52,23,24,4,0,199,5,12,216,237,0.261,0.911
"28116","Beni","Riberalta","U.E. Federico Demmer",101,0,0,1,48,26,14,9,2,201,8,7,216,238,0.239,0.908
"28117","Beni","Riberalta","U.E. Federico Demmer",107,0,2,0,47,31,11,11,0,209,7,7,223,238,0.225,0.937
"28118","Beni","Riberalta","U.E. Federico Demmer",88,1,1,0,63,34,12,6,0,205,7,8,220,235,0.307,0.936
"28119","Beni","Riberalta","U.E. Federico Demmer",98,2,0,2,38,32,12,12,1,197,11,11,219,236,0.193,0.928
"28120","Beni","Riberalta","U.E. Federico Demmer",100,0,0,1,43,25,14,11,0,194,10,12,216,235,0.222,0.919
"28121","Beni","Riberalta","U.E. Federico Demmer",99,0,1,0,37,29,20,9,0,195,7,8,210,232,0.19,0.905
"28122","Beni","Riberalta","U.E. Federico Demmer",96,1,1,0,54,23,23,3,3,204,3,5,212,235,0.265,0.902
"28123","Beni","Riberalta","U.E. Federico Demmer",93,1,2,2,47,31,19,9,0,204,6,5,215,232,0.23,0.927
"28124","Beni","Riberalta","U.E. Federico Demmer",109,3,0,3,40,33,15,7,0,210,4,4,218,238,0.19,0.916
"28125","Beni","Riberalta","U.E. Federico Demmer",85,0,1,1,47,28,21,11,0,194,2,15,211,237,0.242,0.89
"28126","Beni","Riberalta","U.E. Federico Demmer",92,0,0,1,49,32,17,5,0,196,6,11,213,234,0.25,0.91
"28127","Beni","Riberalta","U.E. Federico Demmer",103,2,1,2,42,20,20,9,0,199,7,4,210,236,0.211,0.89
"28128","Beni","Riberalta","U.E. Federico Demmer",102,0,1,1,47,30,16,5,1,203,6,3,212,237,0.232,0.895
"28129","Beni","Riberalta","U.E. Federico Demmer",94,0,1,0,46,28,22,4,0,195,7,10,212,233,0.236,0.91
"28130","Beni","Riberalta","U.E. Federico Demmer",98,1,2,2,50,21,11,7,0,192,5,13,210,236,0.26,0.89
"28131","Beni","Riberalta","U.E. Litoral",91,0,0,0,61,26,33,6,1,218,5,9,232,239,0.28,0.971
"28132","Beni","Riberalta","U.E. Litoral",72,1,1,0,66,22,32,9,0,203,12,7,222,239,0.325,0.929
"28133","Beni","Riberalta","U.E. Litoral",89,1,0,1,46,26,45,5,4,217,4,5,226,237,0.212,0.954
"28134","Beni","Riberalta","U.E. Litoral",92,1,1,3,64,28,28,5,3,225,8,9,242,253,0.284,0.957
"28135","Beni","Riberalta","U.E.  San Juan",90,1,1,1,55,30,24,6,1,209,7,9,225,237,0.263,0.949
"28136","Beni","Riberalta","U.E.  San Juan",60,2,1,1,77,27,23,5,2,198,6,8,212,232,0.389,0.914
"28137","Beni","Riberalta","U.E.  San Juan",64,1,4,3,79,27,23,5,3,209,6,3,218,236,0.378,0.924
"28138","Beni","Riberalta","U.E.  San Juan",64,2,0,0,77,25,16,8,1,193,14,11,218,236,0.399,0.924
"28139","Beni","Riberalta","U.E.  San Juan",63,2,2,3,76,21,11,4,1,183,15,13,211,236,0.415,0.894
"28140","Beni","Riberalta","U.E.  San Juan",83,1,0,0,49,25,11,14,0,183,10,13,206,234,0.268,0.88
"28141","Beni","Riberalta","U.E.  San Juan",74,2,1,2,72,19,15,7,0,192,10,18,220,234,0.375,0.94
"28142","Beni","Riberalta","U.E.  San Juan",66,1,3,4,68,22,28,9,0,201,5,11,217,236,0.338,0.919
"28143","Beni","Riberalta","U.E.  San Juan",49,0,2,4,72,33,18,4,1,183,10,10,203,236,0.393,0.86
"28144","Beni","Riberalta","U.E.  San Juan",60,2,2,0,79,33,14,2,0,192,11,7,210,235,0.411,0.894
"28145","Beni","Riberalta","U.E.  San Juan",62,2,1,0,84,20,15,6,1,191,10,8,209,232,0.44,0.901
"28146","Beni","Riberalta","U.E.  San Juan",73,1,0,0,78,28,19,10,3,212,5,4,221,236,0.368,0.936
"28147","Beni","Riberalta","U.E.  San Juan",70,1,1,4,60,19,21,5,0,181,11,13,205,231,0.331,0.887
"28148","Beni","Riberalta","U.E.  San Juan",72,1,0,1,63,30,25,7,1,200,9,9,218,234,0.315,0.932
"28149","Beni","Riberalta","U.E.  San Juan",53,6,2,1,76,44,19,5,0,206,11,3,220,237,0.369,0.928
"28150","Beni","Riberalta","U.E.  San Juan",79,0,0,0,68,22,20,5,1,195,7,8,210,237,0.349,0.886
"28151","Beni","Riberalta","U.E.  San Juan",79,1,3,1,61,23,25,5,1,199,8,9,216,236,0.307,0.915
"28152","Beni","Riberalta","U.E.  San Juan",69,0,3,2,68,45,18,4,0,209,11,11,231,238,0.325,0.971
"28153","Beni","Riberalta","U.E.  San Juan",61,0,2,2,79,28,18,7,0,197,5,13,215,234,0.401,0.919
"28154","Beni","Riberalta","U.E.  San Juan",66,1,1,3,71,17,19,6,1,185,10,7,202,217,0.384,0.931
"28155","Beni","Riberalta","U.E. Zaida Gosalvez Alarcón",80,1,0,0,63,10,9,5,0,168,16,9,193,230,0.375,0.839
"28156","Beni","Riberalta","U.E.   Warnes",77,1,2,4,85,12,3,8,3,195,15,6,216,237,0.436,0.911
"28157","Beni","Riberalta","U.E.   Warnes",63,0,0,0,79,9,2,6,0,159,8,12,179,188,0.497,0.952
"28158","Beni","Riberalta","U.E. Bolívar",42,3,16,5,89,19,4,8,1,187,9,8,204,226,0.476,0.903
"28159","Beni","Riberalta","U.E. Bolívar",43,1,3,5,95,21,7,9,1,185,22,8,215,246,0.514,0.874
"28160","Beni","Riberalta","Escuela 12 de Octubre",63,0,1,0,80,11,7,19,0,181,9,16,206,225,0.442,0.916
"28161","Beni","Riberalta","Escuela Alto Ivon",3,0,0,0,183,7,4,5,0,202,6,10,218,239,0.906,0.912
"28162","Beni","Riberalta","Escuela Alto Ivon",3,2,0,0,150,12,5,0,1,173,5,9,187,208,0.867,0.899
"28163","Beni","Riberalta","U.E. Santa Maria",38,4,1,3,98,18,10,15,1,188,9,5,202,221,0.521,0.914
"28164","Beni","Riberalta","U.E. Santa Maria",35,2,3,4,99,10,11,15,1,180,8,11,199,222,0.55,0.896
"28165","Beni","Riberalta","U.E. La Esperanza",91,1,2,1,65,15,9,17,1,202,14,10,226,233,0.322,0.97
"28166","Beni","Riberalta","U.E. Popechi",53,1,4,2,100,21,6,11,4,202,14,10,226,233,0.495,0.97
"28167","Beni","Guayaramerín","Esc. Juddi De Suarez",53,0,0,0,48,55,11,10,0,177,7,6,190,224,0.271,0.848
"28168","Beni","Guayaramerín","Esc. Rosario Del Yata",41,2,2,2,79,32,12,11,1,182,8,5,195,228,0.434,0.855
"28169","Beni","Guayaramerín","U.E.   Los Almendros",56,1,1,1,72,30,12,8,0,181,7,11,199,232,0.398,0.858
"28170","Beni","Guayaramerín","U.E.   Los Almendros",61,0,2,1,60,45,17,5,0,191,6,5,202,236,0.314,0.856
"28171","Beni","Guayaramerín","U.E.   Los Almendros",63,3,0,0,74,34,7,2,1,184,7,6,197,228,0.402,0.864
"28172","Beni","Guayaramerín","U.E.   Los Almendros",52,1,1,1,66,41,14,6,1,183,10,9,202,228,0.361,0.886
"28173","Beni","Guayaramerín","U.E.   Los Almendros",65,0,0,0,60,31,15,4,1,176,9,18,203,236,0.341,0.86
"28174","Beni","Guayaramerín","U.E.   Los Almendros",61,0,2,0,68,41,6,5,0,183,2,12,197,230,0.372,0.857
"28175","Beni","Guayaramerín","U.E.   Los Almendros",67,0,1,0,62,39,8,6,0,183,10,8,201,233,0.339,0.863
"28176","Beni","Guayaramerín","U.E.   Los Almendros",55,1,3,1,72,32,8,4,1,177,6,14,197,229,0.407,0.86
"28177","Beni","Guayaramerín","U.E.   Los Almendros",73,0,1,0,59,40,6,5,1,185,9,6,200,230,0.319,0.87
"28178","Beni","Guayaramerín","U.E.   Los Almendros",57,0,1,0,72,38,10,7,0,185,5,6,196,227,0.389,0.863
"28179","Beni","Guayaramerín","U.E.  Lic. Mixto Guayamerin",87,0,0,0,41,23,7,5,0,163,4,8,175,221,0.252,0.792
"28180","Beni","Guayaramerín","U.E.  Lic. Mixto Guayamerin",75,0,1,0,46,20,18,4,0,164,2,3,169,224,0.28,0.754
"28181","Beni","Guayaramerín","U.E.  Lic. Mixto Guayamerin",70,0,2,0,53,28,8,4,0,165,6,5,176,230,0.321,0.765
"28182","Beni","Guayaramerín","U.E.  Lic. Mixto Guayamerin",88,0,2,0,42,18,11,5,0,166,1,4,171,217,0.253,0.788
"28183","Beni","Guayaramerín","U.E.  Lic. Mixto Guayamerin",72,0,0,0,57,18,19,2,1,169,0,7,176,220,0.337,0.8
"28184","Beni","Guayaramerín","U.E.  Lic. Mixto Guayamerin",69,0,1,0,58,28,7,10,0,173,3,5,181,225,0.335,0.804
"28185","Beni","Guayaramerín","U.E.  Lic. Mixto Guayamerin",84,0,0,0,48,29,17,2,1,181,0,8,189,226,0.265,0.836
"28186","Beni","Guayaramerín","U.E.  Lic. Mixto Guayamerin",80,3,0,2,49,18,9,5,1,167,1,3,171,221,0.293,0.774
"28187","Beni","Guayaramerín","U.E.  Lic. Mixto Guayamerin",70,1,3,0,39,24,9,4,1,151,2,6,159,195,0.258,0.815
"28188","Beni","Guayaramerín","U.E.  Mejillones",68,0,1,2,49,37,9,8,1,175,6,4,185,213,0.28,0.869
"28189","Beni","Guayaramerín","U.E.  Mejillones",72,0,1,1,50,35,10,4,0,173,5,7,185,216,0.289,0.856
"28190","Beni","Guayaramerín","U.E.  Mejillones",66,2,0,1,53,32,10,7,1,172,4,9,185,217,0.308,0.853
"28191","Beni","Guayaramerín","U.E.  Mejillones",69,0,1,2,62,24,12,7,0,177,3,8,188,217,0.35,0.866
"28192","Beni","Guayaramerín","U.E.  Mejillones",81,0,2,0,40,27,7,3,0,160,5,10,175,215,0.25,0.814
"28193","Beni","Guayaramerín","U.E.  Mejillones",68,0,0,1,61,26,11,7,0,174,5,13,192,217,0.351,0.885
"28194","Beni","Guayaramerín","U.E.  Mejillones",68,2,1,0,42,31,11,5,1,161,2,12,175,214,0.261,0.818
"28195","Beni","Guayaramerín","U.E.  Mejillones",69,2,0,1,62,22,5,9,0,170,4,8,182,224,0.365,0.812
"28196","Beni","Guayaramerín","U.E.  Mejillones",79,0,5,1,47,23,13,3,1,172,4,7,183,216,0.273,0.847
"28197","Beni","Guayaramerín","U.E.  Mejillones",71,0,0,2,60,32,5,8,1,179,13,5,197,222,0.335,0.887
"28198","Beni","Guayaramerín","U.E.  Mejillones",81,0,2,1,39,39,12,8,2,184,2,3,189,221,0.212,0.855
"28199","Beni","Guayaramerín","U.E.  Mejillones",73,0,1,1,48,22,12,10,1,168,6,8,182,221,0.286,0.824
"28200","Beni","Guayaramerín","U.E.  Mejillones",75,0,1,0,43,29,10,4,0,162,4,7,173,217,0.265,0.797
"28201","Beni","Guayaramerín","U.E.  Mejillones",88,0,2,0,48,24,4,6,0,172,6,7,185,218,0.279,0.849
"28202","Beni","Guayaramerín","U.E.  Mejillones",80,1,1,1,49,34,4,6,0,176,3,7,186,222,0.278,0.838
"28203","Beni","Guayaramerín","U.E.  Mejillones",96,2,1,0,32,26,10,2,0,169,5,4,178,221,0.189,0.805
"28204","Beni","Guayaramerín","U.E.  Evangélico Nacional",84,1,2,0,40,16,21,8,0,172,2,7,181,216,0.233,0.838
"28205","Beni","Guayaramerín","U.E.  Evangélico Nacional",70,0,0,1,51,15,17,3,1,158,6,6,170,215,0.323,0.791
"28206","Beni","Guayaramerín","U.E.  Evangélico Nacional",74,0,1,0,59,10,19,4,0,167,5,8,180,223,0.353,0.807
"28207","Beni","Guayaramerín","U.E.  Evangélico Nacional",71,0,5,0,50,16,6,5,3,156,7,9,172,224,0.321,0.768
"28208","Beni","Guayaramerín","U.E.  Evangélico Nacional",70,0,1,0,72,21,15,1,0,180,2,0,182,221,0.4,0.824
"28209","Beni","Guayaramerín","U.E.  Evangélico Nacional",74,2,1,0,42,31,12,2,2,166,6,6,178,219,0.253,0.813
"28210","Beni","Guayaramerín","U.E.  Evangélico Nacional",70,0,1,1,64,22,11,4,2,175,3,5,183,223,0.366,0.821
"28211","Beni","Guayaramerín","U.E.  Evangélico Nacional",84,1,2,0,41,21,5,3,3,160,5,8,173,210,0.256,0.824
"28212","Beni","Guayaramerín","U.E.  Evangélico Nacional",82,1,2,0,36,17,10,5,3,156,2,8,166,213,0.231,0.779
"28213","Beni","Guayaramerín","U.E.  Manuel Antonio Ojopi",91,1,0,1,40,29,8,8,3,181,4,4,189,220,0.221,0.859
"28214","Beni","Guayaramerín","U.E.  Manuel Antonio Ojopi",80,0,0,0,49,35,9,8,3,184,5,4,193,225,0.266,0.858
"28215","Beni","Guayaramerín","U.E.  Manuel Antonio Ojopi",64,0,2,1,53,37,10,12,1,180,5,4,189,224,0.294,0.844
"28216","Beni","Guayaramerín","U.E.  Manuel Antonio Ojopi",78,0,3,1,53,21,6,6,3,171,2,5,178,224,0.31,0.795
"28217","Beni","Guayaramerín","U.E.  Manuel Antonio Ojopi",71,1,0,1,53,32,8,8,0,174,5,4,183,219,0.305,0.836
"28218","Beni","Guayaramerín","U.E.  Manuel Antonio Ojopi",79,0,1,1,57,25,11,9,1,184,5,7,196,230,0.31,0.852
"28219","Beni","Guayaramerín","U.E.  Manuel Antonio Ojopi",77,0,0,0,57,24,13,2,2,175,3,3,181,218,0.326,0.83
"28220","Beni","Guayaramerín","U.E.  Manuel Antonio Ojopi",71,1,1,0,61,26,10,2,0,172,6,2,180,223,0.355,0.807
"28221","Beni","Guayaramerín","U.E.  Manuel Antonio Ojopi",75,1,1,0,45,30,12,6,0,170,9,8,187,225,0.265,0.831
"28222","Beni","Guayaramerín","U.E.  Manuel Antonio Ojopi",72,0,0,2,58,37,5,11,2,187,1,4,192,227,0.31,0.846
"28223","Beni","Guayaramerín","U.E.  Manuel Antonio Ojopi",88,0,0,1,46,27,5,7,1,175,7,6,188,226,0.263,0.832
"28224","Beni","Guayaramerín","U.E.  Manuel Antonio Ojopi",78,1,0,0,49,28,8,9,1,174,6,6,186,215,0.282,0.865
"28225","Beni","Guayaramerín","U.E.  Manuel Antonio Ojopi",75,1,0,2,47,33,7,6,1,172,4,6,182,226,0.273,0.805
"28226","Beni","Guayaramerín","U.E.  Manuel Antonio Ojopi",77,1,1,0,48,32,10,3,1,173,1,6,180,219,0.277,0.822
"28227","Beni","Guayaramerín","U.E.  Manuel Antonio Ojopi",87,0,1,0,53,26,12,6,1,186,6,6,198,227,0.285,0.872
"28228","Beni","Guayaramerín","U.E.  San Jose",73,0,0,0,42,43,6,6,0,170,3,8,181,220,0.247,0.823
"28229","Beni","Guayaramerín","U.E.  San Jose",64,2,0,1,46,44,11,4,0,172,6,7,185,226,0.267,0.819
"28230","Beni","Guayaramerín","U.E.  San Jose",61,0,2,0,52,43,5,8,0,171,7,6,184,228,0.304,0.807
"28231","Beni","Guayaramerín","U.E.  San Jose",67,1,0,0,45,43,7,5,1,169,5,4,178,217,0.266,0.82
"28232","Beni","Guayaramerín","U.E.  San Jose",71,1,0,1,51,41,4,3,0,172,5,7,184,220,0.297,0.836
"28233","Beni","Guayaramerín","U.E.  San Jose",77,0,1,0,47,31,4,10,2,172,3,6,181,218,0.273,0.83
"28234","Beni","Guayaramerín","U.E.  San Jose",89,2,0,1,43,30,7,4,1,177,5,4,186,227,0.243,0.819
"28235","Beni","Guayaramerín","U.E.  San Jose",55,0,1,0,50,44,7,6,1,164,1,4,169,204,0.305,0.828
"28236","Beni","Guayaramerín","U.E.  6 de Junio",62,1,1,1,56,38,20,3,0,182,6,6,194,227,0.308,0.855
"28237","Beni","Guayaramerín","U.E.  6 de Junio",59,1,0,0,51,50,14,6,1,182,12,4,198,230,0.28,0.861
"28238","Beni","Guayaramerín","U.E.  6 de Junio",56,0,2,0,63,49,12,4,0,186,1,8,195,228,0.339,0.855
"28239","Beni","Guayaramerín","U.E.  6 de Junio",61,1,0,0,58,36,10,1,0,167,7,11,185,223,0.347,0.83
"28240","Beni","Guayaramerín","U.E.  6 de Junio",76,2,0,1,47,44,7,5,0,182,6,10,198,229,0.258,0.865
"28241","Beni","Guayaramerín","U.E.  6 de Junio",63,0,2,1,40,55,9,8,1,179,5,9,193,228,0.223,0.846
"28242","Beni","Guayaramerín","U.E.  6 de Junio",66,0,0,1,62,35,10,4,0,178,2,15,195,230,0.348,0.848
"28243","Beni","Guayaramerín","U.E.  6 de Junio",70,0,2,1,59,42,13,6,0,193,1,5,199,225,0.306,0.884
"28244","Beni","Guayaramerín","U.E.  6 de Junio",67,1,0,1,42,46,16,4,0,177,9,14,200,222,0.237,0.901
"28245","Beni","Guayaramerín","U.E.  Alto de la Alianza",71,0,2,0,48,38,8,4,0,171,5,6,182,221,0.281,0.824
"28246","Beni","Guayaramerín","U.E.  Alto de la Alianza",46,0,2,3,52,47,12,4,1,167,9,11,187,227,0.311,0.824
"28247","Beni","Guayaramerín","U.E.  Alto de la Alianza",52,1,1,1,68,32,8,13,0,176,7,7,190,220,0.386,0.864
"28248","Beni","Guayaramerín","U.E.  Alto de la Alianza",67,2,1,1,53,34,13,4,0,175,2,13,190,230,0.303,0.826
"28249","Beni","Guayaramerín","U.E.  Alto de la Alianza",73,0,0,0,59,32,8,7,1,180,5,7,192,227,0.328,0.846
"28250","Beni","Guayaramerín","U.E.  Alto de la Alianza",48,0,0,3,78,33,20,4,0,186,5,4,195,227,0.419,0.859
"28251","Beni","Guayaramerín","U.E.  Alto de la Alianza",57,1,0,0,56,42,10,7,0,173,5,13,191,232,0.324,0.823
"28252","Beni","Guayaramerín","U.E.  Alto de la Alianza",66,0,0,1,55,39,15,8,2,186,4,3,193,230,0.296,0.839
"28253","Beni","Guayaramerín","U.E.  Alto de la Alianza",62,0,1,1,60,36,10,11,0,181,3,7,191,225,0.331,0.849
"28254","Beni","Guayaramerín","U.E.  Alto de la Alianza",60,1,0,1,46,49,10,4,1,172,3,10,185,226,0.267,0.819
"28255","Beni","Guayaramerín","U.E.  Alto de la Alianza",61,0,2,4,65,36,13,7,1,189,3,1,193,225,0.344,0.858
"28256","Beni","Guayaramerín","U.E.  Elmer Botsford",87,0,1,0,36,37,4,3,1,169,0,7,176,217,0.213,0.811
"28257","Beni","Guayaramerín","U.E.  Elmer Botsford",83,0,2,0,48,26,3,3,0,165,0,5,170,217,0.291,0.783
"28258","Beni","Guayaramerín","U.E.  Elmer Botsford",80,0,0,1,38,35,6,13,0,173,2,5,180,213,0.22,0.845
"28259","Beni","Guayaramerín","U.E.  Elmer Botsford",97,0,1,2,42,29,3,7,0,181,4,1,186,217,0.232,0.857
"28260","Beni","Guayaramerín","U.E.   Antonio Vaca Diez",67,1,0,0,45,37,9,3,0,162,5,6,173,228,0.278,0.759
"28261","Beni","Guayaramerín","U.E.   Antonio Vaca Diez",75,0,0,2,52,31,9,6,0,175,2,6,183,225,0.297,0.813
"28262","Beni","Guayaramerín","U.E.   Manuel Vicente Ballivian",82,2,2,0,43,16,15,4,1,165,4,3,172,235,0.261,0.732
"28263","Beni","Guayaramerín","U.E.   Manuel Vicente Ballivian",87,0,2,0,42,22,9,3,4,169,1,4,174,236,0.249,0.737
"28264","Beni","Guayaramerín","U.E.   Manuel Vicente Ballivian",85,0,1,1,36,27,9,4,1,164,1,5,170,216,0.22,0.787
"28265","Beni","Guayaramerín","U.E. Miguel Antelo",73,0,1,0,54,52,7,7,3,197,3,5,205,237,0.274,0.865
"28266","Beni","Guayaramerín","U.E. Miguel Antelo",47,0,1,0,48,53,8,5,2,164,4,11,179,206,0.293,0.869
"28267","Beni","Guayaramerín","U.E.   Brasil",69,1,2,0,55,46,12,9,1,195,4,6,205,236,0.282,0.869
"28268","Beni","Guayaramerín","U.E.   Brasil",77,0,0,0,64,36,14,4,3,198,5,6,209,238,0.323,0.878
"28269","Beni","Guayaramerín","U.E.   Brasil",80,0,0,0,56,32,16,8,1,193,3,15,211,233,0.29,0.906
"28270","Beni","Guayaramerín","U.E.   Brasil",75,0,0,0,48,43,17,4,0,187,4,9,200,233,0.257,0.858
"28271","Beni","Guayaramerín","U.E. Belen",64,3,0,0,78,38,18,4,2,207,6,5,218,236,0.377,0.924
"28272","Beni","Guayaramerín","U.E. Belen",54,2,2,1,76,32,11,2,1,181,11,17,209,237,0.42,0.882
"28273","Beni","Guayaramerín","U.E. Belen",60,0,1,1,62,54,10,3,1,192,9,5,206,234,0.323,0.88
"28274","Beni","Guayaramerín","U.E. Simón Bolívar",62,1,1,0,48,48,19,11,6,196,2,2,200,233,0.245,0.858
"28275","Beni","Guayaramerín","U.E. Simón Bolívar",68,1,1,0,63,40,14,6,0,193,8,5,206,233,0.326,0.884
"28276","Beni","Guayaramerín","U.E. 9 de Abril",59,1,0,1,62,44,21,11,1,200,8,10,218,239,0.31,0.912
"28277","Beni","Guayaramerín","U.E. 9 de Abril",65,2,2,1,67,42,7,11,0,197,10,8,215,237,0.34,0.907
"28278","Beni","Guayaramerín","U.E. 9 de Abril",65,4,0,2,68,52,13,2,0,206,7,5,218,235,0.33,0.928
"28279","Beni","Reyes","U.E. Rene Barrientos Ortuño",82,1,0,0,71,16,7,10,0,187,6,7,200,233,0.38,0.858
"28280","Beni","Reyes","U.E. Rene Barrientos Ortuño",77,0,1,0,72,23,9,8,2,192,7,8,207,235,0.375,0.881
"28281","Beni","Reyes","U.E. Rene Barrientos Ortuño",63,0,0,1,91,27,16,6,2,206,8,7,221,239,0.442,0.925
"28282","Beni","Reyes","U.E. Rene Barrientos Ortuño",77,0,0,0,69,21,12,11,0,190,5,14,209,234,0.363,0.893
"28283","Beni","Reyes","U.E. Nacional de Reyes",84,0,2,0,54,25,3,13,0,181,2,7,190,213,0.298,0.892
"28284","Beni","Reyes","U.E. Nacional de Reyes",61,0,1,1,67,26,9,9,0,174,3,7,184,215,0.385,0.856
"28285","Beni","Reyes","U.E. Nacional de Reyes",77,1,0,1,59,18,8,7,2,173,9,4,186,220,0.341,0.845
"28286","Beni","Reyes","U.E. Nacional de Reyes",69,0,2,0,64,16,2,16,1,170,7,9,186,214,0.376,0.869
"28287","Beni","Reyes","U.E. Nacional de Reyes",78,1,1,0,65,15,5,9,0,174,9,7,190,223,0.374,0.852
"28288","Beni","Reyes","U.E. Nacional de Reyes",75,0,1,0,60,28,2,10,0,176,3,9,188,219,0.341,0.858
"28289","Beni","Reyes","U.E. Nacional de Reyes",72,0,0,0,53,28,3,9,2,167,6,6,179,215,0.317,0.833
"28290","Beni","Reyes","U.E. Nacional de Reyes",89,0,2,0,55,17,6,10,2,181,3,3,187,225,0.304,0.831
"28291","Beni","Reyes","U.E. Jesus Alvarez Rodriguez",77,2,1,2,53,27,3,13,0,178,6,11,195,228,0.298,0.855
"28292","Beni","Reyes","U.E. Jesus Alvarez Rodriguez",71,0,2,0,60,21,9,10,0,173,9,4,186,220,0.347,0.845
"28293","Beni","Reyes","U.E. Jesus Alvarez Rodriguez",83,0,0,1,50,13,5,10,0,162,11,10,183,217,0.309,0.843
"28294","Beni","Reyes","U.E. Jesus Alvarez Rodriguez",79,1,2,1,49,29,3,15,2,181,7,10,198,223,0.271,0.888
"28295","Beni","Reyes","U.E. Jesus Alvarez Rodriguez",71,0,3,3,70,21,4,15,0,187,7,8,202,224,0.374,0.902
"28296","Beni","Reyes","U.E. Jesus Alvarez Rodriguez",80,0,2,0,60,22,6,9,0,179,7,10,196,225,0.335,0.871
"28297","Beni","Reyes","U.E. Jesus Alvarez Rodriguez",85,1,1,0,50,22,3,17,3,182,2,7,191,226,0.275,0.845
"28298","Beni","Reyes","U.E. Jesus Alvarez Rodriguez",96,0,0,0,48,15,6,6,1,172,3,8,183,216,0.279,0.847
"28299","Beni","Reyes","U.E. Jesus Alvarez Rodriguez",80,0,0,1,68,26,5,14,0,194,4,5,203,231,0.351,0.879
"28300","Beni","Reyes","Esc. Buen Destino",18,1,3,3,111,15,4,6,3,164,10,8,182,205,0.677,0.888
"28301","Beni","San Borja","U.E. San Francisco De Borja",78,0,0,0,52,24,10,13,1,178,3,6,187,227,0.292,0.824
"28302","Beni","San Borja","U.E. San Francisco De Borja",68,0,0,0,53,26,10,7,1,165,4,10,179,214,0.321,0.836
"28303","Beni","San Borja","U.E. San Francisco De Borja",61,1,1,0,49,38,6,10,1,167,3,10,180,223,0.293,0.807
"28304","Beni","San Borja","U.E. San Francisco De Borja",58,0,1,0,50,30,11,13,0,163,3,9,175,223,0.307,0.785
"28305","Beni","San Borja","U.E. San Francisco De Borja",75,1,0,2,48,23,7,16,3,175,1,3,179,218,0.274,0.821
"28306","Beni","San Borja","U.E. San Francisco De Borja",65,2,0,2,48,28,3,15,1,164,5,12,181,221,0.293,0.819
"28307","Beni","San Borja","U.E. San Francisco De Borja",60,2,0,1,66,19,5,11,1,165,5,8,178,224,0.4,0.795
"28308","Beni","San Borja","U.E. San Francisco De Borja",59,1,0,1,48,34,5,21,1,170,3,9,182,220,0.282,0.827
"28309","Beni","San Borja","U.E. San Francisco De Borja",62,0,0,0,40,32,9,13,0,156,5,11,172,224,0.256,0.768
"28310","Beni","San Borja","U.E. San Francisco De Borja",51,0,1,0,71,24,12,22,1,182,6,5,193,222,0.39,0.869
"28311","Beni","San Borja","U.E. San Francisco De Borja",55,0,0,0,41,43,10,11,1,161,2,8,171,220,0.255,0.777
"28312","Beni","San Borja","U.E. San Francisco De Borja",64,2,1,2,50,33,5,13,1,171,5,4,180,222,0.292,0.811
"28313","Beni","San Borja","U.E. San Francisco De Borja",63,2,0,1,45,33,9,15,2,170,7,9,186,221,0.265,0.842
"28314","Beni","San Borja","U.E. San Francisco De Borja",68,0,0,1,40,28,12,20,1,170,8,9,187,219,0.235,0.854
"28315","Beni","San Borja","U.E. German Busch",93,0,0,3,35,23,7,10,0,171,7,11,189,226,0.205,0.836
"28316","Beni","San Borja","U.E. German Busch",63,0,0,1,50,25,6,23,1,169,3,5,177,224,0.296,0.79
"28317","Beni","San Borja","U.E. German Busch",48,1,2,2,58,31,10,15,2,169,10,12,191,229,0.343,0.834
"28318","Beni","San Borja","U.E. German Busch",72,1,1,0,40,29,5,20,0,168,7,9,184,224,0.238,0.821
"28319","Beni","San Borja","U.E. German Busch",46,0,0,1,47,39,4,19,3,159,8,5,172,227,0.296,0.758
"28320","Beni","San Borja","U.E. German Busch",55,0,0,0,66,21,9,23,3,177,2,11,190,225,0.373,0.844
"28321","Beni","San Borja","U.E. German Busch",62,1,0,1,47,32,6,25,1,175,9,6,190,227,0.269,0.837
"28322","Beni","San Borja","U.E. German Busch",61,0,1,0,56,24,8,20,0,170,8,8,186,222,0.329,0.838
"28323","Beni","San Borja","U.E. German Busch",61,1,1,5,40,25,10,19,1,163,6,8,177,216,0.245,0.819
"28324","Beni","San Borja","U.E. German Busch",68,1,0,0,39,23,12,17,1,161,11,8,180,224,0.242,0.804
"28325","Beni","San Borja","U.E. Arnulfo Martínez",35,0,0,3,66,22,14,18,0,158,7,5,170,220,0.418,0.773
"28326","Beni","San Borja","U.E. Arnulfo Martínez",65,1,0,5,51,23,0,20,0,165,11,6,182,230,0.309,0.791
"28327","Beni","San Borja","U.E. Arnulfo Martínez",40,1,4,4,54,19,9,27,0,158,13,12,183,226,0.342,0.81
"28328","Beni","San Borja","U.E. Arnulfo Martínez",38,0,1,1,85,21,8,14,4,172,6,5,183,227,0.494,0.806
"28329","Beni","San Borja","U.E. Arnulfo Martínez",45,0,0,0,59,22,14,15,0,155,6,5,166,222,0.381,0.748
"28330","Beni","San Borja","U.E. Arnulfo Martínez",43,1,2,5,53,24,5,23,1,157,9,9,175,226,0.338,0.774
"28331","Beni","San Borja","U.E. Arnulfo Martínez",44,1,2,1,68,21,10,23,0,170,3,11,184,228,0.4,0.807
"28332","Beni","San Borja","U.E. Arnulfo Martínez",66,0,2,2,69,16,15,10,1,181,2,5,188,226,0.381,0.832
"28333","Beni","San Borja","U.E. Arnulfo Martínez",43,1,0,0,54,36,7,26,0,167,3,4,174,219,0.323,0.795
"28334","Beni","San Borja","U.E. Arnulfo Martínez",50,1,1,1,49,16,16,24,1,159,10,9,178,221,0.308,0.805
"28335","Beni","San Borja","U.E. Arnulfo Martínez",39,0,1,5,86,25,9,8,0,173,3,7,183,222,0.497,0.824
"28336","Beni","San Borja","U.E. Arnulfo Martínez",43,3,0,1,58,24,15,26,1,171,4,10,185,224,0.339,0.826
"28337","Beni","San Borja","U.E. Arnulfo Martínez",48,0,1,0,60,18,8,24,0,159,5,10,174,222,0.377,0.784
"28338","Beni","San Borja","U.E. Arnulfo Martínez",41,2,1,2,50,31,10,25,0,162,5,8,175,221,0.309,0.792
"28339","Beni","San Borja","U.E. Arnulfo Martínez",45,1,0,0,71,30,12,12,2,173,7,10,190,239,0.41,0.795
"28340","Beni","San Borja","U.E. Villa San Antonio",46,0,0,1,75,22,24,13,1,182,6,8,196,234,0.412,0.838
"28341","Beni","San Borja","U.E. Villa San Antonio",47,0,0,2,68,20,20,29,3,189,7,9,205,235,0.36,0.872
"28342","Beni","San Borja","U.E. Villa San Antonio",37,0,3,1,71,28,30,17,0,187,7,9,203,236,0.38,0.86
"28343","Beni","San Borja","U.E. Villa San Antonio",45,4,0,3,70,37,19,19,2,199,11,7,217,248,0.352,0.875
"28344","Beni","San Borja","U.E. San Ignacio Del Maniqui",33,1,0,1,71,33,12,25,0,176,6,13,195,233,0.403,0.837
"28345","Beni","San Borja","U.E. San Ignacio Del Maniqui",36,0,0,1,82,31,12,23,0,185,11,16,212,231,0.443,0.918
"28346","Beni","San Borja","U.E. San Ignacio Del Maniqui",23,0,1,0,74,32,24,17,0,171,10,11,192,233,0.433,0.824
"28347","Beni","San Borja","U.E. 18 de Noviembre",67,0,1,2,56,38,18,14,0,196,8,12,216,239,0.286,0.904
"28348","Beni","San Borja","U.E. 18 de Noviembre",64,1,0,1,58,35,20,11,1,191,10,7,208,237,0.304,0.878
"28349","Beni","San Borja","U.E. 18 de Noviembre",57,0,0,0,54,42,15,23,1,192,5,12,209,238,0.281,0.878
"28350","Beni","San Borja","U.E. 18 de Noviembre",64,1,0,1,43,27,12,8,1,157,9,13,179,210,0.274,0.852
"28351","Beni","San Borja","U.E. Cochabamba",65,0,0,1,78,23,18,11,1,197,4,11,212,239,0.396,0.887
"28352","Beni","San Borja","U.E. Cochabamba",69,1,0,3,81,31,24,11,2,222,7,14,243,257,0.365,0.946
"28353","Beni","San Borja","Col. Industrial Ingavi",32,0,5,0,93,21,27,2,1,181,5,11,197,226,0.514,0.872
"28354","Beni","San Borja","Col. Industrial Ingavi",32,2,5,0,96,8,28,4,2,177,5,6,188,230,0.542,0.817
"28355","Beni","San Borja","Col. Industrial Ingavi",23,0,7,1,107,17,12,7,3,177,7,12,196,226,0.605,0.867
"28356","Beni","San Borja","Col. Industrial Ingavi",17,2,7,0,119,13,21,2,1,182,6,9,197,231,0.654,0.853
"28357","Beni","San Borja","Col. Industrial Ingavi",21,2,5,0,93,20,22,5,0,168,6,12,186,227,0.554,0.819
"28358","Beni","San Borja","Col. Industrial Ingavi",20,1,10,1,115,13,26,3,0,189,2,4,195,227,0.608,0.859
"28359","Beni","San Borja","Col. Industrial Ingavi",15,2,8,1,120,10,16,2,2,176,2,14,192,227,0.682,0.846
"28360","Beni","San Borja","Col. Industrial Ingavi",20,1,5,1,114,16,15,2,1,175,4,15,194,228,0.651,0.851
"28361","Beni","San Borja","Col. Industrial Ingavi",20,1,6,0,108,21,23,4,3,186,3,6,195,233,0.581,0.837
"28362","Beni","San Borja","Col. Industrial Ingavi",17,0,5,1,117,5,30,3,0,178,6,3,187,221,0.657,0.846
"28363","Beni","San Borja","Col. Industrial Ingavi",21,0,4,2,117,18,22,3,0,187,8,10,205,230,0.626,0.891
"28364","Beni","San Borja","Col. Industrial Ingavi",18,1,3,1,122,15,17,6,0,183,8,7,198,229,0.667,0.865
"28365","Beni","San Borja","Col. Industrial Ingavi",29,0,3,0,99,20,29,3,0,183,5,8,196,221,0.541,0.887
"28366","Beni","San Borja","Esc. El Palmar",10,0,3,0,143,7,23,3,1,190,3,6,199,220,0.753,0.905
"28367","Beni","San Borja","Esc. El Palmar",13,1,4,0,142,8,15,3,0,186,12,4,202,228,0.763,0.886
"28368","Beni","San Borja","Esc. El Palmar",13,1,1,0,141,10,19,3,0,188,3,10,201,231,0.75,0.87
"28369","Beni","San Borja","Esc. La Cruz",2,0,2,1,112,33,19,2,0,171,11,15,197,236,0.655,0.835
"28370","Beni","San Borja","Esc. La Cruz",0,3,1,0,114,47,13,4,0,182,13,12,207,237,0.626,0.873
"28371","Beni","San Borja","Esc. La Cruz",5,0,1,1,149,27,15,1,0,199,10,10,219,240,0.749,0.912
"28372","Beni","San Borja","Esc. De Puerto Yucumo",0,1,2,1,108,87,1,0,1,201,7,8,216,238,0.537,0.908
"28373","Beni","San Borja","Esc. El Chacal",3,3,4,0,154,0,3,0,1,168,17,10,195,240,0.917,0.812
"28374","Beni","San Borja","Esc. Tacuaral De Mattos",1,1,0,0,177,0,2,3,0,184,5,9,198,238,0.962,0.832
"28375","Beni","San Borja","Esc. Tacuaral De Mattos",1,1,3,1,182,3,1,0,0,192,9,7,208,237,0.948,0.878
"28376","Beni","San Borja","Esc. Indigena Arenales",0,2,1,1,142,31,7,2,0,186,7,14,207,240,0.763,0.863
"28377","Beni","San Borja","Esc. Indigena Arenales",0,2,2,0,156,32,6,2,0,200,5,8,213,244,0.78,0.873
"28378","Beni","San Borja","Esc. Mision Fatima",1,1,2,0,152,28,0,0,1,185,14,5,204,238,0.822,0.857
"28379","Beni","San Borja","Esc. Mision Fatima",1,1,1,2,151,17,0,1,1,175,11,13,199,238,0.863,0.836
"28380","Beni","San Borja","U.E. Quiquibey",10,1,1,1,161,14,13,1,0,202,6,4,212,225,0.797,0.942
"28381","Beni","San Borja","U.E. Manguito",0,2,3,0,146,5,9,3,0,168,9,12,189,237,0.869,0.797
"28382","Beni","San Borja","U.E. Manguito",1,4,5,2,154,4,16,0,0,186,11,11,208,245,0.828,0.849
"28383","Beni","San Borja","U.E. Marca Coroico",0,2,3,1,147,1,14,2,1,171,5,19,195,202,0.86,0.965
"28384","Beni","San Borja","U.E. Galilea",18,3,2,1,122,21,25,16,1,209,11,12,232,240,0.584,0.967
"28385","Beni","San Borja","U.E. Galilea",12,1,2,1,117,12,22,14,0,181,11,8,200,205,0.646,0.976
"28386","Beni","San Borja","U.E. Cooperativa Chimane",1,1,36,5,132,3,3,0,1,182,10,14,206,218,0.725,0.945
"28387","Beni","Santa Rosa","U.E. Gerardo Reyes",83,0,1,1,44,28,5,19,1,182,2,4,188,228,0.242,0.825
"28388","Beni","Santa Rosa","U.E. Gerardo Reyes",57,1,3,1,52,28,5,18,1,166,8,8,182,226,0.313,0.805
"28389","Beni","Santa Rosa","U.E. Gerardo Reyes",56,3,1,1,69,17,14,19,0,180,6,9,195,230,0.383,0.848
"28390","Beni","Santa Rosa","U.E. Gerardo Reyes",74,0,1,2,48,32,4,39,0,200,3,7,210,220,0.24,0.955
"28391","Beni","Santa Rosa","U.E. Gerardo Reyes",53,2,0,0,49,32,9,35,1,181,6,11,198,229,0.271,0.865
"28392","Beni","Santa Rosa","U.E. Gerardo Reyes",46,2,2,2,59,25,14,20,1,171,3,10,184,227,0.345,0.811
"28393","Beni","Santa Rosa","U.E. Gerardo Reyes",85,3,3,2,34,25,5,16,2,175,4,7,186,224,0.194,0.83
"28394","Beni","Santa Rosa","U.E. Gerardo Reyes",72,0,3,1,58,27,7,17,2,187,5,3,195,224,0.31,0.871
"28395","Beni","Santa Rosa","U.E. Gerardo Reyes",69,1,0,0,67,31,14,13,0,195,3,4,202,227,0.344,0.89
"28396","Beni","Santa Rosa","U.E. Gerardo Reyes",69,1,0,4,39,36,5,27,1,182,4,10,196,221,0.214,0.887
"28397","Beni","Santa Rosa","U.E. Gerardo Reyes",63,0,2,0,52,33,14,14,2,180,7,9,196,223,0.289,0.879
"28398","Beni","Santa Rosa","U.E. Gerardo Reyes",58,0,0,1,54,24,4,35,0,176,1,10,187,229,0.307,0.817
"28399","Beni","Santa Rosa","U.E. Umbelina Claure de Cuellar",64,0,0,0,54,31,6,19,1,175,7,7,189,236,0.309,0.801
"28400","Beni","Santa Rosa","U.E. Umbelina Claure de Cuellar",54,0,1,1,69,25,10,20,0,180,6,6,192,235,0.383,0.817
"28401","Beni","Santa Rosa","U.E. Umbelina Claure de Cuellar",57,2,1,1,60,22,12,22,2,179,6,12,197,236,0.335,0.835
"28402","Beni","Santa Rosa","U.E. Umbelina Claure de Cuellar",74,0,1,0,52,27,8,18,1,181,4,7,192,234,0.287,0.821
"28403","Beni","Santa Rosa","U.E. Umbelina Claure de Cuellar",64,0,1,0,53,30,12,19,1,180,5,8,193,237,0.294,0.814
"28404","Beni","Santa Rosa","Esc. El Triunfo",86,0,5,1,42,27,1,16,0,178,9,11,198,231,0.236,0.857
"28405","Beni","Santa Rosa","Esc. Puerto Yata",56,3,0,4,55,15,10,10,1,154,11,7,172,202,0.357,0.851
"28406","Beni","Santa Rosa","Escuela Australia",31,4,2,3,100,16,10,14,0,180,11,11,202,234,0.556,0.863
"28407","Beni","Puerto Menor de Rurrenabaque","Esc. Central Piedras Blancas",5,1,4,2,114,11,18,0,1,156,4,6,166,213,0.731,0.779
"28408","Beni","Puerto Menor de Rurrenabaque","Esc. Gualberto Villarruel",74,1,1,0,55,29,7,2,1,170,6,8,184,226,0.324,0.814
"28409","Beni","Puerto Menor de Rurrenabaque","Esc. Gualberto Villarruel",64,1,0,1,57,25,10,2,0,160,3,14,177,220,0.356,0.805
"28410","Beni","Puerto Menor de Rurrenabaque","Esc. Gualberto Villarruel",69,3,0,1,61,25,14,2,0,175,4,7,186,228,0.349,0.816
"28411","Beni","Puerto Menor de Rurrenabaque","Esc. Gualberto Villarruel",55,0,0,1,69,42,11,3,1,182,4,6,192,223,0.379,0.861
"28412","Beni","Puerto Menor de Rurrenabaque","Esc. Gualberto Villarruel",50,0,0,2,92,25,14,2,0,185,7,5,197,226,0.497,0.872
"28413","Beni","Puerto Menor de Rurrenabaque","Esc. Gualberto Villarruel",58,0,0,0,51,46,12,6,1,174,5,11,190,224,0.293,0.848
"28414","Beni","Puerto Menor de Rurrenabaque","Esc. Gualberto Villarruel",65,1,2,1,57,43,10,9,0,188,2,7,197,230,0.303,0.857
"28415","Beni","Puerto Menor de Rurrenabaque","Esc. Gualberto Villarruel",60,0,0,1,63,33,15,11,2,185,5,2,192,228,0.341,0.842
"28416","Beni","Puerto Menor de Rurrenabaque","Esc. Gualberto Villarruel",79,0,1,0,50,28,15,2,0,175,1,11,187,225,0.286,0.831
"28417","Beni","Puerto Menor de Rurrenabaque","Esc. Gualberto Villarruel",45,0,2,0,82,37,12,2,0,180,2,8,190,223,0.456,0.852
"28418","Beni","Puerto Menor de Rurrenabaque","Esc. Gualberto Villarruel",60,2,0,0,64,37,15,3,3,184,5,6,195,225,0.348,0.867
"28419","Beni","Puerto Menor de Rurrenabaque","Esc. Gualberto Villarruel",67,0,0,0,46,39,13,2,1,168,3,9,180,228,0.274,0.789
"28420","Beni","Puerto Menor de Rurrenabaque","Esc. Gualberto Villarruel",61,0,0,1,52,32,18,4,1,169,6,12,187,223,0.308,0.839
"28421","Beni","Puerto Menor de Rurrenabaque","Esc. Gualberto Villarruel",54,0,0,0,68,33,15,5,0,175,0,11,186,221,0.389,0.842
"28422","Beni","Puerto Menor de Rurrenabaque","Esc. Gualberto Villarruel",72,0,1,1,48,30,15,7,2,176,4,4,184,222,0.273,0.829
"28423","Beni","Puerto Menor de Rurrenabaque","Esc. Gualberto Villarruel",66,1,0,0,55,26,20,3,1,172,5,13,190,223,0.32,0.852
"28424","Beni","Puerto Menor de Rurrenabaque","Esc. Gualberto Villarruel",76,3,0,2,59,29,10,1,1,181,4,13,198,233,0.326,0.85
"28425","Beni","Puerto Menor de Rurrenabaque","Unidad Educativa Lucio Lens",53,1,2,0,50,38,30,2,1,177,5,5,187,229,0.282,0.817
"28426","Beni","Puerto Menor de Rurrenabaque","Unidad Educativa Lucio Lens",49,2,3,1,64,46,17,2,1,185,6,7,198,227,0.346,0.872
"28427","Beni","Puerto Menor de Rurrenabaque","Unidad Educativa Lucio Lens",55,0,1,1,54,44,16,4,0,175,5,15,195,223,0.309,0.874
"28428","Beni","Puerto Menor de Rurrenabaque","Unidad Educativa Lucio Lens",51,0,0,2,41,63,17,5,1,180,3,10,193,227,0.228,0.85
"28429","Beni","Puerto Menor de Rurrenabaque","Unidad Educativa Lucio Lens",51,0,0,0,43,48,17,5,0,164,4,14,182,227,0.262,0.802
"28430","Beni","Puerto Menor de Rurrenabaque","Unidad Educativa Lucio Lens",18,1,2,0,108,28,26,3,1,187,9,5,201,230,0.578,0.874
"28431","Beni","Puerto Menor de Rurrenabaque","Unidad Educativa Lucio Lens",63,0,0,0,64,27,17,6,1,178,6,9,193,226,0.36,0.854
"28432","Beni","Puerto Menor de Rurrenabaque","Unidad Educativa Lucio Lens",40,0,2,0,72,51,16,8,1,190,5,9,204,233,0.379,0.876
"28433","Beni","Puerto Menor de Rurrenabaque","Unidad Educativa Lucio Lens",61,1,0,0,45,40,30,6,0,183,7,10,200,227,0.246,0.881
"28434","Beni","Puerto Menor de Rurrenabaque","Unidad Educativa Lucio Lens",56,0,1,1,66,34,21,0,1,180,2,11,193,223,0.367,0.865
"28435","Beni","Puerto Menor de Rurrenabaque","Unidad Educativa Lucio Lens",61,1,0,0,70,32,10,3,0,177,3,12,192,225,0.395,0.853
"28436","Beni","Puerto Menor de Rurrenabaque","Unidad Educativa Lucio Lens",41,0,0,0,67,39,21,5,3,176,3,10,189,225,0.381,0.84
"28437","Beni","Puerto Menor de Rurrenabaque","Unidad Educativa Lucio Lens",31,2,3,1,57,58,24,3,1,180,9,4,193,230,0.317,0.839
"28438","Beni","Puerto Menor de Rurrenabaque","Unidad Educativa Lucio Lens",53,1,1,0,59,36,22,4,1,177,3,8,188,222,0.333,0.847
"28439","Beni","Puerto Menor de Rurrenabaque","Unidad Educativa Lucio Lens",51,0,0,1,56,47,19,3,0,177,6,8,191,225,0.316,0.849
"28440","Beni","Puerto Menor de Rurrenabaque","Unidad Educativa Lucio Lens",52,1,1,0,58,42,25,5,0,184,2,4,190,221,0.315,0.86
"28441","Beni","Puerto Menor de Rurrenabaque","Unidad Educativa Lucio Lens",41,1,1,0,87,27,19,6,1,183,4,12,199,231,0.475,0.861
"28442","Beni","Puerto Menor de Rurrenabaque","Unidad Educativa Lucio Lens",40,1,0,1,58,43,18,4,2,167,52,10,229,229,0.347,1
"28443","Beni","Puerto Menor de Rurrenabaque","Unidad Educativa Lucio Lens",46,0,2,0,58,47,15,6,0,174,8,11,193,225,0.333,0.858
"28444","Beni","Puerto Menor de Rurrenabaque","Unidad Educativa Lucio Lens",52,0,2,1,67,34,20,3,0,179,5,5,189,228,0.374,0.829
"28445","Beni","Puerto Menor de Rurrenabaque","Unidad Educativa Lucio Lens",45,1,1,1,71,35,25,1,0,180,6,14,200,231,0.394,0.866
"28446","Beni","Puerto Menor de Rurrenabaque","Unidad Educativa Lucio Lens",38,0,1,0,50,49,32,3,1,174,3,10,187,218,0.287,0.858
"28447","Beni","Puerto Menor de Rurrenabaque","Escuela Villa Lourdes",36,1,1,0,99,40,29,4,0,210,6,6,222,238,0.471,0.933
"28448","Beni","Puerto Menor de Rurrenabaque","Escuela Villa Lourdes",39,0,1,0,102,32,25,5,0,204,4,7,215,233,0.5,0.923
"28449","Beni","Puerto Menor de Rurrenabaque","Escuela Villa Lourdes",50,2,0,2,89,38,20,4,0,205,9,9,223,234,0.434,0.953
"28450","Beni","Puerto Menor de Rurrenabaque","Esc. Central Nuevos Horizontes",22,1,2,1,104,22,27,2,2,183,6,4,193,227,0.568,0.85
"28451","Beni","Puerto Menor de Rurrenabaque","Esc. Central Nuevos Horizontes",18,0,3,1,109,24,23,3,0,181,10,8,199,229,0.602,0.869
"28452","Beni","Puerto Menor de Rurrenabaque","Esc. Playa Ancha",5,0,0,2,131,4,11,1,1,155,8,5,168,184,0.845,0.913
"28453","Beni","Puerto Menor de Rurrenabaque","U.E. Collana Linares",9,1,3,0,191,3,19,0,0,226,5,5,236,240,0.845,0.983
"28454","Beni","Puerto Menor de Rurrenabaque","U.E. Collana Linares",6,0,1,1,195,2,15,0,2,222,6,2,230,239,0.878,0.962
"28455","Beni","Puerto Menor de Rurrenabaque","U.E. Bajo Colorado",2,1,1,2,203,5,8,0,1,223,7,1,231,240,0.91,0.963
"28456","Beni","Santa Ana","Esc. Cec. El Totaisal",17,1,6,2,136,8,3,11,0,184,11,9,204,235,0.739,0.868
"28457","Beni","Santa Ana","U.E. Andrés Alberdi Salegui",66,0,0,1,45,30,1,22,2,167,4,9,180,214,0.269,0.841
"28458","Beni","Santa Ana","U.E. Andrés Alberdi Salegui",70,0,0,0,39,31,7,20,1,168,4,8,180,222,0.232,0.811
"28459","Beni","Santa Ana","U.E. Andrés Alberdi Salegui",80,0,0,4,36,32,3,19,0,174,1,5,180,222,0.207,0.811
"28460","Beni","Santa Ana","U.E. Andrés Alberdi Salegui",62,0,0,0,39,28,8,28,0,165,4,8,177,219,0.236,0.808
"28461","Beni","Santa Ana","U.E. Andrés Alberdi Salegui",69,0,0,0,17,46,6,21,2,161,7,12,180,218,0.106,0.826
"28462","Beni","Santa Ana","U.E. Andrés Alberdi Salegui",52,0,0,0,40,39,4,19,0,154,7,10,171,214,0.26,0.799
"28463","Beni","Santa Ana","U.E. Andrés Alberdi Salegui",56,1,1,1,50,37,3,17,1,167,3,6,176,219,0.299,0.804
"28464","Beni","Santa Ana","U.E. Andrés Alberdi Salegui",74,0,1,0,33,45,3,23,0,179,2,2,183,220,0.184,0.832
"28465","Beni","Santa Ana","U.E. Andrés Alberdi Salegui",67,0,0,0,33,36,3,24,0,163,3,13,179,219,0.202,0.817
"28466","Beni","Santa Ana","U.E. Andrés Alberdi Salegui",71,0,0,0,36,39,3,16,0,165,1,5,171,217,0.218,0.788
"28467","Beni","Santa Ana","U.E. Andrés Alberdi Salegui",70,0,0,0,57,26,4,17,1,175,7,2,184,221,0.326,0.833
"28468","Beni","Santa Ana","U.E. Monseñor Daniel Rivero",39,2,0,0,60,22,5,38,3,169,5,6,180,210,0.355,0.857
"28469","Beni","Santa Ana","U.E. Monseñor Daniel Rivero",40,0,1,2,55,32,4,22,0,156,4,13,173,213,0.353,0.812
"28470","Beni","Santa Ana","U.E. Monseñor Daniel Rivero",48,0,1,0,36,25,4,36,1,151,10,8,169,213,0.238,0.793
"28471","Beni","Santa Ana","U.E. Monseñor Daniel Rivero",49,1,0,1,46,27,5,25,0,154,11,9,174,214,0.299,0.813
"28472","Beni","Santa Ana","U.E. Monseñor Daniel Rivero",42,0,2,0,54,29,12,27,1,167,5,3,175,221,0.323,0.792
"28473","Beni","Santa Ana","U.E. Monseñor Daniel Rivero",34,0,1,1,56,30,1,33,0,156,6,9,171,216,0.359,0.792
"28474","Beni","Santa Ana","U.E. Monseñor Daniel Rivero",53,1,0,1,34,31,6,26,0,152,2,9,163,206,0.224,0.791
"28475","Beni","Santa Ana","U.E. Monseñor Daniel Rivero",32,2,2,2,53,33,5,26,0,155,6,8,169,214,0.342,0.79
"28476","Beni","Santa Ana","U.E. Monseñor Daniel Rivero",53,0,1,1,48,29,9,32,1,174,7,1,182,225,0.276,0.809
"28477","Beni","Santa Ana","U.E. Monseñor Daniel Rivero",52,0,2,0,49,31,5,19,0,158,5,10,173,218,0.31,0.794
"28478","Beni","Santa Ana","U.E. Monseñor Daniel Rivero",56,0,1,2,39,29,6,31,0,164,3,8,175,220,0.238,0.795
"28479","Beni","Santa Ana","U.E. Monseñor Daniel Rivero",48,0,1,2,39,29,8,29,0,156,6,3,165,219,0.25,0.753
"28480","Beni","Santa Ana","U.E. Monseñor Daniel Rivero",53,0,0,1,44,25,2,38,0,163,4,10,177,215,0.27,0.823
"28481","Beni","Santa Ana","U.E. Guillermo Searle",58,0,0,1,55,49,8,10,1,182,4,10,196,236,0.302,0.831
"28482","Beni","Santa Ana","U.E. Guillermo Searle",57,0,3,1,53,36,7,19,0,176,8,6,190,237,0.301,0.802
"28483","Beni","Santa Ana","U.E. Guillermo Searle",62,1,0,1,46,31,6,20,0,167,6,14,187,235,0.275,0.796
"28484","Beni","Santa Ana","U.E. Guillermo Searle",52,1,0,0,42,54,10,15,0,174,4,5,183,239,0.241,0.766
"28485","Beni","Santa Ana","U.E. Guillermo Searle",57,1,1,0,55,43,8,18,0,183,6,6,195,236,0.301,0.826
"28486","Beni","Santa Ana","U.E. Guillermo Searle",64,2,1,0,50,35,8,14,0,174,4,5,183,232,0.287,0.789
"28487","Beni","Santa Ana","U.E. Guillermo Searle",63,1,1,1,45,39,12,19,1,182,9,6,197,234,0.247,0.842
"28488","Beni","Santa Ana","U.E. John Fitzgerald Kennedy",42,0,0,0,65,52,10,31,0,200,5,7,212,239,0.325,0.887
"28489","Beni","Santa Ana","Esc. Wenceslao Añez",10,0,0,0,86,36,7,23,0,162,5,20,187,219,0.531,0.854
"28490","Beni","Santa Ana","Esc. Wenceslao Añez",20,0,1,0,82,57,5,13,3,181,5,17,203,235,0.453,0.864
"28491","Beni","Exaltación","Esc. Jose Max Paredes",27,2,0,1,116,4,5,17,0,172,7,2,181,224,0.674,0.808
"28492","Beni","Exaltación","Esc. Jose Max Paredes",52,0,2,0,102,11,4,9,0,180,4,2,186,231,0.567,0.805
"28493","Beni","Exaltación","Esc. Coquinal",9,4,4,2,140,21,4,6,1,191,5,3,199,238,0.733,0.836
"28494","Beni","San Ignacio","L. Gilfredo Cortez Candia",55,0,4,1,99,10,6,5,0,180,5,8,193,226,0.55,0.854
"28495","Beni","San Ignacio","L. Gilfredo Cortez Candia",38,0,3,1,102,14,9,4,0,171,7,13,191,225,0.596,0.849
"28496","Beni","San Ignacio","L. Gilfredo Cortez Candia",33,0,2,1,104,27,11,6,2,186,5,7,198,227,0.559,0.872
"28497","Beni","San Ignacio","L. Gilfredo Cortez Candia",30,2,4,0,114,20,8,5,1,184,4,7,195,231,0.62,0.844
"28498","Beni","San Ignacio","L. Gilfredo Cortez Candia",29,0,2,1,129,19,12,3,0,195,6,6,207,233,0.662,0.888
"28499","Beni","San Ignacio","L. Gilfredo Cortez Candia",25,2,2,0,118,18,8,2,1,176,6,10,192,228,0.67,0.842
"28500","Beni","San Ignacio","L. Gilfredo Cortez Candia",42,2,4,0,101,18,9,15,1,192,8,4,204,228,0.526,0.895
"28501","Beni","San Ignacio","L. Gilfredo Cortez Candia",31,0,4,0,110,14,11,10,0,180,7,5,192,226,0.611,0.85
"28502","Beni","San Ignacio","L. Gilfredo Cortez Candia",49,0,1,0,100,16,7,5,0,178,10,6,194,231,0.562,0.84
"28503","Beni","San Ignacio","L. Gilfredo Cortez Candia",22,1,2,0,137,18,10,3,0,193,9,5,207,228,0.71,0.908
"28504","Beni","San Ignacio","L. Gilfredo Cortez Candia",26,0,2,1,128,16,5,6,0,184,5,5,194,224,0.696,0.866
"28505","Beni","San Ignacio","L. Gilfredo Cortez Candia",45,1,2,0,103,20,10,2,1,184,6,3,193,220,0.56,0.877
"28506","Beni","San Ignacio","L. Gilfredo Cortez Candia",40,2,1,0,100,12,12,9,0,176,8,8,192,229,0.568,0.838
"28507","Beni","San Ignacio","L. Gilfredo Cortez Candia",41,2,2,0,124,11,6,5,1,192,5,5,202,232,0.646,0.871
"28508","Beni","San Ignacio","L. Gilfredo Cortez Candia",30,0,1,1,125,23,10,5,0,195,6,4,205,232,0.641,0.884
"28509","Beni","San Ignacio","L. Gilfredo Cortez Candia",27,0,0,0,122,23,10,4,0,186,6,8,200,224,0.656,0.893
"28510","Beni","San Ignacio","U.E. Mayor Pedro Vaca Diez",50,0,3,0,93,16,13,10,0,185,1,5,191,227,0.503,0.841
"28511","Beni","San Ignacio","U.E. Mayor Pedro Vaca Diez",41,1,1,0,108,26,5,7,2,191,5,1,197,233,0.565,0.845
"28512","Beni","San Ignacio","U.E. Mayor Pedro Vaca Diez",33,0,2,0,123,18,11,6,0,193,2,6,201,228,0.637,0.882
"28513","Beni","San Ignacio","U.E. Mayor Pedro Vaca Diez",32,2,2,0,117,30,7,3,0,193,5,9,207,233,0.606,0.888
"28514","Beni","San Ignacio","U.E. Mayor Pedro Vaca Diez",33,1,2,0,124,18,7,9,1,195,2,5,202,230,0.636,0.878
"28515","Beni","San Ignacio","U.E. Mayor Pedro Vaca Diez",35,0,1,0,105,23,12,6,0,182,9,7,198,229,0.577,0.865
"28516","Beni","San Ignacio","U.E. Mayor Pedro Vaca Diez",34,0,5,0,108,27,8,6,0,188,4,7,199,227,0.574,0.877
"28517","Beni","San Ignacio","U.E. Mayor Pedro Vaca Diez",34,0,2,0,130,12,10,5,0,193,1,10,204,229,0.674,0.891
"28518","Beni","San Ignacio","U.E. Mayor Pedro Vaca Diez",25,1,1,0,126,16,7,2,0,178,10,5,193,225,0.708,0.858
"28519","Beni","San Ignacio","U.E. Mayor Pedro Vaca Diez",24,0,2,0,131,17,6,5,0,185,12,6,203,227,0.708,0.894
"28520","Beni","San Ignacio","U.E. Mayor Pedro Vaca Diez",29,0,3,0,106,14,10,8,1,171,6,3,180,219,0.62,0.822
"28521","Beni","San Ignacio","U.E. Mayor Pedro Vaca Diez",47,0,3,0,89,22,7,6,0,174,6,11,191,229,0.511,0.834
"28522","Beni","San Ignacio","U.E. Mayor Pedro Vaca Diez",44,0,0,0,101,20,10,8,2,185,5,7,197,226,0.546,0.872
"28523","Beni","San Ignacio","U.E. Mayor Pedro Vaca Diez",36,0,2,0,108,17,10,6,0,179,7,2,188,223,0.603,0.843
"28524","Beni","San Ignacio","U.E. Mayor Pedro Vaca Diez",40,1,1,0,105,14,5,12,0,178,6,7,191,225,0.59,0.849
"28525","Beni","San Ignacio","U.E. Mayor Pedro Vaca Diez",20,2,3,1,117,24,15,5,0,187,5,9,201,233,0.626,0.863
"28526","Beni","San Ignacio","Esc. San Francisco",19,0,2,3,122,18,9,3,1,177,5,12,194,233,0.689,0.833
"28527","Beni","San Ignacio","Esc. Ovidio Roca C.",71,3,2,1,59,25,7,1,0,169,12,8,189,221,0.349,0.855
"28528","Beni","San Ignacio","Esc. Ovidio Roca C.",63,1,2,2,61,27,2,7,2,167,9,10,186,214,0.365,0.869
"28529","Beni","San Ignacio","Escuela Santísima Trinidad",19,0,0,0,147,7,17,0,0,190,2,10,202,225,0.774,0.898
"28530","Beni","San Ignacio","Esc. San Jose Del Cabitu",4,0,1,2,143,5,2,16,2,175,4,14,193,233,0.817,0.828
"28531","Beni","Loreto","Esc. Perfecta Vda. De Bejarano",24,0,6,0,99,30,3,4,0,166,1,11,178,228,0.596,0.781
"28532","Beni","Loreto","Esc. Perfecta Vda. De Bejarano",40,1,4,1,101,18,4,5,0,174,3,2,179,224,0.58,0.799
"28533","Beni","Loreto","Esc. Camiaco",13,0,2,0,93,56,4,7,1,176,12,10,198,234,0.528,0.846
"28534","Beni","Loreto","Esc. Sachojere",38,0,3,0,70,41,4,7,1,164,6,8,178,221,0.427,0.805
"28535","Beni","San Andrés","Esc. Humberto Velarde",40,0,1,1,74,30,16,18,0,180,4,6,190,220,0.411,0.864
"28536","Beni","San Andrés","Esc. Peroto",71,0,6,3,64,16,4,5,0,169,5,5,179,210,0.379,0.852
"28537","Beni","San Andrés","Esc. Santa Rosa",21,0,7,1,84,49,12,2,1,177,7,7,191,226,0.475,0.845
"28538","Beni","San Andrés","Esc. Santa Rosa",15,4,8,1,103,28,15,4,0,178,8,10,196,230,0.579,0.852
"28539","Beni","San Andrés","Esc. Central 2 De Agosto",34,0,0,0,102,23,33,1,0,193,2,9,204,233,0.528,0.876
"28540","Beni","San Andrés","Esc. Central 2 De Agosto",20,1,2,1,119,14,18,1,1,177,8,6,191,231,0.672,0.827
"28541","Beni","San Andrés","Esc. Central 2 De Agosto",18,2,1,0,111,18,29,3,1,183,6,6,195,234,0.607,0.833
"28542","Beni","San Andrés","Esc. Central 2 De Agosto",25,0,5,1,87,23,33,2,1,177,7,3,187,228,0.492,0.82
"28543","Beni","San Andrés","Esc. Central 2 De Agosto",26,1,0,1,102,20,24,3,1,178,11,9,198,229,0.573,0.865
"28544","Beni","San Andrés","Esc. Central 2 De Agosto",24,2,0,1,94,19,42,4,0,186,7,8,201,230,0.505,0.874
"28545","Beni","San Andrés","Esc. Central 2 De Agosto",22,2,2,1,115,22,23,2,2,191,1,16,208,231,0.602,0.9
"28546","Beni","San Andrés","Esc. Central 2 De Agosto",33,0,0,2,105,20,26,3,0,189,5,8,202,230,0.556,0.878
"28547","Beni","San Andrés","Esc. Central 2 De Agosto",29,1,0,0,98,22,25,0,1,176,5,10,191,232,0.557,0.823
"28548","Beni","San Andrés","Esc. Central 2 De Agosto",29,1,1,2,105,23,16,0,0,177,5,6,188,226,0.593,0.832
"28549","Beni","San Andrés","Esc. Caimanes",19,0,9,0,78,52,15,4,2,179,5,8,192,235,0.436,0.817
"28550","Beni","San Andrés","Esc. Somopae",25,3,1,5,93,35,14,4,2,182,10,3,195,223,0.511,0.874
"28551","Beni","San Andrés","Esc. Buen Jesus",23,0,2,0,79,51,13,3,2,173,9,9,191,226,0.457,0.845
"28552","Beni","San Andrés","Escuela 4 de Julio",8,2,0,0,131,5,7,1,0,154,2,1,157,174,0.851,0.902
"28553","Beni","San Andrés","Escuela Elvira",24,4,2,2,83,47,8,3,2,175,9,12,196,227,0.474,0.863
"28554","Beni","San Andrés","Escuela Nueva Magdalena",20,2,1,1,139,6,23,0,1,193,6,5,204,228,0.72,0.895
"28555","Beni","San Andrés","Escuela de Nueva Betania",20,0,6,1,103,26,24,1,1,182,7,8,197,236,0.566,0.835
"28556","Beni","San Andrés","U.E. Canaan",21,1,0,1,155,6,13,1,0,198,3,5,206,236,0.783,0.873
"28557","Beni","San Joaquín","U.E. Arturo Cuellar Rea",26,0,0,1,59,51,2,14,1,154,7,5,166,228,0.383,0.728
"28558","Beni","San Joaquín","U.E. Arturo Cuellar Rea",24,0,0,1,77,44,5,8,0,159,5,5,169,225,0.484,0.751
"28559","Beni","San Joaquín","U.E. Arturo Cuellar Rea",26,1,1,0,59,67,4,8,0,166,4,2,172,231,0.355,0.745
"28560","Beni","San Joaquín","U.E. Arturo Cuellar Rea",22,0,1,0,69,53,4,8,0,157,5,11,173,230,0.439,0.752
"28561","Beni","San Joaquín","U.E. Arturo Cuellar Rea",20,0,0,0,77,54,4,15,1,171,1,2,174,229,0.45,0.76
"28562","Beni","San Joaquín","U.E. Arturo Cuellar Rea",34,1,0,0,62,45,8,18,0,168,1,6,175,233,0.369,0.751
"28563","Beni","San Joaquín","Unidad Educativa 21 de Agosto",36,0,1,0,74,46,2,8,0,167,3,2,172,225,0.443,0.764
"28564","Beni","San Joaquín","Unidad Educativa 21 de Agosto",42,1,1,1,48,59,4,13,1,170,6,3,179,221,0.282,0.81
"28565","Beni","San Joaquín","Unidad Educativa 21 de Agosto",29,0,0,0,63,64,2,10,1,169,1,4,174,228,0.373,0.763
"28566","Beni","San Joaquín","Unidad Educativa 21 de Agosto",32,0,0,0,57,59,3,16,2,169,4,5,178,217,0.337,0.82
"28567","Beni","San Joaquín","Unidad Educativa 21 de Agosto",46,0,0,1,57,52,5,11,0,172,4,2,178,220,0.331,0.809
"28568","Beni","San Joaquín","Unidad Educativa 21 de Agosto",33,0,0,0,56,71,5,7,0,172,5,1,178,221,0.326,0.805
"28569","Beni","San Ramón","U.E. Napoleón Añez Ortiz",29,0,0,0,64,80,4,3,1,181,3,3,187,218,0.354,0.858
"28570","Beni","San Ramón","U.E. Napoleón Añez Ortiz",23,0,0,0,69,57,10,21,0,180,1,3,184,221,0.383,0.833
"28571","Beni","San Ramón","U.E. Napoleón Añez Ortiz",42,1,0,0,56,66,6,7,0,178,4,2,184,217,0.315,0.848
"28572","Beni","San Ramón","U.E. Napoleón Añez Ortiz",18,0,0,1,66,78,3,20,2,188,8,6,202,229,0.351,0.882
"28573","Beni","San Ramón","U.E. Napoleón Añez Ortiz",49,0,1,0,44,70,6,4,0,174,1,4,179,216,0.253,0.829
"28574","Beni","San Ramón","U.E. Napoleón Añez Ortiz",25,1,0,0,63,81,2,18,0,190,5,2,197,225,0.332,0.876
"28575","Beni","San Ramón","U.E. Napoleón Añez Ortiz",27,0,0,0,78,63,3,17,0,188,4,0,192,219,0.415,0.877
"28576","Beni","San Ramón","U.E. Napoleón Añez Ortiz",37,0,1,0,45,61,3,22,0,169,3,0,172,224,0.266,0.768
"28577","Beni","San Ramón","U.E. Napoleón Añez Ortiz",58,0,0,0,40,68,4,18,0,188,0,3,191,224,0.213,0.853
"28578","Beni","San Ramón","U.E. Napoleón Añez Ortiz",32,0,1,0,53,90,3,10,1,190,4,1,195,232,0.279,0.841
"28579","Beni","San Ramón","U.E. Napoleón Añez Ortiz",24,0,1,0,60,59,3,19,0,166,5,6,177,219,0.361,0.808
"28580","Beni","Puerto Siles","Esc. Antofagasta",29,3,0,0,104,36,5,16,1,194,4,3,201,246,0.536,0.817
"28581","Beni","Magdalena","U.E. Mcal. Jose Ballivian",25,0,2,1,64,76,8,14,0,190,3,4,197,218,0.337,0.904
"28582","Beni","Magdalena","U.E. Mcal. Jose Ballivian",34,1,1,1,64,80,2,7,0,190,2,6,198,217,0.337,0.912
"28583","Beni","Magdalena","U.E. Mcal. Jose Ballivian",18,0,0,0,62,70,9,9,0,168,5,12,185,218,0.369,0.849
"28584","Beni","Magdalena","U.E. Mcal. Jose Ballivian",24,0,2,1,44,85,5,18,0,179,5,4,188,222,0.246,0.847
"28585","Beni","Magdalena","U.E. Mcal. Jose Ballivian",20,0,0,0,71,75,3,13,0,182,8,4,194,225,0.39,0.862
"28586","Beni","Magdalena","U.E. Mcal. Jose Ballivian",22,1,0,1,61,82,3,10,0,180,4,5,189,224,0.339,0.844
"28587","Beni","Magdalena","U.E. Mcal. Jose Ballivian",15,0,0,2,55,69,3,10,1,155,3,4,162,188,0.355,0.862
"28588","Beni","Magdalena","U.E. Gil Coimbra Ojopi",35,0,0,0,53,84,5,9,0,186,6,6,198,231,0.285,0.857
"28589","Beni","Magdalena","U.E. Gil Coimbra Ojopi",26,0,2,0,67,74,4,18,1,192,5,3,200,229,0.349,0.873
"28590","Beni","Magdalena","U.E. Gil Coimbra Ojopi",35,0,0,0,47,87,3,18,0,190,4,2,196,224,0.247,0.875
"28591","Beni","Magdalena","U.E. Gil Coimbra Ojopi",18,0,0,2,67,71,2,15,2,177,1,4,182,216,0.379,0.843
"28592","Beni","Magdalena","U.E. Gil Coimbra Ojopi",34,0,2,1,50,92,5,14,0,198,2,5,205,220,0.253,0.932
"28593","Beni","Magdalena","U.E. Gil Coimbra Ojopi",19,0,0,1,59,86,2,16,2,185,2,6,193,227,0.319,0.85
"28594","Beni","Magdalena","U.E. Gil Coimbra Ojopi",31,0,0,1,62,81,5,8,0,188,4,5,197,227,0.33,0.868
"28595","Beni","Magdalena","U.E. Gil Coimbra Ojopi",30,0,1,0,52,74,9,17,0,183,3,7,193,228,0.284,0.846
"28596","Beni","Magdalena","U.E. Gil Coimbra Ojopi",22,0,1,0,55,83,3,16,0,180,4,7,191,231,0.306,0.827
"28597","Beni","Magdalena","U.E. Gil Coimbra Ojopi",25,0,0,0,65,73,2,7,0,172,3,4,179,223,0.378,0.803
"28598","Beni","Magdalena","U.E. Cnel. Carmelo Cuellar J.",21,0,1,0,75,98,1,5,2,203,4,3,210,229,0.369,0.917
"28599","Beni","Magdalena","U.E. Macedonio Paz Pino",39,0,3,0,68,57,6,13,0,186,2,10,198,229,0.366,0.865
"28600","Beni","Magdalena","U.E. Macedonio Paz Pino",28,1,1,0,89,43,6,25,1,194,2,2,198,226,0.459,0.876
"28601","Beni","Magdalena","U.E. Macedonio Paz Pino",43,0,2,0,79,48,4,15,0,191,5,1,197,231,0.414,0.853
"28602","Beni","Magdalena","U.E. Macedonio Paz Pino",43,0,2,1,50,68,5,9,0,178,2,8,188,221,0.281,0.851
"28603","Beni","Magdalena","U.E. Macedonio Paz Pino",33,0,1,0,83,51,2,24,0,194,7,2,203,229,0.428,0.886
"28604","Beni","Magdalena","Esc. San Borja Rio Blanco",2,2,2,1,46,56,38,15,0,162,1,7,170,195,0.284,0.872
"28605","Beni","Baures","U.E. Carmelo López",44,0,0,0,79,55,5,4,0,187,1,6,194,228,0.422,0.851
"28606","Beni","Baures","U.E. Carmelo López",35,0,0,0,84,69,3,2,0,193,2,5,200,228,0.435,0.877
"28607","Beni","Baures","U.E. Carmelo López",36,0,0,0,84,59,3,1,0,183,2,2,187,231,0.459,0.81
"28608","Beni","Baures","U.E. Carmelo López",47,0,0,0,60,63,5,2,0,177,0,4,181,221,0.339,0.819
"28609","Beni","Baures","U.E. Carmelo López",38,0,0,0,68,59,2,6,1,174,3,8,185,223,0.391,0.83
"28610","Beni","Baures","U.E. Carmelo López",33,0,0,0,88,68,2,5,0,196,3,3,202,230,0.449,0.878
"28611","Beni","Baures","Esc. El Remanzo",15,1,0,0,104,56,2,1,0,179,3,2,184,233,0.581,0.79
"28612","Beni","Baures","Esc. Seccional Cafetal",9,0,2,0,106,30,9,1,0,157,4,4,165,233,0.675,0.708
"28613","Beni","Baures","U.E. Jasiaquiri",9,0,0,0,93,48,0,2,0,152,0,5,157,186,0.612,0.844
"28614","Beni","Baures","Esc. Monte Cristo Del Tiquin",11,0,3,0,116,12,13,1,0,156,2,5,163,230,0.744,0.709
"28615","Beni","Huacaraje","U.E. Juan Alberto Orellana",24,0,2,0,73,50,5,13,0,167,6,3,176,226,0.437,0.779
"28616","Beni","Huacaraje","U.E. Juan Alberto Orellana",36,0,0,0,55,72,5,6,0,174,3,2,179,221,0.316,0.81
"28617","Beni","Huacaraje","U.E. Juan Alberto Orellana",38,0,1,0,59,61,4,15,0,178,1,2,181,220,0.331,0.823
"28618","Beni","Huacaraje","U.E. Juan Alberto Orellana",28,0,0,0,56,78,10,11,0,183,1,0,184,219,0.306,0.84
"28619","Beni","Huacaraje","U.E. Juan Alberto Orellana",14,1,0,0,62,85,2,5,0,169,3,8,180,222,0.367,0.811
"28620","Beni","Huacaraje","Esc. El Carmen",26,0,0,1,79,86,3,1,0,196,2,3,201,233,0.403,0.863
"28621","Beni","Huacaraje","Esc. El Carmen",21,1,3,0,93,68,3,0,0,189,3,5,197,226,0.492,0.872
"28622","Pando","Cobija","U. E. Instituto Americano",95,0,0,0,62,3,20,3,1,184,1,6,191,231,0.337,0.827
"28623","Pando","Cobija","U. E. Instituto Americano",101,0,0,0,57,4,27,3,1,193,0,1,194,228,0.295,0.851
"28624","Pando","Cobija","U. E. Instituto Americano",119,0,1,1,59,6,13,3,3,205,1,3,209,234,0.288,0.893
"28625","Pando","Cobija","U. E.  America",96,0,1,1,57,5,16,0,0,176,0,5,181,220,0.324,0.823
"28626","Pando","Cobija","U. E.  America",113,0,1,1,49,7,7,5,0,183,0,4,187,223,0.268,0.839
"28627","Pando","Cobija","U.E. Mariano Baptista (Edificio SEDUCA)",84,1,0,1,62,5,16,4,3,176,1,5,182,225,0.352,0.809
"28628","Pando","Cobija","U.E. Mariano Baptista (Edificio SEDUCA)",69,0,1,0,54,5,31,5,5,170,2,6,178,227,0.318,0.784
"28629","Pando","Cobija","U.E. Mariano Baptista (Edificio SEDUCA)",84,0,3,1,53,2,33,2,3,181,2,4,187,227,0.293,0.824
"28630","Pando","Cobija","U.E. Mariano Baptista (Edificio SEDUCA)",78,0,1,1,59,2,29,2,6,178,2,1,181,229,0.331,0.79
"28631","Pando","Cobija","U.E. Mariano Baptista (Edificio SEDUCA)",92,1,3,0,50,1,27,6,3,183,1,5,189,232,0.273,0.815
"28632","Pando","Cobija","U. E. Vaca Diez (Intermedio)",66,0,0,0,76,3,16,0,1,162,1,2,165,223,0.469,0.74
"28633","Pando","Cobija","U. E. Vaca Diez (Intermedio)",70,0,2,0,67,5,21,2,1,168,3,4,175,229,0.399,0.764
"28634","Pando","Cobija","U. E. Vaca Diez (Intermedio)",66,0,1,1,62,2,17,4,1,154,4,7,165,228,0.403,0.724
"28635","Pando","Cobija","U. E. Vaca Diez (Intermedio)",80,0,2,0,75,1,17,3,1,179,0,2,181,229,0.419,0.79
"28636","Pando","Cobija","U. E. Cobija",69,0,2,0,82,8,19,3,0,183,1,4,188,231,0.448,0.814
"28637","Pando","Cobija","U. E. Cobija",94,0,0,0,63,2,25,4,1,189,2,2,193,230,0.333,0.839
"28638","Pando","Cobija","U. E. Cobija",84,0,2,0,68,3,13,2,1,173,4,2,179,227,0.393,0.789
"28639","Pando","Cobija","U. E. Cobija",68,0,6,1,70,6,30,2,2,185,4,5,194,237,0.378,0.819
"28640","Pando","Cobija","U. E. Cobija",78,1,0,0,68,6,14,5,1,173,1,6,180,227,0.393,0.793
"28641","Pando","Cobija","U. E. Cobija",95,2,2,0,60,5,18,2,1,185,3,3,191,227,0.324,0.841
"28642","Pando","Cobija","U. E. Cobija",88,1,3,0,66,3,21,4,5,191,1,6,198,229,0.346,0.865
"28643","Pando","Cobija","U. E. Cobija",51,0,3,1,79,2,29,2,2,169,4,2,175,229,0.467,0.764
"28644","Pando","Cobija","U. E. Cobija",77,0,2,0,69,3,20,4,0,175,3,3,181,222,0.394,0.815
"28645","Pando","Cobija","U. E. Cobija",85,1,1,0,59,2,20,5,2,175,0,12,187,230,0.337,0.813
"28646","Pando","Cobija","U. E. Cobija",51,0,2,1,83,1,19,2,2,161,2,8,171,229,0.516,0.747
"28647","Pando","Cobija","U. E. Cobija",97,1,1,1,62,4,19,5,0,190,2,3,195,230,0.326,0.848
"28648","Pando","Cobija","U. E. Cobija",91,0,1,0,62,5,9,4,0,172,1,4,177,223,0.36,0.794
"28649","Pando","Cobija","U. E. Cobija",79,1,2,0,80,1,20,2,3,188,1,5,194,231,0.426,0.84
"28650","Pando","Cobija","U. E. Juana Azurduy De Padilla",90,0,2,1,50,7,17,7,3,177,4,4,185,232,0.282,0.797
"28651","Pando","Cobija","U. E. Juana Azurduy De Padilla",88,0,2,0,64,7,14,5,1,181,1,5,187,229,0.354,0.817
"28652","Pando","Cobija","U. E. Juana Azurduy De Padilla",89,0,1,1,62,6,13,4,3,179,3,2,184,228,0.346,0.807
"28653","Pando","Cobija","U. E. 11 de Octubre",78,0,4,2,70,5,22,7,3,191,1,5,197,232,0.366,0.849
"28654","Pando","Cobija","U. E. 11 de Octubre",84,0,5,2,68,5,17,4,1,186,2,6,194,228,0.366,0.851
"28655","Pando","Cobija","U. E. 11 de Octubre",52,0,1,0,94,3,22,2,3,177,2,9,188,222,0.531,0.847
"28656","Pando","Cobija","U. E. 11 de Octubre",85,0,2,1,59,5,26,3,3,184,2,2,188,229,0.321,0.821
"28657","Pando","Cobija","U. E. 11 de Octubre",78,0,3,0,78,5,13,4,4,185,1,2,188,232,0.422,0.81
"28658","Pando","Cobija","U. E. 11 de Octubre",83,1,3,0,70,6,22,0,4,189,4,8,201,231,0.37,0.87
"28659","Pando","Cobija","U. E. 11 de Octubre",80,1,6,1,67,1,14,11,1,182,2,8,192,228,0.368,0.842
"28660","Pando","Cobija","U. E. 11 de Octubre",85,0,2,2,74,3,24,2,1,193,8,3,204,233,0.383,0.876
"28661","Pando","Cobija","U. E. 11 de Octubre",85,2,3,0,79,2,13,3,5,192,3,5,200,229,0.411,0.873
"28662","Pando","Cobija","U. E. 11 de Octubre",91,0,1,0,67,0,16,6,0,181,4,5,190,228,0.37,0.833
"28663","Pando","Cobija","U. E. 11 de Octubre",73,0,2,0,75,4,32,1,3,190,1,5,196,232,0.395,0.845
"28664","Pando","Cobija","U. E. Mariscal Sucre",69,0,1,1,78,3,21,3,3,179,2,7,188,232,0.436,0.81
"28665","Pando","Cobija","U. E. Mariscal Sucre",65,0,1,0,76,1,28,3,3,177,5,4,186,229,0.429,0.812
"28666","Pando","Cobija","U. E. Mariscal Sucre",54,0,5,0,82,2,32,1,6,182,0,9,191,233,0.451,0.82
"28667","Pando","Cobija","U. E. Mariscal Sucre",60,0,3,0,83,3,21,1,0,171,3,6,180,227,0.485,0.793
"28668","Pando","Cobija","U. E. Mariscal Sucre",70,0,5,2,75,2,18,6,3,181,3,8,192,232,0.414,0.828
"28669","Pando","Cobija","U. E. Mariscal Sucre",55,0,5,0,87,3,32,3,3,188,1,3,192,233,0.463,0.824
"28670","Pando","Cobija","U. E. Mariscal Sucre",73,0,0,1,73,2,19,4,3,175,2,9,186,233,0.417,0.798
"28671","Pando","Cobija","U. E. Mariscal Sucre",61,0,2,0,69,4,31,2,10,179,4,3,186,229,0.385,0.812
"28672","Pando","Cobija","U. E. Mariscal Sucre",82,1,1,0,81,4,17,2,5,193,4,5,202,234,0.42,0.863
"28673","Pando","Cobija","U. E. Mariscal Sucre",76,0,1,0,72,1,20,3,4,177,4,9,190,232,0.407,0.819
"28674","Pando","Cobija","U. E. Mariscal Sucre",61,0,3,0,58,4,25,2,3,156,2,4,162,191,0.372,0.848
"28675","Pando","Cobija","U. E. Rogelia Menacho De Balcazar",79,0,0,0,69,1,19,6,2,176,3,8,187,231,0.392,0.81
"28676","Pando","Cobija","U. E. Rogelia Menacho De Balcazar",94,2,4,4,71,1,20,2,3,201,2,1,204,235,0.353,0.868
"28677","Pando","Cobija","U. E. Rogelia Menacho De Balcazar",81,0,1,1,71,3,17,9,2,185,8,9,202,229,0.384,0.882
"28678","Pando","Cobija","U. E. Rogelia Menacho De Balcazar",63,0,1,2,76,3,38,1,2,186,2,5,193,234,0.409,0.825
"28679","Pando","Cobija","U. E. Rogelia Menacho De Balcazar",79,0,2,2,67,4,31,6,3,194,3,3,200,233,0.345,0.858
"28680","Pando","Cobija","U. E. Rogelia Menacho De Balcazar",66,0,2,0,83,4,26,7,4,192,6,10,208,235,0.432,0.885
"28681","Pando","Cobija","U. E. Rogelia Menacho De Balcazar",73,2,1,0,87,7,12,4,1,187,2,6,195,235,0.465,0.83
"28682","Pando","Cobija","U. E. Rogelia Menacho De Balcazar",63,0,0,1,59,5,23,0,4,155,5,4,164,183,0.381,0.896
"28683","Pando","Cobija","U. E. José Manuel Pando",100,1,2,0,61,4,14,2,1,185,2,7,194,227,0.33,0.855
"28684","Pando","Cobija","U. E. José Manuel Pando",88,0,0,0,69,4,18,8,6,193,2,6,201,231,0.358,0.87
"28685","Pando","Cobija","U. E. José Manuel Pando",76,0,2,0,68,1,28,7,1,183,2,4,189,235,0.372,0.804
"28686","Pando","Cobija","U. E. José Manuel Pando",88,1,3,1,57,6,18,6,1,181,3,4,188,225,0.315,0.836
"28687","Pando","Cobija","U. E. José Manuel Pando",77,2,1,1,65,5,20,8,2,181,3,8,192,235,0.359,0.817
"28688","Pando","Cobija","U. E. José Manuel Pando",80,2,0,2,78,3,18,7,1,191,2,7,200,234,0.408,0.855
"28689","Pando","Cobija","U. E. José Manuel Pando",68,0,5,0,78,4,21,5,1,182,3,8,193,234,0.429,0.825
"28690","Pando","Cobija","U. E. José Manuel Pando",72,1,0,2,64,4,15,2,5,165,3,8,176,224,0.388,0.786
"28691","Pando","Cobija","U. E. José Manuel Pando",73,0,2,2,79,5,14,6,4,185,5,4,194,232,0.427,0.836
"28692","Pando","Cobija","U. E. José Manuel Pando",66,1,2,2,81,4,20,5,2,183,3,6,192,230,0.443,0.835
"28693","Pando","Cobija","U. E. José Manuel Pando",78,2,1,0,79,3,23,7,3,196,1,4,201,233,0.403,0.863
"28694","Pando","Cobija","U. E. José Manuel Pando",103,0,0,3,57,5,20,5,3,196,1,3,200,234,0.291,0.855
"28695","Pando","Cobija","U. E. José Manuel Pando",88,1,1,1,62,2,18,7,2,182,7,8,197,228,0.341,0.864
"28696","Pando","Cobija","U. E. José Manuel Pando",93,0,5,0,65,5,18,8,2,196,4,2,202,236,0.332,0.856
"28697","Pando","Cobija","U.E. Defensores Del Acre",84,1,2,2,61,2,15,1,4,172,4,5,181,226,0.355,0.801
"28698","Pando","Cobija","U.E. Defensores Del Acre",89,1,2,0,80,8,15,4,1,200,4,4,208,227,0.4,0.916
"28699","Pando","Cobija","U.E. Defensores Del Acre",59,0,2,0,90,4,19,1,3,178,4,9,191,229,0.506,0.834
"28700","Pando","Cobija","U.E. Defensores Del Acre",73,0,0,0,63,2,26,5,2,171,4,6,181,225,0.368,0.804
"28701","Pando","Cobija","U.E. Defensores Del Acre",96,0,1,0,46,2,26,6,0,177,4,7,188,231,0.26,0.814
"28702","Pando","Cobija","U.E. Defensores Del Acre",79,2,1,1,66,3,23,1,1,177,5,8,190,228,0.373,0.833
"28703","Pando","Cobija","U.E. Defensores Del Acre",82,0,1,2,70,10,15,3,4,187,5,4,196,230,0.374,0.852
"28704","Pando","Cobija","U.E. Defensores Del Acre",80,2,0,1,65,7,21,5,1,182,7,4,193,227,0.357,0.85
"28705","Pando","Cobija","U.E. Defensores Del Acre",85,0,1,2,71,5,24,4,0,192,3,10,205,234,0.37,0.876
"28706","Pando","Cobija","U.E. Defensores Del Acre",89,1,2,2,51,9,20,0,1,175,2,11,188,233,0.291,0.807
"28707","Pando","Cobija","U.E. Defensores Del Acre",112,1,1,1,51,6,20,4,0,196,4,4,204,235,0.26,0.868
"28708","Pando","Cobija","U.E. Defensores Del Acre",82,0,3,0,83,4,18,2,1,193,2,10,205,244,0.43,0.84
"28709","Pando","Cobija","U.E. German Busch",92,1,1,1,54,9,15,7,5,185,4,5,194,222,0.292,0.874
"28710","Pando","Cobija","U.E. German Busch",65,0,1,0,85,8,17,5,1,182,8,8,198,229,0.467,0.865
"28711","Pando","Cobija","U.E. German Busch",81,1,0,1,62,4,25,6,3,183,4,2,189,223,0.339,0.848
"28712","Pando","Cobija","U.E. German Busch",92,1,0,0,54,11,16,6,4,184,11,6,201,229,0.293,0.878
"28713","Pando","Cobija","U.E. German Busch",90,1,0,1,57,8,21,7,0,185,4,4,193,228,0.308,0.846
"28714","Pando","Cobija","(Cárcel) Cárcel Pública (Villa Busch)",43,0,1,1,114,7,10,7,2,185,8,1,194,232,0.616,0.836
"28715","Pando","Cobija","U.E. De Bella Vista",65,0,5,1,84,5,25,3,2,190,6,5,201,233,0.442,0.863
"28716","Pando","Cobija","U.E. De Bella Vista",65,2,0,0,96,3,22,1,2,191,3,7,201,237,0.503,0.848
"28717","Pando","Cobija","U.E. De Bella Vista",66,0,2,0,95,4,12,3,3,185,3,6,194,233,0.514,0.833
"28718","Pando","Cobija","U.E. De Bella Vista",62,0,4,1,94,3,24,3,0,191,2,6,199,231,0.492,0.861
"28719","Pando","Cobija","U.E. De Bella Vista",76,1,3,1,86,3,12,4,2,188,4,4,196,233,0.457,0.841
"28720","Pando","Cobija","U. E. Abaroa",105,4,0,0,75,11,12,15,1,223,2,3,228,238,0.336,0.958
"28721","Pando","Cobija","U. E. Juan Evo Morales Ayma",90,1,4,0,89,5,24,2,2,217,0,11,228,238,0.41,0.958
"28722","Pando","Cobija","U. E. Marcelo Quiroga Santa Cruz",67,1,2,1,98,6,43,1,0,219,8,6,233,240,0.447,0.971
"28723","Pando","Cobija","U. E. Alfredo Ovando Candia",56,0,6,0,101,6,29,1,1,200,5,11,216,238,0.505,0.908
"28724","Pando","Cobija","U. E. Alfredo Ovando Candia",56,0,2,1,107,1,17,4,1,189,3,24,216,247,0.566,0.874
"28725","Pando","Cobija","U. E. Vaca Diez (Medio)",110,0,1,2,49,4,8,4,0,178,1,2,181,223,0.275,0.812
"28726","Pando","Cobija","U. E. Vaca Diez (Medio)",102,0,0,0,57,2,11,1,1,174,4,2,180,230,0.328,0.783
"28727","Pando","Cobija","U. E. Vaca Diez (Medio)",113,2,1,1,50,4,16,4,0,191,0,3,194,233,0.262,0.833
"28728","Pando","Cobija","Kinder Victor Leon Arueta (Vaca Diez Medio)",92,2,0,1,44,8,15,4,1,167,1,4,172,218,0.263,0.789
"28729","Pando","Cobija","U.E. Villa Cruz",96,0,0,0,58,6,13,10,0,183,4,4,191,234,0.317,0.816
"28730","Pando","Cobija","U.E. Villa Cruz",99,0,1,0,65,5,15,3,2,190,1,5,196,228,0.342,0.86
"28731","Pando","Cobija","U.E. Villa Cruz",93,1,1,1,65,3,15,1,2,182,1,7,190,228,0.357,0.833
"28732","Pando","Cobija","U.E. Villa Cruz",71,0,3,0,73,3,29,2,4,185,2,3,190,232,0.395,0.819
"28733","Pando","Cobija","U.E. Villa Cruz",81,1,0,0,64,4,11,23,0,184,7,9,200,232,0.348,0.862
"28734","Pando","Cobija","U.E. Villa Cruz",106,0,1,0,50,7,20,3,2,189,5,12,206,236,0.265,0.873
"28735","Pando","Cobija","U.E. Villa Cruz",98,0,0,1,66,2,21,4,3,195,0,11,206,234,0.338,0.88
"28736","Pando","Cobija","U.E. Villa Cruz",79,1,2,0,64,3,27,3,2,181,4,6,191,222,0.354,0.86
"28737","Pando","Cobija","U.E. Villa Cruz",79,0,0,0,76,7,17,5,2,186,2,4,192,232,0.409,0.828
"28738","Pando","Cobija","U.E. Villa Cruz",97,3,0,1,58,2,10,3,2,176,4,8,188,226,0.33,0.832
"28739","Pando","Cobija","U.E. Villa Cruz",80,0,4,0,65,5,15,4,0,173,2,8,183,227,0.376,0.806
"28740","Pando","Cobija","U.E. Villa Cruz",70,0,2,0,82,5,24,6,0,189,0,3,192,224,0.434,0.857
"28741","Pando","Cobija","U.E. Villa Cruz",111,1,1,0,51,3,13,7,2,189,1,2,192,229,0.27,0.838
"28742","Pando","Cobija","U.E. Villa Cruz",88,1,0,1,53,6,19,11,2,181,1,15,197,229,0.293,0.86
"28743","Pando","Cobija","U.E. Villa Cruz",88,1,2,0,50,4,39,3,0,187,7,10,204,233,0.267,0.876
"28744","Pando","Cobija","U.E. Villa Cruz",91,0,2,3,58,3,30,4,3,194,3,8,205,229,0.299,0.895
"28745","Pando","Cobija","U. E. Sofia Calpiñeiro",92,0,1,3,53,6,18,3,1,177,1,6,184,229,0.299,0.803
"28746","Pando","Cobija","U. E. Sofia Calpiñeiro",89,0,0,1,56,6,14,6,1,173,4,7,184,226,0.324,0.814
"28747","Pando","Cobija","U. E. Sofia Calpiñeiro",87,1,2,1,62,0,10,5,0,168,4,8,180,226,0.369,0.796
"28748","Pando","Cobija","U. E. Sofia Calpiñeiro",95,0,0,5,55,5,8,2,0,170,3,3,176,220,0.324,0.8
"28749","Pando","Cobija","U. E. Sofia Calpiñeiro",95,1,1,0,52,8,6,3,0,166,1,10,177,220,0.313,0.805
"28750","Pando","Cobija","U. E. Sofia Calpiñeiro",100,0,1,2,40,4,8,3,2,160,2,13,175,218,0.25,0.803
"28751","Pando","Cobija","U. E. Sofia Calpiñeiro",97,2,0,1,52,12,14,1,1,180,5,5,190,224,0.289,0.848
"28752","Pando","Cobija","U. E. Sofia Calpiñeiro",95,0,0,5,45,6,8,5,2,166,3,5,174,219,0.271,0.795
"28753","Pando","Cobija","U. E. Sofia Calpiñeiro",99,2,0,0,49,1,14,4,0,169,5,9,183,227,0.29,0.806
"28754","Pando","Cobija","U. E. Sofia Calpiñeiro",107,0,0,2,51,3,4,6,0,173,4,6,183,224,0.295,0.817
"28755","Pando","Cobija","U. E. Sofia Calpiñeiro",88,1,0,1,53,7,12,3,2,167,4,7,178,220,0.317,0.809
"28756","Pando","Cobija","U. E. Manuela Rojas",112,0,0,1,44,7,13,12,1,190,6,8,204,232,0.232,0.879
"28757","Pando","Cobija","U. E. Manuela Rojas",95,1,1,1,67,9,18,5,3,200,4,8,212,235,0.335,0.902
"28758","Pando","Cobija","U. E. Manuela Rojas",89,0,2,4,62,4,25,5,2,193,4,3,200,232,0.321,0.862
"28759","Pando","Cobija","U. E. Manuela Rojas",85,0,0,3,59,8,21,12,2,190,4,15,209,240,0.311,0.871
"28760","Pando","Cobija","U. E. Manuela Rojas",88,1,1,2,71,6,24,6,0,199,3,9,211,238,0.357,0.887
"28761","Pando","Cobija","U. E. Manuela Rojas",109,0,1,0,56,6,17,9,2,200,1,12,213,235,0.28,0.906
"28762","Pando","Cobija","U. E. Manuela Rojas",70,0,0,1,66,6,28,5,5,181,2,7,190,234,0.365,0.812
"28763","Pando","Cobija","U. E. Manuela Rojas",97,0,0,1,40,11,21,13,0,183,5,8,196,228,0.219,0.86
"28764","Pando","Cobija","U. E. Manuela Rojas",100,0,1,1,45,10,19,7,2,185,4,8,197,234,0.243,0.842
"28765","Pando","Cobija","U. E. Manuela Rojas",86,2,0,0,63,7,24,5,0,187,40,5,232,232,0.337,1
"28766","Pando","Cobija","U. E. Manuela Rojas",102,1,0,1,65,4,21,9,0,203,4,2,209,237,0.32,0.882
"28767","Pando","Cobija","U. E. Manuela Rojas",107,0,1,1,42,16,25,9,1,202,3,8,213,237,0.208,0.899
"28768","Pando","Cobija","U. E. Manuela Rojas",93,0,1,1,62,3,21,9,1,191,3,4,198,238,0.325,0.832
"28769","Pando","Cobija","U. E. Simon Bolivar",75,0,2,1,85,6,21,8,0,198,4,6,208,233,0.429,0.893
"28770","Pando","Cobija","U. E. Simon Bolivar",75,1,0,0,79,9,13,11,4,192,2,9,203,236,0.411,0.86
"28771","Pando","Cobija","U. E. Simon Bolivar",58,0,0,0,105,2,29,3,1,198,7,6,211,234,0.53,0.902
"28772","Pando","Cobija","U. E. Simon Bolivar",89,1,2,1,72,6,21,5,2,199,2,13,214,233,0.362,0.918
"28773","Pando","Cobija","U. E. Simon Bolivar",90,0,0,0,83,6,16,7,0,202,6,6,214,237,0.411,0.903
"28774","Pando","Cobija","U. E. Simon Bolivar",68,0,2,0,108,7,22,1,1,209,1,8,218,236,0.517,0.924
"28775","Pando","Cobija","U. E. Simon Bolivar",88,1,0,0,81,9,16,5,1,201,8,3,212,238,0.403,0.891
"28776","Pando","Cobija","U. E. Simon Bolivar",65,0,3,0,88,9,29,3,3,200,4,4,208,236,0.44,0.881
"28777","Pando","Cobija","U. E. Simon Bolivar",80,3,0,1,73,9,25,3,0,194,6,10,210,233,0.376,0.901
"28778","Pando","Cobija","U. E. Simon Bolivar",81,0,1,2,68,8,27,3,2,192,3,7,202,234,0.354,0.863
"28779","Pando","Cobija","U. E. Simon Bolivar",70,1,1,2,77,7,16,3,1,178,4,9,191,216,0.433,0.884
"28780","Pando","Porvenir","U.E. Mons. Santisteban",58,0,0,0,108,2,4,2,0,174,5,7,186,231,0.621,0.805
"28781","Pando","Porvenir","U.E. Mons. Santisteban",71,1,1,1,99,5,9,2,0,189,3,9,201,230,0.524,0.874
"28782","Pando","Porvenir","U.E. Mons. Santisteban",59,0,0,0,106,10,7,4,0,186,4,9,199,235,0.57,0.847
"28783","Pando","Porvenir","U.E. Mons. Santisteban",54,0,0,1,107,10,9,9,0,190,1,5,196,230,0.563,0.852
"28784","Pando","Porvenir","U.E. Mons. Santisteban",81,0,0,1,97,6,8,8,0,201,0,3,204,228,0.483,0.895
"28785","Pando","Porvenir","U.E. Mons. Santisteban",64,0,0,0,74,9,3,3,1,154,1,3,158,184,0.481,0.859
"28786","Pando","Porvenir","U.E. Bruno Racua",70,1,0,1,90,2,7,0,1,172,5,22,199,234,0.523,0.85
"28787","Pando","Porvenir","U.E. Bruno Racua",65,0,0,0,88,5,3,1,1,163,3,6,172,227,0.54,0.758
"28788","Pando","Porvenir","U.E. Bruno Racua",64,0,2,3,99,7,13,2,0,190,5,5,200,228,0.521,0.877
"28789","Pando","Porvenir","U.E. Bruno Racua",61,0,1,0,106,7,5,1,0,181,5,5,191,229,0.586,0.834
"28790","Pando","Porvenir","U.E. Bruno Racua",69,0,0,0,100,8,4,5,0,186,0,9,195,228,0.538,0.855
"28791","Pando","Porvenir","U.E. Bruno Racua",67,0,0,0,76,4,4,3,0,154,3,5,162,180,0.494,0.9
"28792","Pando","Porvenir","U.E. Villa Bella",73,1,1,0,101,3,10,10,3,202,4,8,214,236,0.5,0.907
"28793","Pando","Porvenir","U.E. Villa Bella",56,1,1,0,113,9,6,10,0,196,6,13,215,235,0.577,0.915
"28794","Pando","Porvenir","U.E. Villa Bella",67,1,0,1,106,3,9,8,1,196,6,6,208,229,0.541,0.908
"28795","Pando","Porvenir","U.E.  Gutembert Cruz",70,0,9,2,97,2,3,4,1,188,9,9,206,231,0.516,0.892
"28796","Pando","Bolpebra","U.E.  Genoveva Rios",107,3,2,2,49,5,4,0,0,172,9,4,185,233,0.285,0.794
"28797","Pando","Bolpebra","U.E. De Mukden",115,0,0,5,33,3,7,8,0,171,3,14,188,229,0.193,0.821
"28798","Pando","Bella Flor","U.E.  Km. 35 de Karamanu",59,1,1,1,96,2,6,3,2,171,6,12,189,236,0.561,0.801
"28799","Pando","Bella Flor","U.E.  Km. 60 de San Antonio",66,0,1,0,123,4,3,4,2,203,0,9,212,249,0.606,0.851
"28800","Pando","Bella Flor","U.E.  Hugo Antequera",92,2,1,1,60,11,9,4,2,182,3,10,195,234,0.33,0.833
"28801","Pando","Bella Flor","U.E.  Hugo Antequera",93,0,0,2,69,12,13,3,1,193,2,2,197,231,0.358,0.853
"28802","Pando","Bella Flor","U.E. Jorge Benito Vera",54,0,2,0,93,2,14,0,0,165,3,6,174,236,0.564,0.737
"28803","Pando","Bella Flor","U.E. Jorge Benito Vera",50,1,0,0,107,0,16,0,0,174,1,3,178,245,0.615,0.727
"28804","Pando","Bella Flor","U. E. 24 de Septiembre",33,1,0,2,121,3,0,0,0,160,0,1,161,181,0.756,0.89
"28805","Pando","Puerto Rico","U.E.  La Salle Emeterio Ruiz",52,1,2,1,105,3,12,4,0,180,4,10,194,228,0.583,0.851
"28806","Pando","Puerto Rico","U.E.  La Salle Emeterio Ruiz",56,0,9,1,102,3,5,0,0,176,6,10,192,235,0.58,0.817
"28807","Pando","Puerto Rico","U.E.  La Salle Emeterio Ruiz",59,0,3,0,93,5,14,4,1,179,3,10,192,237,0.52,0.81
"28808","Pando","Puerto Rico","U.E.  La Salle Emeterio Ruiz",78,0,9,3,81,3,11,6,0,191,4,8,203,233,0.424,0.871
"28809","Pando","Puerto Rico","U.E.  La Salle Emeterio Ruiz",67,0,7,1,90,0,11,1,1,178,2,10,190,237,0.506,0.802
"28810","Pando","Puerto Rico","U.E.  La Salle Emeterio Ruiz",58,0,5,0,104,4,14,1,0,186,0,7,193,234,0.559,0.825
"28811","Pando","Puerto Rico","U.E.  La Salle Emeterio Ruiz",42,0,8,1,107,1,11,3,1,174,2,10,186,232,0.615,0.802
"28812","Pando","Puerto Rico","U.E.  La Salle Emeterio Ruiz",92,0,4,0,59,3,10,1,0,169,7,10,186,236,0.349,0.788
"28813","Pando","Puerto Rico","U.E.  La Salle Emeterio Ruiz",63,1,4,0,80,6,12,0,0,166,2,11,179,238,0.482,0.752
"28814","Pando","Puerto Rico","U.E.  La Salle Emeterio Ruiz",41,1,4,0,101,5,12,2,0,166,5,9,180,235,0.608,0.766
"28815","Pando","Puerto Rico","U.E.  La Salle Emeterio Ruiz",84,1,2,0,81,4,14,3,0,189,2,5,196,233,0.429,0.841
"28816","Pando","Puerto Rico","U.E. Puerto Rico",34,0,7,0,128,2,12,3,0,186,2,7,195,240,0.688,0.812
"28817","Pando","Puerto Rico","U.E.  German Busch",68,1,2,2,100,7,1,4,0,185,13,17,215,235,0.541,0.915
"28818","Pando","Puerto Rico","U.E.  German Busch",63,1,3,1,75,8,0,0,1,152,5,5,162,186,0.493,0.871
"28819","Pando","Puerto Rico","U.E. Batraja",52,1,2,2,118,6,5,4,0,190,6,11,207,232,0.621,0.892
"28820","Pando","Puerto Rico","U.E. De Las Arenas",61,1,1,3,77,12,10,0,1,166,7,7,180,191,0.464,0.942
"28821","Pando","San Pedro","U.E.  12 de Abril",95,1,1,0,44,9,1,1,0,152,7,9,168,216,0.289,0.778
"28822","Pando","San Pedro","U.E. Fortaleza",57,0,1,0,98,2,1,3,0,162,2,4,168,225,0.605,0.747
"28823","Pando","Filadelfia","U.E. Filadelfia",48,1,1,0,129,7,9,2,0,197,4,9,210,231,0.655,0.909
"28824","Pando","Filadelfia","U.E. Filadelfia",55,0,1,0,124,8,3,4,0,195,4,3,202,234,0.636,0.863
"28825","Pando","Filadelfia","U.E. Villa Bella",64,1,1,0,64,23,1,2,0,156,7,8,171,196,0.41,0.872
"28826","Pando","Filadelfia","U.E. Nueva Empresa",49,2,3,1,100,7,14,2,0,178,8,8,194,232,0.562,0.836
"28827","Pando","Filadelfia","U.E. Chive",76,1,0,1,78,7,17,4,0,184,4,7,195,234,0.424,0.833
"28828","Pando","Filadelfia","U.E. De Holanda",59,3,0,1,106,15,5,4,1,194,8,9,211,235,0.546,0.898
"28829","Pando","Filadelfia","U.E.  Juancito Pinto",68,1,1,0,72,29,23,0,1,195,3,9,207,236,0.369,0.877
"28830","Pando","Filadelfia","U.E. Nueva Alianza",65,1,1,0,89,12,15,1,0,184,6,13,203,233,0.484,0.871
"28831","Pando","Filadelfia","U. E. Puerto Sucre",66,0,2,1,103,8,6,6,0,192,6,10,208,219,0.536,0.95
"28832","Pando","Puerto Gonzalo Moreno","U.E. Luz En El Camino",72,1,0,1,95,6,4,0,0,179,7,9,195,231,0.531,0.844
"28833","Pando","Puerto Gonzalo Moreno","U.E. Luz En El Camino",60,0,1,0,100,10,4,4,2,181,0,5,186,230,0.552,0.809
"28834","Pando","Puerto Gonzalo Moreno","U.E. Luz En El Camino",57,1,1,0,113,6,3,2,0,183,1,2,186,229,0.617,0.812
"28835","Pando","Puerto Gonzalo Moreno","U.E. Luz En El Camino",64,0,1,0,98,7,3,1,0,174,3,9,186,227,0.563,0.819
"28836","Pando","Puerto Gonzalo Moreno","U.E. Luz En El Camino",48,1,0,0,113,15,3,2,0,182,0,6,188,232,0.621,0.81
"28837","Pando","Puerto Gonzalo Moreno","U.E. Luz En El Camino",64,0,0,0,94,14,1,3,0,176,3,2,181,232,0.534,0.78
"28838","Pando","Puerto Gonzalo Moreno","U.E.  Portachuelo Dios Es Amor",7,0,1,0,177,1,3,0,0,189,1,3,193,226,0.937,0.854
"28839","Pando","Puerto Gonzalo Moreno","U.E. Agua Dulce",51,1,0,0,98,45,0,0,0,195,5,7,207,230,0.503,0.9
"28840","Pando","Puerto Gonzalo Moreno","U.E. Pedro Herrera",81,2,0,1,82,15,5,0,0,186,3,8,197,232,0.441,0.849
"28841","Pando","Puerto Gonzalo Moreno","U.E. Pedro Herrera",87,0,0,0,64,16,2,2,0,171,4,5,180,225,0.374,0.8
"28842","Pando","Puerto Gonzalo Moreno","U.E. Pedro Herrera",95,0,0,0,67,11,4,1,0,178,2,8,188,228,0.376,0.825
"28843","Pando","Puerto Gonzalo Moreno","U.E. Miraflores",50,1,0,0,119,16,3,3,2,194,1,4,199,236,0.613,0.843
"28844","Pando","Puerto Gonzalo Moreno","U.E. 2 de Agosto",47,2,2,0,115,5,9,4,1,185,2,16,203,241,0.622,0.842
"28845","Pando","San Lorenzo","U.E. Gregoria Destre Maturana",62,0,2,0,134,2,4,1,0,205,4,5,214,229,0.654,0.934
"28846","Pando","San Lorenzo","U.E.  24 de Septiembre",60,1,0,1,96,3,10,2,0,173,3,12,188,233,0.555,0.807
"28847","Pando","San Lorenzo","U.E.  24 de Septiembre",52,1,1,2,103,9,10,2,1,181,5,6,192,235,0.569,0.817
"28848","Pando","San Lorenzo","U.E.  24 de Septiembre",79,0,0,0,84,8,6,1,0,178,1,6,185,235,0.472,0.787
"28849","Pando","San Lorenzo","U.E.  24 de Septiembre",85,0,2,1,77,8,1,1,2,177,2,2,181,236,0.435,0.767
"28850","Pando","San Lorenzo","U.E.  24 de Septiembre",87,0,1,0,93,6,3,2,0,192,2,6,200,234,0.484,0.855
"28851","Pando","San Lorenzo","U.E. Vista Alegre",66,1,2,0,110,9,13,1,0,202,3,6,211,236,0.545,0.894
"28852","Pando","San Lorenzo","U.E. Galilea",18,0,0,0,182,0,1,0,0,201,0,0,201,226,0.905,0.889
"28853","Pando","San Lorenzo","U.E.  Soledad",70,0,0,0,94,10,7,2,0,183,5,4,192,216,0.514,0.889
"28854","Pando","Sena","U.E. El Sena",73,3,2,1,65,12,20,10,0,186,7,8,201,235,0.349,0.855
"28855","Pando","Sena","U.E. El Sena",58,2,2,1,76,19,14,12,0,184,4,18,206,230,0.413,0.896
"28856","Pando","Sena","U.E. El Sena",60,1,1,1,76,10,15,8,2,174,8,15,197,236,0.437,0.835
"28857","Pando","Sena","U.E. El Sena",50,3,2,1,79,9,17,9,0,170,6,13,189,232,0.465,0.815
"28858","Pando","Sena","U.E. El Sena",75,0,1,0,74,6,17,7,2,182,5,6,193,233,0.407,0.828
"28859","Pando","Sena","U.E. El Sena",50,4,0,2,109,14,8,2,0,189,4,7,200,236,0.577,0.847
"28860","Pando","Sena","U.E. El Sena",77,0,1,2,65,8,16,11,0,180,1,15,196,233,0.361,0.841
"28861","Pando","Sena","U.E. El Sena",67,2,2,1,81,8,16,8,0,185,3,10,198,234,0.438,0.846
"28862","Pando","Sena","U.E. El Sena",65,2,0,0,81,14,16,7,0,185,2,10,197,233,0.438,0.845
"28863","Pando","Sena","U.E. El Sena",69,0,0,2,84,9,22,2,0,188,4,11,203,233,0.447,0.871
"28864","Pando","Sena","U.E. Palma Real",59,0,2,0,85,15,5,9,0,175,7,8,190,230,0.486,0.826
"28865","Pando","Sena","U.E. El Turi (Rio Manurape)",39,1,6,0,100,14,7,8,0,175,10,10,195,205,0.571,0.951
"28866","Pando","Sena","U.E. San Francisco",45,2,0,1,102,16,17,4,0,187,4,11,202,227,0.545,0.89
"28867","Pando","Sena","U.E. 4 de Agosto",35,0,1,1,98,9,3,3,2,152,8,9,169,179,0.645,0.944
"28868","Pando","Sena","U. E. Nuestra Señora del Carmen",57,1,2,1,90,4,15,2,0,172,5,5,182,198,0.523,0.919
"28869","Pando","Santa Rosa","U.E.  Zacarias Moreno",86,0,4,1,69,4,8,4,0,176,2,10,188,221,0.392,0.851
"28870","Pando","Santa Rosa","U.E. Genoveva Ríos",11,0,1,0,168,0,12,2,0,194,1,12,207,237,0.866,0.873
"28871","Pando","Ingavi","U.E. Humaita",90,0,4,0,61,7,9,1,2,174,2,9,185,235,0.351,0.787
"28872","Pando","Ingavi","U.E. Humaita",85,0,1,2,59,6,12,0,1,166,4,4,174,211,0.355,0.825
"28873","Pando","Nueva Esperanza","U.E.  Manuel Estremadoiro Martinez",56,0,1,0,82,7,7,1,0,154,4,4,162,233,0.532,0.695
"28874","Pando","Nueva Esperanza","U.E.  Monte Sinai",1,6,0,0,153,0,1,0,1,162,2,5,169,196,0.944,0.862
"28875","Pando","Villa Nueva","U.E.  Andres Idagua",82,1,0,0,88,4,6,2,0,183,3,16,202,233,0.481,0.867
"28876","Pando","Villa Nueva","U.E.  Andres Idagua",95,0,0,0,72,7,6,1,1,182,3,19,204,230,0.396,0.887
"28877","Pando","Villa Nueva","U.E.  Andres Idagua",83,0,0,1,77,3,3,1,1,169,4,25,198,239,0.456,0.828
"28878","Pando","Villa Nueva","U.E.  Roberto Gonzales",37,1,0,1,107,10,3,0,0,159,4,3,166,191,0.673,0.869
"28879","Pando","Santos Mercado","19 de Octubre",84,2,1,0,74,7,4,1,0,173,3,8,184,231,0.428,0.797
"28880","Pando","Santos Mercado","19 de Octubre",81,0,0,0,77,5,5,2,1,171,4,6,181,229,0.45,0.79
"28881","Pando","Santos Mercado","U.E.  23 de Marzo",91,2,0,1,74,9,3,2,0,182,3,10,195,234,0.407,0.833
"28882","Pando","Santos Mercado","U.E.  23 de Marzo",92,0,1,1,57,9,8,1,1,170,3,19,192,233,0.335,0.824
"28883","Pando","Santos Mercado","U.E. 11 de Septiembre",60,0,3,1,83,4,2,0,0,153,4,4,161,202,0.542,0.797
